,level_0,index,date,home_team,away_team,home_score,away_score,tournament,city,country,neutral,total goals,score_dif,Result
0,0,0,1872,Scotland,England,0,0,Friendly,Glasgow,Scotland,False,0,0,Draw
1,1,1,1873,England,Scotland,4,2,Friendly,London,England,False,6,2,England
2,2,2,1874,Scotland,England,2,1,Friendly,Glasgow,Scotland,False,3,1,Scotland
3,3,3,1875,England,Scotland,2,2,Friendly,London,England,False,4,0,Draw
4,4,4,1876,Scotland,England,3,0,Friendly,Glasgow,Scotland,False,3,3,Scotland
5,5,5,1876,Scotland,Wales,4,0,Friendly,Glasgow,Scotland,False,4,4,Scotland
6,6,6,1877,England,Scotland,1,3,Friendly,London,England,False,4,-2,Scotland
7,7,7,1877,Wales,Scotland,0,2,Friendly,Wrexham,Wales,False,2,-2,Scotland
8,8,8,1878,Scotland,England,7,2,Friendly,Glasgow,Scotland,False,9,5,Scotland
9,9,9,1878,Scotland,Wales,9,0,Friendly,Glasgow,Scotland,False,9,9,Scotland
10,10,10,1879,England,Wales,2,1,Friendly,London,England,False,3,1,England
11,11,11,1879,England,Scotland,5,4,Friendly,London,England,False,9,1,England
12,12,12,1879,Wales,Scotland,0,3,Friendly,Wrexham,Wales,False,3,-3,Scotland
13,13,13,1880,Scotland,England,5,4,Friendly,Glasgow,Scotland,False,9,1,Scotland
14,14,14,1880,Wales,England,2,3,Friendly,Wrexham,Wales,False,5,-1,England
15,15,15,1880,Scotland,Wales,5,1,Friendly,Glasgow,Scotland,False,6,4,Scotland
16,16,16,1881,England,Wales,0,1,Friendly,Blackburn,England,False,1,-1,Wales
17,17,17,1881,England,Scotland,1,6,Friendly,London,England,False,7,-5,Scotland
18,18,18,1881,Wales,Scotland,1,5,Friendly,Wrexham,Wales,False,6,-4,Scotland
19,19,19,1882,Northern Ireland,England,0,13,Friendly,Belfast,Republic of Ireland,False,13,-13,England
20,20,20,1882,Wales,Northern Ireland,7,1,Friendly,Wrexham,Wales,False,8,6,Wales
21,21,21,1882,Scotland,England,5,1,Friendly,Glasgow,Scotland,False,6,4,Scotland
22,22,22,1882,Wales,England,5,3,Friendly,Wrexham,Wales,False,8,2,Wales
23,23,23,1882,Scotland,Wales,5,0,Friendly,Glasgow,Scotland,False,5,5,Scotland
24,24,24,1883,England,Wales,5,0,Friendly,London,England,False,5,5,England
25,25,25,1883,England,Northern Ireland,7,0,Friendly,Liverpool,England,False,7,7,England
26,26,26,1883,England,Scotland,2,3,Friendly,Sheffield,England,False,5,-1,Scotland
27,27,27,1883,Wales,Scotland,0,3,Friendly,Wrexham,Wales,False,3,-3,Scotland
28,28,28,1883,Northern Ireland,Wales,1,1,Friendly,Belfast,Republic of Ireland,False,2,0,Draw
29,29,29,1884,Northern Ireland,Scotland,0,5,British Championship,Belfast,Republic of Ireland,False,5,-5,Scotland
30,30,30,1884,Wales,Northern Ireland,6,0,British Championship,Wrexham,Wales,False,6,6,Wales
31,31,31,1884,Northern Ireland,England,1,8,British Championship,Belfast,Republic of Ireland,False,9,-7,England
32,32,32,1884,Scotland,England,1,0,British Championship,Glasgow,Scotland,False,1,1,Scotland
33,33,33,1884,Wales,England,0,4,British Championship,Wrexham,Wales,False,4,-4,England
34,34,34,1884,Scotland,Wales,4,1,British Championship,Glasgow,Scotland,False,5,3,Scotland
35,35,35,1885,England,Northern Ireland,4,0,British Championship,Manchester,England,False,4,4,England
36,36,36,1885,England,Wales,1,1,British Championship,Blackburn,England,False,2,0,Draw
37,37,37,1885,Scotland,Northern Ireland,8,2,British Championship,Glasgow,Scotland,False,10,6,Scotland
38,38,38,1885,England,Scotland,1,1,British Championship,London,England,False,2,0,Draw
39,39,39,1885,Wales,Scotland,1,8,British Championship,Wrexham,Wales,False,9,-7,Scotland
40,40,40,1885,Northern Ireland,Wales,2,8,British Championship,Belfast,Republic of Ireland,False,10,-6,Wales
41,41,41,1885,United States,Canada,0,1,Friendly,Newark,United States,False,1,-1,Canada
42,42,42,1886,Wales,Northern Ireland,5,0,British Championship,Wrexham,Wales,False,5,5,Wales
43,43,43,1886,Northern Ireland,England,1,6,British Championship,Belfast,Republic of Ireland,False,7,-5,England
44,44,44,1886,Northern Ireland,Scotland,2,7,British Championship,Belfast,Republic of Ireland,False,9,-5,Scotland
45,45,45,1886,Scotland,England,1,1,British Championship,Glasgow,Scotland,False,2,0,Draw
46,46,46,1886,Wales,England,1,3,British Championship,Wrexham,Wales,False,4,-2,England
47,47,47,1886,Scotland,Wales,4,1,British Championship,Glasgow,Scotland,False,5,3,Scotland
48,48,48,1886,United States,Canada,3,2,Friendly,Newark,United States,False,5,1,United States
49,49,49,1887,England,Northern Ireland,7,0,British Championship,Sheffield,England,False,7,7,England
50,50,50,1887,Scotland,Northern Ireland,4,1,British Championship,Glasgow,Scotland,False,5,3,Scotland
51,51,51,1887,England,Wales,4,0,British Championship,London,England,False,4,4,England
52,52,52,1887,Northern Ireland,Wales,4,1,British Championship,Belfast,Republic of Ireland,False,5,3,Northern Ireland
53,53,53,1887,England,Scotland,2,3,British Championship,Blackburn,England,False,5,-1,Scotland
54,54,54,1887,Wales,Scotland,0,2,British Championship,Wrexham,Wales,False,2,-2,Scotland
55,55,55,1888,England,Wales,5,1,British Championship,Crewe,England,False,6,4,England
56,56,56,1888,Wales,Northern Ireland,11,0,British Championship,Wrexham,Wales,False,11,11,Wales
57,57,57,1888,Scotland,Wales,5,1,British Championship,Edinburgh,Scotland,False,6,4,Scotland
58,58,58,1888,Scotland,England,0,5,British Championship,Glasgow,Scotland,False,5,-5,England
59,59,59,1888,Northern Ireland,Scotland,2,10,British Championship,Belfast,Republic of Ireland,False,12,-8,Scotland
60,60,60,1888,Northern Ireland,England,1,5,British Championship,Belfast,Republic of Ireland,False,6,-4,England
61,61,61,1888,Scotland,Canada,4,0,Friendly,Glasgow,Scotland,False,4,4,Scotland
62,62,62,1889,England,Wales,4,1,British Championship,Stoke-on-Trent,England,False,5,3,England
63,63,63,1889,England,Northern Ireland,6,1,British Championship,Liverpool,England,False,7,5,England
64,64,64,1889,Scotland,Northern Ireland,7,0,British Championship,Glasgow,Scotland,False,7,7,Scotland
65,65,65,1889,England,Scotland,2,3,British Championship,London,England,False,5,-1,Scotland
66,66,66,1889,Wales,Scotland,0,0,British Championship,Wrexham,Wales,False,0,0,Draw
67,67,67,1889,Northern Ireland,Wales,1,3,British Championship,Belfast,Republic of Ireland,False,4,-2,Wales
68,68,68,1890,Wales,Northern Ireland,5,2,British Championship,Shrewsbury,England,True,7,3,Wales
69,69,69,1890,Northern Ireland,England,1,9,British Championship,Belfast,Republic of Ireland,False,10,-8,England
70,70,70,1890,Wales,England,1,3,British Championship,Wrexham,Wales,False,4,-2,England
71,71,71,1890,Scotland,Wales,5,0,British Championship,Paisley,Scotland,False,5,5,Scotland
72,72,72,1890,Northern Ireland,Scotland,1,4,British Championship,Belfast,Republic of Ireland,False,5,-3,Scotland
73,73,73,1890,Scotland,England,1,1,British Championship,Glasgow,Scotland,False,2,0,Draw
74,74,74,1891,Northern Ireland,Wales,7,2,British Championship,Belfast,Republic of Ireland,False,9,5,Northern Ireland
75,75,75,1891,England,Wales,4,1,British Championship,Sunderland,England,False,5,3,England
76,76,76,1891,England,Northern Ireland,6,1,British Championship,Wolverhampton,England,False,7,5,England
77,77,77,1891,Wales,Scotland,3,4,British Championship,Wrexham,Wales,False,7,-1,Scotland
78,78,78,1891,Scotland,Northern Ireland,2,1,British Championship,Glasgow,Scotland,False,3,1,Scotland
79,79,79,1892,Wales,Northern Ireland,1,1,British Championship,Bangor,Wales,False,2,0,Draw
80,80,80,1892,Northern Ireland,England,0,2,British Championship,Belfast,Republic of Ireland,False,2,-2,England
81,81,81,1892,Wales,England,0,2,British Championship,Wrexham,Wales,False,2,-2,England
82,82,82,1892,Northern Ireland,Scotland,2,3,British Championship,Belfast,Republic of Ireland,False,5,-1,Scotland
83,83,83,1892,Scotland,Wales,6,1,British Championship,Edinburgh,Scotland,False,7,5,Scotland
84,84,84,1892,Scotland,England,1,4,British Championship,Glasgow,Scotland,False,5,-3,England
85,85,85,1893,England,Northern Ireland,6,1,British Championship,Birmingham,England,False,7,5,England
86,86,86,1893,England,Wales,6,0,British Championship,Stoke-on-Trent,England,False,6,6,England
87,87,87,1893,Wales,Scotland,0,8,British Championship,Wrexham,Wales,False,8,-8,Scotland
88,88,88,1893,Scotland,Northern Ireland,6,1,British Championship,Glasgow,Scotland,False,7,5,Scotland
89,89,89,1893,England,Scotland,5,2,British Championship,Richmond,England,False,7,3,England
90,90,90,1894,Wales,Northern Ireland,4,1,British Championship,Swansea,Wales,False,5,3,Wales
91,91,91,1894,Northern Ireland,England,2,2,British Championship,Belfast,Republic of Ireland,False,4,0,Draw
92,92,92,1894,Wales,England,1,5,British Championship,Wrexham,Wales,False,6,-4,England
93,93,93,1894,Scotland,Wales,5,2,British Championship,Kilmarnock,Scotland,False,7,3,Scotland
94,94,94,1894,Northern Ireland,Scotland,1,2,British Championship,Belfast,Republic of Ireland,False,3,-1,Scotland
95,95,95,1894,Scotland,England,2,2,British Championship,Glasgow,Scotland,False,4,0,Draw
96,96,96,1895,England,Northern Ireland,9,0,British Championship,Derby,England,False,9,9,England
97,97,97,1895,Northern Ireland,Wales,2,2,British Championship,Belfast,Republic of Ireland,False,4,0,Draw
98,98,98,1895,England,Wales,1,1,British Championship,London,England,False,2,0,Draw
99,99,99,1895,Wales,Scotland,2,2,British Championship,Wrexham,Wales,False,4,0,Draw
100,100,100,1895,Scotland,Northern Ireland,3,1,British Championship,Glasgow,Scotland,False,4,2,Scotland
101,101,101,1895,England,Scotland,3,0,British Championship,Liverpool,England,False,3,3,England
102,102,102,1896,Wales,Northern Ireland,6,1,British Championship,Wrexham,Wales,False,7,5,Wales
103,103,103,1896,Northern Ireland,England,0,2,British Championship,Belfast,Republic of Ireland,False,2,-2,England
104,104,104,1896,Wales,England,1,9,British Championship,Cardiff,Wales,False,10,-8,England
105,105,105,1896,Scotland,Wales,4,0,British Championship,Dundee,Scotland,False,4,4,Scotland
106,106,106,1896,Northern Ireland,Scotland,3,3,British Championship,Belfast,Republic of Ireland,False,6,0,Draw
107,107,107,1896,Scotland,England,2,1,British Championship,Glasgow,Scotland,False,3,1,Scotland
108,108,108,1897,England,Northern Ireland,6,0,British Championship,Nottingham,England,False,6,6,England
109,109,109,1897,Northern Ireland,Wales,4,3,British Championship,Belfast,Republic of Ireland,False,7,1,Northern Ireland
110,110,110,1897,Wales,Scotland,2,2,British Championship,Wrexham,Wales,False,4,0,Draw
111,111,111,1897,Scotland,Northern Ireland,5,1,British Championship,Glasgow,Scotland,False,6,4,Scotland
112,112,112,1897,England,Wales,4,0,British Championship,Sheffield,England,False,4,4,England
113,113,113,1897,England,Scotland,1,2,British Championship,London,England,False,3,-1,Scotland
114,114,114,1898,Wales,Northern Ireland,0,1,British Championship,Llandudno,Wales,False,1,-1,Northern Ireland
115,115,115,1898,Northern Ireland,England,2,3,British Championship,Belfast,Republic of Ireland,False,5,-1,England
116,116,116,1898,Scotland,Wales,5,2,British Championship,Motherwell,Scotland,False,7,3,Scotland
117,117,117,1898,Northern Ireland,Scotland,0,3,British Championship,Belfast,Republic of Ireland,False,3,-3,Scotland
118,118,118,1898,Wales,England,0,3,British Championship,Wrexham,Wales,False,3,-3,England
119,119,119,1898,Scotland,England,1,3,British Championship,Glasgow,Scotland,False,4,-2,England
120,120,120,1899,England,Northern Ireland,13,2,British Championship,Sunderland,England,False,15,11,England
121,121,121,1899,Northern Ireland,Wales,1,0,British Championship,Belfast,Republic of Ireland,False,1,1,Northern Ireland
122,122,122,1899,Wales,Scotland,0,6,British Championship,Wrexham,Wales,False,6,-6,Scotland
123,123,123,1899,England,Wales,4,0,British Championship,Bristol,England,False,4,4,England
124,124,124,1899,Scotland,Northern Ireland,9,1,British Championship,Glasgow,Scotland,False,10,8,Scotland
125,125,125,1899,England,Scotland,2,1,British Championship,Birmingham,England,False,3,1,England
126,126,126,1900,Scotland,Wales,5,2,British Championship,Aberdeen,Scotland,False,7,3,Scotland
127,127,127,1900,Wales,Northern Ireland,2,0,British Championship,Llandudno,Wales,False,2,2,Wales
128,128,128,1900,Northern Ireland,Scotland,0,3,British Championship,Belfast,Republic of Ireland,False,3,-3,Scotland
129,129,129,1900,Northern Ireland,England,0,2,British Championship,Dublin,Republic of Ireland,False,2,-2,England
130,130,130,1900,Wales,England,1,1,British Championship,Cardiff,Wales,False,2,0,Draw
131,131,131,1900,Scotland,England,4,1,British Championship,Glasgow,Scotland,False,5,3,Scotland
132,132,132,1901,Scotland,Northern Ireland,11,0,British Championship,Glasgow,Scotland,False,11,11,Scotland
133,133,133,1901,Wales,Scotland,1,1,British Championship,Wrexham,Wales,False,2,0,Draw
134,134,134,1901,England,Northern Ireland,3,0,British Championship,Southampton,England,False,3,3,England
135,135,135,1901,England,Wales,6,0,British Championship,Newcastle,England,False,6,6,England
136,136,136,1901,Northern Ireland,Wales,0,1,British Championship,Belfast,Republic of Ireland,False,1,-1,Wales
137,137,137,1901,England,Scotland,2,2,British Championship,London,England,False,4,0,Draw
138,138,138,1902,Wales,Northern Ireland,0,3,British Championship,Cardiff,Wales,False,3,-3,Northern Ireland
139,139,139,1902,Northern Ireland,Scotland,1,5,British Championship,Belfast,Republic of Ireland,False,6,-4,Scotland
140,140,140,1902,Wales,England,0,0,British Championship,Wrexham,Wales,False,0,0,Draw
141,141,141,1902,Scotland,Wales,5,1,British Championship,Greenock,Scotland,False,6,4,Scotland
142,142,142,1902,Northern Ireland,England,0,1,British Championship,Belfast,Republic of Ireland,False,1,-1,England
143,143,143,1902,England,Scotland,2,2,British Championship,Birmingham,England,False,4,0,Draw
144,144,144,1902,Uruguay,Argentina,0,6,Friendly,Montevideo,Uruguay,False,6,-6,Argentina
145,145,145,1902,Austria,Hungary,5,0,Friendly,Vienna,Austria,False,5,5,Austria
146,146,146,1903,England,Wales,2,1,British Championship,Portsmouth,England,False,3,1,England
147,147,147,1903,Wales,Scotland,0,1,British Championship,Cardiff,Wales,False,1,-1,Scotland
148,148,148,1903,Scotland,Northern Ireland,0,2,British Championship,Glasgow,Scotland,False,2,-2,Northern Ireland
149,149,149,1903,Northern Ireland,Wales,2,0,British Championship,Belfast,Republic of Ireland,False,2,2,Northern Ireland
150,150,150,1903,England,Scotland,1,2,British Championship,Sheffield,England,False,3,-1,Scotland
151,152,152,1903,Argentina,Uruguay,2,3,Friendly,Buenos Aires,Argentina,False,5,-1,Uruguay
152,153,153,1903,Austria,Hungary,4,2,Friendly,Vienna,Austria,False,6,2,Austria
153,154,154,1904,Wales,England,2,2,British Championship,Wrexham,Wales,False,4,0,Draw
154,155,155,1904,Northern Ireland,England,1,3,British Championship,Belfast,Republic of Ireland,False,4,-2,England
155,156,156,1904,Scotland,Wales,1,1,British Championship,Dundee,Scotland,False,2,0,Draw
156,157,157,1904,Wales,Northern Ireland,0,1,British Championship,Bangor,Wales,False,1,-1,Northern Ireland
157,158,158,1904,Northern Ireland,Scotland,1,1,British Championship,Dublin,Republic of Ireland,False,2,0,Draw
158,159,159,1904,Scotland,England,0,1,British Championship,Glasgow,Scotland,False,1,-1,England
159,160,160,1904,Belgium,France,3,3,Friendly,Brussels,Belgium,False,6,0,Draw
160,161,161,1904,Hungary,Austria,3,0,Friendly,Budapest,Hungary,False,3,3,Hungary
161,162,162,1905,France,Switzerland,1,0,Friendly,Paris,France,False,1,1,France
162,163,163,1905,England,Northern Ireland,1,1,British Championship,Middlesbrough,England,False,2,0,Draw
163,164,164,1905,Wales,Scotland,3,1,British Championship,Wrexham,Wales,False,4,2,Wales
164,165,165,1905,Scotland,Northern Ireland,4,0,British Championship,Glasgow,Scotland,False,4,4,Scotland
165,166,166,1905,England,Wales,3,1,British Championship,Liverpool,England,False,4,2,England
166,167,167,1905,England,Scotland,1,0,British Championship,London,England,False,1,1,England
167,168,168,1905,Northern Ireland,Wales,2,2,British Championship,Belfast,Republic of Ireland,False,4,0,Draw
168,169,169,1905,Hungary,Austria,0,0,Friendly,Budapest,Hungary,False,0,0,Draw
169,170,170,1905,Belgium,Netherlands,1,4,Friendly,Antwerp,Belgium,False,5,-3,Netherlands
170,171,171,1905,Belgium,France,7,0,Friendly,Brussels,Belgium,False,7,7,Belgium
171,172,172,1905,Netherlands,Belgium,4,0,Friendly,Rotterdam,Netherlands,False,4,4,Netherlands
172,173,173,1905,Argentina,Uruguay,0,0,Copa Lipton,Buenos Aires,Argentina,False,0,0,Draw
173,174,174,1906,Northern Ireland,England,0,5,British Championship,Belfast,Republic of Ireland,False,5,-5,England
174,175,175,1906,Scotland,Wales,0,2,British Championship,Edinburgh,Scotland,False,2,-2,Wales
175,176,176,1906,Northern Ireland,Scotland,0,1,British Championship,Dublin,Republic of Ireland,False,1,-1,Scotland
176,177,177,1906,Wales,England,0,1,British Championship,Cardiff,Wales,False,1,-1,England
177,179,179,1906,Wales,Northern Ireland,4,4,British Championship,Wrexham,Wales,False,8,0,Draw
178,180,180,1906,Scotland,England,2,1,British Championship,Glasgow,Scotland,False,3,1,Scotland
179,181,181,1906,France,Belgium,0,5,Friendly,Saint-Cloud,France,False,5,-5,Belgium
180,182,182,1906,Belgium,Netherlands,5,0,Friendly,Antwerp,Belgium,False,5,5,Belgium
181,183,183,1906,Netherlands,Belgium,2,3,Friendly,Rotterdam,Netherlands,False,5,-1,Belgium
182,184,184,1906,Uruguay,Argentina,0,2,Copa Lipton,Montevideo,Uruguay,False,2,-2,Argentina
183,185,186,1906,Argentina,Uruguay,2,1,Copa Newton,Buenos Aires,Argentina,False,3,1,Argentina
184,186,187,1906,Hungary,Austria,3,1,Friendly,Budapest,Hungary,False,4,2,Hungary
185,187,188,1907,England,Northern Ireland,1,0,British Championship,Liverpool,England,False,1,1,England
186,188,189,1907,Northern Ireland,Wales,2,3,British Championship,Belfast,Republic of Ireland,False,5,-1,Wales
187,189,190,1907,Wales,Scotland,1,0,British Championship,Wrexham,Wales,False,1,1,Wales
188,190,191,1907,Scotland,Northern Ireland,3,0,British Championship,Glasgow,Scotland,False,3,3,Scotland
189,191,192,1907,England,Wales,1,1,British Championship,London,England,False,2,0,Draw
190,192,193,1907,England,Scotland,1,1,British Championship,Newcastle,England,False,2,0,Draw
191,194,195,1907,Belgium,Netherlands,1,3,Friendly,Antwerp,Belgium,False,4,-2,Netherlands
192,195,196,1907,Belgium,France,1,2,Friendly,Brussels,Belgium,False,3,-1,France
193,196,197,1907,Austria,Hungary,3,1,Friendly,Vienna,Austria,False,4,2,Austria
194,197,198,1907,Netherlands,Belgium,1,2,Friendly,Haarlem,Netherlands,False,3,-1,Belgium
195,198,200,1907,Hungary,Austria,4,1,Friendly,Budapest,Hungary,False,5,3,Hungary
196,199,201,1908,Northern Ireland,England,1,3,British Championship,Belfast,Republic of Ireland,False,4,-2,England
197,200,202,1908,Scotland,Wales,2,1,British Championship,Dundee,Scotland,False,3,1,Scotland
198,201,203,1908,Switzerland,France,1,2,Friendly,Geneva,Switzerland,False,3,-1,France
199,202,204,1908,Northern Ireland,Scotland,0,5,British Championship,Dublin,Republic of Ireland,False,5,-5,Scotland
200,203,205,1908,Wales,England,1,7,British Championship,Wrexham,Wales,False,8,-6,England
201,204,206,1908,Belgium,Netherlands,1,4,Friendly,Antwerp,Belgium,False,5,-3,Netherlands
202,205,207,1908,Scotland,England,1,1,British Championship,Glasgow,Scotland,False,2,0,Draw
203,207,209,1908,Switzerland,Germany,5,3,Friendly,Basel,Switzerland,False,8,2,Switzerland
204,208,210,1908,Wales,Northern Ireland,0,1,British Championship,Aberdare,Wales,False,1,-1,Northern Ireland
205,209,211,1908,France,Belgium,1,2,Friendly,Colombes,France,False,3,-1,Belgium
206,210,212,1908,Netherlands,Belgium,3,1,Friendly,Rotterdam,Netherlands,False,4,2,Netherlands
207,211,213,1908,Austria,Hungary,4,0,Friendly,Vienna,Austria,False,4,4,Austria
208,212,214,1908,Netherlands,France,4,1,Friendly,Rotterdam,Netherlands,False,5,3,Netherlands
209,213,215,1908,Austria,England,1,6,Friendly,Vienna,Austria,False,7,-5,England
210,214,216,1908,Austria,Germany,3,2,Friendly,Vienna,Austria,False,5,1,Austria
211,215,217,1908,Austria,England,1,11,Friendly,Vienna,Austria,False,12,-10,England
212,216,218,1908,Hungary,England,0,7,Friendly,Budapest,Hungary,False,7,-7,England
213,217,220,1908,Sweden,Norway,11,3,Friendly,Gothenburg,Sweden,False,14,8,Sweden
214,218,221,1908,Uruguay,Argentina,2,2,Copa Lipton,Montevideo,Uruguay,False,4,0,Draw
215,219,222,1908,Argentina,Uruguay,2,1,Copa Newton,Buenos Aires,Argentina,False,3,1,Argentina
216,220,223,1908,Argentina,Uruguay,0,1,Copa Premio Honor Argentino,Buenos Aires,Argentina,False,1,-1,Uruguay
217,221,224,1908,Netherlands,Sweden,5,3,Friendly,The Hague,Netherlands,False,8,2,Netherlands
218,222,225,1908,Belgium,Sweden,2,1,Friendly,Brussels,Belgium,False,3,1,Belgium
219,223,226,1908,Hungary,Austria,5,3,Friendly,Budapest,Hungary,False,8,2,Hungary
220,224,227,1909,England,Northern Ireland,4,0,British Championship,Bradford,England,False,4,4,England
221,225,228,1909,Wales,Scotland,3,2,British Championship,Wrexham,Wales,False,5,1,Wales
222,226,229,1909,England,Wales,2,0,British Championship,Nottingham,England,False,2,2,England
223,227,230,1909,Scotland,Northern Ireland,5,0,British Championship,Glasgow,Scotland,False,5,5,Scotland
224,228,231,1909,Northern Ireland,Wales,2,3,British Championship,Belfast,Republic of Ireland,False,5,-1,Wales
225,229,232,1909,Belgium,Netherlands,1,4,Friendly,Antwerp,Belgium,False,5,-3,Netherlands
226,230,233,1909,England,Scotland,2,0,British Championship,London,England,False,2,2,England
227,231,234,1909,Germany,Switzerland,1,0,Friendly,Karlsruhe,Germany,False,1,1,Germany
228,232,235,1909,Hungary,Germany,3,3,Friendly,Budapest,Hungary,False,6,0,Draw
229,233,236,1909,Netherlands,Belgium,4,1,Friendly,Rotterdam,Netherlands,False,5,3,Netherlands
230,234,237,1909,Austria,Hungary,3,4,Friendly,Vienna,Austria,False,7,-1,Hungary
231,235,238,1909,Belgium,France,5,2,Friendly,Brussels,Belgium,False,7,3,Belgium
232,236,239,1909,Hungary,England,2,4,Friendly,Budapest,Hungary,False,6,-2,England
233,237,240,1909,Hungary,Austria,1,1,Friendly,Budapest,Hungary,False,2,0,Draw
234,238,241,1909,Hungary,England,2,8,Friendly,Budapest,Hungary,False,10,-6,England
235,239,242,1909,Austria,England,1,8,Friendly,Vienna,Austria,False,9,-7,England
236,240,243,1909,Argentina,Uruguay,2,1,Copa Lipton,Buenos Aires,Argentina,False,3,1,Argentina
237,241,244,1909,Uruguay,Argentina,2,2,Copa Newton,Montevideo,Uruguay,False,4,0,Draw
238,242,245,1909,Argentina,Uruguay,3,1,Copa Premio Honor Argentino,Buenos Aires,Argentina,False,4,2,Argentina
239,243,246,1910,Northern Ireland,England,1,1,British Championship,Belfast,Republic of Ireland,False,2,0,Draw
240,244,247,1910,Scotland,Wales,1,0,British Championship,Kilmarnock,Scotland,False,1,1,Scotland
241,245,248,1910,Belgium,Netherlands,3,2,Friendly,Antwerp,Belgium,False,5,1,Belgium
242,246,249,1910,Wales,England,0,1,British Championship,Cardiff,Wales,False,1,-1,England
243,247,250,1910,Northern Ireland,Scotland,1,0,British Championship,Belfast,Republic of Ireland,False,1,1,Northern Ireland
244,248,251,1910,Scotland,England,2,0,British Championship,Glasgow,Scotland,False,2,2,Scotland
245,249,252,1910,France,Belgium,0,4,Friendly,Gentilly,France,False,4,-4,Belgium
246,250,253,1910,Switzerland,Germany,2,3,Friendly,Basel,Switzerland,False,5,-1,Germany
247,251,254,1910,Netherlands,Belgium,7,0,Friendly,Haarlem,Netherlands,False,7,7,Netherlands
248,252,255,1910,Wales,Northern Ireland,4,1,British Championship,Wrexham,Wales,False,5,3,Wales
249,253,256,1910,Netherlands,Germany,4,2,Friendly,Arnhem,Netherlands,False,6,2,Netherlands
250,254,257,1910,Austria,Hungary,2,1,Friendly,Vienna,Austria,False,3,1,Austria
251,255,258,1910,Italy,France,6,2,Friendly,Milan,Italy,False,8,4,Italy
252,256,259,1910,Germany,Belgium,0,3,Friendly,Duisburg,Germany,False,3,-3,Belgium
253,257,260,1910,Hungary,Italy,6,1,Friendly,Budapest,Hungary,False,7,5,Hungary
254,258,261,1910,Argentina,Chile,3,1,Friendly,Buenos Aires,Argentina,False,4,2,Argentina
255,259,262,1910,Chile,Uruguay,0,3,Friendly,Buenos Aires,Argentina,True,3,-3,Uruguay
256,260,263,1910,Argentina,Chile,5,1,Friendly,Buenos Aires,Argentina,False,6,4,Argentina
257,261,264,1910,Argentina,Uruguay,4,1,Friendly,Buenos Aires,Argentina,False,5,3,Argentina
258,262,265,1910,Uruguay,Argentina,3,1,Copa Lipton,Montevideo,Uruguay,False,4,2,Uruguay
259,263,266,1910,Chile,Argentina,0,3,Friendly,Viña del Mar,Chile,False,3,-3,Argentina
260,264,267,1910,Norway,Sweden,0,4,Friendly,Kristiania,Norway,False,4,-4,Sweden
261,265,268,1910,Germany,Netherlands,1,2,Friendly,Kleve,Germany,False,3,-1,Netherlands
262,266,269,1910,Hungary,Austria,3,0,Friendly,Budapest,Hungary,False,3,3,Hungary
263,267,270,1910,Argentina,Uruguay,1,1,Copa Premio Honor Argentino,Buenos Aires,Argentina,False,2,0,Draw
264,268,271,1910,Argentina,Uruguay,2,6,Copa Premio Honor Argentino,Buenos Aires,Argentina,False,8,-4,Uruguay
265,269,272,1911,France,Hungary,0,3,Friendly,Maisons-Alfort,France,False,3,-3,Hungary
266,270,273,1911,Italy,Hungary,0,1,Friendly,Milan,Italy,False,1,-1,Hungary
267,271,274,1911,Switzerland,Hungary,2,0,Friendly,Zürich,Switzerland,False,2,2,Switzerland
268,272,275,1911,Northern Ireland,Wales,1,2,British Championship,Belfast,Republic of Ireland,False,3,-1,Wales
269,273,276,1911,England,Northern Ireland,2,1,British Championship,Derby,England,False,3,1,England
270,274,277,1911,Wales,Scotland,2,2,British Championship,Cardiff,Wales,False,4,0,Draw
271,275,278,1911,England,Wales,3,0,British Championship,London,England,False,3,3,England
272,276,279,1911,Scotland,Northern Ireland,2,0,British Championship,Glasgow,Scotland,False,2,2,Scotland
273,277,280,1911,Belgium,Netherlands,1,5,Friendly,Antwerp,Belgium,False,6,-4,Netherlands
274,278,281,1911,Germany,Switzerland,6,2,Friendly,Stuttgart,Germany,False,8,4,Germany
275,279,282,1911,England,Scotland,1,1,British Championship,Liverpool,England,False,2,0,Draw
276,280,283,1911,Netherlands,Belgium,3,1,Friendly,Dordrecht,Netherlands,False,4,2,Netherlands
277,281,284,1911,France,Italy,2,2,Friendly,Saint-Ouen,France,False,4,0,Draw
278,282,285,1911,Belgium,Germany,2,1,Friendly,Liège,Belgium,False,3,1,Belgium
279,283,286,1911,Switzerland,France,5,2,Friendly,Geneva,Switzerland,False,7,3,Switzerland
280,284,287,1911,Belgium,France,7,1,Friendly,Uccle,Belgium,False,8,6,Belgium
281,285,288,1911,Austria,Hungary,3,1,Friendly,Vienna,Austria,False,4,2,Austria
282,286,289,1911,Italy,Switzerland,2,2,Friendly,Milan,Italy,False,4,0,Draw
283,287,290,1911,Switzerland,Italy,3,0,Friendly,La Chaux-de-Fonds,Switzerland,False,3,3,Switzerland
284,288,291,1911,Sweden,Germany,2,4,Friendly,Solna,Sweden,False,6,-2,Germany
285,289,292,1911,Argentina,Uruguay,0,2,Copa Lipton,Buenos Aires,Argentina,False,2,-2,Uruguay
286,290,293,1911,Sweden,Norway,4,1,Friendly,Solna,Sweden,False,5,3,Sweden
287,291,294,1911,Uruguay,Argentina,2,3,Copa Newton,Montevideo,Uruguay,False,5,-1,Argentina
288,292,295,1911,Uruguay,Argentina,1,1,Copa Premio Honor Uruguayo,Montevideo,Uruguay,False,2,0,Draw
289,293,296,1911,Germany,Austria,1,2,Friendly,Dresden,Germany,False,3,-1,Austria
290,294,297,1911,Argentina,Uruguay,2,0,Copa Premio Honor Argentino,Buenos Aires,Argentina,False,2,2,Argentina
291,295,298,1911,Finland,Sweden,2,5,Friendly,Helsinki,Finland,False,7,-3,Sweden
292,296,299,1911,Germany,Sweden,1,3,Friendly,Hamburg,Germany,False,4,-2,Sweden
293,297,300,1911,Hungary,Switzerland,9,0,Friendly,Budapest,Hungary,False,9,9,Hungary
294,298,301,1911,Luxembourg,France,1,4,Friendly,Luxembourg,Luxembourg,False,5,-3,France
295,299,302,1911,Uruguay,Argentina,3,0,Copa Premio Honor Uruguayo,Montevideo,Uruguay,False,3,3,Uruguay
296,300,303,1911,Hungary,Austria,2,0,Friendly,Budapest,Hungary,False,2,2,Hungary
297,301,304,1911,Germany,Hungary,1,4,Friendly,Munich,Germany,False,5,-3,Hungary
298,302,305,1912,France,Belgium,1,1,Friendly,Saint-Ouen,France,False,2,0,Draw
299,303,306,1912,Northern Ireland,England,1,6,British Championship,Dublin,Republic of Ireland,False,7,-5,England
300,305,308,1912,France,Switzerland,4,1,Friendly,Saint-Ouen,France,False,5,3,France
301,306,309,1912,Belgium,Switzerland,9,2,Friendly,Antwerp,Belgium,False,11,7,Belgium
302,307,310,1912,Scotland,Wales,1,0,British Championship,Edinburgh,Scotland,False,1,1,Scotland
303,308,311,1912,Belgium,Netherlands,1,2,Friendly,Antwerp,Belgium,False,3,-1,Netherlands
304,309,312,1912,Wales,England,0,2,British Championship,Wrexham,Wales,False,2,-2,England
305,310,313,1912,Northern Ireland,Scotland,1,4,British Championship,Belfast,Republic of Ireland,False,5,-3,Scotland
306,311,314,1912,Italy,France,3,4,Friendly,Turin,Italy,False,7,-1,France
307,312,315,1912,Scotland,England,1,1,British Championship,Glasgow,Scotland,False,2,0,Draw
308,313,316,1912,Netherlands,Germany,5,5,Friendly,Zwolle,Netherlands,False,10,0,Draw
309,314,317,1912,Wales,Northern Ireland,2,3,British Championship,Cardiff,Wales,False,5,-1,Northern Ireland
310,315,318,1912,Hungary,Germany,4,4,Friendly,Budapest,Hungary,False,8,0,Draw
311,316,319,1912,Netherlands,Belgium,4,3,Friendly,Dordrecht,Netherlands,False,7,1,Netherlands
312,317,320,1912,Austria,Hungary,1,1,Friendly,Vienna,Austria,False,2,0,Draw
313,318,321,1912,Switzerland,Germany,1,2,Friendly,St. Gallen,Switzerland,False,3,-1,Germany
314,319,322,1912,Norway,Sweden,1,2,Friendly,Kristiania,Norway,False,3,-1,Sweden
315,320,323,1912,Sweden,Hungary,2,2,Friendly,Gothenburg,Sweden,False,4,0,Draw
316,321,324,1912,Norway,Hungary,0,6,Friendly,Kristiania,Norway,False,6,-6,Hungary
317,322,325,1912,Sweden,Finland,7,1,Friendly,Solna,Sweden,False,8,6,Sweden
318,323,326,1912,Norway,Russia,2,1,Friendly,Stockholm,Sweden,True,3,1,Norway
319,324,327,1912,Russia,Hungary,0,9,Friendly,Moscow,Russia,False,9,-9,Hungary
320,325,328,1912,Russia,Hungary,0,12,Friendly,Moscow,Russia,False,12,-12,Hungary
321,326,329,1912,Uruguay,Argentina,2,0,Copa Lipton,Montevideo,Uruguay,False,2,2,Uruguay
322,327,330,1912,Uruguay,Argentina,3,0,Copa Premio Honor Uruguayo,Montevideo,Uruguay,False,3,3,Uruguay
323,328,331,1912,Argentina,Uruguay,0,1,Copa Premio Honor Argentino,Buenos Aires,Argentina,False,1,-1,Uruguay
324,329,332,1912,Argentina,Uruguay,3,3,Copa Newton,Avellaneda,Argentina,False,6,0,Draw
325,330,333,1912,Denmark,Germany,3,1,Friendly,Copenhagen,Denmark,False,4,2,Denmark
326,331,334,1912,Hungary,Austria,4,0,Friendly,Budapest,Hungary,False,4,4,Hungary
327,332,335,1912,Sweden,Norway,4,2,Friendly,Gothenburg,Sweden,False,6,2,Sweden
328,333,336,1912,Germany,Netherlands,2,3,Friendly,Leipzig,Germany,False,5,-1,Netherlands
329,334,337,1912,Uruguay,Argentina,1,3,Friendly,Montevideo,Uruguay,False,4,-2,Argentina
330,335,339,1912,Italy,Austria,1,3,Friendly,Genoa,Italy,False,4,-2,Austria
331,336,340,1913,France,Italy,1,0,Friendly,Saint-Ouen,France,False,1,1,France
332,337,341,1913,Northern Ireland,Wales,0,1,British Championship,Belfast,Republic of Ireland,False,1,-1,Wales
333,338,342,1913,Northern Ireland,England,2,1,British Championship,Belfast,Republic of Ireland,False,3,1,Northern Ireland
334,339,343,1913,Belgium,France,3,0,Friendly,Brussels,Belgium,False,3,3,Belgium
335,340,344,1913,Wales,Scotland,0,0,British Championship,Wrexham,Wales,False,0,0,Draw
336,341,345,1913,Belgium,Netherlands,3,3,Friendly,Antwerp,Belgium,False,6,0,Draw
337,342,346,1913,Switzerland,France,1,4,Friendly,Geneva,Switzerland,False,5,-3,France
338,343,347,1913,Northern Ireland,Scotland,1,2,British Championship,Dublin,Republic of Ireland,False,3,-1,Scotland
339,344,348,1913,England,Wales,4,3,British Championship,Bristol,England,False,7,1,England
340,345,349,1913,England,Scotland,1,0,British Championship,London,England,False,1,1,England
341,346,350,1913,France,Luxembourg,8,0,Friendly,Saint-Ouen,France,False,8,8,France
342,347,351,1913,Netherlands,Belgium,2,4,Friendly,Zwolle,Netherlands,False,6,-2,Belgium
343,348,352,1913,Austria,Hungary,1,4,Friendly,Vienna,Austria,False,5,-3,Hungary
344,349,353,1913,Italy,Belgium,1,0,Friendly,Turin,Italy,False,1,1,Italy
345,350,354,1913,Russia,Sweden,1,4,Friendly,Moscow,Russia,False,5,-3,Sweden
346,351,355,1913,Switzerland,Belgium,1,2,Friendly,Basel,Switzerland,False,3,-1,Belgium
347,352,356,1913,Germany,Switzerland,1,2,Friendly,Freiburg,Germany,False,3,-1,Switzerland
348,353,357,1913,Hungary,Sweden,2,0,Friendly,Budapest,Hungary,False,2,2,Hungary
349,354,358,1913,Denmark,Sweden,8,0,Friendly,Copenhagen,Denmark,False,8,8,Denmark
350,355,359,1913,Sweden,Norway,9,0,Friendly,Stockholm,Sweden,False,9,9,Sweden
351,356,360,1913,Argentina,Uruguay,1,1,Friendly,Avellaneda,Argentina,False,2,0,Draw
352,357,361,1913,Austria,Italy,2,0,Friendly,Vienna,Austria,False,2,2,Austria
353,358,362,1913,Argentina,Uruguay,2,1,Friendly,Avellaneda,Argentina,False,3,1,Argentina
354,359,363,1913,Argentina,Uruguay,4,0,Copa Lipton,Avellaneda,Argentina,False,4,4,Argentina
355,360,364,1913,Argentina,Uruguay,2,0,Copa Premio Honor Argentino,Buenos Aires,Argentina,False,2,2,Argentina
356,361,365,1913,Russia,Norway,1,1,Friendly,Moscow,Russia,False,2,0,Draw
357,362,366,1913,Chile,Argentina,0,2,Friendly,Viña del Mar,Chile,False,2,-2,Argentina
358,363,367,1913,Sweden,Denmark,0,10,Friendly,Stockholm,Sweden,False,10,-10,Denmark
359,364,368,1913,Uruguay,Argentina,1,0,Copa Premio Honor Uruguayo,Montevideo,Uruguay,False,1,1,Uruguay
360,365,369,1913,Germany,Denmark,1,4,Friendly,Hamburg,Germany,False,5,-3,Denmark
361,366,370,1913,Hungary,Austria,4,3,Friendly,Budapest,Hungary,False,7,1,Hungary
362,367,371,1913,Norway,Sweden,1,1,Friendly,Kristiania,Norway,False,2,0,Draw
363,368,372,1913,Uruguay,Argentina,1,0,Copa Newton,Montevideo,Uruguay,False,1,1,Uruguay
364,369,373,1913,Belgium,Switzerland,2,0,Friendly,Verviers,Belgium,False,2,2,Belgium
365,370,374,1913,Belgium,Germany,6,2,Friendly,Antwerp,Belgium,False,8,4,Belgium
366,371,375,1914,Italy,Austria,0,0,Friendly,Milan,Italy,False,0,0,Draw
367,372,376,1914,Wales,Northern Ireland,1,2,British Championship,Wrexham,Wales,False,3,-1,Northern Ireland
368,373,377,1914,France,Belgium,4,3,Friendly,Lille,France,False,7,1,France
369,374,378,1914,Luxembourg,France,5,4,Friendly,Luxembourg,Luxembourg,False,9,1,Luxembourg
370,375,379,1914,England,Northern Ireland,0,3,British Championship,Middlesbrough,England,False,3,-3,Northern Ireland
371,376,380,1914,Scotland,Wales,0,0,British Championship,Glasgow,Scotland,False,0,0,Draw
372,377,381,1914,France,Switzerland,2,2,Friendly,Saint-Ouen,France,False,4,0,Draw
373,378,382,1914,Northern Ireland,Scotland,1,1,British Championship,Belfast,Republic of Ireland,False,2,0,Draw
374,379,383,1914,Belgium,Netherlands,2,4,Friendly,Antwerp,Belgium,False,6,-2,Netherlands
375,380,384,1914,Wales,England,0,2,British Championship,Cardiff,Wales,False,2,-2,England
376,381,385,1914,Italy,France,2,0,Friendly,Turin,Italy,False,2,2,Italy
377,382,386,1914,Italy,Switzerland,1,1,Friendly,Genoa,Italy,False,2,0,Draw
378,383,387,1914,Netherlands,Germany,4,4,Friendly,Amsterdam,Netherlands,False,8,0,Draw
379,384,388,1914,Netherlands,Belgium,4,2,Friendly,Amsterdam,Netherlands,False,6,2,Netherlands
380,385,389,1914,Austria,Hungary,2,0,Friendly,Vienna,Austria,False,2,2,Austria
381,386,390,1914,Denmark,Netherlands,4,3,Friendly,Copenhagen,Denmark,False,7,1,Denmark
382,387,391,1914,Switzerland,Italy,0,1,Friendly,Berne,Switzerland,False,1,-1,Italy
383,388,392,1914,Sweden,Finland,4,3,Friendly,Solna,Sweden,False,7,1,Sweden
384,389,393,1914,Hungary,France,5,1,Friendly,Budapest,Hungary,False,6,4,Hungary
385,390,394,1914,Sweden,Hungary,1,1,Friendly,Solna,Sweden,False,2,0,Draw
386,391,395,1914,Norway,Sweden,0,1,Friendly,Kristiania,Norway,False,1,-1,Sweden
387,392,396,1914,Sweden,Russia,2,2,Friendly,Solna,Sweden,False,4,0,Draw
388,393,397,1914,Norway,Russia,1,1,Friendly,Kristiania,Norway,False,2,0,Draw
389,394,398,1914,Uruguay,Argentina,3,2,Copa Premio Honor Uruguayo,Montevideo,Uruguay,False,5,1,Uruguay
390,395,399,1914,Argentina,Uruguay,2,1,Copa Premio Honor Argentino,Buenos Aires,Argentina,False,3,1,Argentina
391,396,400,1914,Argentina,Brazil,3,0,Friendly,Buenos Aires,Argentina,False,3,3,Argentina
392,397,401,1914,Argentina,Brazil,0,1,Copa Roca,Buenos Aires,Argentina,False,1,-1,Brazil
393,398,402,1914,Hungary,Austria,2,2,Friendly,Budapest,Hungary,False,4,0,Draw
394,399,403,1914,Sweden,Norway,7,0,Friendly,Solna,Sweden,False,7,7,Sweden
395,400,404,1914,Austria,Hungary,1,2,Friendly,Vienna,Austria,False,3,-1,Hungary
396,401,406,1915,Italy,Switzerland,3,1,Friendly,Turin,Italy,False,4,2,Italy
397,402,408,1915,Hungary,Austria,2,5,Friendly,Budapest,Hungary,False,7,-3,Austria
398,403,410,1915,Austria,Hungary,1,2,Friendly,Vienna,Austria,False,3,-1,Hungary
399,404,411,1915,Denmark,Sweden,2,0,Friendly,Copenhagen,Denmark,False,2,2,Denmark
400,405,412,1915,Norway,Sweden,1,1,Friendly,Kristiania,Norway,False,2,0,Draw
401,406,413,1915,Uruguay,Argentina,2,3,Copa Premio Honor Uruguayo,Montevideo,Uruguay,False,5,-1,Argentina
402,407,414,1915,Argentina,Uruguay,2,1,Copa Lipton,Buenos Aires,Argentina,False,3,1,Argentina
403,408,415,1915,Uruguay,Argentina,2,0,Copa Newton,Montevideo,Uruguay,False,2,2,Uruguay
404,409,416,1915,Denmark,Norway,8,1,Friendly,Copenhagen,Denmark,False,9,7,Denmark
405,410,417,1915,Austria,Hungary,4,2,Friendly,Vienna,Austria,False,6,2,Austria
406,411,418,1915,Sweden,Norway,5,2,Friendly,Stockholm,Sweden,False,7,3,Sweden
407,412,419,1915,Sweden,Denmark,0,2,Friendly,Stockholm,Sweden,False,2,-2,Denmark
408,413,420,1915,Hungary,Austria,6,2,Friendly,Budapest,Hungary,False,8,4,Hungary
409,414,421,1916,Austria,Hungary,3,1,Friendly,Vienna,Austria,False,4,2,Austria
410,415,424,1916,Denmark,Sweden,2,0,Friendly,Copenhagen,Denmark,False,2,2,Denmark
411,416,425,1916,Hungary,Austria,2,1,Friendly,Budapest,Hungary,False,3,1,Hungary
412,417,427,1916,Norway,Denmark,0,2,Friendly,Kristiania,Norway,False,2,-2,Denmark
413,418,428,1916,Chile,Uruguay,0,4,Copa América,Buenos Aires,Argentina,True,4,-4,Uruguay
414,419,429,1916,Sweden,Norway,6,0,Friendly,Stockholm,Sweden,False,6,6,Sweden
415,420,430,1916,Argentina,Chile,6,1,Copa América,Buenos Aires,Argentina,False,7,5,Argentina
416,421,431,1916,Brazil,Chile,1,1,Copa América,Buenos Aires,Argentina,True,2,0,Draw
417,422,432,1916,Argentina,Brazil,1,1,Copa América,Buenos Aires,Argentina,False,2,0,Draw
418,423,433,1916,Argentina,Chile,1,0,Friendly,Buenos Aires,Argentina,False,1,1,Argentina
419,424,434,1916,Brazil,Uruguay,1,2,Copa América,Buenos Aires,Argentina,True,3,-1,Uruguay
420,425,435,1916,Uruguay,Chile,4,1,Friendly,Montevideo,Uruguay,False,5,3,Uruguay
421,426,436,1916,Argentina,Uruguay,0,0,Copa América,Avellaneda,Argentina,False,0,0,Draw
422,427,437,1916,Uruguay,Brazil,0,1,Friendly,Montevideo,Uruguay,False,1,-1,Brazil
423,428,438,1916,Argentina,Uruguay,3,1,Copa Newton,Avellaneda,Argentina,False,4,2,Argentina
424,429,439,1916,Uruguay,Argentina,1,2,Copa Lipton,Montevideo,Uruguay,False,3,-1,Argentina
425,430,440,1916,Sweden,United States,2,3,Friendly,Stockholm,Sweden,False,5,-1,United States
426,431,441,1916,Norway,United States,1,1,Friendly,Kristiania,Norway,False,2,0,Draw
427,432,442,1916,Argentina,Uruguay,7,2,Friendly,Avellaneda,Argentina,False,9,5,Argentina
428,433,443,1916,Hungary,Austria,2,3,Friendly,Budapest,Hungary,False,5,-1,Austria
429,434,444,1916,Norway,Sweden,0,0,Friendly,Kristiania,Norway,False,0,0,Draw
430,435,445,1916,Uruguay,Argentina,0,1,Copa Premio Honor Uruguayo,Montevideo,Uruguay,False,1,-1,Argentina
431,436,446,1916,Sweden,Denmark,4,0,Friendly,Stockholm,Sweden,False,4,4,Sweden
432,437,447,1916,Denmark,Norway,8,0,Friendly,Copenhagen,Denmark,False,8,8,Denmark
433,438,448,1916,Uruguay,Argentina,3,1,Friendly,Montevideo,Uruguay,False,4,2,Uruguay
434,439,449,1916,Austria,Hungary,3,3,Friendly,Vienna,Austria,False,6,0,Draw
435,440,450,1917,Austria,Hungary,1,1,Friendly,Vienna,Austria,False,2,0,Draw
436,441,451,1917,Japan,Philippines,2,15,Friendly,Tokyo,Japan,False,17,-13,Philippines
437,442,452,1917,Denmark,Sweden,1,1,Friendly,Copenhagen,Denmark,False,2,0,Draw
438,443,453,1917,Hungary,Austria,6,2,Friendly,Budapest,Hungary,False,8,4,Hungary
439,444,454,1917,Norway,Denmark,1,2,Friendly,Kristiania,Norway,False,3,-1,Denmark
440,445,455,1917,Austria,Hungary,1,4,Friendly,Vienna,Austria,False,5,-3,Hungary
441,446,456,1917,Uruguay,Argentina,0,2,Copa Premio Honor Uruguayo,Montevideo,Uruguay,False,2,-2,Argentina
442,447,457,1917,Argentina,Uruguay,1,0,Copa Lipton,Avellaneda,Argentina,False,1,1,Argentina
443,448,458,1917,Sweden,Norway,3,3,Friendly,Helsingborg,Sweden,False,6,0,Draw
444,449,459,1917,Uruguay,Argentina,1,0,Copa Newton,Montevideo,Uruguay,False,1,1,Uruguay
445,450,460,1917,Norway,Sweden,0,2,Friendly,Kristiania,Norway,False,2,-2,Sweden
446,451,461,1917,Uruguay,Chile,4,0,Copa América,Montevideo,Uruguay,False,4,4,Uruguay
447,452,462,1917,Argentina,Brazil,4,2,Copa América,Montevideo,Uruguay,True,6,2,Argentina
448,453,463,1917,Argentina,Chile,1,0,Copa América,Montevideo,Uruguay,True,1,1,Argentina
449,454,464,1917,Denmark,Norway,12,0,Friendly,Copenhagen,Denmark,False,12,12,Denmark
450,455,465,1917,Hungary,Austria,2,1,Friendly,Budapest,Hungary,False,3,1,Hungary
451,456,466,1917,Uruguay,Brazil,4,0,Copa América,Montevideo,Uruguay,False,4,4,Uruguay
452,457,467,1917,Brazil,Chile,5,0,Copa América,Montevideo,Uruguay,True,5,5,Brazil
453,458,468,1917,Sweden,Denmark,1,2,Friendly,Stockholm,Sweden,False,3,-1,Denmark
454,459,469,1917,Uruguay,Argentina,1,0,Copa América,Montevideo,Uruguay,False,1,1,Uruguay
455,460,470,1917,Uruguay,Brazil,3,1,Friendly,Montevideo,Uruguay,False,4,2,Uruguay
456,461,471,1917,Austria,Hungary,1,2,Friendly,Vienna,Austria,False,3,-1,Hungary
457,462,472,1917,Switzerland,Austria,0,1,Friendly,Basel,Switzerland,False,1,-1,Austria
458,463,473,1917,Switzerland,Austria,3,2,Friendly,Zürich,Switzerland,False,5,1,Switzerland
459,464,474,1918,Hungary,Austria,2,0,Friendly,Budapest,Hungary,False,2,2,Hungary
460,465,475,1918,Austria,Switzerland,5,1,Friendly,Vienna,Austria,False,6,4,Austria
461,466,476,1918,Hungary,Switzerland,2,1,Friendly,Budapest,Hungary,False,3,1,Hungary
462,467,477,1918,Sweden,Norway,2,0,Friendly,Stockholm,Sweden,False,2,2,Sweden
463,468,478,1918,Austria,Hungary,0,2,Friendly,Vienna,Austria,False,2,-2,Hungary
464,469,479,1918,Denmark,Sweden,3,0,Friendly,Copenhagen,Denmark,False,3,3,Denmark
465,470,480,1918,Norway,Denmark,3,1,Friendly,Kristiania,Norway,False,4,2,Norway
466,471,481,1918,Uruguay,Argentina,1,1,Copa Premio Honor Uruguayo,Montevideo,Uruguay,False,2,0,Draw
467,472,482,1918,Uruguay,Argentina,3,1,Copa Premio Honor Uruguayo,Montevideo,Uruguay,False,4,2,Uruguay
468,473,483,1918,Argentina,Uruguay,0,0,Copa Premio Honor Argentino,Buenos Aires,Argentina,False,0,0,Draw
469,474,484,1918,Argentina,Uruguay,2,1,Copa Premio Honor Argentino,Buenos Aires,Argentina,False,3,1,Argentina
470,475,485,1918,Norway,Sweden,2,1,Friendly,Kristiania,Norway,False,3,1,Norway
471,476,486,1918,Uruguay,Argentina,1,1,Copa Lipton,Montevideo,Uruguay,False,2,0,Draw
472,477,487,1918,Argentina,Uruguay,2,0,Copa Newton,Buenos Aires,Argentina,False,2,2,Argentina
473,478,488,1918,Austria,Hungary,0,3,Friendly,Vienna,Austria,False,3,-3,Hungary
474,479,489,1918,Denmark,Norway,4,0,Friendly,Copenhagen,Denmark,False,4,4,Denmark
475,480,490,1918,Sweden,Denmark,1,2,Friendly,Gothenburg,Sweden,False,3,-1,Denmark
476,481,491,1919,Belgium,France,2,2,Friendly,Brussels,Belgium,False,4,0,Draw
477,482,492,1919,Hungary,Austria,2,1,Friendly,Budapest,Hungary,False,3,1,Hungary
478,483,493,1919,Brazil,Chile,6,0,Copa América,Rio de Janeiro,Brazil,False,6,6,Brazil
479,484,494,1919,Paraguay,Argentina,1,5,Friendly,Asunción,Paraguay,False,6,-4,Argentina
480,485,495,1919,Argentina,Uruguay,2,3,Copa América,Rio de Janeiro,Brazil,True,5,-1,Uruguay
481,486,496,1919,Paraguay,Argentina,0,3,Friendly,Asunción,Paraguay,False,3,-3,Argentina
482,487,497,1919,Chile,Uruguay,0,2,Copa América,Rio de Janeiro,Brazil,True,2,-2,Uruguay
483,488,498,1919,Brazil,Argentina,3,1,Copa América,Rio de Janeiro,Brazil,False,4,2,Brazil
484,489,499,1919,Paraguay,Argentina,1,2,Friendly,Asunción,Paraguay,False,3,-1,Argentina
485,490,500,1919,Argentina,Chile,4,1,Copa América,Rio de Janeiro,Brazil,True,5,3,Argentina
486,491,501,1919,Paraguay,Argentina,1,2,Friendly,Asunción,Paraguay,False,3,-1,Argentina
487,492,502,1919,Brazil,Uruguay,2,2,Copa América,Rio de Janeiro,Brazil,False,4,0,Draw
488,493,503,1919,Brazil,Uruguay,1,0,Copa América,Rio de Janeiro,Brazil,False,1,1,Brazil
489,494,504,1919,Sweden,Finland,1,0,Friendly,Stockholm,Sweden,False,1,1,Sweden
490,495,505,1919,Brazil,Argentina,3,3,Friendly,Rio de Janeiro,Brazil,False,6,0,Draw
491,496,506,1919,Denmark,Sweden,3,0,Friendly,Copenhagen,Denmark,False,3,3,Denmark
492,497,507,1919,Netherlands,Sweden,3,1,Friendly,Amsterdam,Netherlands,False,4,2,Netherlands
493,498,508,1919,Denmark,Norway,5,1,Friendly,Copenhagen,Denmark,False,6,4,Denmark
494,499,509,1919,Norway,Sweden,4,3,Friendly,Kristiania,Norway,False,7,1,Norway
495,500,510,1919,Uruguay,Argentina,4,1,Copa Premio Honor Uruguayo,Montevideo,Uruguay,False,5,3,Uruguay
496,501,511,1919,Sweden,Netherlands,4,1,Friendly,Stockholm,Sweden,False,5,3,Sweden
497,502,512,1919,Uruguay,Argentina,2,1,Copa Newton,Montevideo,Uruguay,False,3,1,Uruguay
498,503,513,1919,Norway,Netherlands,1,1,Friendly,Oslo,Norway,False,2,0,Draw
499,504,514,1919,Argentina,Uruguay,1,2,Copa Lipton,Buenos Aires,Argentina,False,3,-1,Uruguay
500,505,515,1919,Sweden,Norway,1,5,Friendly,Gothenburg,Sweden,False,6,-4,Norway
501,506,516,1919,Norway,Denmark,3,2,Friendly,Kristiania,Norway,False,5,1,Norway
502,507,517,1919,Finland,Sweden,3,3,Friendly,Helsinki,Finland,False,6,0,Draw
503,508,518,1919,Austria,Hungary,2,0,Friendly,Vienna,Austria,False,2,2,Austria
504,509,519,1919,Sweden,Denmark,3,0,Friendly,Stockholm,Sweden,False,3,3,Sweden
505,510,520,1919,Argentina,Uruguay,6,1,Copa Premio Honor Argentino,Buenos Aires,Argentina,False,7,5,Argentina
506,511,521,1919,Northern Ireland,England,1,1,British Championship,Belfast,Republic of Ireland,False,2,0,Draw
507,512,522,1919,Hungary,Austria,3,2,Friendly,Budapest,Hungary,False,5,1,Hungary
508,513,523,1919,Uruguay,Argentina,4,2,Friendly,Montevideo,Uruguay,False,6,2,Uruguay
509,514,524,1920,Italy,France,9,4,Friendly,Milan,Italy,False,13,5,Italy
510,515,525,1920,Northern Ireland,Wales,2,2,British Championship,Belfast,Republic of Ireland,False,4,0,Draw
511,516,526,1920,Wales,Scotland,1,1,British Championship,Cardiff,Wales,False,2,0,Draw
512,517,527,1920,Switzerland,France,0,2,Friendly,Geneva,Switzerland,False,2,-2,France
513,518,528,1920,Scotland,Northern Ireland,3,0,British Championship,Glasgow,Scotland,False,3,3,Scotland
514,519,529,1920,England,Wales,1,2,British Championship,London,England,False,3,-1,Wales
515,520,530,1920,France,Belgium,2,1,Friendly,Paris,France,False,3,1,France
516,521,531,1920,Switzerland,Italy,3,0,Friendly,Berne,Switzerland,False,3,3,Switzerland
517,522,532,1920,Netherlands,Denmark,2,0,Friendly,Amsterdam,Netherlands,False,2,2,Netherlands
518,523,533,1920,England,Scotland,5,4,British Championship,Sheffield,England,False,9,1,England
519,524,534,1920,Austria,Hungary,2,2,Friendly,Vienna,Austria,False,4,0,Draw
520,525,535,1920,Italy,Netherlands,1,1,Friendly,Genoa,Italy,False,2,0,Draw
521,526,536,1920,Switzerland,Netherlands,2,1,Friendly,Basel,Switzerland,False,3,1,Switzerland
522,527,537,1920,Sweden,Finland,4,0,Friendly,Stockholm,Sweden,False,4,4,Sweden
523,528,538,1920,Sweden,Switzerland,0,1,Friendly,Stockholm,Sweden,False,1,-1,Switzerland
524,529,539,1920,Norway,Denmark,1,1,Friendly,Kristiania,Norway,False,2,0,Draw
525,530,540,1920,Norway,Sweden,0,3,Friendly,Kristiania,Norway,False,3,-3,Sweden
526,531,541,1920,Switzerland,Germany,4,1,Friendly,Zürich,Switzerland,False,5,3,Switzerland
527,532,542,1920,Uruguay,Argentina,2,0,Copa Premio Honor Uruguayo,Montevideo,Uruguay,False,2,2,Uruguay
528,533,543,1920,Argentina,Uruguay,1,3,Copa Newton,Buenos Aires,Argentina,False,4,-2,Uruguay
529,534,544,1920,Argentina,Uruguay,1,0,Copa Premio Honor Argentino,Buenos Aires,Argentina,False,1,1,Argentina
530,535,545,1920,Chile,Brazil,0,1,Copa América,Viña del Mar,Chile,False,1,-1,Brazil
531,536,546,1920,Uruguay,Argentina,1,1,Copa América,Viña del Mar,Chile,True,2,0,Draw
532,537,547,1920,Brazil,Uruguay,0,6,Copa América,Viña del Mar,Chile,True,6,-6,Uruguay
533,538,548,1920,Finland,Sweden,1,0,Friendly,Helsinki,Finland,False,1,1,Finland
534,539,549,1920,Chile,Argentina,1,1,Copa América,Viña del Mar,Chile,False,2,0,Draw
535,540,550,1920,Argentina,Brazil,2,0,Copa América,Viña del Mar,Chile,True,2,2,Argentina
536,541,551,1920,Austria,Germany,3,2,Friendly,Vienna,Austria,False,5,1,Austria
537,542,552,1920,Sweden,Norway,0,0,Friendly,Stockholm,Sweden,False,0,0,Draw
538,543,553,1920,Chile,Uruguay,1,2,Copa América,Viña del Mar,Chile,False,3,-1,Uruguay
539,544,554,1920,Sweden,Denmark,0,2,Friendly,Stockholm,Sweden,False,2,-2,Denmark
540,545,555,1920,Finland,Estonia,6,0,Friendly,Helsinki,Finland,False,6,6,Finland
541,546,556,1920,England,Northern Ireland,2,0,British Championship,Sunderland,England,False,2,2,England
542,547,557,1920,Germany,Hungary,1,0,Friendly,Berlin,Germany,False,1,1,Germany
543,548,558,1920,Hungary,Austria,1,2,Friendly,Budapest,Hungary,False,3,-1,Austria
544,549,559,1921,Scotland,Wales,2,1,British Championship,Aberdeen,Scotland,False,3,1,Scotland
545,550,560,1921,France,Italy,1,2,Friendly,Marseille,France,False,3,-1,Italy
546,551,561,1921,Northern Ireland,Scotland,0,2,British Championship,Belfast,Republic of Ireland,False,2,-2,Scotland
547,552,562,1921,Belgium,France,3,1,Friendly,Forest,Belgium,False,4,2,Belgium
548,553,563,1921,Italy,Switzerland,2,1,Friendly,Milan,Italy,False,3,1,Italy
549,554,564,1921,Wales,England,0,0,British Championship,Cardiff,Wales,False,0,0,Draw
550,555,565,1921,Austria,Sweden,2,2,Friendly,Vienna,Austria,False,4,0,Draw
551,556,568,1921,Paraguay,Argentina,3,1,Friendly,Asunción,Paraguay,False,4,2,Paraguay
552,557,569,1921,Scotland,England,3,0,British Championship,Glasgow,Scotland,False,3,3,Scotland
553,558,570,1921,Wales,Northern Ireland,2,1,British Championship,Swansea,Wales,False,3,1,Wales
554,559,571,1921,Paraguay,Argentina,2,2,Friendly,Asunción,Paraguay,False,4,0,Draw
555,560,572,1921,Austria,Hungary,4,1,Friendly,Vienna,Austria,False,5,3,Austria
556,561,573,1921,Switzerland,Austria,2,2,Friendly,St. Gallen,Switzerland,False,4,0,Draw
557,562,574,1921,Belgium,Italy,2,3,Friendly,Antwerp,Belgium,False,5,-1,Italy
558,563,575,1921,Germany,Austria,3,3,Friendly,Dresden,Germany,False,6,0,Draw
559,564,576,1921,Netherlands,Italy,2,2,Friendly,Amsterdam,Netherlands,False,4,0,Draw
560,565,577,1921,Belgium,Netherlands,1,1,Friendly,Antwerp,Belgium,False,2,0,Draw
561,566,578,1921,Belgium,England,0,2,Friendly,Brussels,Belgium,False,2,-2,England
562,567,579,1921,Norway,Finland,3,2,Friendly,Kristiania,Norway,False,5,1,Norway
563,568,580,1921,Sweden,Finland,0,3,Friendly,Stockholm,Sweden,False,3,-3,Finland
564,569,581,1921,Japan,Philippines,0,3,Friendly,Shanghai,China PR,True,3,-3,Philippines
565,570,582,1921,Hungary,Germany,3,0,Friendly,Budapest,Hungary,False,3,3,Hungary
566,571,583,1921,Denmark,Netherlands,1,1,Friendly,Copenhagen,Denmark,False,2,0,Draw
567,572,584,1921,Norway,Sweden,3,1,Friendly,Kristiania,Norway,False,4,2,Norway
568,573,585,1921,Canada,Scotland,0,1,Friendly,Montréal,Canada,False,1,-1,Scotland
569,574,586,1921,Estonia,Sweden,0,0,Friendly,Tallinn,Estonia,False,0,0,Draw
570,575,587,1921,Sweden,Austria,1,3,Friendly,Stockholm,Sweden,False,4,-2,Austria
571,576,588,1921,Finland,Austria,2,3,Friendly,Helsinki,Finland,False,5,-1,Austria
572,577,589,1921,Estonia,Finland,0,3,Friendly,Tallinn,Estonia,False,3,-3,Finland
573,578,590,1921,Costa Rica,El Salvador,7,0,Friendly,Guatemala,Guatemala,True,7,7,Costa Rica
574,579,591,1921,Finland,Germany,3,3,Friendly,Helsinki,Finland,False,6,0,Draw
575,580,592,1921,Guatemala,Costa Rica,0,6,Friendly,Guatemala,Guatemala,False,6,-6,Costa Rica
576,581,593,1921,Sweden,Norway,0,3,Friendly,Stockholm,Sweden,False,3,-3,Norway
577,582,594,1921,Chile,Argentina,1,4,Friendly,Viña del Mar,Chile,False,5,-3,Argentina
578,583,595,1921,Argentina,Brazil,1,0,Copa América,Buenos Aires,Argentina,False,1,1,Argentina
579,584,596,1921,Chile,Argentina,1,1,Friendly,Santiago,Chile,False,2,0,Draw
580,585,597,1921,Denmark,Norway,3,1,Friendly,Copenhagen,Denmark,False,4,2,Denmark
581,586,598,1921,Paraguay,Uruguay,2,1,Copa América,Buenos Aires,Argentina,True,3,1,Paraguay
582,587,599,1921,Sweden,Denmark,0,0,Friendly,Stockholm,Sweden,False,0,0,Draw
583,588,600,1921,Brazil,Paraguay,3,0,Copa América,Buenos Aires,Argentina,True,3,3,Brazil
584,589,601,1921,Argentina,Paraguay,3,0,Copa América,Buenos Aires,Argentina,False,3,3,Argentina
585,590,602,1921,Northern Ireland,England,1,1,British Championship,Belfast,Republic of Ireland,False,2,0,Draw
586,591,603,1921,Brazil,Uruguay,1,2,Copa América,Buenos Aires,Argentina,True,3,-1,Uruguay
587,592,605,1921,Argentina,Uruguay,1,0,Copa América,Buenos Aires,Argentina,False,1,1,Argentina
588,593,606,1921,Uruguay,Paraguay,4,2,Friendly,Montevideo,Uruguay,False,6,2,Uruguay
589,594,607,1921,Hungary,Sweden,4,2,Friendly,Budapest,Hungary,False,6,2,Hungary
590,595,608,1921,Switzerland,Italy,1,1,Friendly,Geneva,Switzerland,False,2,0,Draw
591,596,610,1921,France,Netherlands,0,5,Friendly,Vincennes,France,False,5,-5,Netherlands
592,597,611,1921,Hungary,Poland,1,0,Friendly,Budapest,Hungary,False,1,1,Hungary
593,598,612,1921,Spain,Portugal,3,1,Friendly,Madrid,Spain,False,4,2,Spain
594,599,613,1922,France,Belgium,2,1,Friendly,Colombes,France,False,3,1,France
595,600,614,1922,Italy,Austria,3,3,Friendly,Milan,Italy,False,6,0,Draw
596,601,615,1922,Wales,Scotland,2,1,British Championship,Wrexham,Wales,False,3,1,Wales
597,603,617,1922,Scotland,Northern Ireland,2,1,British Championship,Glasgow,Scotland,False,3,1,Scotland
598,604,619,1922,England,Wales,1,0,British Championship,Liverpool,England,False,1,1,England
599,605,620,1922,Belgium,Netherlands,4,0,Friendly,Antwerp,Belgium,False,4,4,Belgium
600,606,621,1922,Germany,Switzerland,2,2,Friendly,Frankfurt am Main,Germany,False,4,0,Draw
601,607,622,1922,England,Scotland,0,1,British Championship,Birmingham,England,False,1,-1,Scotland
602,608,623,1922,Belgium,Denmark,0,0,Friendly,Liège,Belgium,False,0,0,Draw
603,609,624,1922,Netherlands,Denmark,2,0,Friendly,Amsterdam,Netherlands,False,2,2,Netherlands
604,610,625,1922,Austria,Germany,0,2,Friendly,Vienna,Austria,False,2,-2,Germany
605,611,626,1922,France,Spain,0,4,Friendly,Le Bouscat,France,False,4,-4,Spain
606,612,627,1922,Hungary,Austria,1,1,Friendly,Budapest,Hungary,False,2,0,Draw
607,613,628,1922,Netherlands,Belgium,1,2,Friendly,Amsterdam,Netherlands,False,3,-1,Belgium
608,614,629,1922,Poland,Hungary,0,3,Friendly,Cracow,Poland,False,3,-3,Hungary
609,615,630,1922,Italy,Belgium,4,2,Friendly,Milan,Italy,False,6,2,Italy
610,616,631,1922,Norway,Northern Ireland,2,1,Friendly,Bergen,Norway,False,3,1,Norway
611,617,632,1922,Sweden,Poland,1,2,Friendly,Stockholm,Sweden,False,3,-1,Poland
612,618,633,1922,Finland,Sweden,1,4,Friendly,Helsinki,Finland,False,5,-3,Sweden
613,619,635,1922,Austria,Switzerland,7,1,Friendly,Vienna,Austria,False,8,6,Austria
614,621,637,1922,Norway,France,7,0,Friendly,Kristiania,Norway,False,7,7,Norway
615,622,638,1922,Hungary,Switzerland,1,1,Friendly,Budapest,Hungary,False,2,0,Draw
616,623,639,1922,New Zealand,Australia,3,1,Friendly,Dunedin,New Zealand,False,4,2,New Zealand
617,624,640,1922,New Zealand,Australia,1,1,Friendly,Wellington,New Zealand,False,2,0,Draw
618,625,642,1922,Germany,Hungary,0,0,Friendly,Bochum,Germany,False,0,0,Draw
619,626,643,1922,New Zealand,Australia,3,1,Friendly,Auckland,New Zealand,False,4,2,New Zealand
620,627,644,1922,Sweden,Hungary,1,1,Friendly,Stockholm,Sweden,False,2,0,Draw
621,628,645,1922,Finland,Hungary,1,5,Friendly,Helsinki,Finland,False,6,-4,Hungary
622,629,646,1922,Finland,Estonia,10,2,Friendly,Helsinki,Finland,False,12,8,Finland
623,631,648,1922,Sweden,Norway,0,0,Friendly,Stockholm,Sweden,False,0,0,Draw
624,632,649,1922,Finland,Norway,1,3,Friendly,Helsinki,Finland,False,4,-2,Norway
625,633,650,1922,Romania,Poland,1,1,Friendly,Cernăuţi,Romania,False,2,0,Draw
626,634,651,1922,Norway,Denmark,3,3,Friendly,Fredrikstad,Norway,False,6,0,Draw
627,635,652,1922,Brazil,Chile,1,1,Copa América,Rio de Janeiro,Brazil,False,2,0,Draw
628,636,653,1922,Chile,Uruguay,0,2,Copa América,Rio de Janeiro,Brazil,True,2,-2,Uruguay
629,637,654,1922,Austria,Hungary,2,2,Friendly,Vienna,Austria,False,4,0,Draw
630,638,655,1922,Brazil,Paraguay,1,1,Copa América,Rio de Janeiro,Brazil,False,2,0,Draw
631,639,656,1922,Latvia,Estonia,1,1,Friendly,Riga,Latvia,False,2,0,Draw
632,640,657,1922,Norway,Sweden,0,5,Friendly,Kristiania,Norway,False,5,-5,Sweden
633,641,658,1922,Argentina,Chile,4,0,Copa América,Rio de Janeiro,Brazil,True,4,4,Argentina
634,642,659,1922,Brazil,Uruguay,0,0,Copa América,Rio de Janeiro,Brazil,False,0,0,Draw
635,643,660,1922,Denmark,Sweden,1,2,Friendly,Copenhagen,Denmark,False,3,-1,Sweden
636,644,662,1922,Chile,Paraguay,0,3,Copa América,Rio de Janeiro,Brazil,True,3,-3,Paraguay
637,645,663,1922,Argentina,Uruguay,0,1,Copa América,Rio de Janeiro,Brazil,True,1,-1,Uruguay
638,646,664,1922,Paraguay,Uruguay,1,0,Copa América,Rio de Janeiro,Brazil,True,1,1,Paraguay
639,647,665,1922,Brazil,Argentina,2,0,Copa América,Rio de Janeiro,Brazil,False,2,2,Brazil
640,648,666,1922,Argentina,Paraguay,2,0,Copa América,Rio de Janeiro,Brazil,True,2,2,Argentina
641,649,667,1922,England,Northern Ireland,2,0,British Championship,West Bromwich,England,False,2,2,England
642,650,668,1922,Argentina,Chile,1,0,Friendly,Buenos Aires,Argentina,False,1,1,Argentina
643,651,669,1922,Brazil,Paraguay,3,0,Copa América,Rio de Janeiro,Brazil,False,3,3,Brazil
644,652,670,1922,Brazil,Argentina,2,1,Copa Roca,São Paulo,Brazil,False,3,1,Brazil
645,653,671,1922,Brazil,Paraguay,3,1,Friendly,São Paulo,Brazil,False,4,2,Brazil
646,654,672,1922,Uruguay,Argentina,1,0,Copa Lipton,Montevideo,Uruguay,False,1,1,Uruguay
647,655,673,1922,Switzerland,Netherlands,5,0,Friendly,Berne,Switzerland,False,5,5,Switzerland
648,656,675,1922,Hungary,Austria,1,2,Friendly,Budapest,Hungary,False,3,-1,Austria
649,657,676,1922,Italy,Switzerland,2,2,Friendly,Bologna,Italy,False,4,0,Draw
650,658,677,1922,Uruguay,Argentina,1,0,Copa Premio Honor Uruguayo,Montevideo,Uruguay,False,1,1,Uruguay
651,659,678,1922,Argentina,Uruguay,2,2,Copa Newton,Buenos Aires,Argentina,False,4,0,Draw
652,660,679,1922,Portugal,Spain,1,2,Friendly,Lisbon,Portugal,False,3,-1,Spain
653,661,680,1923,Guatemala,Mexico,2,3,Friendly,Guatemala,Guatemala,False,5,-1,Mexico
654,662,681,1923,Italy,Germany,3,1,Friendly,Milan,Italy,False,4,2,Italy
655,663,682,1923,Guatemala,Mexico,3,1,Friendly,Guatemala,Guatemala,False,4,2,Guatemala
656,664,683,1923,Guatemala,Mexico,1,4,Friendly,Guatemala,Guatemala,False,5,-3,Mexico
657,665,685,1923,Switzerland,Austria,2,0,Friendly,Geneva,Switzerland,False,2,2,Switzerland
658,666,686,1923,Spain,France,3,0,Friendly,San Sebastián,Spain,False,3,3,Spain
659,667,687,1923,Belgium,Spain,1,0,Friendly,Antwerp,Belgium,False,1,1,Belgium
660,669,689,1923,Belgium,France,4,1,Friendly,Forest,Belgium,False,5,3,Belgium
661,670,691,1923,Northern Ireland,Scotland,0,1,British Championship,Belfast,Northern Ireland,False,1,-1,Scotland
662,671,692,1923,Italy,Hungary,0,0,Friendly,Genoa,Italy,False,0,0,Draw
663,672,693,1923,Wales,England,2,2,British Championship,Cardiff,Wales,False,4,0,Draw
664,673,694,1923,Switzerland,Hungary,1,6,Friendly,Lausanne,Switzerland,False,7,-5,Hungary
665,674,695,1923,Scotland,Wales,2,0,British Championship,Paisley,Scotland,False,2,2,Scotland
666,675,696,1923,England,Belgium,6,1,Friendly,London,England,False,7,5,England
667,676,697,1923,Netherlands,France,8,1,Friendly,Amsterdam,Netherlands,False,9,7,Netherlands
668,677,698,1923,Scotland,England,2,2,British Championship,Glasgow,Scotland,False,4,0,Draw
669,678,699,1923,Wales,Northern Ireland,0,3,British Championship,Wrexham,Wales,False,3,-3,Northern Ireland
670,679,700,1923,Austria,Italy,0,0,Friendly,Vienna,Austria,False,0,0,Draw
671,680,701,1923,France,Switzerland,2,2,Friendly,Vincennes,France,False,4,0,Draw
672,681,702,1923,Netherlands,Belgium,1,1,Friendly,Amsterdam,Netherlands,False,2,0,Draw
673,682,703,1923,Austria,Hungary,1,0,Friendly,Vienna,Austria,False,1,1,Austria
674,683,705,1923,France,England,1,4,Friendly,Vincennes,France,False,5,-3,England
675,684,706,1923,Germany,Netherlands,0,0,Friendly,Hamburg,Germany,False,0,0,Draw
676,685,707,1923,Argentina,Paraguay,0,2,Copa Chevallier Boutell,Buenos Aires,Argentina,False,2,-2,Paraguay
677,686,708,1923,Sweden,England,2,4,Friendly,Stockholm,Sweden,False,6,-2,England
678,688,711,1923,Sweden,England,1,3,Friendly,Solna,Sweden,False,4,-2,England
679,689,712,1923,Argentina,Paraguay,1,0,Copa Chevallier Boutell,Buenos Aires,Argentina,False,1,1,Argentina
680,691,715,1923,Switzerland,Germany,1,2,Friendly,Basel,Switzerland,False,3,-1,Germany
681,692,716,1923,Australia,New Zealand,2,1,Friendly,Brisbane,Australia,False,3,1,Australia
682,694,718,1923,Sweden,Austria,4,2,Friendly,Gothenburg,Sweden,False,6,2,Sweden
683,695,719,1923,Australia,New Zealand,2,3,Friendly,Sydney,Australia,False,5,-1,New Zealand
684,696,720,1923,Denmark,Switzerland,3,2,Friendly,Copenhagen,Denmark,False,5,1,Denmark
685,697,721,1923,Norway,Finland,3,0,Friendly,Kristiania,Norway,False,3,3,Norway
686,698,722,1923,Sweden,Finland,5,4,Friendly,Gävle,Sweden,False,9,1,Sweden
687,699,723,1923,Norway,Switzerland,2,2,Friendly,Kristiania,Norway,False,4,0,Draw
688,700,724,1923,Argentina,Uruguay,0,0,Copa Lipton,Buenos Aires,Argentina,False,0,0,Draw
689,701,725,1923,Lithuania,Estonia,0,5,Friendly,Kaunas,Lithuania,False,5,-5,Estonia
690,702,726,1923,Sweden,Germany,2,1,Friendly,Stockholm,Sweden,False,3,1,Sweden
691,703,727,1923,Australia,New Zealand,1,4,Friendly,Newcastle,Australia,False,5,-3,New Zealand
692,705,729,1923,Argentina,Uruguay,2,2,Friendly,Buenos Aires,Argentina,False,4,0,Draw
693,706,730,1923,Uruguay,Argentina,2,2,Copa Premio Honor Uruguayo,Montevideo,Uruguay,False,4,0,Draw
694,707,731,1923,Estonia,Latvia,1,1,Friendly,Tallinn,Estonia,False,2,0,Draw
695,708,732,1923,Germany,Finland,1,2,Friendly,Dresden,Germany,False,3,-1,Finland
696,709,733,1923,Austria,Finland,2,1,Friendly,Vienna,Austria,False,3,1,Austria
697,710,734,1923,Hungary,Finland,3,1,Friendly,Budapest,Hungary,False,4,2,Hungary
698,711,735,1923,Poland,Romania,1,1,Friendly,Lwów,Poland,False,2,0,Draw
699,712,736,1923,Norway,Sweden,2,3,Friendly,Kristiania,Norway,False,5,-1,Sweden
700,713,737,1923,Estonia,Russia,2,4,Friendly,Tallinn,Estonia,False,6,-2,Russia
701,714,738,1923,Finland,Poland,5,3,Friendly,Helsinki,Finland,False,8,2,Finland
702,715,739,1923,Hungary,Austria,2,0,Friendly,Budapest,Hungary,False,2,2,Hungary
703,716,740,1923,Estonia,Poland,1,4,Friendly,Tallinn,Estonia,False,5,-3,Poland
704,717,741,1923,Denmark,Norway,2,1,Friendly,Copenhagen,Denmark,False,3,1,Denmark
705,718,742,1923,Estonia,Finland,2,1,Friendly,Tallinn,Estonia,False,3,1,Estonia
706,719,743,1923,Uruguay,Argentina,0,2,Copa Premio Honor Uruguayo,Montevideo,Uruguay,False,2,-2,Argentina
707,720,744,1923,Sweden,Denmark,1,3,Friendly,Stockholm,Sweden,False,4,-2,Denmark
708,721,745,1923,Northern Ireland,England,2,1,British Championship,Belfast,Northern Ireland,False,3,1,Northern Ireland
709,722,746,1923,Turkey,Romania,2,2,Friendly,Istanbul,Turkey,False,4,0,Draw
710,723,748,1923,France,Norway,0,2,Friendly,Paris,France,False,2,-2,Norway
711,724,749,1923,Hungary,Sweden,2,1,Friendly,Budapest,Hungary,False,3,1,Hungary
712,725,750,1923,Argentina,Paraguay,4,3,Copa América,Montevideo,Uruguay,True,7,1,Argentina
713,726,751,1923,Belgium,England,2,2,Friendly,Antwerp,Belgium,False,4,0,Draw
714,727,752,1923,Poland,Sweden,2,2,Friendly,Cracow,Poland,False,4,0,Draw
715,728,754,1923,Germany,Norway,1,0,Friendly,Hamburg,Germany,False,1,1,Germany
716,729,755,1923,Uruguay,Paraguay,2,0,Copa América,Montevideo,Uruguay,False,2,2,Uruguay
717,730,756,1923,Brazil,Paraguay,0,1,Copa América,Montevideo,Uruguay,True,1,-1,Paraguay
718,731,757,1923,Argentina,Brazil,2,1,Copa América,Montevideo,Uruguay,True,3,1,Argentina
719,732,758,1923,Brazil,Paraguay,2,0,Friendly,Montevideo,Uruguay,True,2,2,Brazil
720,733,759,1923,Netherlands,Switzerland,4,1,Friendly,Amsterdam,Netherlands,False,5,3,Netherlands
721,734,760,1923,Uruguay,Brazil,2,1,Copa América,Montevideo,Uruguay,False,3,1,Uruguay
722,735,762,1923,Argentina,Brazil,0,2,Friendly,Buenos Aires,Argentina,False,2,-2,Brazil
723,736,763,1923,Uruguay,Argentina,2,0,Copa América,Montevideo,Uruguay,False,2,2,Uruguay
724,737,764,1923,Argentina,Chile,6,0,Friendly,Buenos Aires,Argentina,False,6,6,Argentina
725,738,765,1923,Argentina,Brazil,2,0,Copa Roca,Buenos Aires,Argentina,False,2,2,Argentina
726,739,766,1923,Mexico,Guatemala,2,1,Friendly,Mexico City,Mexico,False,3,1,Mexico
727,740,767,1923,Mexico,Guatemala,2,0,Friendly,Mexico City,Mexico,False,2,2,Mexico
728,741,768,1923,Mexico,Guatemala,3,3,Friendly,Mexico City,Mexico,False,6,0,Draw
729,742,769,1923,Spain,Portugal,3,0,Friendly,Seville,Spain,False,3,3,Spain
730,743,770,1924,France,Belgium,2,0,Friendly,Montrouge,France,False,2,2,France
731,744,771,1924,Germany,Austria,4,3,Friendly,Nuremberg,Germany,False,7,1,Germany
732,745,772,1924,Italy,Austria,0,4,Friendly,Genoa,Italy,False,4,-4,Austria
733,746,774,1924,Wales,Scotland,2,0,British Championship,Cardiff,Wales,False,2,2,Wales
734,747,775,1924,Scotland,Northern Ireland,2,0,British Championship,Glasgow,Scotland,False,2,2,Scotland
735,748,776,1924,England,Wales,1,2,British Championship,Blackburn,England,False,3,-1,Wales
736,749,777,1924,Italy,Spain,0,0,Friendly,Milan,Italy,False,0,0,Draw
737,750,779,1924,Northern Ireland,Wales,0,1,British Championship,Belfast,Northern Ireland,False,1,-1,Wales
738,751,780,1924,Netherlands,Belgium,1,1,Friendly,Amsterdam,Netherlands,False,2,0,Draw
739,752,781,1924,Switzerland,France,3,0,Friendly,Geneva,Switzerland,False,3,3,Switzerland
740,753,783,1924,Aruba,Curaçao,0,4,Friendly,Oranjestad,Aruba,False,4,-4,Curaçao
741,754,784,1924,Hungary,Italy,7,1,Friendly,Budapest,Hungary,False,8,6,Hungary
742,755,785,1924,England,Scotland,1,1,British Championship,London,England,False,2,0,Draw
743,756,786,1924,Netherlands,Germany,0,1,Friendly,Amsterdam,Netherlands,False,1,-1,Germany
744,757,787,1924,Switzerland,Denmark,2,0,Friendly,Basel,Switzerland,False,2,2,Switzerland
745,758,788,1924,Belgium,Netherlands,1,1,Friendly,Antwerp,Belgium,False,2,0,Draw
746,759,789,1924,Hungary,Austria,2,2,Friendly,Budapest,Hungary,False,4,0,Draw
747,760,790,1924,Paraguay,Argentina,1,3,Copa Chevallier Boutell,Asunción,Paraguay,False,4,-2,Argentina
748,761,791,1924,France,England,1,3,Friendly,Vincennes,France,False,4,-2,England
749,762,792,1924,Paraguay,Argentina,2,1,Copa Chevallier Boutell,Asunción,Paraguay,False,3,1,Paraguay
750,763,793,1924,Sweden,Poland,5,1,Friendly,Stockholm,Sweden,False,6,4,Sweden
751,764,794,1924,Switzerland,Hungary,4,2,Friendly,Zürich,Switzerland,False,6,2,Switzerland
752,765,795,1924,Austria,Romania,4,1,Friendly,Vienna,Austria,False,5,3,Austria
753,766,796,1924,Austria,Bulgaria,6,0,Friendly,Vienna,Austria,False,6,6,Austria
754,767,797,1924,Argentina,Uruguay,4,0,Copa Newton,Buenos Aires,Argentina,False,4,4,Argentina
755,768,798,1924,Uruguay,Argentina,2,0,Copa Lipton,Montevideo,Uruguay,False,2,2,Uruguay
756,769,799,1924,Egypt,Lithuania,10,0,Friendly,Vincennes,France,True,10,10,Egypt
757,770,800,1924,France,Hungary,0,1,Friendly,Le Havre,France,False,1,-1,Hungary
758,771,801,1924,Australia,Canada,3,2,Friendly,Brisbane,Australia,False,5,1,Australia
759,772,802,1924,Poland,United States,2,3,Friendly,Warsaw,Poland,False,5,-1,United States
760,773,803,1924,Australia,Canada,0,1,Friendly,Sydney,Australia,False,1,-1,Canada
761,774,804,1924,Denmark,Sweden,2,3,Nordic Championship,Copenhagen,Denmark,False,5,-1,Sweden
762,775,805,1924,Norway,Germany,0,2,Friendly,Kristiania,Norway,False,2,-2,Germany
763,776,807,1924,Finland,Turkey,2,4,Friendly,Helsinki,Finland,False,6,-2,Turkey
764,777,808,1924,Estonia,Turkey,1,4,Friendly,Tallinn,Estonia,False,5,-3,Turkey
765,778,809,1924,Austria,Egypt,3,1,Friendly,Vienna,Austria,False,4,2,Austria
766,779,810,1924,Latvia,Turkey,1,3,Friendly,Riga,Latvia,False,4,-2,Turkey
767,780,811,1924,Australia,Canada,4,1,Friendly,Sydney,Australia,False,5,3,Australia
768,781,812,1924,Australia,Canada,0,0,Friendly,Newcastle,Australia,False,0,0,Draw
769,782,813,1924,Poland,Turkey,2,0,Friendly,Łódź,Poland,False,2,2,Poland
770,783,814,1924,Sweden,Egypt,5,0,Friendly,Stockholm,Sweden,False,5,5,Sweden
771,784,815,1924,Australia,Canada,1,4,Friendly,Adelaide,Australia,False,5,-3,Canada
772,785,816,1924,Sweden,Estonia,5,2,Friendly,Stockholm,Sweden,False,7,3,Sweden
773,786,817,1924,Australia,Canada,1,0,Friendly,Sydney,Australia,False,1,1,Australia
774,787,818,1924,Finland,Sweden,5,7,Friendly,Helsinki,Finland,False,12,-2,Sweden
775,788,819,1924,Poland,Finland,1,0,Friendly,Warsaw,Poland,False,1,1,Poland
776,789,820,1924,Latvia,Finland,0,2,Friendly,Riga,Latvia,False,2,-2,Finland
777,790,821,1924,Finland,Norway,2,0,Friendly,Helsinki,Finland,False,2,2,Finland
778,791,822,1924,Estonia,Lithuania,1,2,Friendly,Tallinn,Estonia,False,3,-1,Lithuania
779,792,824,1924,Germany,Sweden,1,4,Friendly,Berlin,Germany,False,5,-3,Sweden
780,793,825,1924,Hungary,Poland,4,0,Friendly,Budapest,Hungary,False,4,4,Hungary
781,794,826,1924,Austria,Hungary,2,1,Friendly,Vienna,Austria,False,3,1,Austria
782,795,827,1924,Finland,Estonia,4,0,Friendly,Helsinki,Finland,False,4,4,Finland
783,796,828,1924,Norway,Denmark,1,3,Nordic Championship,Kristiania,Norway,False,4,-2,Denmark
784,797,829,1924,Hungary,Germany,4,1,Friendly,Budapest,Hungary,False,5,3,Hungary
785,798,830,1924,Sweden,Norway,6,1,Nordic Championship,Solna,Sweden,False,7,5,Sweden
786,799,831,1924,Uruguay,Argentina,1,1,Friendly,Montevideo,Uruguay,False,2,0,Draw
787,800,832,1924,Northern Ireland,South Africa,1,2,Friendly,Belfast,Northern Ireland,False,3,-1,South Africa
788,801,834,1924,Argentina,Uruguay,2,1,Friendly,Buenos Aires,Argentina,False,3,1,Argentina
789,802,835,1924,Denmark,Belgium,2,1,Friendly,Copenhagen,Denmark,False,3,1,Denmark
790,803,836,1924,Argentina,Paraguay,0,0,Copa América,Montevideo,Uruguay,True,0,0,Draw
791,804,837,1924,Latvia,Estonia,2,0,Friendly,Riga,Latvia,False,2,2,Latvia
792,805,838,1924,Uruguay,Chile,5,0,Copa América,Montevideo,Uruguay,False,5,5,Uruguay
793,806,839,1924,England,Northern Ireland,3,1,British Championship,Liverpool,England,False,4,2,England
794,807,840,1924,Argentina,Chile,2,0,Copa América,Montevideo,Uruguay,True,2,2,Argentina
795,808,841,1924,Uruguay,Paraguay,3,1,Copa América,Montevideo,Uruguay,False,4,2,Uruguay
796,809,842,1924,Chile,Paraguay,1,3,Copa América,Montevideo,Uruguay,True,4,-2,Paraguay
797,810,843,1924,Netherlands,South Africa,2,1,Friendly,Amsterdam,Netherlands,False,3,1,Netherlands
798,811,844,1924,Uruguay,Argentina,0,0,Copa América,Montevideo,Uruguay,False,0,0,Draw
799,812,845,1924,Austria,Sweden,1,1,Friendly,Vienna,Austria,False,2,0,Draw
800,813,846,1924,Belgium,France,3,0,Friendly,Brussels,Belgium,False,3,3,Belgium
801,814,847,1924,Italy,Sweden,2,2,Friendly,Milan,Italy,False,4,0,Draw
802,815,848,1924,Russia,Turkey,3,0,Friendly,Moscow,Soviet Union,False,3,3,Russia
803,816,849,1924,Germany,Italy,0,1,Friendly,Duisburg,Germany,False,1,-1,Italy
804,817,850,1924,England,Belgium,4,0,Friendly,West Bromwich,England,False,4,4,England
805,818,851,1924,Germany,Switzerland,1,1,Friendly,Stuttgart,Germany,False,2,0,Draw
806,819,852,1924,Spain,Austria,2,1,Friendly,Barcelona,Spain,False,3,1,Spain
807,820,853,1925,Scotland,Wales,3,1,British Championship,Edinburgh,Scotland,False,4,2,Scotland
808,822,855,1925,Northern Ireland,Scotland,0,3,British Championship,Belfast,Northern Ireland,False,3,-3,Scotland
809,823,856,1925,Wales,England,1,2,British Championship,Swansea,Wales,False,3,-1,England
810,824,857,1925,Belgium,Netherlands,0,1,Friendly,Antwerp,Belgium,False,1,-1,Netherlands
811,825,858,1925,Austria,Switzerland,2,0,Friendly,Vienna,Austria,False,2,2,Austria
812,826,859,1925,Haiti,Jamaica,1,2,Friendly,Port-au-Prince,Haiti,False,3,-1,Jamaica
813,827,860,1925,Italy,France,7,0,Friendly,Turin,Italy,False,7,7,Italy
814,828,861,1925,Hungary,Switzerland,5,0,Friendly,Budapest,Hungary,False,5,5,Hungary
815,829,862,1925,Haiti,Jamaica,0,3,Friendly,Port-au-Prince,Haiti,False,3,-3,Jamaica
816,830,863,1925,Haiti,Jamaica,0,1,Friendly,Port-au-Prince,Haiti,False,1,-1,Jamaica
817,831,864,1925,Netherlands,Germany,2,1,Friendly,Amsterdam,Netherlands,False,3,1,Netherlands
818,832,865,1925,Scotland,England,2,0,British Championship,Glasgow,Scotland,False,2,2,Scotland
819,833,866,1925,Turkey,Bulgaria,2,1,Friendly,Istanbul,Turkey,False,3,1,Turkey
820,834,867,1925,Wales,Northern Ireland,0,0,British Championship,Wrexham,Wales,False,0,0,Draw
821,835,868,1925,France,Austria,0,4,Friendly,Vincennes,France,False,4,-4,Austria
822,836,869,1925,Switzerland,Netherlands,4,1,Friendly,Zürich,Switzerland,False,5,3,Switzerland
823,837,870,1925,Romania,Turkey,1,2,Friendly,Bucharest,Romania,False,3,-1,Turkey
824,838,871,1925,Netherlands,Belgium,5,0,Friendly,Amsterdam,Netherlands,False,5,5,Netherlands
825,839,872,1925,Austria,Hungary,3,1,Friendly,Vienna,Austria,False,4,2,Austria
826,840,873,1925,Turkey,Russia,1,2,Friendly,Ankara,Turkey,False,3,-1,Russia
827,841,875,1925,France,England,2,3,Friendly,Colombes,France,False,5,-1,England
828,842,876,1925,Hungary,Belgium,1,3,Friendly,Budapest,Hungary,False,4,-2,Belgium
829,844,879,1925,Switzerland,Belgium,0,0,Friendly,Lausanne,Switzerland,False,0,0,Draw
830,845,880,1925,Bulgaria,Romania,2,4,Friendly,Sofia,Bulgaria,False,6,-2,Romania
831,846,881,1925,Switzerland,Spain,0,3,Friendly,Berne,Switzerland,False,3,-3,Spain
832,847,882,1925,Norway,Finland,1,0,Friendly,Oslo,Norway,False,1,1,Norway
833,848,883,1925,Sweden,Finland,4,0,Friendly,Gothenburg,Sweden,False,4,4,Sweden
834,849,884,1925,Spain,Italy,1,0,Friendly,Valencia,Spain,False,1,1,Spain
835,850,885,1925,Sweden,Denmark,0,2,Nordic Championship,Stockholm,Sweden,False,2,-2,Denmark
836,851,886,1925,Portugal,Italy,1,0,Friendly,Lisbon,Portugal,False,1,1,Portugal
837,852,887,1925,Denmark,Norway,5,1,Nordic Championship,Copenhagen,Denmark,False,6,4,Denmark
838,853,888,1925,Sweden,Germany,1,0,Friendly,Stockholm,Sweden,False,1,1,Sweden
839,854,889,1925,Finland,Germany,3,5,Friendly,Helsinki,Finland,False,8,-2,Germany
840,855,890,1925,Canada,United States,1,0,Friendly,Montréal,Canada,False,1,1,Canada
841,856,891,1925,Lithuania,Estonia,0,1,Friendly,Kaunas,Lithuania,False,1,-1,Estonia
842,857,892,1925,Estonia,Finland,2,0,Friendly,Tallinn,Estonia,False,2,2,Estonia
843,858,893,1925,Sweden,Austria,2,4,Friendly,Stockholm,Sweden,False,6,-2,Austria
844,859,894,1925,Argentina,Paraguay,1,1,Copa Chevallier Boutell,Buenos Aires,Argentina,False,2,0,Draw
845,860,895,1925,Finland,Austria,1,2,Friendly,Helsinki,Finland,False,3,-1,Austria
846,861,896,1925,Argentina,Paraguay,1,1,Copa Chevallier Boutell,Buenos Aires,Argentina,False,2,0,Draw
847,862,897,1925,Sweden,Hungary,6,2,Friendly,Stockholm,Sweden,False,8,4,Sweden
848,863,898,1925,Uruguay,Paraguay,0,1,Friendly,Montevideo,Uruguay,False,1,-1,Paraguay
849,864,899,1925,Uruguay,Paraguay,0,1,Friendly,Montevideo,Uruguay,False,1,-1,Paraguay
850,865,900,1925,Poland,Hungary,0,2,Friendly,Cracow,Poland,False,2,-2,Hungary
851,866,901,1925,Finland,Latvia,3,1,Friendly,Helsinki,Finland,False,4,2,Finland
852,867,902,1925,Paraguay,Uruguay,1,0,Friendly,Asunción,Paraguay,False,1,1,Paraguay
853,868,903,1925,Paraguay,Uruguay,0,1,Friendly,Asunción,Paraguay,False,1,-1,Uruguay
854,869,904,1925,Norway,Sweden,3,7,Nordic Championship,Oslo,Norway,False,10,-4,Sweden
855,870,905,1925,Paraguay,Uruguay,0,0,Friendly,Asunción,Paraguay,False,0,0,Draw
856,871,906,1925,Estonia,Latvia,2,2,Friendly,Tallinn,Estonia,False,4,0,Draw
857,872,907,1925,Finland,Poland,2,2,Friendly,Helsinki,Finland,False,4,0,Draw
858,873,908,1925,Hungary,Austria,1,1,Friendly,Budapest,Hungary,False,2,0,Draw
859,874,909,1925,Latvia,Lithuania,2,2,Friendly,Riga,Latvia,False,4,0,Draw
860,875,910,1925,Austria,Spain,0,1,Friendly,Vienna,Austria,False,1,-1,Spain
861,876,911,1925,Denmark,Finland,3,3,Friendly,Århus,Denmark,False,6,0,Draw
862,877,912,1925,Turkey,Poland,1,2,Friendly,Istanbul,Turkey,False,3,-1,Poland
863,878,913,1925,Hungary,Spain,0,1,Friendly,Budapest,Hungary,False,1,-1,Spain
864,879,915,1925,Northern Ireland,England,0,0,British Championship,Belfast,Northern Ireland,False,0,0,Draw
865,880,916,1925,Netherlands,Denmark,4,2,Friendly,Amsterdam,Netherlands,False,6,2,Netherlands
866,881,917,1925,Switzerland,Germany,0,4,Friendly,Basel,Switzerland,False,4,-4,Germany
867,882,919,1925,Wales,Scotland,0,3,British Championship,Cardiff,Wales,False,3,-3,Scotland
868,883,920,1925,Poland,Sweden,2,6,Friendly,Cracow,Poland,False,8,-4,Sweden
869,885,922,1925,Hungary,Italy,1,1,Friendly,Budapest,Hungary,False,2,0,Draw
870,886,923,1925,Switzerland,Austria,2,0,Friendly,Berne,Switzerland,False,2,2,Switzerland
871,887,924,1925,United States,Canada,6,1,Friendly,New York,United States,False,7,5,United States
872,888,925,1925,Argentina,Paraguay,2,0,Copa América,Buenos Aires,Argentina,False,2,2,Argentina
873,889,926,1925,Brazil,Paraguay,5,2,Copa América,Buenos Aires,Argentina,True,7,3,Brazil
874,890,927,1925,Argentina,Brazil,4,1,Copa América,Buenos Aires,Argentina,False,5,3,Argentina
875,891,928,1925,Belgium,Austria,3,4,Friendly,Liège,Belgium,False,7,-1,Austria
876,892,930,1925,Brazil,Paraguay,3,1,Copa América,Buenos Aires,Argentina,True,4,2,Brazil
877,893,931,1925,Argentina,Paraguay,3,1,Copa América,Buenos Aires,Argentina,False,4,2,Argentina
878,894,932,1925,Argentina,Brazil,2,2,Copa América,Buenos Aires,Argentina,False,4,0,Draw
879,896,934,1926,Haiti,Curaçao,1,1,Friendly,Port-au-Prince,Haiti,False,2,0,Draw
880,897,935,1926,Haiti,Curaçao,0,1,Friendly,Port-au-Prince,Haiti,False,1,-1,Curaçao
881,898,936,1926,Haiti,Curaçao,2,1,Friendly,Port-au-Prince,Haiti,False,3,1,Haiti
882,899,937,1926,Northern Ireland,Wales,3,0,British Championship,Belfast,Northern Ireland,False,3,3,Northern Ireland
883,900,938,1926,Belgium,Hungary,0,2,Friendly,Brussels,Belgium,False,2,-2,Hungary
884,901,939,1926,Haiti,Curaçao,2,2,Friendly,Port-au-Prince,Haiti,False,4,0,Draw
885,902,940,1926,Scotland,Northern Ireland,4,0,British Championship,Glasgow,Scotland,False,4,4,Scotland
886,903,941,1926,England,Wales,1,3,British Championship,London,England,False,4,-2,Wales
887,904,942,1926,Jamaica,Curaçao,2,0,Friendly,Kingston,Jamaica,False,2,2,Jamaica
888,906,944,1926,Belgium,Netherlands,1,1,Friendly,Antwerp,Belgium,False,2,0,Draw
889,907,945,1926,Italy,Republic of Ireland,3,0,Friendly,Turin,Italy,False,3,3,Italy
890,908,946,1926,Netherlands,Switzerland,5,0,Friendly,Amsterdam,Netherlands,False,5,5,Netherlands
891,909,947,1926,France,Belgium,4,3,Friendly,Vincennes,France,False,7,1,France
892,910,948,1926,England,Scotland,0,1,British Championship,Manchester,England,False,1,-1,Scotland
893,911,949,1926,France,Portugal,4,2,Friendly,Toulouse,France,False,6,2,France
894,912,950,1926,Germany,Netherlands,4,2,Friendly,Düsseldorf,Germany,False,6,2,Germany
895,913,951,1926,Switzerland,Italy,1,1,Friendly,Zürich,Switzerland,False,2,0,Draw
896,914,952,1926,France,Switzerland,1,0,Friendly,Colombes,France,False,1,1,France
897,915,953,1926,Romania,Bulgaria,6,1,Friendly,Bucharest,Romania,False,7,5,Romania
898,916,954,1926,Kenya,Uganda,1,1,Friendly,Nairobi,Kenya,False,2,0,Draw
899,917,955,1926,Hungary,Austria,0,3,Friendly,Budapest,Hungary,False,3,-3,Austria
900,918,956,1926,Netherlands,Belgium,1,5,Friendly,Amsterdam,Netherlands,False,6,-4,Belgium
901,919,957,1926,Kenya,Uganda,2,1,Friendly,Nairobi,Kenya,False,3,1,Kenya
902,920,958,1926,Turkey,Romania,1,3,Friendly,Istanbul,Turkey,False,4,-2,Romania
903,921,959,1926,Italy,Switzerland,3,2,Friendly,Milan,Italy,False,5,1,Italy
904,922,960,1926,Belgium,England,3,5,Friendly,Antwerp,Belgium,False,8,-2,England
905,923,961,1926,Argentina,Paraguay,2,1,Copa Chevallier Boutell,Buenos Aires,Argentina,False,3,1,Argentina
906,924,962,1926,Austria,France,4,1,Friendly,Vienna,Austria,False,5,3,Austria
907,925,964,1926,Argentina,Paraguay,2,1,Copa Chevallier Boutell,Buenos Aires,Argentina,False,3,1,Argentina
908,926,965,1926,Finland,Norway,2,5,Friendly,Helsinki,Finland,False,7,-3,Norway
909,928,967,1926,Sweden,Norway,3,2,Nordic Championship,Stockholm,Sweden,False,5,1,Sweden
910,929,968,1926,Denmark,Netherlands,4,1,Friendly,Copenhagen,Denmark,False,5,3,Denmark
911,930,969,1926,Estonia,Lithuania,3,1,Friendly,Tallinn,Estonia,False,4,2,Estonia
912,933,972,1926,Belgium,France,2,2,Friendly,Brussels,Belgium,False,4,0,Draw
913,934,973,1926,Finland,Denmark,3,2,Friendly,Helsinki,Finland,False,5,1,Finland
914,935,974,1926,Germany,Sweden,3,3,Friendly,Nuremberg,Germany,False,6,0,Draw
915,936,977,1926,Poland,Estonia,2,0,Friendly,Warsaw,Poland,False,2,2,Poland
916,937,979,1926,Sweden,Italy,5,3,Friendly,Stockholm,Sweden,False,8,2,Sweden
917,938,980,1926,Latvia,Sweden,4,1,Friendly,Riga,Latvia,False,5,3,Latvia
918,939,981,1926,Estonia,Sweden,1,7,Friendly,Tallinn,Estonia,False,8,-6,Sweden
919,940,982,1926,Finland,Sweden,2,3,Friendly,Helsinki,Finland,False,5,-1,Sweden
920,941,983,1926,Poland,Finland,7,1,Friendly,Poznań,Poland,False,8,6,Poland
921,942,984,1926,Latvia,Finland,1,4,Friendly,Riga,Latvia,False,5,-3,Finland
922,943,985,1926,Hungary,Poland,4,1,Friendly,Budapest,Hungary,False,5,3,Hungary
923,944,986,1926,Lithuania,Latvia,2,3,Friendly,Kaunas,Lithuania,False,5,-1,Latvia
924,945,987,1926,Finland,Estonia,1,1,Friendly,Helsinki,Finland,False,2,0,Draw
925,946,988,1926,Poland,Turkey,6,1,Friendly,Lwów,Poland,False,7,5,Poland
926,947,989,1926,Austria,Hungary,2,3,Friendly,Vienna,Austria,False,5,-1,Hungary
927,948,990,1926,Latvia,Estonia,0,1,Friendly,Riga,Latvia,False,1,-1,Estonia
928,949,991,1926,Norway,Denmark,2,2,Nordic Championship,Oslo,Norway,False,4,0,Draw
929,950,993,1926,Denmark,Sweden,2,0,Nordic Championship,Copenhagen,Denmark,False,2,2,Denmark
930,951,994,1926,Sweden,Poland,3,1,Friendly,Stockholm,Sweden,False,4,2,Sweden
931,952,996,1926,Austria,Switzerland,7,1,Friendly,Vienna,Austria,False,8,6,Austria
932,953,997,1926,Chile,Bolivia,7,1,Copa América,Santiago,Chile,False,8,6,Chile
933,954,998,1926,Argentina,Bolivia,5,0,Copa América,Santiago,Chile,True,5,5,Argentina
934,955,999,1926,Chile,Uruguay,1,3,Copa América,Santiago,Chile,False,4,-2,Uruguay
935,956,1000,1926,Argentina,Paraguay,8,0,Copa América,Santiago,Chile,True,8,8,Argentina
936,957,1001,1926,England,Northern Ireland,3,3,British Championship,Liverpool,England,False,6,0,Draw
937,958,1002,1926,Bolivia,Paraguay,1,6,Copa América,Santiago,Chile,True,7,-5,Paraguay
938,959,1003,1926,Argentina,Uruguay,0,2,Copa América,Santiago,Chile,True,2,-2,Uruguay
939,960,1004,1926,Bolivia,Uruguay,0,6,Copa América,Santiago,Chile,True,6,-6,Uruguay
940,961,1006,1926,Scotland,Wales,3,0,British Championship,Glasgow,Scotland,False,3,3,Scotland
941,962,1007,1926,Chile,Argentina,1,1,Copa América,Santiago,Chile,False,2,0,Draw
942,963,1008,1926,Netherlands,Germany,2,3,Friendly,Amsterdam,Netherlands,False,5,-1,Germany
943,964,1009,1926,Paraguay,Uruguay,1,6,Copa América,Santiago,Chile,True,7,-5,Uruguay
944,965,1010,1926,Chile,Paraguay,5,1,Copa América,Santiago,Chile,False,6,4,Chile
945,966,1011,1926,United States,Canada,6,2,Friendly,New York,United States,False,8,4,United States
946,967,1012,1926,Austria,Sweden,3,1,Friendly,Vienna,Austria,False,4,2,Austria
947,968,1013,1926,Hungary,Sweden,3,1,Friendly,Budapest,Hungary,False,4,2,Hungary
948,969,1014,1926,Jamaica,Haiti,6,0,Friendly,Kingston,Jamaica,False,6,6,Jamaica
949,970,1015,1926,Germany,Switzerland,2,3,Friendly,Munich,Germany,False,5,-1,Switzerland
950,971,1016,1926,Spain,Hungary,4,2,Friendly,Vigo,Spain,False,6,2,Spain
951,972,1017,1926,Portugal,Hungary,3,3,Friendly,Porto,Portugal,False,6,0,Draw
952,974,1019,1927,Switzerland,Italy,1,5,Friendly,Geneva,Switzerland,False,6,-4,Italy
953,975,1020,1927,Wales,England,3,3,British Championship,Wrexham,Wales,False,6,0,Draw
954,977,1022,1927,Northern Ireland,Scotland,0,2,British Championship,Belfast,Northern Ireland,False,2,-2,Scotland
955,978,1023,1927,Belgium,Netherlands,2,0,Friendly,Antwerp,Belgium,False,2,2,Belgium
956,979,1024,1927,Portugal,France,4,0,Friendly,Lisbon,Portugal,False,4,4,Portugal
957,980,1025,1927,Scotland,England,1,2,British Championship,Glasgow,Scotland,False,3,-1,England
958,981,1026,1927,Belgium,Sweden,2,1,Friendly,Forest,Belgium,False,3,1,Belgium
959,982,1027,1927,Wales,Northern Ireland,2,2,British Championship,Cardiff,Wales,False,4,0,Draw
960,983,1028,1927,Austria,Hungary,6,0,Friendly,Vienna,Austria,False,6,6,Austria
961,985,1030,1927,Italy,Portugal,3,1,Friendly,Turin,Italy,False,4,2,Italy
962,986,1031,1927,Spain,Switzerland,1,0,Friendly,Santander,Spain,False,1,1,Spain
963,987,1033,1927,France,Italy,3,3,Friendly,Colombes,France,False,6,0,Draw
964,988,1034,1927,Netherlands,Belgium,3,2,Friendly,Amsterdam,Netherlands,False,5,1,Netherlands
965,990,1036,1927,Belgium,England,1,9,Friendly,Brussels,Belgium,False,10,-8,England
966,992,1038,1927,Luxembourg,England,2,5,Friendly,Esch-sur-Alzette,Luxembourg,False,7,-3,England
967,993,1039,1927,Austria,Belgium,4,1,Friendly,Vienna,Austria,False,5,3,Austria
968,994,1040,1927,France,Spain,1,4,Friendly,Colombes,France,False,5,-3,Spain
969,995,1042,1927,France,England,0,6,Friendly,Colombes,France,False,6,-6,England
970,996,1043,1927,Italy,Spain,2,0,Friendly,Bologna,Italy,False,2,2,Italy
971,997,1044,1927,Norway,Denmark,0,1,Friendly,Oslo,Norway,False,1,-1,Denmark
972,998,1045,1927,Sweden,Latvia,12,0,Friendly,Stockholm,Sweden,False,12,12,Sweden
973,999,1046,1927,Switzerland,Austria,1,4,Friendly,Zürich,Switzerland,False,5,-3,Austria
974,1000,1047,1927,Denmark,Netherlands,1,1,Friendly,Copenhagen,Denmark,False,2,0,Draw
975,1001,1048,1927,Hungary,France,13,1,Friendly,Budapest,Hungary,False,14,12,Hungary
976,1002,1049,1927,Sweden,Finland,6,2,Friendly,Stockholm,Sweden,False,8,4,Sweden
977,1003,1050,1927,Norway,Finland,3,1,Friendly,Oslo,Norway,False,4,2,Norway
978,1004,1051,1927,Estonia,Latvia,4,1,Friendly,Tallinn,Estonia,False,5,3,Estonia
979,1005,1052,1927,Romania,Poland,3,3,Friendly,Bucharest,Romania,False,6,0,Draw
980,1006,1053,1927,Sweden,Denmark,0,0,Nordic Championship,Stockholm,Sweden,False,0,0,Draw
981,1007,1054,1927,New Zealand,Canada,2,2,Friendly,Dunedin,New Zealand,False,4,0,Draw
982,1008,1055,1927,Norway,Sweden,3,5,Nordic Championship,Oslo,Norway,False,8,-2,Sweden
983,1009,1056,1927,Sweden,Estonia,3,1,Friendly,Norrköping,Sweden,False,4,2,Sweden
984,1010,1057,1927,New Zealand,Canada,1,2,Friendly,Christchurch,New Zealand,False,3,-1,Canada
985,1011,1058,1927,New Zealand,Canada,1,0,Friendly,Wellington,New Zealand,False,1,1,New Zealand
986,1012,1059,1927,Uruguay,Argentina,0,1,Copa Newton,Montevideo,Uruguay,False,1,-1,Argentina
987,1013,1060,1927,Bulgaria,Turkey,3,3,Friendly,Sofia,Bulgaria,False,6,0,Draw
988,1014,1061,1927,New Zealand,Canada,1,4,Friendly,Auckland,New Zealand,False,5,-3,Canada
989,1015,1062,1927,Latvia,Lithuania,6,3,Friendly,Riga,Latvia,False,9,3,Latvia
990,1016,1063,1927,Estonia,Finland,2,1,Friendly,Tallinn,Estonia,False,3,1,Estonia
991,1017,1064,1927,Lithuania,Estonia,0,5,Friendly,Kaunas,Lithuania,False,5,-5,Estonia
992,1018,1066,1927,Japan,Philippines,2,1,Friendly,Shanghai,China PR,True,3,1,Japan
993,1019,1067,1927,Argentina,Uruguay,0,1,Copa Lipton,Buenos Aires,Argentina,False,1,-1,Uruguay
994,1020,1069,1927,Sweden,Belgium,7,0,Friendly,Stockholm,Sweden,False,7,7,Sweden
995,1021,1070,1927,Finland,Latvia,3,1,Friendly,Helsinki,Finland,False,4,2,Finland
996,1022,1072,1927,Hungary,Austria,5,3,International Cup,Budapest,Hungary,False,8,2,Hungary
997,1023,1073,1927,Latvia,Estonia,4,1,Friendly,Riga,Latvia,False,5,3,Latvia
998,1024,1074,1927,Denmark,Germany,3,1,Friendly,Copenhagen,Denmark,False,4,2,Denmark
999,1026,1076,1927,Turkey,Bulgaria,3,1,Friendly,Istanbul,Turkey,False,4,2,Turkey
1000,1027,1077,1927,Northern Ireland,England,2,0,British Championship,Belfast,Northern Ireland,False,2,2,Northern Ireland
1001,1028,1079,1927,Germany,Norway,6,2,Friendly,Altona,Germany,False,8,4,Germany
1002,1029,1081,1927,Wales,Scotland,2,2,British Championship,Wrexham,Wales,False,4,0,Draw
1003,1030,1082,1927,Argentina,Bolivia,7,1,Copa América,Lima,Peru,True,8,6,Argentina
1004,1031,1083,1927,Denmark,Norway,3,1,Nordic Championship,Copenhagen,Denmark,False,4,2,Denmark
1005,1032,1084,1927,Peru,Uruguay,0,4,Copa América,Lima,Peru,False,4,-4,Uruguay
1006,1033,1085,1927,Bolivia,Uruguay,0,9,Copa América,Lima,Peru,True,9,-9,Uruguay
1007,1034,1086,1927,Italy,Austria,0,1,International Cup,Bologna,Italy,False,1,-1,Austria
1008,1035,1087,1927,Switzerland,Sweden,2,2,Friendly,Zürich,Switzerland,False,4,0,Draw
1009,1036,1088,1927,Honduras,El Salvador,1,0,Friendly,Tegucigalpa,Honduras,False,1,1,Honduras
1010,1037,1089,1927,Honduras,El Salvador,0,0,Friendly,Tegucigalpa,Honduras,False,0,0,Draw
1011,1038,1090,1927,Netherlands,Sweden,1,0,Friendly,Amsterdam,Netherlands,False,1,1,Netherlands
1012,1039,1091,1927,Peru,Bolivia,3,2,Copa América,Lima,Peru,False,5,1,Peru
1013,1040,1092,1927,Argentina,Uruguay,3,2,Copa América,Lima,Peru,True,5,1,Argentina
1014,1041,1093,1927,Germany,Netherlands,2,2,Friendly,Cologne,Germany,False,4,0,Draw
1015,1042,1094,1927,Peru,Argentina,1,5,Copa América,Lima,Peru,False,6,-4,Argentina
1016,1043,1095,1927,Chile,Uruguay,2,3,Friendly,Viña del Mar,Chile,False,5,-1,Uruguay
1017,1044,1096,1928,Italy,Switzerland,3,2,International Cup,Genoa,Italy,False,5,1,Italy
1018,1045,1097,1928,Belgium,Austria,1,2,Friendly,Brussels,Belgium,False,3,-1,Austria
1019,1046,1098,1928,Portugal,Spain,2,2,Friendly,Lisbon,Portugal,False,4,0,Draw
1020,1047,1099,1928,Northern Ireland,Wales,1,2,British Championship,Belfast,Northern Ireland,False,3,-1,Wales
1021,1048,1100,1928,Belgium,Republic of Ireland,2,4,Friendly,Liège,Belgium,False,6,-2,Republic of Ireland
1022,1049,1101,1928,France,Northern Ireland,4,0,Friendly,Montrouge,France,False,4,4,France
1023,1050,1102,1928,Scotland,Northern Ireland,0,1,British Championship,Glasgow,Scotland,False,1,-1,Northern Ireland
1024,1051,1103,1928,Netherlands,Belgium,1,1,Friendly,Amsterdam,Netherlands,False,2,0,Draw
1025,1052,1104,1928,Switzerland,France,4,3,Friendly,Lausanne,Switzerland,False,7,1,Switzerland
1026,1053,1105,1928,Guyana,Trinidad and Tobago,1,1,Friendly,Georgetown,British Guyana,False,2,0,Draw
1027,1054,1106,1928,Italy,Hungary,4,3,International Cup,Rome,Italy,False,7,1,Italy
1028,1055,1107,1928,England,Scotland,1,5,British Championship,London,England,False,6,-4,Scotland
1029,1057,1109,1928,Belgium,Netherlands,1,0,Friendly,Antwerp,Belgium,False,1,1,Belgium
1030,1058,1110,1928,Portugal,Argentina,0,0,Friendly,Lisbon,Portugal,False,0,0,Draw
1031,1059,1112,1928,France,Belgium,2,3,Friendly,Colombes,France,False,5,-1,Belgium
1032,1060,1113,1928,Portugal,Italy,4,1,Friendly,Porto,Portugal,False,5,3,Portugal
1033,1061,1114,1928,Romania,Turkey,4,2,Friendly,Arad,Romania,False,6,2,Romania
1034,1062,1115,1928,Switzerland,Germany,2,3,Friendly,Berne,Switzerland,False,5,-1,Germany
1035,1063,1116,1928,Uganda,Kenya,4,0,Friendly,Kampala,Uganda,False,4,4,Uganda
1036,1065,1118,1928,Netherlands,Denmark,2,0,Friendly,Amsterdam,Netherlands,False,2,2,Netherlands
1037,1066,1119,1928,Spain,Italy,1,1,Friendly,Gijón,Spain,False,2,0,Draw
1038,1067,1120,1928,France,Portugal,1,1,Friendly,Paris,France,False,2,0,Draw
1039,1068,1121,1928,Hungary,Austria,5,5,Friendly,Budapest,Hungary,False,10,0,Draw
1040,1069,1122,1928,Switzerland,Netherlands,2,1,Friendly,Basel,Switzerland,False,3,1,Switzerland
1041,1071,1125,1928,France,England,1,5,Friendly,Colombes,France,False,6,-4,England
1042,1072,1126,1928,Belgium,England,1,3,Friendly,Antwerp,Belgium,False,4,-2,England
1043,1073,1127,1928,Finland,Norway,0,6,Friendly,Helsinki,Finland,False,6,-6,Norway
1044,1074,1128,1928,Sweden,Norway,6,1,Nordic Championship,Stockholm,Sweden,False,7,5,Sweden
1045,1075,1129,1928,Poland,United States,3,3,Friendly,Warsaw,Poland,False,6,0,Draw
1046,1076,1130,1928,Netherlands,Egypt,1,2,Friendly,Rotterdam,Netherlands,False,3,-1,Egypt
1047,1077,1131,1928,Norway,Denmark,2,3,Nordic Championship,Oslo,Norway,False,5,-1,Denmark
1048,1078,1132,1928,Luxembourg,Egypt,1,1,Friendly,Esch-sur-Alzette,Luxembourg,False,2,0,Draw
1049,1079,1133,1928,Poland,Sweden,2,1,Friendly,Katowice,Poland,False,3,1,Poland
1050,1080,1134,1928,Latvia,Sweden,0,4,Friendly,Riga,Latvia,False,4,-4,Sweden
1051,1081,1135,1928,Estonia,Sweden,0,1,Friendly,Tallinn,Estonia,False,1,-1,Sweden
1052,1082,1136,1928,Latvia,Lithuania,3,0,Baltic Cup,Tallinn,Estonia,True,3,3,Latvia
1053,1083,1137,1928,Estonia,Lithuania,6,0,Baltic Cup,Tallinn,Estonia,False,6,6,Estonia
1054,1084,1138,1928,Estonia,Latvia,0,1,Baltic Cup,Tallinn,Estonia,False,1,-1,Latvia
1055,1085,1139,1928,Sweden,Austria,2,3,Friendly,Stockholm,Sweden,False,5,-1,Austria
1056,1086,1140,1928,Finland,Estonia,2,2,Friendly,Helsinki,Finland,False,4,0,Draw
1057,1087,1141,1928,Paraguay,Uruguay,3,1,Friendly,Asunción,Paraguay,False,4,2,Paraguay
1058,1088,1142,1928,Belarus,Switzerland,6,3,Friendly,Moscow,Soviet Union,True,9,3,Belarus
1059,1089,1143,1928,Belarus,Ukraine,2,6,Friendly,Moscow,Soviet Union,True,8,-4,Ukraine
1060,1090,1144,1928,Latvia,Finland,2,1,Friendly,Riga,Latvia,False,3,1,Latvia
1061,1091,1145,1928,Paraguay,Uruguay,1,1,Friendly,Asunción,Paraguay,False,2,0,Draw
1062,1092,1146,1928,Belarus,Finland,1,2,Friendly,Moscow,Soviet Union,True,3,-1,Finland
1063,1093,1147,1928,Argentina,Uruguay,1,0,Copa Newton,Avellaneda,Argentina,False,1,1,Argentina
1064,1094,1148,1928,Lithuania,Latvia,1,1,Friendly,Kaunas,Lithuania,False,2,0,Draw
1065,1095,1149,1928,Finland,Sweden,2,3,Friendly,Helsinki,Finland,False,5,-1,Sweden
1066,1096,1150,1928,Germany,Denmark,2,1,Friendly,Nuremberg,Germany,False,3,1,Germany
1067,1097,1151,1928,Uruguay,Argentina,2,2,Copa Lipton,Montevideo,Uruguay,False,4,0,Draw
1068,1098,1153,1928,Latvia,Estonia,1,1,Friendly,Riga,Latvia,False,2,0,Draw
1069,1099,1154,1928,Norway,Germany,0,2,Friendly,Oslo,Norway,False,2,-2,Germany
1070,1100,1155,1928,Sweden,Germany,2,0,Friendly,Stockholm,Sweden,False,2,2,Sweden
1071,1101,1156,1928,Austria,Hungary,5,1,International Cup,Vienna,Austria,False,6,4,Austria
1072,1102,1157,1928,Denmark,Sweden,3,1,Nordic Championship,Copenhagen,Denmark,False,4,2,Denmark
1073,1103,1158,1928,Switzerland,Italy,2,3,International Cup,Zürich,Switzerland,False,5,-1,Italy
1074,1104,1159,1928,England,Northern Ireland,2,1,British Championship,Liverpool,England,False,3,1,England
1075,1105,1161,1928,Scotland,Wales,4,2,British Championship,Glasgow,Scotland,False,6,2,Scotland
1076,1106,1162,1928,Austria,Switzerland,2,0,International Cup,Vienna,Austria,False,2,2,Austria
1077,1107,1164,1928,Hungary,Switzerland,3,1,International Cup,Budapest,Hungary,False,4,2,Hungary
1078,1108,1165,1928,Netherlands,Belgium,1,1,Friendly,Amsterdam,Netherlands,False,2,0,Draw
1079,1109,1166,1928,Italy,Austria,2,2,Friendly,Rome,Italy,False,4,0,Draw
1080,1110,1167,1928,Wales,England,2,3,British Championship,Swansea,Wales,False,5,-1,England
1081,1111,1168,1928,Italy,Netherlands,3,2,Friendly,Milan,Italy,False,5,1,Italy
1082,1112,1169,1928,El Salvador,Honduras,5,0,Friendly,San Salvador,El Salvador,False,5,5,El Salvador
1083,1113,1170,1929,Wales,Northern Ireland,2,2,British Championship,Wrexham,Wales,False,4,0,Draw
1084,1114,1171,1929,Germany,Switzerland,7,1,Friendly,Mannheim,Germany,False,8,6,Germany
1085,1115,1172,1929,Northern Ireland,Scotland,3,7,British Championship,Belfast,Northern Ireland,False,10,-4,Scotland
1086,1116,1173,1929,France,Hungary,3,0,Friendly,Colombes,France,False,3,3,France
1087,1118,1176,1929,Netherlands,Switzerland,3,2,Friendly,Amsterdam,Netherlands,False,5,1,Netherlands
1088,1119,1177,1929,Spain,Portugal,5,0,Friendly,Seville,Spain,False,5,5,Spain
1089,1120,1178,1929,France,Portugal,2,0,Friendly,Colombes,France,False,2,2,France
1090,1121,1179,1929,Austria,Italy,3,0,International Cup,Vienna,Austria,False,3,3,Austria
1091,1122,1180,1929,Scotland,England,1,0,British Championship,Glasgow,Scotland,False,1,1,Scotland
1092,1123,1181,1929,Spain,France,8,1,Friendly,Zaragoza,Spain,False,9,7,Spain
1093,1124,1182,1929,Switzerland,Hungary,4,5,International Cup,Berne,Switzerland,False,9,-1,Hungary
1094,1125,1183,1929,Barbados,Trinidad and Tobago,3,0,Friendly,Bridgetown,Barbados,False,3,3,Barbados
1095,1126,1184,1929,Romania,Bulgaria,3,0,Friendly,Bucharest,Romania,False,3,3,Romania
1096,1127,1185,1929,Barbados,Trinidad and Tobago,2,0,Friendly,Bridgetown,Barbados,False,2,2,Barbados
1097,1128,1186,1929,Barbados,Trinidad and Tobago,2,1,Friendly,Bridgetown,Barbados,False,3,1,Barbados
1098,1129,1187,1929,Italy,Germany,1,2,Friendly,Turin,Italy,False,3,-1,Germany
1099,1130,1188,1929,Republic of Ireland,Belgium,4,0,Friendly,Dublin,Irish Free State,False,4,4,Republic of Ireland
1100,1131,1189,1929,El Salvador,Nicaragua,9,0,Friendly,San Salvador,El Salvador,False,9,9,El Salvador
1101,1132,1190,1929,Austria,Hungary,2,2,Friendly,Vienna,Austria,False,4,0,Draw
1102,1133,1191,1929,Belgium,Netherlands,3,1,Friendly,Antwerp,Belgium,False,4,2,Belgium
1103,1135,1193,1929,France,England,1,4,Friendly,Colombes,France,False,5,-3,England
1104,1137,1195,1929,Belgium,England,1,5,Friendly,Forest,Belgium,False,6,-4,England
1105,1138,1196,1929,Kenya,Uganda,3,5,Friendly,Nairobi,Kenya,False,8,-2,Uganda
1106,1139,1197,1929,Spain,England,4,3,Friendly,Madrid,Spain,False,7,1,Spain
1107,1141,1199,1929,Belgium,France,4,1,Friendly,Liège,Belgium,False,5,3,Belgium
1108,1142,1200,1929,Norway,Scotland,3,7,Friendly,Bergen,Norway,False,10,-4,Scotland
1109,1143,1201,1929,Germany,Scotland,1,1,Friendly,Berlin,Germany,False,2,0,Draw
1110,1144,1202,1929,Netherlands,Scotland,0,2,Friendly,Amsterdam,Netherlands,False,2,-2,Scotland
1111,1145,1203,1929,Sweden,Netherlands,6,2,Friendly,Stockholm,Sweden,False,8,4,Sweden
1112,1146,1204,1929,Norway,Netherlands,4,4,Friendly,Oslo,Norway,False,8,0,Draw
1113,1147,1205,1929,Sweden,Finland,3,1,Nordic Championship,Stockholm,Sweden,False,4,2,Sweden
1114,1148,1206,1929,Argentina,Uruguay,2,0,Friendly,Buenos Aires,Argentina,False,2,2,Argentina
1115,1149,1207,1929,Sweden,Denmark,3,2,Nordic Championship,Gothenburg,Sweden,False,5,1,Sweden
1116,1150,1208,1929,Uruguay,Argentina,1,1,Friendly,Montevideo,Uruguay,False,2,0,Draw
1117,1151,1209,1929,Norway,Finland,4,0,Nordic Championship,Oslo,Norway,False,4,4,Norway
1118,1152,1210,1929,Denmark,Norway,2,5,Nordic Championship,Copenhagen,Denmark,False,7,-3,Norway
1119,1153,1211,1929,Germany,Sweden,3,0,Friendly,Cologne,Germany,False,3,3,Germany
1120,1154,1213,1929,Bulgaria,Greece,1,1,Friendly,Sofia,Bulgaria,False,2,0,Draw
1121,1155,1214,1929,Sweden,Estonia,4,1,Friendly,Landskrona,Sweden,False,5,3,Sweden
1122,1156,1215,1929,Estonia,Finland,1,1,Friendly,Tallinn,Estonia,False,2,0,Draw
1123,1157,1216,1929,Sweden,Latvia,10,0,Friendly,Malmö,Sweden,False,10,10,Sweden
1124,1158,1217,1929,Latvia,Lithuania,3,1,Baltic Cup,Riga,Latvia,False,4,2,Latvia
1125,1159,1218,1929,Estonia,Lithuania,5,2,Baltic Cup,Riga,Latvia,True,7,3,Estonia
1126,1160,1219,1929,Latvia,Estonia,2,2,Baltic Cup,Riga,Latvia,False,4,0,Draw
1127,1161,1220,1929,Finland,Estonia,2,1,Friendly,Helsinki,Finland,False,3,1,Finland
1128,1163,1223,1929,Bulgaria,Romania,2,3,Friendly,Sofia,Bulgaria,False,5,-1,Romania
1129,1164,1224,1929,Finland,Latvia,3,1,Friendly,Helsinki,Finland,False,4,2,Finland
1130,1165,1225,1929,Estonia,Latvia,4,1,Friendly,Tallinn,Estonia,False,5,3,Estonia
1131,1166,1226,1929,Uruguay,Argentina,2,1,Copa Newton,Montevideo,Uruguay,False,3,1,Uruguay
1132,1167,1227,1929,Argentina,Uruguay,0,0,Copa Lipton,Buenos Aires,Argentina,False,0,0,Draw
1133,1168,1228,1929,Norway,Sweden,2,1,Nordic Championship,Oslo,Norway,False,3,1,Norway
1134,1169,1230,1929,Hungary,Austria,2,1,Friendly,Budapest,Hungary,False,3,1,Hungary
1135,1171,1232,1929,Denmark,Finland,8,0,Nordic Championship,Copenhagen,Denmark,False,8,8,Denmark
1136,1172,1233,1929,Northern Ireland,England,0,3,British Championship,Belfast,Northern Ireland,False,3,-3,England
1137,1173,1234,1929,Germany,Finland,4,0,Friendly,Altona,Germany,False,4,4,Germany
1138,1174,1235,1929,Trinidad and Tobago,Guyana,0,0,Friendly,Port of Spain,Trinidad and Tobago,False,0,0,Draw
1139,1175,1236,1929,Wales,Scotland,2,4,British Championship,Cardiff,Wales,False,6,-2,Scotland
1140,1176,1237,1929,Switzerland,Austria,1,3,International Cup,Berne,Switzerland,False,4,-2,Austria
1141,1177,1239,1929,Paraguay,Uruguay,3,0,Copa América,Buenos Aires,Argentina,True,3,3,Paraguay
1142,1178,1240,1929,Trinidad and Tobago,Guyana,0,1,Friendly,Port of Spain,Trinidad and Tobago,False,1,-1,Guyana
1143,1179,1241,1929,Argentina,Peru,3,0,Copa América,Buenos Aires,Argentina,False,3,3,Argentina
1144,1180,1242,1929,Netherlands,Norway,1,4,Friendly,Amsterdam,Netherlands,False,5,-3,Norway
1145,1181,1243,1929,Trinidad and Tobago,Guyana,3,1,Friendly,Port of Spain,Trinidad and Tobago,False,4,2,Trinidad and Tobago
1146,1182,1244,1929,Argentina,Paraguay,4,1,Copa América,Buenos Aires,Argentina,False,5,3,Argentina
1147,1183,1245,1929,Peru,Uruguay,1,4,Copa América,Buenos Aires,Argentina,True,5,-3,Uruguay
1148,1184,1246,1929,Trinidad and Tobago,Guyana,1,1,Friendly,Port of Spain,Trinidad and Tobago,False,2,0,Draw
1149,1185,1247,1929,Trinidad and Tobago,Guyana,0,1,Friendly,Port of Spain,Trinidad and Tobago,False,1,-1,Guyana
1150,1186,1248,1929,Paraguay,Peru,5,0,Copa América,Avellaneda,Argentina,True,5,5,Paraguay
1151,1187,1249,1929,Argentina,Uruguay,2,0,Copa América,Buenos Aires,Argentina,False,2,2,Argentina
1152,1188,1250,1929,England,Wales,6,0,British Championship,London,England,False,6,6,England
1153,1189,1251,1929,Italy,Portugal,6,1,Friendly,Milan,Italy,False,7,5,Italy
1154,1193,1255,1930,Northern Ireland,Wales,7,0,British Championship,Belfast,Northern Ireland,False,7,7,Northern Ireland
1155,1194,1256,1930,Italy,Switzerland,4,2,Friendly,Rome,Italy,False,6,2,Italy
1156,1195,1257,1930,Kenya,Uganda,0,0,Friendly,Nairobi,Kenya,False,0,0,Draw
1157,1196,1258,1930,Scotland,Northern Ireland,3,1,British Championship,Glasgow,Scotland,False,4,2,Scotland
1158,1197,1259,1930,Portugal,France,2,0,Friendly,Porto,Portugal,False,2,2,Portugal
1159,1198,1260,1930,Germany,Italy,0,2,Friendly,Frankfurt am Main,Germany,False,2,-2,Italy
1160,1199,1262,1930,France,Switzerland,3,3,Friendly,Colombes,France,False,6,0,Draw
1161,1200,1263,1930,England,Scotland,5,2,British Championship,London,England,False,7,3,England
1162,1201,1264,1930,Netherlands,Italy,1,1,Friendly,Amsterdam,Netherlands,False,2,0,Draw
1163,1202,1265,1930,France,Belgium,1,6,Friendly,Colombes,France,False,7,-5,Belgium
1164,1203,1266,1930,Switzerland,Hungary,2,2,Friendly,Basel,Switzerland,False,4,0,Draw
1165,1204,1268,1930,Curaçao,Aruba,2,1,Friendly,Willemstad,Curaçao,False,3,1,Curaçao
1166,1205,1270,1930,Uganda,Kenya,5,0,Friendly,Kampala,Uganda,False,5,5,Uganda
1167,1206,1271,1930,Netherlands,Belgium,2,2,Friendly,Amsterdam,Netherlands,False,4,0,Draw
1168,1207,1272,1930,Switzerland,Germany,0,5,Friendly,Zürich,Switzerland,False,5,-5,Germany
1169,1208,1274,1930,Germany,England,3,3,Friendly,Berlin,Germany,False,6,0,Draw
1170,1209,1275,1930,Belgium,Republic of Ireland,1,3,Friendly,Brussels,Belgium,False,4,-2,Republic of Ireland
1171,1211,1277,1930,Hungary,Italy,0,5,International Cup,Budapest,Hungary,False,5,-5,Italy
1172,1212,1278,1930,Austria,England,0,0,Friendly,Vienna,Austria,False,0,0,Draw
1173,1213,1279,1930,Belgium,Netherlands,3,1,Friendly,Antwerp,Belgium,False,4,2,Belgium
1174,1214,1280,1930,France,Scotland,0,2,Friendly,Colombes,France,False,2,-2,Scotland
1175,1215,1281,1930,Argentina,Uruguay,1,1,Copa Newton,Buenos Aires,Argentina,False,2,0,Draw
1176,1216,1282,1930,Belgium,France,1,2,Friendly,Liège,Belgium,False,3,-1,France
1177,1217,1283,1930,Romania,Greece,8,1,Balkan Cup,Bucharest,Romania,False,9,7,Romania
1178,1219,1286,1930,Hungary,Austria,2,1,Friendly,Budapest,Hungary,False,3,1,Hungary
1179,1220,1287,1930,Norway,Finland,6,2,Nordic Championship,Oslo,Norway,False,8,4,Norway
1180,1221,1288,1930,Belgium,Portugal,2,1,Friendly,Antwerp,Belgium,False,3,1,Belgium
1181,1222,1289,1930,Hungary,Netherlands,6,2,Friendly,Budapest,Hungary,False,8,4,Hungary
1182,1224,1293,1930,Sweden,Switzerland,1,0,Friendly,Stockholm,Sweden,False,1,1,Sweden
1183,1225,1294,1930,Finland,Denmark,1,6,Nordic Championship,Helsinki,Finland,False,7,-5,Denmark
1184,1226,1295,1930,Norway,Switzerland,3,0,Friendly,Oslo,Norway,False,3,3,Norway
1185,1227,1296,1930,Denmark,Sweden,6,1,Nordic Championship,Copenhagen,Denmark,False,7,5,Denmark
1186,1228,1297,1930,Italy,Spain,2,3,Friendly,Bologna,Italy,False,5,-1,Spain
1187,1229,1298,1930,Estonia,Latvia,1,1,Friendly,Tallinn,Estonia,False,2,0,Draw
1188,1230,1299,1930,Sweden,Norway,6,3,Nordic Championship,Stockholm,Sweden,False,9,3,Sweden
1189,1231,1300,1930,Belgium,United States,0,3,FIFA World Cup,Montevideo,Uruguay,True,3,-3,United States
1190,1232,1301,1930,France,Mexico,4,1,FIFA World Cup,Montevideo,Uruguay,True,5,3,France
1191,1234,1303,1930,Peru,Romania,1,3,FIFA World Cup,Montevideo,Uruguay,True,4,-2,Romania
1192,1235,1304,1930,Argentina,France,1,0,FIFA World Cup,Montevideo,Uruguay,True,1,1,Argentina
1193,1236,1305,1930,Chile,Mexico,3,0,FIFA World Cup,Montevideo,Uruguay,True,3,3,Chile
1194,1238,1307,1930,Paraguay,United States,0,3,FIFA World Cup,Montevideo,Uruguay,True,3,-3,United States
1195,1239,1308,1930,Estonia,Sweden,1,5,Friendly,Tallinn,Estonia,False,6,-4,Sweden
1196,1240,1309,1930,Uruguay,Peru,1,0,FIFA World Cup,Montevideo,Uruguay,False,1,1,Uruguay
1197,1241,1310,1930,Argentina,Mexico,6,3,FIFA World Cup,Montevideo,Uruguay,True,9,3,Argentina
1198,1242,1311,1930,Chile,France,1,0,FIFA World Cup,Montevideo,Uruguay,True,1,1,Chile
1199,1243,1312,1930,Belgium,Paraguay,0,1,FIFA World Cup,Montevideo,Uruguay,True,1,-1,Paraguay
1200,1244,1313,1930,Bolivia,Brazil,0,4,FIFA World Cup,Montevideo,Uruguay,True,4,-4,Brazil
1201,1245,1314,1930,Uruguay,Romania,4,0,FIFA World Cup,Montevideo,Uruguay,False,4,4,Uruguay
1202,1246,1315,1930,Argentina,Chile,3,1,FIFA World Cup,Montevideo,Uruguay,True,4,2,Argentina
1203,1247,1316,1930,Latvia,Sweden,0,5,Friendly,Riga,Latvia,False,5,-5,Sweden
1204,1248,1317,1930,Argentina,United States,6,1,FIFA World Cup,Montevideo,Uruguay,True,7,5,Argentina
1205,1250,1319,1930,Uruguay,Argentina,4,2,FIFA World Cup,Montevideo,Uruguay,False,6,2,Uruguay
1206,1251,1320,1930,Brazil,France,3,2,Friendly,Rio de Janeiro,Brazil,False,5,1,Brazil
1207,1253,1322,1930,Latvia,Finland,3,0,Friendly,Riga,Latvia,False,3,3,Latvia
1208,1254,1323,1930,Estonia,Finland,4,0,Friendly,Tallinn,Estonia,False,4,4,Estonia
1209,1256,1325,1930,Lithuania,Estonia,2,1,Baltic Cup,Kaunas,Lithuania,False,3,1,Lithuania
1210,1257,1326,1930,Estonia,Latvia,2,3,Baltic Cup,Kaunas,Lithuania,True,5,-1,Latvia
1211,1258,1327,1930,Brazil,United States,4,3,Friendly,Rio de Janeiro,Brazil,False,7,1,Brazil
1212,1259,1328,1930,Lithuania,Latvia,3,3,Baltic Cup,Kaunas,Lithuania,False,6,0,Draw
1213,1260,1329,1930,Denmark,Germany,6,3,Friendly,Copenhagen,Denmark,False,9,3,Denmark
1214,1261,1330,1930,Austria,Hungary,2,3,Friendly,Vienna,Austria,False,5,-1,Hungary
1215,1263,1332,1930,Norway,Denmark,1,0,Nordic Championship,Oslo,Norway,False,1,1,Norway
1216,1264,1333,1930,Belgium,Sweden,2,2,Friendly,Liège,Belgium,False,4,0,Draw
1217,1265,1334,1930,Finland,Sweden,4,4,Nordic Championship,Helsinki,Finland,False,8,0,Draw
1218,1266,1335,1930,Germany,Hungary,5,3,Friendly,Dresden,Germany,False,8,2,Germany
1219,1267,1336,1930,Sweden,Poland,0,3,Friendly,Stockholm,Sweden,False,3,-3,Poland
1220,1268,1337,1930,Bulgaria,Romania,5,3,Balkan Cup,Sofia,Bulgaria,False,8,2,Bulgaria
1221,1269,1338,1930,England,Northern Ireland,5,1,British Championship,Sheffield,England,False,6,4,England
1222,1270,1339,1930,Scotland,Wales,1,1,British Championship,Glasgow,Scotland,False,2,0,Draw
1223,1272,1341,1930,Poland,Latvia,6,0,Friendly,Warsaw,Poland,False,6,6,Poland
1224,1273,1342,1930,Germany,Norway,1,1,Friendly,Breslau,Germany,False,2,0,Draw
1225,1274,1343,1930,Switzerland,Netherlands,6,3,Friendly,Zürich,Switzerland,False,9,3,Switzerland
1226,1275,1344,1930,Austria,Sweden,4,1,Friendly,Vienna,Austria,False,5,3,Austria
1227,1277,1346,1930,Wales,England,0,4,British Championship,Wrexham,Wales,False,4,-4,England
1228,1278,1347,1930,Portugal,Spain,0,1,Friendly,Porto,Portugal,False,1,-1,Spain
1229,1279,1348,1930,France,Belgium,2,2,Friendly,Montrouge,France,False,4,0,Draw
1230,1280,1349,1930,Greece,Bulgaria,6,1,Balkan Cup,Athens,Greece,False,7,5,Greece
1231,1281,1351,1931,Italy,France,5,0,Friendly,Bologna,Italy,False,5,5,Italy
1232,1282,1352,1931,Barbados,Martinique,3,2,Friendly,Bridgetown,Barbados,False,5,1,Barbados
1233,1283,1353,1931,Barbados,Martinique,0,0,Friendly,Bridgetown,Barbados,False,0,0,Draw
1234,1285,1355,1931,Northern Ireland,Scotland,0,0,British Championship,Belfast,Northern Ireland,False,0,0,Draw
1235,1286,1356,1931,Italy,Austria,2,1,International Cup,Milan,Italy,False,3,1,Italy
1236,1287,1357,1931,Barbados,Martinique,1,2,Friendly,Bridgetown,Barbados,False,3,-1,Martinique
1237,1288,1358,1931,Guyana,Trinidad and Tobago,2,1,Friendly,Georgetown,British Guyana,False,3,1,Guyana
1238,1289,1359,1931,Barbados,Trinidad and Tobago,1,5,Friendly,Georgetown,British Guyana,True,6,-4,Trinidad and Tobago
1239,1290,1360,1931,Guyana,Trinidad and Tobago,0,2,Friendly,Georgetown,British Guyana,False,2,-2,Trinidad and Tobago
1240,1291,1361,1931,Barbados,Trinidad and Tobago,1,7,Friendly,Georgetown,British Guyana,True,8,-6,Trinidad and Tobago
1241,1292,1362,1931,Guyana,Barbados,9,0,Friendly,Georgetown,British Guyana,False,9,9,Guyana
1242,1293,1363,1931,Guyana,Barbados,7,0,Friendly,Georgetown,British Guyana,False,7,7,Guyana
1243,1294,1364,1931,France,Germany,1,0,Friendly,Colombes,France,False,1,1,France
1244,1295,1367,1931,Scotland,England,2,0,British Championship,Glasgow,Scotland,False,2,2,Scotland
1245,1296,1368,1931,Netherlands,Belgium,3,2,Friendly,Amsterdam,Netherlands,False,5,1,Netherlands
1246,1297,1369,1931,Switzerland,Italy,1,1,International Cup,Berne,Switzerland,False,2,0,Draw
1247,1298,1370,1931,Curaçao,Aruba,1,0,Friendly,Willemstad,Curaçao,False,1,1,Curaçao
1248,1300,1372,1931,Hungary,Switzerland,6,2,International Cup,Budapest,Hungary,False,8,4,Hungary
1249,1301,1373,1931,Portugal,Italy,0,2,Friendly,Porto,Portugal,False,2,-2,Italy
1250,1302,1374,1931,Paraguay,Argentina,0,1,Friendly,Asunción,Paraguay,False,1,-1,Argentina
1251,1303,1375,1931,Spain,Italy,0,0,Friendly,Bilbao,Spain,False,0,0,Draw
1252,1304,1377,1931,Wales,Northern Ireland,3,2,British Championship,Wrexham,Wales,False,5,1,Wales
1253,1305,1378,1931,Paraguay,Argentina,1,1,Friendly,Asunción,Paraguay,False,2,0,Draw
1254,1306,1379,1931,Netherlands,Germany,1,1,Friendly,Amsterdam,Netherlands,False,2,0,Draw
1255,1307,1380,1931,Spain,Republic of Ireland,1,1,Friendly,Barcelona,Spain,False,2,0,Draw
1256,1308,1381,1931,Austria,Hungary,0,0,International Cup,Vienna,Austria,False,0,0,Draw
1257,1309,1382,1931,Belgium,Netherlands,4,2,Friendly,Antwerp,Belgium,False,6,2,Belgium
1258,1310,1383,1931,Romania,Bulgaria,5,2,Balkan Cup,Bucharest,Romania,False,7,3,Romania
1259,1311,1384,1931,France,England,5,2,Friendly,Colombes,France,False,7,3,France
1260,1312,1385,1931,Austria,Scotland,5,0,Friendly,Vienna,Austria,False,5,5,Austria
1261,1313,1386,1931,Belgium,England,1,4,Friendly,Brussels,Belgium,False,5,-3,England
1262,1314,1387,1931,Italy,Scotland,3,0,Friendly,Rome,Italy,False,3,3,Italy
1263,1315,1389,1931,Germany,Austria,0,6,Friendly,Berlin,Germany,False,6,-6,Austria
1264,1316,1390,1931,Switzerland,Scotland,2,3,Friendly,Geneva,Switzerland,False,5,-1,Scotland
1265,1317,1391,1931,Denmark,Norway,3,1,Nordic Championship,Copenhagen,Denmark,False,4,2,Denmark
1266,1318,1392,1931,Latvia,Estonia,0,1,Friendly,Riga,Latvia,False,1,-1,Estonia
1267,1319,1393,1931,Portugal,Belgium,3,2,Friendly,Lisbon,Portugal,False,5,1,Portugal
1268,1320,1394,1931,Estonia,Lithuania,4,1,Friendly,Tallinn,Estonia,False,5,3,Estonia
1269,1321,1396,1931,Denmark,Netherlands,0,2,Friendly,Copenhagen,Denmark,False,2,-2,Netherlands
1270,1323,1398,1931,Austria,Switzerland,2,0,Friendly,Vienna,Austria,False,2,2,Austria
1271,1324,1399,1931,Finland,Estonia,3,1,Friendly,Helsinki,Finland,False,4,2,Finland
1272,1325,1400,1931,Sweden,Germany,0,0,Friendly,Stockholm,Sweden,False,0,0,Draw
1273,1326,1401,1931,Norway,Germany,2,2,Friendly,Oslo,Norway,False,4,0,Draw
1274,1327,1402,1931,Sweden,Denmark,3,1,Nordic Championship,Stockholm,Sweden,False,4,2,Sweden
1275,1328,1404,1931,Latvia,Lithuania,5,2,Friendly,Riga,Latvia,False,7,3,Latvia
1276,1329,1405,1931,Sweden,Finland,8,2,Nordic Championship,Stockholm,Sweden,False,10,6,Sweden
1277,1330,1406,1931,Argentina,Paraguay,1,1,Copa Chevallier Boutell,Buenos Aires,Argentina,False,2,0,Draw
1278,1331,1407,1931,Sweden,Estonia,3,1,Friendly,Sandviken,Sweden,False,4,2,Sweden
1279,1332,1408,1931,Argentina,Paraguay,3,1,Copa Chevallier Boutell,Buenos Aires,Argentina,False,4,2,Argentina
1280,1333,1409,1931,Sweden,Latvia,6,0,Friendly,Västerås,Sweden,False,6,6,Sweden
1281,1334,1411,1931,Finland,Latvia,4,0,Friendly,Helsinki,Finland,False,4,4,Finland
1282,1335,1412,1931,Poland,Romania,2,3,Friendly,Warsaw,Poland,False,5,-1,Romania
1283,1336,1413,1931,Lithuania,Romania,2,4,Friendly,Kaunas,Lithuania,False,6,-2,Romania
1284,1337,1414,1931,Estonia,Lithuania,2,0,Baltic Cup,Tallinn,Estonia,False,2,2,Estonia
1285,1338,1415,1931,Latvia,Lithuania,1,0,Baltic Cup,Tallinn,Estonia,True,1,1,Latvia
1286,1339,1416,1931,Estonia,Latvia,3,1,Baltic Cup,Tallinn,Estonia,False,4,2,Estonia
1287,1340,1417,1931,Brazil,Uruguay,2,0,Copa Rio Branco,Rio de Janeiro,Brazil,False,2,2,Brazil
1288,1341,1418,1931,Finland,Norway,4,4,Nordic Championship,Helsinki,Finland,False,8,0,Draw
1289,1342,1419,1931,Austria,Germany,5,0,Friendly,Vienna,Austria,False,5,5,Austria
1290,1343,1420,1931,Scotland,Northern Ireland,3,1,British Championship,Glasgow,Scotland,False,4,2,Scotland
1291,1345,1422,1931,Bulgaria,Turkey,5,1,Balkan Cup,Sofia,Bulgaria,False,6,4,Bulgaria
1292,1346,1423,1931,Germany,Denmark,4,2,Friendly,Hanover,Germany,False,6,2,Germany
1293,1347,1424,1931,Latvia,Estonia,2,1,Friendly,Riga,Latvia,False,3,1,Latvia
1294,1348,1425,1931,Norway,Sweden,2,1,Nordic Championship,Oslo,Norway,False,3,1,Norway
1295,1351,1428,1931,Hungary,Austria,2,2,International Cup,Budapest,Hungary,False,4,0,Draw
1296,1352,1429,1931,Belgium,Poland,2,1,Friendly,Brussels,Belgium,False,3,1,Belgium
1297,1353,1430,1931,Denmark,Finland,2,3,Nordic Championship,Copenhagen,Denmark,False,5,-1,Finland
1298,1354,1431,1931,Kenya,Uganda,2,1,Friendly,Nairobi,Kenya,False,3,1,Kenya
1299,1355,1432,1931,Northern Ireland,England,2,6,British Championship,Belfast,Northern Ireland,False,8,-4,England
1300,1356,1433,1931,Bulgaria,Greece,2,1,Balkan Cup,Sofia,Bulgaria,False,3,1,Bulgaria
1301,1358,1435,1931,Wales,Scotland,2,3,British Championship,Wrexham,Wales,False,5,-1,Scotland
1302,1359,1436,1931,Hungary,Sweden,3,1,Friendly,Budapest,Hungary,False,4,2,Hungary
1303,1361,1438,1931,England,Wales,3,1,British Championship,Liverpool,England,False,4,2,England
1304,1362,1439,1931,France,Netherlands,3,4,Friendly,Colombes,France,False,7,-1,Netherlands
1305,1363,1440,1931,Greece,Romania,2,4,Balkan Cup,Athens,Greece,False,6,-2,Romania
1306,1364,1441,1931,Switzerland,Austria,1,8,International Cup,Basel,Switzerland,False,9,-7,Austria
1307,1365,1442,1931,Northern Ireland,Wales,4,0,British Championship,Belfast,Northern Ireland,False,4,4,Northern Ireland
1308,1366,1443,1931,Belgium,Switzerland,2,1,Friendly,Brussels,Belgium,False,3,1,Belgium
1309,1367,1444,1931,England,Spain,7,1,Friendly,London,England,False,8,6,England
1310,1368,1445,1931,Republic of Ireland,Spain,0,5,Friendly,Dublin,Irish Free State,False,5,-5,Spain
1311,1369,1446,1931,Italy,Hungary,3,2,International Cup,Turin,Italy,False,5,1,Italy
1312,1370,1447,1932,Italy,Switzerland,3,0,International Cup,Naples,Italy,False,3,3,Italy
1313,1371,1448,1932,Egypt,Hungary,0,0,Friendly,Cairo,Egypt,False,0,0,Draw
1314,1372,1449,1932,Germany,Switzerland,2,0,Friendly,Leipzig,Germany,False,2,2,Germany
1315,1373,1450,1932,Haiti,Jamaica,4,1,Friendly,Port-au-Prince,Haiti,False,5,3,Haiti
1316,1374,1451,1932,Austria,Italy,2,1,International Cup,Vienna,Austria,False,3,1,Austria
1317,1375,1452,1932,Belgium,Netherlands,1,4,Friendly,Antwerp,Belgium,False,5,-3,Netherlands
1318,1376,1454,1932,Haiti,Jamaica,0,1,Friendly,Port-au-Prince,Haiti,False,1,-1,Jamaica
1319,1377,1455,1932,Switzerland,France,3,3,Friendly,Berne,Switzerland,False,6,0,Draw
1320,1378,1456,1932,Dominica,Martinique,1,0,Friendly,Roseau,Dominica,False,1,1,Dominica
1321,1379,1457,1932,Greece,Bulgaria,1,2,Friendly,Athens,Greece,False,3,-1,Bulgaria
1322,1380,1458,1932,Greece,Bulgaria,2,2,Friendly,Athens,Greece,False,4,0,Draw
1323,1381,1459,1932,England,Scotland,3,0,British Championship,London,England,False,3,3,England
1324,1382,1460,1932,France,Italy,1,2,Friendly,Colombes,France,False,3,-1,Italy
1325,1383,1461,1932,Guyana,Trinidad and Tobago,1,0,Friendly,Bridgetown,Barbados,True,1,1,Guyana
1326,1384,1462,1932,Barbados,Trinidad and Tobago,1,0,Friendly,Bridgetown,Barbados,False,1,1,Barbados
1327,1385,1463,1932,Netherlands,Belgium,2,1,Friendly,Amsterdam,Netherlands,False,3,1,Netherlands
1328,1387,1465,1932,Barbados,Guyana,0,1,Friendly,Bridgetown,Barbados,False,1,-1,Guyana
1329,1388,1466,1932,Barbados,Guyana,2,2,Friendly,Bridgetown,Barbados,False,4,0,Draw
1330,1389,1467,1932,Guyana,Trinidad and Tobago,1,2,Friendly,Bridgetown,Barbados,True,3,-1,Trinidad and Tobago
1331,1390,1468,1932,Austria,Hungary,8,2,Friendly,Vienna,Austria,False,10,6,Austria
1332,1392,1470,1932,Barbados,Trinidad and Tobago,1,3,Friendly,Bridgetown,Barbados,False,4,-2,Trinidad and Tobago
1333,1393,1471,1932,Belgium,France,5,2,Friendly,Brussels,Belgium,False,7,3,Belgium
1334,1395,1473,1932,France,Scotland,1,3,Friendly,Colombes,France,False,4,-2,Scotland
1335,1396,1474,1932,Hungary,Italy,1,1,International Cup,Budapest,Hungary,False,2,0,Draw
1336,1397,1475,1932,Netherlands,Republic of Ireland,0,2,Friendly,Amsterdam,Netherlands,False,2,-2,Republic of Ireland
1337,1398,1476,1932,Argentina,Uruguay,2,0,Friendly,Buenos Aires,Argentina,False,2,2,Argentina
1338,1399,1477,1932,Sweden,Finland,7,1,Friendly,Stockholm,Sweden,False,8,6,Sweden
1339,1400,1478,1932,Uruguay,Argentina,1,0,Friendly,Montevideo,Uruguay,False,1,1,Uruguay
1340,1402,1482,1932,Estonia,Latvia,3,0,Friendly,Tallinn,Estonia,False,3,3,Estonia
1341,1403,1483,1932,Denmark,Belgium,3,4,Friendly,Copenhagen,Denmark,False,7,-1,Belgium
1342,1404,1484,1932,Norway,Estonia,3,0,Friendly,Oslo,Norway,False,3,3,Norway
1343,1405,1486,1932,Bulgaria,France,3,5,Friendly,Sofia,Bulgaria,False,8,-2,France
1344,1406,1487,1932,Finland,Sweden,1,3,Nordic Championship,Helsinki,Finland,False,4,-2,Sweden
1345,1407,1488,1932,Romania,France,6,3,Friendly,Bucharest,Romania,False,9,3,Romania
1346,1408,1489,1932,Sweden,Belgium,3,1,Friendly,Stockholm,Sweden,False,4,2,Sweden
1347,1409,1490,1932,Norway,Finland,2,1,Nordic Championship,Oslo,Norway,False,3,1,Norway
1348,1410,1491,1932,Denmark,Sweden,3,1,Nordic Championship,Copenhagen,Denmark,False,4,2,Denmark
1349,1411,1492,1932,Switzerland,Hungary,3,1,International Cup,Berne,Switzerland,False,4,2,Switzerland
1350,1412,1493,1932,Bulgaria,Romania,2,0,Balkan Cup,Belgrade,Yugoslavia,True,2,2,Bulgaria
1351,1413,1495,1932,Greece,Romania,0,3,Balkan Cup,Belgrade,Yugoslavia,True,3,-3,Romania
1352,1414,1496,1932,Lithuania,Latvia,2,3,Friendly,Kaunas,Lithuania,False,5,-1,Latvia
1353,1415,1498,1932,Finland,Germany,1,4,Friendly,Helsinki,Finland,False,5,-3,Germany
1354,1416,1499,1932,Sweden,Norway,1,4,Nordic Championship,Gothenburg,Sweden,False,5,-3,Norway
1355,1417,1500,1932,Bulgaria,Greece,2,0,Balkan Cup,Belgrade,Yugoslavia,True,2,2,Bulgaria
1356,1418,1502,1932,Poland,Sweden,2,0,Friendly,Warsaw,Poland,False,2,2,Poland
1357,1419,1503,1932,Latvia,Sweden,0,0,Friendly,Riga,Latvia,False,0,0,Draw
1358,1420,1504,1932,Estonia,Sweden,1,3,Friendly,Tallinn,Estonia,False,4,-2,Sweden
1359,1421,1505,1932,Sweden,Austria,3,4,Friendly,Stockholm,Sweden,False,7,-1,Austria
1360,1422,1506,1932,Latvia,Lithuania,2,1,Friendly,Liepāja,Latvia,False,3,1,Latvia
1361,1423,1507,1932,Lithuania,Estonia,1,0,Friendly,Kaunas,Lithuania,False,1,1,Lithuania
1362,1424,1508,1932,Uganda,Kenya,13,1,Friendly,Kampala,Uganda,False,14,12,Uganda
1363,1425,1509,1932,Latvia,Lithuania,4,1,Baltic Cup,Riga,Latvia,False,5,3,Latvia
1364,1426,1510,1932,Estonia,Lithuania,1,2,Baltic Cup,Riga,Latvia,True,3,-1,Lithuania
1365,1427,1511,1932,Finland,Denmark,4,2,Nordic Championship,Helsinki,Finland,False,6,2,Finland
1366,1428,1512,1932,Latvia,Estonia,1,0,Baltic Cup,Riga,Latvia,False,1,1,Latvia
1367,1429,1513,1932,Lithuania,Latvia,1,0,Friendly,Kaunas,Lithuania,False,1,1,Lithuania
1368,1430,1514,1932,Northern Ireland,Scotland,0,4,British Championship,Belfast,Northern Ireland,False,4,-4,Scotland
1369,1432,1516,1932,Germany,Sweden,4,3,Friendly,Nuremberg,Germany,False,7,1,Germany
1370,1433,1517,1932,Norway,Denmark,1,2,Nordic Championship,Oslo,Norway,False,3,-1,Denmark
1371,1434,1518,1932,Sweden,Lithuania,8,1,Friendly,Stockholm,Sweden,False,9,7,Sweden
1372,1435,1519,1932,Hungary,Austria,2,3,Friendly,Budapest,Hungary,False,5,-1,Austria
1373,1436,1520,1932,Poland,Latvia,2,1,Friendly,Warsaw,Poland,False,3,1,Poland
1374,1437,1521,1932,Romania,Poland,0,5,Friendly,Bucharest,Romania,False,5,-5,Poland
1375,1438,1523,1932,England,Northern Ireland,1,0,British Championship,Blackpool,England,False,1,1,England
1376,1439,1524,1932,Austria,Switzerland,3,1,International Cup,Vienna,Austria,False,4,2,Austria
1377,1440,1525,1932,Scotland,Wales,2,5,British Championship,Edinburgh,Scotland,False,7,-3,Wales
1378,1441,1527,1932,Hungary,Germany,2,1,Friendly,Budapest,Hungary,False,3,1,Hungary
1379,1442,1528,1932,Turkey,Bulgaria,2,3,Friendly,Istanbul,Turkey,False,5,-1,Bulgaria
1380,1443,1529,1932,Switzerland,Sweden,2,1,Friendly,Basel,Switzerland,False,3,1,Switzerland
1381,1444,1530,1932,Wales,England,0,0,British Championship,Wrexham,Wales,False,0,0,Draw
1382,1445,1531,1932,Italy,Hungary,4,2,Friendly,Milan,Italy,False,6,2,Italy
1383,1446,1532,1932,Germany,Netherlands,0,2,Friendly,Düsseldorf,Germany,False,2,-2,Netherlands
1384,1447,1533,1932,Uruguay,Brazil,1,2,Copa Rio Branco,Montevideo,Uruguay,False,3,-1,Brazil
1385,1448,1534,1932,England,Austria,4,3,Friendly,London,England,False,7,1,England
1386,1449,1535,1932,Wales,Northern Ireland,4,1,British Championship,Wrexham,Wales,False,5,3,Wales
1387,1450,1536,1932,Belgium,Austria,1,6,Friendly,Brussels,Belgium,False,7,-5,Austria
1388,1451,1537,1933,Italy,Germany,3,1,Friendly,Bologna,Italy,False,4,2,Italy
1389,1452,1538,1933,Uruguay,Argentina,2,1,Friendly,Montevideo,Uruguay,False,3,1,Uruguay
1390,1453,1539,1933,Netherlands,Switzerland,0,2,Friendly,Amsterdam,Netherlands,False,2,-2,Switzerland
1391,1454,1540,1933,Portugal,Hungary,1,0,Friendly,Lisbon,Portugal,False,1,1,Portugal
1392,1455,1541,1933,Argentina,Uruguay,4,1,Friendly,Avellaneda,Argentina,False,5,3,Argentina
1393,1456,1542,1933,Belgium,Italy,2,3,Friendly,Brussels,Belgium,False,5,-1,Italy
1394,1457,1543,1933,France,Austria,0,4,Friendly,Paris,France,False,4,-4,Austria
1395,1458,1544,1933,Netherlands,Hungary,1,2,Friendly,Amsterdam,Netherlands,False,3,-1,Hungary
1396,1459,1545,1933,Switzerland,Belgium,3,3,Friendly,Zürich,Switzerland,False,6,0,Draw
1397,1460,1546,1933,Germany,France,3,3,Friendly,Berlin,Germany,False,6,0,Draw
1398,1462,1548,1933,France,Belgium,3,0,Friendly,Colombes,France,False,3,3,France
1399,1463,1549,1933,Scotland,England,2,1,British Championship,Glasgow,Scotland,False,3,1,Scotland
1400,1464,1550,1933,Spain,Portugal,3,0,Friendly,Vigo,Spain,False,3,3,Spain
1401,1465,1551,1933,Switzerland,Italy,0,3,International Cup,Geneva,Switzerland,False,3,-3,Italy
1402,1467,1553,1933,Belgium,Netherlands,1,3,Friendly,Antwerp,Belgium,False,4,-2,Netherlands
1403,1468,1554,1933,France,Spain,1,0,Friendly,Colombes,France,False,1,1,France
1404,1469,1555,1933,Hungary,Austria,1,1,Friendly,Budapest,Hungary,False,2,0,Draw
1405,1471,1558,1933,Netherlands,Belgium,1,2,Friendly,Amsterdam,Netherlands,False,3,-1,Belgium
1406,1473,1560,1933,Italy,England,1,1,Friendly,Rome,Italy,False,2,0,Draw
1407,1474,1561,1933,Switzerland,England,0,4,Friendly,Berne,Switzerland,False,4,-4,England
1408,1475,1562,1933,Spain,Bulgaria,13,0,Friendly,Madrid,Spain,False,13,13,Spain
1409,1476,1563,1933,France,Wales,1,1,Friendly,Colombes,France,False,2,0,Draw
1410,1477,1564,1933,Latvia,Estonia,2,0,Friendly,Riga,Latvia,False,2,2,Latvia
1411,1479,1566,1933,Poland,Belgium,0,1,Friendly,Warsaw,Poland,False,1,-1,Belgium
1412,1480,1567,1933,Romania,Bulgaria,7,0,Balkan Cup,Bucharest,Romania,False,7,7,Romania
1413,1481,1568,1933,Australia,New Zealand,4,2,Friendly,Brisbane,Australia,False,6,2,Australia
1414,1483,1570,1933,Bulgaria,Greece,2,0,Balkan Cup,Bucharest,Romania,True,2,2,Bulgaria
1415,1484,1572,1933,Austria,Belgium,4,1,Friendly,Vienna,Austria,False,5,3,Austria
1416,1485,1573,1933,Denmark,Norway,2,2,Nordic Championship,Copenhagen,Denmark,False,4,0,Draw
1417,1487,1575,1933,Sweden,Estonia,6,2,FIFA World Cup qualification,Stockholm,Sweden,False,8,4,Sweden
1418,1488,1576,1933,Latvia,Lithuania,6,2,Friendly,Riga,Latvia,False,8,4,Latvia
1419,1489,1577,1933,Australia,New Zealand,6,4,Friendly,Sydney,Australia,False,10,2,Australia
1420,1490,1578,1933,Sweden,Denmark,2,3,Nordic Championship,Stockholm,Sweden,False,5,-1,Denmark
1421,1491,1579,1933,Australia,New Zealand,4,2,Friendly,Sydney,Australia,False,6,2,Australia
1422,1492,1580,1933,Lithuania,Sweden,0,2,FIFA World Cup qualification,Kaunas,Lithuania,False,2,-2,Sweden
1423,1493,1581,1933,Sweden,Hungary,5,2,Friendly,Stockholm,Sweden,False,7,3,Sweden
1424,1494,1582,1933,Latvia,Sweden,1,1,Friendly,Riga,Latvia,False,2,0,Draw
1425,1495,1583,1933,Sweden,Finland,2,0,Nordic Championship,Stockholm,Sweden,False,2,2,Sweden
1426,1496,1584,1933,Estonia,Lithuania,2,1,Friendly,Tallinn,Estonia,False,3,1,Estonia
1427,1497,1586,1933,Estonia,Latvia,2,1,Friendly,Tallinn,Estonia,False,3,1,Estonia
1428,1498,1587,1933,Finland,Lithuania,9,2,Friendly,Helsinki,Finland,False,11,7,Finland
1429,1499,1588,1933,Finland,Estonia,2,1,Friendly,Helsinki,Finland,False,3,1,Finland
1430,1500,1589,1933,Lithuania,Estonia,1,1,Baltic Cup,Kaunas,Lithuania,False,2,0,Draw
1431,1501,1590,1933,Estonia,Latvia,0,1,Baltic Cup,Kaunas,Lithuania,True,1,-1,Latvia
1432,1502,1591,1933,Finland,Norway,1,5,Nordic Championship,Helsinki,Finland,False,6,-4,Norway
1433,1503,1592,1933,Lithuania,Latvia,2,2,Baltic Cup,Kaunas,Lithuania,False,4,0,Draw
1434,1504,1593,1933,Lithuania,Estonia,0,5,Friendly,Kaunas,Lithuania,False,5,-5,Estonia
1435,1506,1595,1933,Scotland,Northern Ireland,1,2,British Championship,Glasgow,Scotland,False,3,-1,Northern Ireland
1436,1507,1597,1933,Hungary,Switzerland,3,0,International Cup,Budapest,Hungary,False,3,3,Hungary
1437,1508,1598,1933,Norway,Sweden,0,1,Nordic Championship,Oslo,Norway,False,1,-1,Sweden
1438,1509,1600,1933,Austria,Hungary,2,2,Friendly,Vienna,Austria,False,4,0,Draw
1439,1510,1601,1933,Wales,Scotland,3,2,British Championship,Cardiff,Wales,False,5,1,Wales
1440,1511,1603,1933,Aruba,Curaçao,1,3,Friendly,Oranjestad,Aruba,False,4,-2,Curaçao
1441,1512,1604,1933,Denmark,Finland,2,0,Nordic Championship,Copenhagen,Denmark,False,2,2,Denmark
1442,1513,1605,1933,Aruba,Curaçao,0,2,Friendly,Oranjestad,Aruba,False,2,-2,Curaçao
1443,1514,1606,1933,Northern Ireland,England,0,3,British Championship,Belfast,Northern Ireland,False,3,-3,England
1444,1516,1608,1933,Germany,Belgium,8,1,Friendly,Duisburg,Germany,False,9,7,Germany
1445,1517,1609,1933,Hungary,Italy,0,1,International Cup,Budapest,Hungary,False,1,-1,Italy
1446,1518,1610,1933,Trinidad and Tobago,Barbados,8,4,Friendly,Port of Spain,Trinidad and Tobago,False,12,4,Trinidad and Tobago
1447,1519,1611,1933,Trinidad and Tobago,Guyana,2,0,Friendly,Port of Spain,Trinidad and Tobago,False,2,2,Trinidad and Tobago
1448,1520,1612,1933,Barbados,Guyana,0,2,Friendly,Port of Spain,Trinidad and Tobago,True,2,-2,Guyana
1449,1521,1613,1933,Trinidad and Tobago,Guyana,1,1,Friendly,Port of Spain,Trinidad and Tobago,False,2,0,Draw
1450,1522,1614,1933,Switzerland,Romania,2,2,FIFA World Cup qualification,Berne,Switzerland,False,4,0,Draw
1451,1523,1615,1933,Trinidad and Tobago,Barbados,3,1,Friendly,Port of Spain,Trinidad and Tobago,False,4,2,Trinidad and Tobago
1452,1524,1616,1933,Trinidad and Tobago,Guyana,1,0,Friendly,Port of Spain,Trinidad and Tobago,False,1,1,Trinidad and Tobago
1453,1525,1617,1933,Barbados,Guyana,2,5,Friendly,Port of Spain,Trinidad and Tobago,True,7,-3,Guyana
1454,1526,1618,1933,Northern Ireland,Wales,1,1,British Championship,Belfast,Northern Ireland,False,2,0,Draw
1455,1527,1619,1933,Germany,Norway,2,2,Friendly,Magdeburg,Germany,False,4,0,Draw
1456,1528,1620,1933,Trinidad and Tobago,Barbados,6,0,Friendly,Port of Spain,Trinidad and Tobago,False,6,6,Trinidad and Tobago
1457,1529,1621,1933,England,Wales,1,2,British Championship,Newcastle,England,False,3,-1,Wales
1458,1530,1622,1933,Switzerland,Germany,0,2,Friendly,Zürich,Switzerland,False,2,-2,Germany
1459,1531,1623,1933,Belgium,Denmark,2,2,Friendly,Brussels,Belgium,False,4,0,Draw
1460,1532,1624,1933,Scotland,Austria,2,2,Friendly,Glasgow,Scotland,False,4,0,Draw
1461,1533,1625,1933,Germany,Poland,1,0,Friendly,Berlin,Germany,False,1,1,Germany
1462,1534,1626,1933,Italy,Switzerland,5,2,International Cup,Florence,Italy,False,7,3,Italy
1463,1535,1627,1933,England,France,4,1,Friendly,London,England,False,5,3,England
1464,1536,1628,1933,Netherlands,Austria,0,1,Friendly,Amsterdam,Netherlands,False,1,-1,Austria
1465,1537,1629,1933,Uruguay,Argentina,0,1,Friendly,Montevideo,Uruguay,False,1,-1,Argentina
1466,1538,1630,1934,Germany,Hungary,3,1,Friendly,Frankfurt am Main,Germany,False,4,2,Germany
1467,1539,1631,1934,Belgium,France,2,3,Friendly,Brussels,Belgium,False,5,-1,France
1468,1540,1632,1934,Haiti,Cuba,1,3,FIFA World Cup qualification,Port-au-Prince,Haiti,False,4,-2,Cuba
1469,1541,1633,1934,Haiti,Cuba,1,1,FIFA World Cup qualification,Port-au-Prince,Haiti,False,2,0,Draw
1470,1542,1635,1934,Haiti,Cuba,0,6,FIFA World Cup qualification,Port-au-Prince,Haiti,False,6,-6,Cuba
1471,1543,1636,1934,Italy,Austria,2,4,International Cup,Turin,Italy,False,6,-2,Austria
1472,1544,1637,1934,Republic of Ireland,Belgium,4,4,FIFA World Cup qualification,Dublin,Irish Free State,True,8,0,Draw
1473,1545,1638,1934,Mexico,Cuba,3,2,FIFA World Cup qualification,Mexico City,Mexico,False,5,1,Mexico
1474,1546,1639,1934,France,Switzerland,0,1,Friendly,Paris,France,False,1,-1,Switzerland
1475,1547,1640,1934,Luxembourg,Germany,1,9,FIFA World Cup qualification,Luxembourg,Luxembourg,False,10,-8,Germany
1476,1548,1641,1934,Mexico,Cuba,5,0,FIFA World Cup qualification,Mexico City,Mexico,False,5,5,Mexico
1477,1549,1642,1934,Netherlands,Belgium,9,3,Friendly,Amsterdam,Netherlands,False,12,6,Netherlands
1478,1550,1643,1934,Spain,Portugal,9,0,FIFA World Cup qualification,Madrid,Spain,False,9,9,Spain
1479,1551,1644,1934,Guadeloupe,Martinique,0,6,Friendly,Basse-Terre,Guadeloupe,False,6,-6,Martinique
1480,1552,1645,1934,Egypt,Israel,7,1,FIFA World Cup qualification,Cairo,Egypt,False,8,6,Egypt
1481,1554,1647,1934,Mexico,Cuba,4,1,FIFA World Cup qualification,Mexico City,Mexico,False,5,3,Mexico
1482,1555,1648,1934,Portugal,Spain,1,2,FIFA World Cup qualification,Lisbon,Portugal,False,3,-1,Spain
1483,1556,1649,1934,Bulgaria,Hungary,1,4,FIFA World Cup qualification,Sofia,Bulgaria,False,5,-3,Hungary
1484,1558,1651,1934,Italy,Greece,4,0,FIFA World Cup qualification,Milan,Italy,False,4,4,Italy
1485,1559,1652,1934,Switzerland,Austria,2,3,International Cup,Geneva,Switzerland,False,5,-1,Austria
1486,1560,1654,1934,Israel,Egypt,1,4,FIFA World Cup qualification,Tel Aviv,Palestine,True,5,-3,Egypt
1487,1561,1655,1934,Netherlands,Republic of Ireland,5,2,FIFA World Cup qualification,Amsterdam,Netherlands,False,7,3,Netherlands
1488,1562,1656,1934,England,Scotland,3,0,British Championship,London,England,False,3,3,England
1489,1563,1657,1934,Austria,Hungary,5,2,Friendly,Vienna,Austria,False,7,3,Austria
1490,1564,1658,1934,Luxembourg,France,1,6,FIFA World Cup qualification,Luxembourg,Luxembourg,False,7,-5,France
1491,1565,1659,1934,Austria,Bulgaria,6,1,FIFA World Cup qualification,Vienna,Austria,False,7,5,Austria
1492,1566,1660,1934,Belgium,Netherlands,2,4,FIFA World Cup qualification,Antwerp,Belgium,False,6,-2,Netherlands
1493,1568,1663,1934,Hungary,England,2,1,Friendly,Budapest,Hungary,False,3,1,Hungary
1494,1569,1664,1934,Netherlands,France,4,5,Friendly,Amsterdam,Netherlands,False,9,-1,France
1495,1571,1666,1934,Japan,Indonesia,1,7,Friendly,Manila,Philippines,True,8,-6,Indonesia
1496,1572,1669,1934,Philippines,Indonesia,3,2,Friendly,Manila,Philippines,False,5,1,Philippines
1497,1573,1671,1934,Denmark,Poland,4,2,Friendly,Copenhagen,Denmark,False,6,2,Denmark
1498,1574,1672,1934,Sweden,Poland,4,2,Friendly,Stockholm,Sweden,False,6,2,Sweden
1499,1575,1673,1934,Mexico,United States,2,4,FIFA World Cup qualification,Rome,Italy,True,6,-2,United States
1500,1576,1674,1934,Argentina,Sweden,2,3,FIFA World Cup,Bologna,Italy,True,5,-1,Sweden
1501,1577,1675,1934,Austria,France,3,2,FIFA World Cup,Turin,Italy,True,5,1,Austria
1502,1578,1676,1934,Belgium,Germany,2,5,FIFA World Cup,Florence,Italy,True,7,-3,Germany
1503,1579,1677,1934,Brazil,Spain,1,3,FIFA World Cup,Genoa,Italy,True,4,-2,Spain
1504,1580,1679,1934,Egypt,Hungary,2,4,FIFA World Cup,Naples,Italy,True,6,-2,Hungary
1505,1581,1680,1934,Italy,United States,7,1,FIFA World Cup,Rome,Italy,False,8,6,Italy
1506,1582,1681,1934,Netherlands,Switzerland,2,3,FIFA World Cup,Milan,Italy,True,5,-1,Switzerland
1507,1583,1682,1934,Austria,Hungary,2,1,FIFA World Cup,Bologna,Italy,True,3,1,Austria
1508,1584,1684,1934,Germany,Sweden,2,1,FIFA World Cup,Milan,Italy,True,3,1,Germany
1509,1585,1685,1934,Italy,Spain,1,1,FIFA World Cup,Florence,Italy,False,2,0,Draw
1510,1586,1686,1934,Italy,Spain,1,0,FIFA World Cup,Florence,Italy,False,1,1,Italy
1511,1587,1688,1934,Italy,Austria,1,0,FIFA World Cup,Milan,Italy,False,1,1,Italy
1512,1588,1690,1934,Austria,Germany,2,3,FIFA World Cup,Naples,Italy,True,5,-1,Germany
1513,1590,1692,1934,Lithuania,Latvia,2,0,Friendly,Kaunas,Lithuania,False,2,2,Lithuania
1514,1591,1693,1934,Denmark,Sweden,3,5,Nordic Championship,Copenhagen,Denmark,False,8,-2,Sweden
1515,1592,1696,1934,Lithuania,Estonia,1,1,Friendly,Kaunas,Lithuania,False,2,0,Draw
1516,1593,1697,1934,Sweden,Norway,3,3,Nordic Championship,Stockholm,Sweden,False,6,0,Draw
1517,1594,1698,1934,Finland,Denmark,2,1,Nordic Championship,Helsinki,Finland,False,3,1,Finland
1518,1595,1699,1934,Uruguay,Argentina,2,2,Friendly,Montevideo,Uruguay,False,4,0,Draw
1519,1596,1700,1934,Curaçao,Suriname,3,1,Friendly,Willemstad,Curaçao,False,4,2,Curaçao
1520,1597,1701,1934,Curaçao,Suriname,3,2,Friendly,Willemstad,Curaçao,False,5,1,Curaçao
1521,1598,1702,1934,Curaçao,Suriname,2,2,Friendly,Willemstad,Curaçao,False,4,0,Draw
1522,1599,1703,1934,Aruba,Suriname,1,1,Friendly,Oranjestad,Aruba,False,2,0,Draw
1523,1600,1704,1934,Suriname,Trinidad and Tobago,3,3,Friendly,Paramaribo,Netherlands Guyana,False,6,0,Draw
1524,1601,1705,1934,Estonia,Finland,1,1,Friendly,Tallinn,Estonia,False,2,0,Draw
1525,1602,1706,1934,Latvia,Finland,1,1,Friendly,Riga,Latvia,False,2,0,Draw
1526,1603,1707,1934,Argentina,Uruguay,1,0,Friendly,Avellaneda,Argentina,False,1,1,Argentina
1527,1604,1708,1934,Lithuania,Finland,1,0,Friendly,Kaunas,Lithuania,False,1,1,Lithuania
1528,1605,1711,1934,Norway,Finland,4,2,Nordic Championship,Oslo,Norway,False,6,2,Norway
1529,1606,1712,1934,Latvia,Lithuania,1,3,Friendly,Riga,Latvia,False,4,-2,Lithuania
1530,1607,1713,1934,Poland,Germany,2,5,Friendly,Warsaw,Poland,False,7,-3,Germany
1531,1609,1715,1934,Finland,Sweden,5,4,Nordic Championship,Helsinki,Finland,False,9,1,Finland
1532,1610,1716,1934,Norway,Denmark,3,1,Nordic Championship,Oslo,Norway,False,4,2,Norway
1533,1611,1717,1934,Sweden,Latvia,3,1,Friendly,Stockholm,Sweden,False,4,2,Sweden
1534,1612,1718,1934,Wales,England,0,4,British Championship,Cardiff,Wales,False,4,-4,England
1535,1613,1719,1934,Denmark,Germany,2,5,Friendly,Copenhagen,Denmark,False,7,-3,Germany
1536,1614,1720,1934,Hungary,Austria,3,1,International Cup,Budapest,Hungary,False,4,2,Hungary
1537,1615,1721,1934,Latvia,Poland,2,6,Friendly,Riga,Latvia,False,8,-4,Poland
1538,1616,1722,1934,Poland,Romania,3,3,Friendly,Lwów,Poland,False,6,0,Draw
1539,1618,1724,1934,Northern Ireland,Scotland,2,1,British Championship,Belfast,Northern Ireland,False,3,1,Northern Ireland
1540,1619,1725,1934,Switzerland,Netherlands,2,4,Friendly,Berne,Switzerland,False,6,-2,Netherlands
1541,1620,1726,1934,Austria,Switzerland,3,0,International Cup,Vienna,Austria,False,3,3,Austria
1542,1621,1727,1934,England,Italy,3,2,Friendly,London,England,False,5,1,England
1543,1622,1728,1934,Scotland,Wales,3,2,British Championship,Aberdeen,Scotland,False,5,1,Scotland
1544,1623,1729,1934,Italy,Hungary,4,2,Friendly,Milan,Italy,False,6,2,Italy
1545,1624,1730,1934,Republic of Ireland,Hungary,2,4,Friendly,Dublin,Irish Free State,False,6,-2,Hungary
1546,1628,1734,1934,Greece,Romania,2,2,Balkan Cup,Athens,Greece,False,4,0,Draw
1547,1629,1735,1934,Bulgaria,Romania,2,3,Balkan Cup,Athens,Greece,True,5,-1,Romania
1548,1630,1736,1935,Greece,Bulgaria,1,2,Balkan Cup,Athens,Greece,False,3,-1,Bulgaria
1549,1632,1738,1935,Argentina,Chile,4,1,Copa América,Lima,Peru,True,5,3,Argentina
1550,1633,1739,1935,Peru,Uruguay,0,1,Copa América,Lima,Peru,False,1,-1,Uruguay
1551,1634,1740,1935,Chile,Uruguay,1,2,Copa América,Lima,Peru,True,3,-1,Uruguay
1552,1635,1741,1935,Peru,Argentina,1,4,Copa América,Lima,Peru,False,5,-3,Argentina
1553,1636,1742,1935,Spain,France,2,0,Friendly,Madrid,Spain,False,2,2,Spain
1554,1637,1743,1935,Peru,Chile,1,0,Copa América,Lima,Peru,False,1,1,Peru
1555,1638,1744,1935,Argentina,Uruguay,0,3,Copa América,Lima,Peru,True,3,-3,Uruguay
1556,1639,1745,1935,Germany,Switzerland,4,0,Friendly,Stuttgart,Germany,False,4,4,Germany
1557,1640,1746,1935,England,Northern Ireland,2,1,British Championship,Liverpool,England,False,3,1,England
1558,1641,1747,1935,Italy,France,2,1,Friendly,Rome,Italy,False,3,1,Italy
1559,1642,1748,1935,Netherlands,Germany,2,3,Friendly,Amsterdam,Netherlands,False,5,-1,Germany
1560,1643,1749,1935,Uganda,Kenya,5,1,Friendly,Kampala,Uganda,False,6,4,Uganda
1561,1644,1751,1935,France,Germany,1,3,Friendly,Paris,France,False,4,-2,Germany
1562,1645,1752,1935,Curaçao,Aruba,2,0,Friendly,Willemstad,Curaçao,False,2,2,Curaçao
1563,1646,1753,1935,Austria,Italy,0,2,International Cup,Vienna,Austria,False,2,-2,Italy
1564,1647,1754,1935,Curaçao,Aruba,4,0,Friendly,Willemstad,Curaçao,False,4,4,Curaçao
1565,1648,1755,1935,Wales,Northern Ireland,3,1,British Championship,Wrexham,Wales,False,4,2,Wales
1566,1649,1756,1935,Netherlands,Belgium,4,2,Friendly,Amsterdam,Netherlands,False,6,2,Netherlands
1567,1650,1757,1935,Scotland,England,2,0,British Championship,Glasgow,Scotland,False,2,2,Scotland
1568,1651,1758,1935,Belgium,France,1,1,Friendly,Brussels,Belgium,False,2,0,Draw
1569,1652,1760,1935,Switzerland,Hungary,6,2,International Cup,Zürich,Switzerland,False,8,4,Switzerland
1570,1653,1761,1935,Belgium,Germany,1,6,Friendly,Brussels,Belgium,False,7,-5,Germany
1571,1654,1762,1935,Portugal,Spain,3,3,Friendly,Lisbon,Portugal,False,6,0,Draw
1572,1655,1763,1935,Switzerland,Republic of Ireland,1,0,Friendly,Basel,Switzerland,False,1,1,Switzerland
1573,1656,1764,1935,Germany,Republic of Ireland,3,1,Friendly,Dortmund,Germany,False,4,2,Germany
1574,1657,1765,1935,Kenya,Uganda,1,3,Friendly,Nairobi,Kenya,False,4,-2,Uganda
1575,1658,1766,1935,Austria,Poland,5,2,Friendly,Vienna,Austria,False,7,3,Austria
1576,1659,1767,1935,Belgium,Netherlands,0,2,Friendly,Brussels,Belgium,False,2,-2,Netherlands
1577,1660,1768,1935,Germany,Spain,1,2,Friendly,Cologne,Germany,False,3,-1,Spain
1578,1661,1769,1935,Hungary,Austria,6,3,Friendly,Budapest,Hungary,False,9,3,Hungary
1579,1662,1770,1935,Netherlands,England,0,1,Friendly,Amsterdam,Netherlands,False,1,-1,England
1580,1663,1771,1935,France,Hungary,2,0,Friendly,Colombes,France,False,2,2,France
1581,1664,1772,1935,United States,Scotland,1,5,Friendly,New York,United States,False,6,-4,Scotland
1582,1665,1773,1935,Suriname,Curaçao,0,1,Friendly,Paramaribo,Netherlands Guyana,False,1,-1,Curaçao
1583,1666,1774,1935,Suriname,Curaçao,4,1,Friendly,Paramaribo,Netherlands Guyana,False,5,3,Suriname
1584,1667,1775,1935,Suriname,Curaçao,2,1,Friendly,Paramaribo,Netherlands Guyana,False,3,1,Suriname
1585,1669,1777,1935,Belgium,Switzerland,2,2,Friendly,Brussels,Belgium,False,4,0,Draw
1586,1670,1778,1935,Latvia,Lithuania,6,1,Friendly,Riga,Latvia,False,7,5,Latvia
1587,1671,1779,1935,United States,Scotland,1,4,Friendly,Newark,United States,False,5,-3,Scotland
1588,1672,1780,1935,Latvia,Estonia,1,1,Friendly,Riga,Latvia,False,2,0,Draw
1589,1673,1781,1935,Sweden,Finland,2,2,Nordic Championship,Stockholm,Sweden,False,4,0,Draw
1590,1674,1782,1935,Bulgaria,Greece,5,2,Balkan Cup,Sofia,Bulgaria,False,7,3,Bulgaria
1591,1675,1783,1935,Sweden,Denmark,3,1,Nordic Championship,Gothenburg,Sweden,False,4,2,Sweden
1592,1677,1785,1935,Bulgaria,Romania,4,0,Balkan Cup,Sofia,Bulgaria,False,4,4,Bulgaria
1593,1678,1786,1935,Estonia,Lithuania,2,2,Friendly,Tallinn,Estonia,False,4,0,Draw
1594,1680,1788,1935,Denmark,Norway,1,0,Nordic Championship,Copenhagen,Denmark,False,1,1,Denmark
1595,1682,1790,1935,Greece,Romania,2,2,Balkan Cup,Sofia,Bulgaria,True,4,0,Draw
1596,1683,1791,1935,Norway,Germany,1,1,Friendly,Oslo,Norway,False,2,0,Draw
1597,1684,1792,1935,Sweden,Germany,3,1,Friendly,Stockholm,Sweden,False,4,2,Sweden
1598,1685,1793,1935,Latvia,Sweden,0,3,Friendly,Riga,Latvia,False,3,-3,Sweden
1599,1686,1794,1935,Estonia,Sweden,1,2,Friendly,Tallinn,Estonia,False,3,-1,Sweden
1600,1687,1795,1935,Uruguay,Argentina,1,1,Friendly,Montevideo,Uruguay,False,2,0,Draw
1601,1688,1796,1935,Suriname,Trinidad and Tobago,0,3,Friendly,Paramaribo,Netherlands Guyana,False,3,-3,Trinidad and Tobago
1602,1689,1797,1935,Estonia,Finland,2,2,Friendly,Tallinn,Estonia,False,4,0,Draw
1603,1690,1798,1935,Argentina,Uruguay,3,0,Friendly,Avellaneda,Argentina,False,3,3,Argentina
1604,1691,1799,1935,Germany,Finland,6,0,Friendly,Munich,Germany,False,6,6,Germany
1605,1692,1800,1935,Luxembourg,Germany,0,1,Friendly,Luxembourg,Luxembourg,False,1,-1,Germany
1606,1694,1802,1935,Estonia,Lithuania,1,2,Baltic Cup,Tallinn,Estonia,False,3,-1,Lithuania
1607,1695,1803,1935,Latvia,Lithuania,2,2,Baltic Cup,Tallinn,Estonia,True,4,0,Draw
1608,1696,1804,1935,Estonia,Latvia,1,1,Baltic Cup,Tallinn,Estonia,False,2,0,Draw
1609,1697,1805,1935,Germany,Romania,4,2,Friendly,Erfurt,Germany,False,6,2,Germany
1610,1698,1806,1935,Sweden,Romania,7,1,Friendly,Stockholm,Sweden,False,8,6,Sweden
1611,1699,1808,1935,Finland,Norway,1,5,Nordic Championship,Helsinki,Finland,False,6,-4,Norway
1612,1700,1809,1935,Lithuania,Latvia,2,2,Friendly,Kaunas,Lithuania,False,4,0,Draw
1613,1701,1810,1935,Germany,Estonia,5,0,Friendly,Stettin,Germany,False,5,5,Germany
1614,1702,1811,1935,Germany,Poland,1,0,Friendly,Breslau,Germany,False,1,1,Germany
1615,1703,1812,1935,Poland,Latvia,3,3,Friendly,Łódź,Poland,False,6,0,Draw
1616,1704,1813,1935,Lithuania,Estonia,2,2,Friendly,Kaunas,Lithuania,False,4,0,Draw
1617,1705,1814,1935,Curaçao,Aruba,1,0,Friendly,Willemstad,Curaçao,False,1,1,Curaçao
1618,1707,1816,1935,Norway,Sweden,0,2,Nordic Championship,Oslo,Norway,False,2,-2,Sweden
1619,1708,1817,1935,Wales,Scotland,1,1,British Championship,Cardiff,Wales,False,2,0,Draw
1620,1709,1818,1935,Austria,Hungary,4,4,International Cup,Vienna,Austria,False,8,0,Draw
1621,1710,1819,1935,Denmark,Finland,5,1,Nordic Championship,Copenhagen,Denmark,False,6,4,Denmark
1622,1711,1820,1935,Poland,Austria,1,0,Friendly,Warsaw,Poland,False,1,1,Poland
1623,1712,1821,1935,Germany,Latvia,3,0,Friendly,Königsberg,Germany,False,3,3,Germany
1624,1713,1822,1935,Northern Ireland,England,1,3,British Championship,Belfast,Northern Ireland,False,4,-2,England
1625,1714,1823,1935,Germany,Bulgaria,4,2,Friendly,Leipzig,Germany,False,6,2,Germany
1626,1715,1825,1935,Switzerland,France,2,1,Friendly,Geneva,Switzerland,False,3,1,Switzerland
1627,1716,1826,1935,Netherlands,Denmark,3,0,Friendly,Amsterdam,Netherlands,False,3,3,Netherlands
1628,1717,1827,1935,Romania,Poland,4,1,Friendly,Bucharest,Romania,False,5,3,Romania
1629,1718,1828,1935,Switzerland,Norway,2,0,Friendly,Zürich,Switzerland,False,2,2,Switzerland
1630,1719,1829,1935,France,Sweden,2,0,Friendly,Paris,France,False,2,2,France
1631,1720,1830,1935,Hungary,Switzerland,6,1,Friendly,Budapest,Hungary,False,7,5,Hungary
1632,1721,1831,1935,Scotland,Northern Ireland,2,1,British Championship,Edinburgh,Scotland,False,3,1,Scotland
1633,1722,1832,1935,Belgium,Sweden,5,1,Friendly,Brussels,Belgium,False,6,4,Belgium
1634,1723,1833,1935,Italy,Hungary,2,2,International Cup,Milan,Italy,False,4,0,Draw
1635,1724,1834,1935,England,Germany,3,0,Friendly,London,England,False,3,3,England
1636,1725,1835,1935,Republic of Ireland,Netherlands,3,5,Friendly,Dublin,Irish Free State,False,8,-2,Netherlands
1637,1726,1836,1935,Curaçao,Trinidad and Tobago,3,1,Friendly,Willemstad,Curaçao,False,4,2,Curaçao
1638,1727,1837,1935,Jamaica,Trinidad and Tobago,2,3,Friendly,Kingston,Jamaica,False,5,-1,Trinidad and Tobago
1639,1728,1838,1936,French Guiana,Suriname,1,3,Friendly,Cayenne,French Guiana,False,4,-2,Suriname
1640,1729,1839,1936,Jamaica,Trinidad and Tobago,0,1,Friendly,Kingston,Jamaica,False,1,-1,Trinidad and Tobago
1641,1730,1840,1936,Jamaica,Trinidad and Tobago,1,2,Friendly,Kingston,Jamaica,False,3,-1,Trinidad and Tobago
1642,1731,1841,1936,France,Netherlands,1,6,Friendly,Paris,France,False,7,-5,Netherlands
1643,1732,1842,1936,Spain,Austria,4,5,Friendly,Madrid,Spain,False,9,-1,Austria
1644,1733,1843,1936,Portugal,Austria,2,3,Friendly,Porto,Portugal,False,5,-1,Austria
1645,1734,1844,1936,Curaçao,Trinidad and Tobago,4,2,Friendly,Willemstad,Curaçao,False,6,2,Curaçao
1646,1735,1845,1936,England,Wales,1,2,British Championship,Wolverhampton,England,False,3,-1,Wales
1647,1737,1847,1936,Belgium,Poland,0,2,Friendly,Brussels,Belgium,False,2,-2,Poland
1648,1738,1848,1936,Trinidad and Tobago,Curaçao,3,0,Friendly,Port of Spain,Trinidad and Tobago,False,3,3,Trinidad and Tobago
1649,1739,1849,1936,Spain,Germany,1,2,Friendly,Barcelona,Spain,False,3,-1,Germany
1650,1740,1850,1936,Portugal,Germany,1,3,Friendly,Lisbon,Portugal,False,4,-2,Germany
1651,1741,1851,1936,France,Belgium,3,0,Friendly,Colombes,France,False,3,3,France
1652,1742,1852,1936,Northern Ireland,Wales,3,2,British Championship,Belfast,Northern Ireland,False,5,1,Northern Ireland
1653,1743,1853,1936,Hungary,Germany,3,2,Friendly,Budapest,Hungary,False,5,1,Hungary
1654,1744,1854,1936,Republic of Ireland,Switzerland,1,0,Friendly,Dublin,Irish Free State,False,1,1,Republic of Ireland
1655,1746,1856,1936,Netherlands,Belgium,8,0,Friendly,Amsterdam,Netherlands,False,8,8,Netherlands
1656,1747,1857,1936,England,Scotland,1,1,British Championship,London,England,False,2,0,Draw
1657,1748,1858,1936,Austria,Hungary,3,5,Friendly,Vienna,Austria,False,8,-2,Hungary
1658,1749,1859,1936,Switzerland,Italy,1,2,Friendly,Zürich,Switzerland,False,3,-1,Italy
1659,1750,1860,1936,Belgium,Netherlands,1,1,Friendly,Brussels,Belgium,False,2,0,Draw
1660,1751,1861,1936,Hungary,Republic of Ireland,3,3,Friendly,Budapest,Hungary,False,6,0,Draw
1661,1752,1862,1936,Switzerland,Spain,0,2,Friendly,Berne,Switzerland,False,2,-2,Spain
1662,1753,1863,1936,Austria,England,2,1,Friendly,Vienna,Austria,False,3,1,Austria
1663,1754,1864,1936,Belgium,England,3,2,Friendly,Brussels,Belgium,False,5,1,Belgium
1664,1755,1865,1936,Luxembourg,Republic of Ireland,1,5,Friendly,Luxembourg,Luxembourg,False,6,-4,Republic of Ireland
1665,1757,1867,1936,Italy,Austria,2,2,Friendly,Rome,Italy,False,4,0,Draw
1666,1758,1868,1936,Romania,Greece,5,2,Balkan Cup,Bucharest,Romania,False,7,3,Romania
1667,1759,1869,1936,Bulgaria,Greece,5,4,Balkan Cup,Bucharest,Romania,True,9,1,Bulgaria
1668,1760,1870,1936,Romania,Bulgaria,4,1,Balkan Cup,Bucharest,Romania,False,5,3,Romania
1669,1761,1871,1936,Switzerland,Belgium,1,1,Friendly,Basel,Switzerland,False,2,0,Draw
1670,1762,1872,1936,Estonia,Latvia,3,4,Friendly,Tallinn,Estonia,False,7,-1,Latvia
1671,1763,1873,1936,Hungary,Italy,1,2,Friendly,Budapest,Hungary,False,3,-1,Italy
1672,1764,1874,1936,Denmark,Sweden,4,3,Nordic Championship,Copenhagen,Denmark,False,7,1,Denmark
1673,1765,1875,1936,Lithuania,Latvia,1,5,Friendly,Kaunas,Lithuania,False,6,-4,Latvia
1674,1766,1876,1936,Norway,Switzerland,1,2,Friendly,Oslo,Norway,False,3,-1,Switzerland
1675,1767,1877,1936,Egypt,Greece,3,1,Friendly,Cairo,Egypt,False,4,2,Egypt
1676,1768,1878,1936,Sweden,Switzerland,5,2,Friendly,Stockholm,Sweden,False,7,3,Sweden
1677,1769,1879,1936,Finland,Denmark,1,4,Nordic Championship,Helsinki,Finland,False,5,-3,Denmark
1678,1770,1880,1936,Lithuania,Estonia,2,0,Friendly,Kaunas,Lithuania,False,2,2,Lithuania
1679,1771,1881,1936,New Zealand,Australia,1,7,Friendly,Dunedin,New Zealand,False,8,-6,Australia
1680,1772,1882,1936,Sweden,Norway,2,0,Nordic Championship,Gothenburg,Sweden,False,2,2,Sweden
1681,1773,1883,1936,New Zealand,Australia,0,10,Friendly,Wellington,New Zealand,False,10,-10,Australia
1682,1775,1885,1936,New Zealand,Australia,1,4,Friendly,Auckland,New Zealand,False,5,-3,Australia
1683,1776,1886,1936,Sweden,Norway,3,4,Friendly,Stockholm,Sweden,False,7,-1,Norway
1684,1777,1887,1936,Argentina,Uruguay,1,0,Friendly,Buenos Aires,Argentina,False,1,1,Argentina
1685,1778,1888,1936,Estonia,Finland,2,2,Friendly,Tallinn,Estonia,False,4,0,Draw
1686,1779,1889,1936,Latvia,Lithuania,2,1,Baltic Cup,Riga,Latvia,False,3,1,Latvia
1687,1780,1890,1936,Estonia,Lithuania,2,1,Baltic Cup,Riga,Latvia,True,3,1,Estonia
1688,1781,1891,1936,Latvia,Estonia,2,1,Baltic Cup,Riga,Latvia,False,3,1,Latvia
1689,1782,1892,1936,Latvia,Poland,3,3,Friendly,Riga,Latvia,False,6,0,Draw
1690,1783,1893,1936,Norway,Finland,0,2,Nordic Championship,Oslo,Norway,False,2,-2,Finland
1691,1784,1895,1936,Poland,Germany,1,1,Friendly,Warsaw,Poland,False,2,0,Draw
1692,1785,1896,1936,Norway,Denmark,3,3,Nordic Championship,Oslo,Norway,False,6,0,Draw
1693,1786,1897,1936,Uruguay,Argentina,2,1,Friendly,Montevideo,Uruguay,False,3,1,Uruguay
1694,1787,1899,1936,Finland,Sweden,1,2,Nordic Championship,Helsinki,Finland,False,3,-1,Sweden
1695,1788,1900,1936,Germany,Luxembourg,7,2,Friendly,Krefeld,Germany,False,9,5,Germany
1696,1789,1901,1936,Hungary,Austria,5,3,International Cup,Budapest,Hungary,False,8,2,Hungary
1697,1790,1902,1936,Denmark,Poland,2,1,Friendly,Copenhagen,Denmark,False,3,1,Denmark
1698,1791,1903,1936,Romania,Hungary,1,2,Friendly,Bucharest,Romania,False,3,-1,Hungary
1699,1792,1904,1936,Scotland,Germany,2,0,Friendly,Glasgow,Scotland,False,2,2,Scotland
1700,1793,1905,1936,Republic of Ireland,Germany,5,2,Friendly,Dublin,Irish Free State,False,7,3,Republic of Ireland
1701,1794,1906,1936,Wales,England,2,1,British Championship,Cardiff,Wales,False,3,1,Wales
1702,1795,1908,1936,Italy,Switzerland,4,2,International Cup,Milan,Italy,False,6,2,Italy
1703,1796,1909,1936,Northern Ireland,Scotland,1,3,British Championship,Belfast,Northern Ireland,False,4,-2,Scotland
1704,1797,1910,1936,Netherlands,Norway,3,3,Friendly,Amsterdam,Netherlands,False,6,0,Draw
1705,1798,1911,1936,Switzerland,Austria,1,3,International Cup,Zürich,Switzerland,False,4,-2,Austria
1706,1799,1912,1936,Germany,Italy,2,2,Friendly,Berlin,Germany,False,4,0,Draw
1707,1800,1913,1936,England,Northern Ireland,3,1,British Championship,Stoke-on-Trent,England,False,4,2,England
1708,1801,1914,1936,England,Hungary,6,2,Friendly,London,England,False,8,4,England
1709,1802,1915,1936,Scotland,Wales,1,2,British Championship,Dundee,Scotland,False,3,-1,Wales
1710,1803,1916,1936,Republic of Ireland,Hungary,2,3,Friendly,Dublin,Irish Free State,False,5,-1,Hungary
1711,1806,1919,1936,Brazil,Peru,3,2,Copa América,Buenos Aires,Argentina,True,5,1,Brazil
1712,1807,1920,1936,Argentina,Chile,2,1,Copa América,Buenos Aires,Argentina,False,3,1,Argentina
1713,1808,1921,1937,Paraguay,Uruguay,4,2,Copa América,Buenos Aires,Argentina,True,6,2,Paraguay
1714,1809,1922,1937,Brazil,Chile,6,4,Copa América,Buenos Aires,Argentina,True,10,2,Brazil
1715,1810,1923,1937,Suriname,Guyana,8,0,Friendly,Paramaribo,Netherlands Guyana,False,8,8,Suriname
1716,1811,1924,1937,Guyana,Trinidad and Tobago,0,3,Friendly,Paramaribo,Netherlands Guyana,True,3,-3,Trinidad and Tobago
1717,1812,1925,1937,Peru,Uruguay,2,4,Copa América,Buenos Aires,Argentina,True,6,-2,Uruguay
1718,1813,1926,1937,Suriname,Trinidad and Tobago,1,1,Friendly,Paramaribo,Netherlands Guyana,False,2,0,Draw
1719,1814,1927,1937,Suriname,Trinidad and Tobago,3,3,Friendly,Paramaribo,Netherlands Guyana,False,6,0,Draw
1720,1815,1928,1937,Argentina,Paraguay,6,1,Copa América,Buenos Aires,Argentina,False,7,5,Argentina
1721,1816,1929,1937,Chile,Uruguay,3,0,Copa América,Buenos Aires,Argentina,True,3,3,Chile
1722,1817,1930,1937,Suriname,Trinidad and Tobago,2,2,Friendly,Paramaribo,Netherlands Guyana,False,4,0,Draw
1723,1818,1931,1937,Guyana,Trinidad and Tobago,2,3,Friendly,Paramaribo,Netherlands Guyana,True,5,-1,Trinidad and Tobago
1724,1819,1932,1937,Brazil,Paraguay,5,0,Copa América,Buenos Aires,Argentina,True,5,5,Brazil
1725,1820,1933,1937,Argentina,Peru,1,0,Copa América,Buenos Aires,Argentina,False,1,1,Argentina
1726,1821,1934,1937,Chile,Paraguay,2,3,Copa América,Buenos Aires,Argentina,True,5,-1,Paraguay
1727,1822,1935,1937,Brazil,Uruguay,3,2,Copa América,Buenos Aires,Argentina,True,5,1,Brazil
1728,1823,1936,1937,Chile,Peru,2,2,Copa América,Buenos Aires,Argentina,True,4,0,Draw
1729,1824,1937,1937,Argentina,Uruguay,2,3,Copa América,Buenos Aires,Argentina,False,5,-1,Uruguay
1730,1825,1938,1937,France,Austria,1,2,Friendly,Paris,France,False,3,-1,Austria
1731,1826,1939,1937,Paraguay,Peru,0,1,Copa América,Buenos Aires,Argentina,True,1,-1,Peru
1732,1827,1940,1937,Argentina,Brazil,1,0,Copa América,Buenos Aires,Argentina,False,1,1,Argentina
1733,1828,1941,1937,Germany,Netherlands,2,2,Friendly,Düsseldorf,Germany,False,4,0,Draw
1734,1829,1942,1937,Argentina,Brazil,2,0,Copa América,Buenos Aires,Argentina,False,2,2,Argentina
1735,1830,1943,1937,Belgium,France,3,1,Friendly,Brussels,Belgium,False,4,2,Belgium
1736,1831,1945,1937,Netherlands,Switzerland,2,1,Friendly,Amsterdam,Netherlands,False,3,1,Netherlands
1737,1832,1946,1937,Wales,Northern Ireland,4,1,British Championship,Wrexham,Wales,False,5,3,Wales
1738,1833,1947,1937,Austria,Italy,2,0,International Cup,Vienna,Austria,False,2,2,Austria
1739,1834,1948,1937,Germany,France,4,0,Friendly,Stuttgart,Germany,False,4,4,Germany
1740,1835,1949,1937,Luxembourg,Germany,2,3,Friendly,Luxembourg,Luxembourg,False,5,-1,Germany
1741,1836,1950,1937,Belgium,Netherlands,2,1,Friendly,Antwerp,Belgium,False,3,1,Belgium
1742,1837,1951,1937,Switzerland,Hungary,1,5,International Cup,Basel,Switzerland,False,6,-4,Hungary
1743,1838,1952,1937,Scotland,England,3,1,British Championship,Glasgow,Scotland,False,4,2,Scotland
1744,1839,1953,1937,Belgium,Switzerland,1,2,Friendly,Brussels,Belgium,False,3,-1,Switzerland
1745,1841,1955,1937,Germany,Belgium,1,0,Friendly,Hanover,Germany,False,1,1,Germany
1746,1842,1956,1937,Italy,Hungary,2,0,International Cup,Turin,Italy,False,2,2,Italy
1747,1843,1957,1937,Aruba,Curaçao,1,1,Friendly,Oranjestad,Aruba,False,2,0,Draw
1748,1844,1958,1937,Aruba,Curaçao,1,1,Friendly,Oranjestad,Aruba,False,2,0,Draw
1749,1845,1959,1937,Netherlands,Belgium,1,0,Friendly,Rotterdam,Netherlands,False,1,1,Netherlands
1750,1846,1960,1937,Switzerland,Germany,0,1,Friendly,Zürich,Switzerland,False,1,-1,Germany
1751,1847,1962,1937,Austria,Scotland,1,1,Friendly,Vienna,Austria,False,2,0,Draw
1752,1849,1964,1937,Norway,England,0,6,Friendly,Oslo,Norway,False,6,-6,England
1753,1850,1965,1937,Germany,Denmark,8,0,Friendly,Breslau,Germany,False,8,8,Germany
1754,1851,1966,1937,Sweden,England,0,4,Friendly,Solna,Sweden,False,4,-4,England
1755,1852,1967,1937,Switzerland,Republic of Ireland,0,1,Friendly,Berne,Switzerland,False,1,-1,Republic of Ireland
1756,1853,1968,1937,Uganda,Kenya,9,5,Friendly,Kampala,Uganda,False,14,4,Uganda
1757,1854,1969,1937,Finland,England,0,8,Friendly,Helsinki,Finland,False,8,-8,England
1758,1855,1971,1937,France,Republic of Ireland,0,2,Friendly,Colombes,France,False,2,-2,Republic of Ireland
1759,1856,1972,1937,Hungary,Austria,2,2,Friendly,Budapest,Hungary,False,4,0,Draw
1760,1857,1973,1937,Norway,Italy,1,3,Friendly,Oslo,Norway,False,4,-2,Italy
1761,1858,1974,1937,Lithuania,Estonia,1,2,Friendly,Kaunas,Lithuania,False,3,-1,Estonia
1762,1859,1978,1937,Romania,Belgium,2,1,Friendly,Bucharest,Romania,False,3,1,Romania
1763,1860,1979,1937,Denmark,Norway,5,1,Nordic Championship,Copenhagen,Denmark,False,6,4,Denmark
1764,1861,1980,1937,Sweden,Finland,4,0,FIFA World Cup qualification,Solna,Sweden,False,4,4,Sweden
1765,1862,1981,1937,Sweden,Estonia,7,2,FIFA World Cup qualification,Solna,Sweden,False,9,5,Sweden
1766,1863,1982,1937,Poland,Sweden,3,1,Friendly,Warsaw,Poland,False,4,2,Poland
1767,1864,1983,1937,Latvia,Germany,1,3,Friendly,Riga,Latvia,False,4,-2,Germany
1768,1865,1984,1937,Romania,Sweden,2,2,Friendly,Bucharest,Romania,False,4,0,Draw
1769,1866,1985,1937,Finland,Germany,0,2,FIFA World Cup qualification,Helsinki,Finland,False,2,-2,Germany
1770,1867,1986,1937,Poland,Romania,2,4,Friendly,Łódź,Poland,False,6,-2,Romania
1771,1868,1987,1937,Estonia,Romania,2,1,Friendly,Tallinn,Estonia,False,3,1,Estonia
1772,1869,1988,1937,Latvia,Lithuania,4,2,FIFA World Cup qualification,Riga,Latvia,False,6,2,Latvia
1773,1870,1990,1937,Finland,Estonia,0,1,FIFA World Cup qualification,Turku,Finland,False,1,-1,Estonia
1774,1872,1992,1937,Germany,Estonia,4,1,FIFA World Cup qualification,Königsberg,Germany,False,5,3,Germany
1775,1874,1994,1937,Lithuania,Latvia,1,5,FIFA World Cup qualification,Kaunas,Lithuania,False,6,-4,Latvia
1776,1875,1995,1937,Estonia,Latvia,1,1,Baltic Cup,Kaunas,Lithuania,True,2,0,Draw
1777,1876,1996,1937,Finland,Norway,0,2,Nordic Championship,Helsinki,Finland,False,2,-2,Norway
1778,1877,1997,1937,Lithuania,Estonia,0,4,Baltic Cup,Kaunas,Lithuania,False,4,-4,Estonia
1779,1878,1998,1937,Estonia,Latvia,0,2,Baltic Cup,Kaunas,Lithuania,True,2,-2,Latvia
1780,1879,1999,1937,Bulgaria,Poland,3,3,Friendly,Sofia,Bulgaria,False,6,0,Draw
1781,1880,2000,1937,Mexico,United States,7,2,Friendly,Mexico City,Mexico,False,9,5,Mexico
1782,1881,2001,1937,Poland,Denmark,3,1,Friendly,Warsaw,Poland,False,4,2,Poland
1783,1882,2002,1937,Austria,Switzerland,4,3,International Cup,Vienna,Austria,False,7,1,Austria
1784,1884,2004,1937,Latvia,Estonia,3,1,Friendly,Riga,Latvia,False,4,2,Latvia
1785,1885,2005,1937,Mexico,United States,7,3,Friendly,Mexico City,Mexico,False,10,4,Mexico
1786,1886,2006,1937,Norway,Sweden,3,2,Nordic Championship,Oslo,Norway,False,5,1,Norway
1787,1887,2008,1937,Sweden,Denmark,1,2,Nordic Championship,Solna,Sweden,False,3,-1,Denmark
1788,1888,2009,1937,Austria,Latvia,2,1,FIFA World Cup qualification,Vienna,Austria,False,3,1,Austria
1789,1889,2010,1937,Austria,Hungary,1,2,International Cup,Vienna,Austria,False,3,-1,Hungary
1790,1890,2011,1937,France,Switzerland,2,1,Friendly,Paris,France,False,3,1,France
1791,1891,2012,1937,Norway,Republic of Ireland,3,2,FIFA World Cup qualification,Oslo,Norway,False,5,1,Norway
1792,1893,2014,1937,Poland,Latvia,2,1,Friendly,Katowice,Poland,False,3,1,Poland
1793,1894,2015,1937,Uruguay,Argentina,0,3,Copa Newton,Montevideo,Uruguay,False,3,-3,Argentina
1794,1895,2016,1937,El Salvador,Honduras,3,2,Friendly,San Salvador,El Salvador,False,5,1,El Salvador
1795,1896,2018,1937,Denmark,Finland,2,1,Nordic Championship,Copenhagen,Denmark,False,3,1,Denmark
1796,1897,2019,1937,Northern Ireland,England,1,5,British Championship,Belfast,Northern Ireland,False,6,-4,England
1797,1898,2021,1937,Germany,Norway,3,0,Friendly,Berlin,Germany,False,3,3,Germany
1798,1899,2022,1937,Wales,Scotland,2,1,British Championship,Cardiff,Wales,False,3,1,Wales
1799,1900,2023,1937,Netherlands,France,2,3,Friendly,Amsterdam,Netherlands,False,5,-1,France
1800,1901,2024,1937,Switzerland,Italy,2,2,International Cup,Geneva,Switzerland,False,4,0,Draw
1801,1903,2026,1937,Republic of Ireland,Norway,3,3,FIFA World Cup qualification,Dublin,Irish Free State,True,6,0,Draw
1802,1904,2027,1937,Scotland,Northern Ireland,1,1,British Championship,Aberdeen,Scotland,False,2,0,Draw
1803,1905,2028,1937,Argentina,Uruguay,5,1,Copa Lipton,Avellaneda,Argentina,False,6,4,Argentina
1804,1906,2029,1937,Hungary,Switzerland,2,0,International Cup,Budapest,Hungary,False,2,2,Hungary
1805,1907,2030,1937,England,Wales,2,1,British Championship,Middlesbrough,England,False,3,1,England
1806,1908,2031,1937,Germany,Sweden,5,0,FIFA World Cup qualification,Altona,Germany,False,5,5,Germany
1807,1909,2032,1937,Netherlands,Luxembourg,4,0,FIFA World Cup qualification,Rotterdam,Netherlands,False,4,4,Netherlands
1808,1910,2033,1937,Spain,Portugal,1,2,Friendly,Vigo,Spain,False,3,-1,Portugal
1809,1913,2036,1937,France,Italy,0,0,Friendly,Paris,France,False,0,0,Draw
1810,1917,2040,1938,Dominica,Saint Lucia,4,1,Friendly,Roseau,Dominica,False,5,3,Dominica
1811,1918,2041,1938,Portugal,Hungary,4,0,Friendly,Lisbon,Portugal,False,4,4,Portugal
1812,1920,2043,1938,Dominica,Saint Lucia,1,3,Friendly,Roseau,Dominica,False,4,-2,Saint Lucia
1813,1921,2044,1938,Dominica,Saint Lucia,1,0,Friendly,Roseau,Dominica,False,1,1,Dominica
1814,1922,2045,1938,Luxembourg,Hungary,0,6,Friendly,Luxembourg,Luxembourg,False,6,-6,Hungary
1815,1923,2046,1938,Israel,Greece,1,3,FIFA World Cup qualification,Tel Aviv,Palestine,True,4,-2,Greece
1816,1924,2047,1938,France,Belgium,5,3,Friendly,Paris,France,False,8,2,France
1817,1925,2048,1938,Portugal,Spain,1,0,Friendly,Lisbon,Portugal,False,1,1,Portugal
1818,1926,2049,1938,Germany,Switzerland,1,1,Friendly,Cologne,Germany,False,2,0,Draw
1819,1927,2050,1938,Greece,Israel,1,0,FIFA World Cup qualification,Athens,Greece,False,1,1,Greece
1820,1928,2051,1938,Netherlands,Belgium,7,2,Friendly,Rotterdam,Netherlands,False,9,5,Netherlands
1821,1929,2052,1938,Haiti,Jamaica,5,2,Friendly,Port-au-Prince,Haiti,False,7,3,Haiti
1822,1930,2053,1938,Luxembourg,Belgium,2,3,FIFA World Cup qualification,Luxembourg,Luxembourg,False,5,-1,Belgium
1823,1931,2054,1938,Switzerland,Poland,3,3,Friendly,Zürich,Switzerland,False,6,0,Draw
1824,1932,2055,1938,Northern Ireland,Wales,1,0,British Championship,Belfast,Northern Ireland,False,1,1,Northern Ireland
1825,1933,2056,1938,Haiti,Jamaica,2,0,Friendly,Port-au-Prince,Haiti,False,2,2,Haiti
1826,1934,2057,1938,Germany,Luxembourg,2,1,Friendly,Wuppertal,Germany,False,3,1,Germany
1827,1935,2058,1938,Germany,Hungary,1,1,Friendly,Nuremberg,Germany,False,2,0,Draw
1828,1936,2059,1938,Haiti,Jamaica,2,0,Friendly,Port-au-Prince,Haiti,False,2,2,Haiti
1829,1937,2060,1938,France,Bulgaria,6,1,Friendly,Paris,France,False,7,5,France
1830,1938,2061,1938,Hungary,Greece,11,1,FIFA World Cup qualification,Budapest,Hungary,False,12,10,Hungary
1831,1939,2062,1938,Guyana,Trinidad and Tobago,1,1,Friendly,Georgetown,British Guyana,False,2,0,Draw
1832,1940,2063,1938,Guyana,Trinidad and Tobago,0,3,Friendly,Georgetown,British Guyana,False,3,-3,Trinidad and Tobago
1833,1941,2064,1938,Belgium,Netherlands,1,1,FIFA World Cup qualification,Antwerp,Belgium,False,2,0,Draw
1834,1943,2067,1938,Guyana,Trinidad and Tobago,0,2,Friendly,Georgetown,British Guyana,False,2,-2,Trinidad and Tobago
1835,1944,2068,1938,England,Scotland,0,1,British Championship,London,England,False,1,-1,Scotland
1836,1945,2070,1938,Germany,Portugal,1,1,Friendly,Frankfurt am Main,Germany,False,2,0,Draw
1837,1946,2071,1938,Switzerland,Portugal,2,1,FIFA World Cup qualification,Milan,Italy,True,3,1,Switzerland
1838,1948,2073,1938,Switzerland,Belgium,0,3,Friendly,Lausanne,Switzerland,False,3,-3,Belgium
1839,1949,2074,1938,Germany,England,3,6,Friendly,Berlin,Germany,False,9,-3,England
1840,1950,2075,1938,Italy,Belgium,6,1,Friendly,Milan,Italy,False,7,5,Italy
1841,1951,2076,1938,Latvia,Lithuania,2,0,Friendly,Riga,Latvia,False,2,2,Latvia
1842,1952,2078,1938,Netherlands,Scotland,1,3,Friendly,Amsterdam,Netherlands,False,4,-2,Scotland
1843,1953,2079,1938,Switzerland,England,2,1,Friendly,Zürich,Switzerland,False,3,1,Switzerland
1844,1955,2081,1938,Poland,Republic of Ireland,6,0,Friendly,Warsaw,Poland,False,6,6,Poland
1845,1956,2082,1938,France,England,2,4,Friendly,Colombes,France,False,6,-2,England
1846,1959,2085,1938,Norway,Estonia,1,0,Friendly,Oslo,Norway,False,1,1,Norway
1847,1960,2086,1938,Germany,Switzerland,1,1,FIFA World Cup,Paris,France,True,2,0,Draw
1848,1961,2087,1938,Brazil,Poland,6,5,FIFA World Cup,Strasbourg,France,True,11,1,Brazil
1849,1962,2088,1938,Cuba,Romania,3,3,FIFA World Cup,Toulouse,France,True,6,0,Draw
1850,1963,2090,1938,France,Belgium,3,1,FIFA World Cup,Colombes,France,False,4,2,France
1851,1964,2091,1938,Hungary,Indonesia,6,0,FIFA World Cup,Reims,France,True,6,6,Hungary
1852,1965,2092,1938,Italy,Norway,2,1,FIFA World Cup,Marseille,France,True,3,1,Italy
1853,1966,2093,1938,Cuba,Romania,2,1,FIFA World Cup,Toulouse,France,True,3,1,Cuba
1854,1967,2094,1938,Germany,Switzerland,2,4,FIFA World Cup,Paris,France,True,6,-2,Switzerland
1855,1968,2095,1938,Sweden,Latvia,3,3,Friendly,Solna,Sweden,False,6,0,Draw
1856,1969,2096,1938,Lithuania,Estonia,0,2,Friendly,Kaunas,Lithuania,False,2,-2,Estonia
1857,1971,2098,1938,Cuba,Sweden,0,8,FIFA World Cup,Antibes,France,True,8,-8,Sweden
1858,1972,2099,1938,France,Italy,1,3,FIFA World Cup,Colombes,France,False,4,-2,Italy
1859,1973,2100,1938,Hungary,Switzerland,2,0,FIFA World Cup,Lille,France,True,2,2,Hungary
1860,1975,2102,1938,Sweden,Finland,2,0,Friendly,Solna,Sweden,False,2,2,Sweden
1861,1976,2103,1938,Brazil,Italy,1,2,FIFA World Cup,Marseille,France,True,3,-1,Italy
1862,1977,2104,1938,Hungary,Sweden,5,1,FIFA World Cup,Paris,France,True,6,4,Hungary
1863,1978,2105,1938,Norway,Finland,9,0,Nordic Championship,Oslo,Norway,False,9,9,Norway
1864,1979,2106,1938,Argentina,Uruguay,1,0,Friendly,Buenos Aires,Argentina,False,1,1,Argentina
1865,1980,2107,1938,Brazil,Sweden,4,2,FIFA World Cup,Bordeaux,France,True,6,2,Brazil
1866,1981,2108,1938,Hungary,Italy,2,4,FIFA World Cup,Colombes,France,True,6,-2,Italy
1867,1983,2110,1938,Denmark,Sweden,0,1,Nordic Championship,Copenhagen,Denmark,False,1,-1,Sweden
1868,1984,2111,1938,Netherlands,Indonesia,9,2,Friendly,Amsterdam,Netherlands,False,11,7,Netherlands
1869,1985,2112,1938,Finland,Sweden,2,4,Nordic Championship,Helsinki,Finland,False,6,-2,Sweden
1870,1986,2113,1938,Curaçao,Suriname,2,1,Friendly,Willemstad,Curaçao,False,3,1,Curaçao
1871,1987,2114,1938,Curaçao,Suriname,1,0,Friendly,Willemstad,Curaçao,False,1,1,Curaçao
1872,1988,2115,1938,Aruba,Suriname,5,0,Friendly,Oranjestad,Aruba,False,5,5,Aruba
1873,1989,2116,1938,Curaçao,Suriname,4,1,Friendly,Willemstad,Curaçao,False,5,3,Curaçao
1874,1990,2117,1938,Trinidad and Tobago,Suriname,1,2,Friendly,Port of Spain,Trinidad and Tobago,False,3,-1,Suriname
1875,1991,2118,1938,Suriname,Trinidad and Tobago,3,0,Friendly,Paramaribo,Netherlands Guyana,False,3,3,Suriname
1876,1992,2119,1938,Estonia,Latvia,0,2,Friendly,Tallinn,Estonia,False,2,-2,Latvia
1877,1993,2120,1938,Suriname,Trinidad and Tobago,0,1,Friendly,Paramaribo,Netherlands Guyana,False,1,-1,Trinidad and Tobago
1878,1995,2122,1938,Bolivia,Ecuador,1,1,Friendly,Bogotá,Colombia,True,2,0,Draw
1879,1996,2123,1938,Colombia,Peru,2,4,Friendly,Bogotá,Colombia,False,6,-2,Peru
1880,1997,2124,1938,Colombia,Ecuador,1,2,Friendly,Bogotá,Colombia,False,3,-1,Ecuador
1881,1998,2125,1938,Bolivia,Venezuela,3,1,Friendly,Bogotá,Colombia,True,4,2,Bolivia
1882,1999,2126,1938,Ecuador,Peru,1,9,Friendly,Bogotá,Colombia,True,10,-8,Peru
1883,2000,2127,1938,Colombia,Venezuela,2,0,Friendly,Bogotá,Colombia,False,2,2,Colombia
1884,2001,2128,1938,Colombia,Bolivia,1,2,Friendly,Bogotá,Colombia,False,3,-1,Bolivia
1885,2002,2129,1938,Estonia,Finland,1,3,Friendly,Tallinn,Estonia,False,4,-2,Finland
1886,2003,2130,1938,Peru,Venezuela,2,1,Friendly,Bogotá,Colombia,True,3,1,Peru
1887,2004,2131,1938,Saint Kitts and Nevis,Grenada,0,4,Friendly,Basseterre,Saint Kitts and Nevis,False,4,-4,Grenada
1888,2005,2132,1938,Saint Kitts and Nevis,Grenada,2,4,Friendly,Basseterre,Saint Kitts and Nevis,False,6,-2,Grenada
1889,2006,2133,1938,Ecuador,Venezuela,5,2,Friendly,Bogotá,Colombia,True,7,3,Ecuador
1890,2007,2134,1938,Bolivia,Ecuador,2,1,Friendly,Bogotá,Colombia,True,3,1,Bolivia
1891,2008,2136,1938,Finland,Denmark,2,1,Nordic Championship,Helsinki,Finland,False,3,1,Finland
1892,2009,2137,1938,Australia,India,5,3,Friendly,Sydney,Australia,False,8,2,Australia
1893,2010,2138,1938,Estonia,Lithuania,3,1,Baltic Cup,Tallinn,Estonia,False,4,2,Estonia
1894,2011,2139,1938,Latvia,Lithuania,1,1,Baltic Cup,Tallinn,Estonia,True,2,0,Draw
1895,2012,2140,1938,Norway,Sweden,2,1,Friendly,Oslo,Norway,False,3,1,Norway
1896,2013,2141,1938,Estonia,Latvia,1,1,Baltic Cup,Tallinn,Estonia,False,2,0,Draw
1897,2014,2143,1938,Australia,India,4,4,Friendly,Brisbane,Australia,False,8,0,Draw
1898,2015,2144,1938,Australia,India,1,4,Friendly,Newcastle,Australia,False,5,-3,India
1899,2016,2145,1938,Finland,Lithuania,3,1,Friendly,Helsinki,Finland,False,4,2,Finland
1900,2017,2146,1938,Germany,Poland,4,1,Friendly,Chemnitz,Germany,False,5,3,Germany
1901,2018,2147,1938,Republic of Ireland,Switzerland,4,0,Friendly,Dublin,Éire,False,4,4,Republic of Ireland
1902,2019,2148,1938,Norway,Denmark,1,1,Nordic Championship,Oslo,Norway,False,2,0,Draw
1903,2020,2149,1938,Australia,India,5,4,Friendly,Sydney,Australia,False,9,1,Australia
1904,2021,2150,1938,Latvia,Poland,2,1,Friendly,Riga,Latvia,False,3,1,Latvia
1905,2023,2152,1938,Romania,Germany,1,4,Friendly,Bucharest,Romania,False,5,-3,Germany
1906,2024,2153,1938,Australia,India,3,1,Friendly,Melbourne,Australia,False,4,2,Australia
1907,2025,2154,1938,Sweden,Norway,2,3,Nordic Championship,Solna,Sweden,False,5,-1,Norway
1908,2026,2155,1938,Northern Ireland,Scotland,0,2,British Championship,Belfast,Northern Ireland,False,2,-2,Scotland
1909,2027,2156,1938,Kenya,Uganda,1,3,Friendly,Nairobi,Kenya,False,4,-2,Uganda
1910,2028,2157,1938,Uruguay,Argentina,2,3,Friendly,Montevideo,Uruguay,False,5,-1,Argentina
1911,2030,2159,1938,Wales,England,4,2,British Championship,Cardiff,Wales,False,6,2,Wales
1912,2031,2160,1938,Denmark,Netherlands,2,2,Friendly,Copenhagen,Denmark,False,4,0,Draw
1913,2032,2161,1938,Poland,Norway,2,2,Friendly,Warsaw,Poland,False,4,0,Draw
1914,2035,2164,1938,Switzerland,Portugal,1,0,Friendly,Lausanne,Switzerland,False,1,1,Switzerland
1915,2036,2165,1938,England,Norway,4,0,Friendly,Newcastle,England,False,4,4,England
1916,2037,2166,1938,Scotland,Wales,3,2,British Championship,Edinburgh,Scotland,False,5,1,Scotland
1917,2038,2167,1938,Republic of Ireland,Poland,3,2,Friendly,Dublin,Éire,False,5,1,Republic of Ireland
1918,2039,2168,1938,England,Northern Ireland,7,0,British Championship,Manchester,England,False,7,7,England
1919,2040,2169,1938,Italy,Switzerland,2,0,Friendly,Bologna,Italy,False,2,2,Italy
1920,2041,2171,1938,Italy,France,1,0,Friendly,Naples,Italy,False,1,1,Italy
1921,2042,2172,1938,Scotland,Hungary,3,1,Friendly,Glasgow,Scotland,False,4,2,Scotland
1922,2043,2173,1939,Dominica,Martinique,3,1,Friendly,Roseau,Dominica,False,4,2,Dominica
1923,2044,2174,1939,Brazil,Argentina,1,5,Copa Roca,Rio de Janeiro,Brazil,False,6,-4,Argentina
1924,2045,2175,1939,Chile,Paraguay,1,5,Copa América,Lima,Peru,True,6,-4,Paraguay
1925,2046,2176,1939,Peru,Ecuador,5,2,Copa América,Lima,Peru,False,7,3,Peru
1926,2047,2177,1939,Brazil,Argentina,3,2,Copa Roca,Rio de Janeiro,Brazil,False,5,1,Brazil
1927,2048,2178,1939,Ecuador,Uruguay,0,6,Copa América,Lima,Peru,True,6,-6,Uruguay
1928,2049,2179,1939,France,Poland,4,0,Friendly,Paris,France,False,4,4,France
1929,2050,2180,1939,Peru,Chile,3,1,Copa América,Lima,Peru,False,4,2,Peru
1930,2051,2181,1939,Belgium,Germany,1,4,Friendly,Brussels,Belgium,False,5,-3,Germany
1931,2052,2182,1939,Chile,Uruguay,2,3,Copa América,Lima,Peru,True,5,-1,Uruguay
1932,2053,2183,1939,Peru,Paraguay,3,0,Copa América,Lima,Peru,False,3,3,Peru
1933,2054,2184,1939,Chile,Ecuador,4,1,Copa América,Lima,Peru,True,5,3,Chile
1934,2055,2185,1939,Paraguay,Uruguay,1,3,Copa América,Lima,Peru,True,4,-2,Uruguay
1935,2056,2186,1939,Ecuador,Paraguay,1,3,Copa América,Lima,Peru,True,4,-2,Paraguay
1936,2057,2187,1939,Peru,Uruguay,2,1,Copa América,Lima,Peru,False,3,1,Peru
1937,2058,2188,1939,Portugal,Switzerland,2,4,Friendly,Lisbon,Portugal,False,6,-2,Switzerland
1938,2059,2189,1939,Chile,Paraguay,4,1,Friendly,Santiago,Chile,False,5,3,Chile
1939,2061,2191,1939,Netherlands,Hungary,3,2,Friendly,Rotterdam,Netherlands,False,5,1,Netherlands
1940,2062,2192,1939,Haiti,Panama,1,0,Friendly,Port-au-Prince,Haiti,False,1,1,Haiti
1941,2063,2193,1939,Wales,Northern Ireland,3,1,British Championship,Wrexham,Wales,False,4,2,Wales
1942,2064,2194,1939,France,Hungary,2,2,Friendly,Paris,France,False,4,0,Draw
1943,2065,2195,1939,Belgium,Netherlands,5,4,Friendly,Antwerp,Belgium,False,9,1,Belgium
1944,2066,2196,1939,Haiti,Panama,1,1,Friendly,Port-au-Prince,Haiti,False,2,0,Draw
1945,2067,2197,1939,Republic of Ireland,Hungary,2,2,Friendly,Cork,Éire,False,4,0,Draw
1946,2068,2198,1939,Haiti,Panama,3,0,Friendly,Port-au-Prince,Haiti,False,3,3,Haiti
1947,2069,2199,1939,Italy,Germany,3,2,Friendly,Florence,Italy,False,5,1,Italy
1948,2070,2200,1939,Luxembourg,Germany,2,1,Friendly,Differdange,Luxembourg,False,3,1,Luxembourg
1949,2071,2201,1939,Switzerland,Hungary,3,1,Friendly,Zürich,Switzerland,False,4,2,Switzerland
1950,2072,2202,1939,Scotland,England,1,2,British Championship,Glasgow,Scotland,False,3,-1,England
1951,2073,2203,1939,Netherlands,Belgium,3,2,Friendly,Amsterdam,Netherlands,False,5,1,Netherlands
1952,2075,2206,1939,Switzerland,Netherlands,2,1,Friendly,Berne,Switzerland,False,3,1,Switzerland
1953,2076,2207,1939,Italy,England,2,2,Friendly,Milan,Italy,False,4,0,Draw
1954,2077,2208,1939,Belgium,Switzerland,1,2,Friendly,Liège,Belgium,False,3,-1,Switzerland
1955,2078,2209,1939,Belgium,France,1,3,Friendly,Brussels,Belgium,False,4,-2,France
1956,2079,2210,1939,Hungary,Republic of Ireland,2,2,Friendly,Budapest,Hungary,False,4,0,Draw
1957,2080,2211,1939,Romania,Latvia,4,0,Friendly,Bucharest,Romania,False,4,4,Romania
1958,2081,2213,1939,France,Wales,2,1,Friendly,Colombes,France,False,3,1,France
1959,2082,2214,1939,Germany,Republic of Ireland,1,1,Friendly,Bremen,Germany,False,2,0,Draw
1960,2083,2215,1939,Bulgaria,Latvia,3,0,Friendly,Sofia,Bulgaria,False,3,3,Bulgaria
1961,2084,2216,1939,Romania,England,0,2,Friendly,Bucharest,Romania,False,2,-2,England
1962,2085,2217,1939,Poland,Belgium,3,3,Friendly,Łódź,Poland,False,6,0,Draw
1963,2086,2218,1939,Sweden,Norway,3,2,Friendly,Solna,Sweden,False,5,1,Sweden
1964,2087,2219,1939,Poland,Switzerland,1,1,Friendly,Warsaw,Poland,False,2,0,Draw
1965,2088,2221,1939,Hungary,Italy,1,3,Friendly,Budapest,Hungary,False,4,-2,Italy
1966,2089,2222,1939,Sweden,Finland,5,1,Nordic Championship,Solna,Sweden,False,6,4,Sweden
1967,2090,2223,1939,Romania,Italy,0,1,Friendly,Bucharest,Romania,False,1,-1,Italy
1968,2091,2224,1939,Sweden,Lithuania,7,0,Friendly,Karlstad,Sweden,False,7,7,Sweden
1969,2092,2225,1939,Norway,Sweden,1,0,Friendly,Copenhagen,Denmark,True,1,1,Norway
1970,2093,2226,1939,Denmark,Finland,5,0,Friendly,Copenhagen,Denmark,False,5,5,Denmark
1971,2094,2227,1939,Denmark,Norway,6,3,Friendly,Copenhagen,Denmark,False,9,3,Denmark
1972,2095,2228,1939,Norway,Germany,0,4,Friendly,Oslo,Norway,False,4,-4,Germany
1973,2096,2229,1939,Denmark,Germany,0,2,Friendly,Copenhagen,Denmark,False,2,-2,Germany
1974,2097,2230,1939,Estonia,Germany,0,2,Friendly,Tallinn,Estonia,False,2,-2,Germany
1975,2098,2231,1939,Finland,Italy,2,3,Friendly,Helsinki,Finland,False,5,-1,Italy
1976,2099,2232,1939,Latvia,Estonia,3,3,Friendly,Riga,Latvia,False,6,0,Draw
1977,2100,2233,1939,Finland,Estonia,4,2,Friendly,Helsinki,Finland,False,6,2,Finland
1978,2101,2234,1939,Panama,Cuba,0,4,Friendly,Panama City,Panama,False,4,-4,Cuba
1979,2102,2235,1939,Paraguay,Argentina,0,1,Copa Chevallier Boutell,Asunción,Paraguay,False,1,-1,Argentina
1980,2103,2236,1939,Paraguay,Argentina,2,2,Copa Chevallier Boutell,Asunción,Paraguay,False,4,0,Draw
1981,2104,2238,1939,Estonia,Lithuania,0,1,Friendly,Tallinn,Estonia,False,1,-1,Lithuania
1982,2105,2239,1939,Poland,Hungary,4,2,Friendly,Warsaw,Poland,False,6,2,Poland
1983,2106,2240,1939,Slovakia,Germany,2,0,Friendly,Bratislava,Slovakia,False,2,2,Slovakia
1984,2107,2242,1939,Finland,Norway,1,2,Nordic Championship,Helsinki,Finland,False,3,-1,Norway
1985,2108,2244,1939,Denmark,Finland,8,1,Nordic Championship,Copenhagen,Denmark,False,9,7,Denmark
1986,2109,2245,1939,Norway,Sweden,2,3,Nordic Championship,Oslo,Norway,False,5,-1,Sweden
1987,2110,2246,1939,Finland,Latvia,0,3,Friendly,Helsinki,Finland,False,3,-3,Latvia
1988,2111,2247,1939,Hungary,Germany,5,1,Friendly,Budapest,Hungary,False,6,4,Hungary
1989,2112,2248,1939,Sweden,Denmark,4,1,Nordic Championship,Solna,Sweden,False,5,3,Sweden
1990,2113,2250,1939,Bulgaria,Germany,1,2,Friendly,Sofia,Bulgaria,False,3,-1,Germany
1991,2114,2251,1939,Denmark,Norway,4,1,Nordic Championship,Copenhagen,Denmark,False,5,3,Denmark
1992,2116,2253,1939,Switzerland,Italy,3,1,Friendly,Zürich,Switzerland,False,4,2,Switzerland
1993,2117,2255,1939,Germany,Italy,5,2,Friendly,Berlin,Germany,False,7,3,Germany
1994,2118,2256,1939,Uganda,Kenya,5,2,Friendly,Kampala,Uganda,False,7,3,Uganda
1995,2119,2257,1939,Germany,Slovakia,3,1,Friendly,Chemnitz,Germany,False,4,2,Germany
1996,2120,2258,1940,France,Portugal,3,2,Friendly,Paris,France,False,5,1,France
1997,2121,2259,1940,Argentina,Paraguay,3,1,Copa Chevallier Boutell,Avellaneda,Argentina,False,4,2,Argentina
1998,2122,2260,1940,Brazil,Argentina,2,2,Copa Roca,São Paulo,Brazil,False,4,0,Draw
1999,2123,2261,1940,Kenya,Uganda,3,6,Friendly,Nairobi,Kenya,False,9,-3,Uganda
2000,2124,2262,1940,Argentina,Paraguay,4,0,Copa Chevallier Boutell,Buenos Aires,Argentina,False,4,4,Argentina
2001,2125,2263,1940,Brazil,Argentina,0,3,Copa Roca,São Paulo,Brazil,False,3,-3,Argentina
2002,2126,2264,1940,Argentina,Chile,4,1,Friendly,San Martín,Argentina,False,5,3,Argentina
2003,2127,2265,1940,Italy,Switzerland,1,1,Friendly,Turin,Italy,False,2,0,Draw
2004,2128,2266,1940,Argentina,Brazil,6,1,Copa Roca,Buenos Aires,Argentina,False,7,5,Argentina
2005,2129,2267,1940,Argentina,Chile,3,2,Friendly,Buenos Aires,Argentina,False,5,1,Argentina
2006,2130,2268,1940,Argentina,Brazil,2,3,Copa Roca,Buenos Aires,Argentina,False,5,-1,Brazil
2007,2131,2269,1940,Uruguay,Chile,3,2,Friendly,Montevideo,Uruguay,False,5,1,Uruguay
2008,2132,2270,1940,Argentina,Brazil,5,1,Copa Roca,Avellaneda,Argentina,False,6,4,Argentina
2009,2133,2271,1940,Belgium,Netherlands,7,1,Friendly,Antwerp,Belgium,False,8,6,Belgium
2010,2134,2272,1940,Brazil,Uruguay,3,4,Copa Rio Branco,Rio de Janeiro,Brazil,False,7,-1,Uruguay
2011,2135,2273,1940,Brazil,Uruguay,1,1,Copa Rio Branco,Rio de Janeiro,Brazil,False,2,0,Draw
2012,2136,2274,1940,Hungary,Switzerland,3,0,Friendly,Budapest,Hungary,False,3,3,Hungary
2013,2137,2275,1940,Netherlands,Luxembourg,4,5,Friendly,Rotterdam,Netherlands,False,9,-1,Luxembourg
2014,2139,2277,1940,Croatia,Switzerland,4,0,Friendly,Zagreb,Croatia,False,4,4,Croatia
2015,2140,2278,1940,Germany,Hungary,2,2,Friendly,Berlin,Germany,False,4,0,Draw
2016,2142,2280,1940,Italy,Romania,2,1,Friendly,Rome,Italy,False,3,1,Italy
2017,2143,2281,1940,Netherlands,Belgium,4,2,Friendly,Amsterdam,Netherlands,False,6,2,Netherlands
2018,2144,2282,1940,Switzerland,Croatia,0,1,Friendly,Berne,Switzerland,False,1,-1,Croatia
2019,2145,2283,1940,Israel,Lebanon,5,1,Friendly,Tel Aviv,Palestine,False,6,4,Israel
2020,2146,2284,1940,Hungary,Croatia,1,0,Friendly,Budapest,Hungary,False,1,1,Hungary
2021,2147,2285,1940,Italy,Germany,3,2,Friendly,Milan,Italy,False,5,1,Italy
2022,2148,2286,1940,Hungary,Romania,2,0,Friendly,Budapest,Hungary,False,2,2,Hungary
2023,2149,2287,1940,Bulgaria,Slovakia,1,4,Friendly,Sofia,Bulgaria,False,5,-3,Slovakia
2024,2152,2290,1940,Japan,Philippines,1,0,Friendly,Nishinomiya,Japan,False,1,1,Japan
2025,2153,2291,1940,Germany,Romania,9,3,Friendly,Frankfurt am Main,Germany,False,12,6,Germany
2026,2154,2292,1940,Estonia,Latvia,2,1,Friendly,Tallinn,Estonia,False,3,1,Estonia
2027,2155,2293,1940,Uruguay,Argentina,3,0,Friendly,Montevideo,Uruguay,False,3,3,Uruguay
2028,2156,2294,1940,Lithuania,Estonia,2,0,Friendly,Kaunas,Soviet Union,False,2,2,Lithuania
2029,2157,2295,1940,Argentina,Uruguay,5,0,Friendly,Buenos Aires,Argentina,False,5,5,Argentina
2030,2158,2296,1940,Finland,Sweden,2,3,Friendly,Helsinki,Finland,False,5,-1,Sweden
2031,2159,2297,1940,Germany,Finland,13,0,Friendly,Leipzig,Germany,False,13,13,Germany
2032,2160,2298,1940,Latvia,Lithuania,1,0,Baltic Cup,Riga,Soviet Union,True,1,1,Latvia
2033,2161,2299,1940,Estonia,Lithuania,1,1,Baltic Cup,Riga,Soviet Union,True,2,0,Draw
2034,2162,2300,1940,Slovakia,Germany,0,1,Friendly,Bratislava,Slovakia,False,1,-1,Germany
2035,2163,2301,1940,Sweden,Finland,5,0,Friendly,Solna,Sweden,False,5,5,Sweden
2036,2165,2304,1940,Hungary,Germany,2,2,Friendly,Budapest,Hungary,False,4,0,Draw
2037,2166,2305,1940,Sweden,Denmark,1,1,Friendly,Solna,Sweden,False,2,0,Draw
2038,2167,2306,1940,Lithuania,Latvia,4,3,Friendly,Kaunas,Soviet Union,False,7,1,Lithuania
2039,2168,2307,1940,Denmark,Sweden,3,3,Friendly,Copenhagen,Denmark,False,6,0,Draw
2040,2169,2308,1940,Germany,Bulgaria,7,3,Friendly,Munich,Germany,False,10,4,Germany
2041,2170,2310,1940,Cuba,Puerto Rico,1,1,Friendly,Havana,Cuba,False,2,0,Draw
2042,2171,2311,1940,Germany,Denmark,1,0,Friendly,Hamburg,Germany,False,1,1,Germany
2043,2172,2312,1940,Italy,Hungary,1,1,Friendly,Genoa,Italy,False,2,0,Draw
2044,2173,2313,1940,Croatia,Hungary,1,1,Friendly,Zagreb,Croatia,False,2,0,Draw
2045,2174,2314,1941,Chile,Argentina,1,2,Friendly,Santiago,Chile,False,3,-1,Argentina
2046,2175,2315,1941,Chile,Argentina,2,5,Friendly,Santiago,Chile,False,7,-3,Argentina
2047,2176,2316,1941,Portugal,Spain,2,2,Friendly,Lisbon,Portugal,False,4,0,Draw
2048,2177,2317,1941,Curaçao,Aruba,4,0,Friendly,Willemstad,Curaçao,False,4,4,Curaçao
2049,2178,2318,1941,Curaçao,Aruba,2,1,Friendly,Willemstad,Curaçao,False,3,1,Curaçao
2050,2179,2319,1941,Peru,Argentina,1,1,Friendly,Lima,Peru,False,2,0,Draw
2051,2180,2320,1941,Peru,Argentina,1,1,Friendly,Lima,Peru,False,2,0,Draw
2052,2181,2321,1941,Peru,Argentina,0,3,Friendly,Lima,Peru,False,3,-3,Argentina
2053,2182,2322,1941,Chile,Ecuador,5,0,Copa América,Santiago,Chile,False,5,5,Chile
2054,2183,2323,1941,Chile,Peru,1,0,Copa América,Santiago,Chile,False,1,1,Chile
2055,2184,2324,1941,Ecuador,Uruguay,0,6,Copa América,Santiago,Chile,True,6,-6,Uruguay
2056,2185,2325,1941,Argentina,Peru,2,1,Copa América,Santiago,Chile,True,3,1,Argentina
2057,2186,2326,1941,Argentina,Ecuador,6,1,Copa América,Santiago,Chile,True,7,5,Argentina
2058,2187,2327,1941,Chile,Uruguay,0,2,Copa América,Santiago,Chile,False,2,-2,Uruguay
2059,2188,2328,1941,Guadeloupe,Martinique,1,2,Friendly,Basse-Terre,Guadeloupe,False,3,-1,Martinique
2060,2189,2329,1941,Uganda,Kenya,3,4,Friendly,Kampala,Uganda,False,7,-1,Kenya
2061,2190,2330,1941,Argentina,Uruguay,1,0,Copa América,Santiago,Chile,True,1,1,Argentina
2062,2191,2331,1941,Ecuador,Peru,0,4,Copa América,Santiago,Chile,True,4,-4,Peru
2063,2192,2332,1941,Peru,Uruguay,0,2,Copa América,Santiago,Chile,True,2,-2,Uruguay
2064,2193,2333,1941,Chile,Argentina,0,1,Copa América,Santiago,Chile,False,1,-1,Argentina
2065,2194,2334,1941,Germany,Switzerland,4,2,Friendly,Stuttgart,Germany,False,6,2,Germany
2066,2195,2335,1941,Spain,Portugal,5,1,Friendly,Bilbao,Spain,False,6,4,Spain
2067,2196,2337,1941,Germany,Hungary,7,0,Friendly,Cologne,Germany,False,7,7,Germany
2068,2197,2338,1941,Aruba,Curaçao,0,0,Friendly,Oranjestad,Aruba,False,0,0,Draw
2069,2198,2339,1941,Aruba,Curaçao,2,2,Friendly,Oranjestad,Aruba,False,4,0,Draw
2070,2199,2340,1941,Switzerland,Germany,2,1,Friendly,Berne,Switzerland,False,3,1,Switzerland
2071,2200,2341,1941,Curaçao,Panama,3,3,CCCF Championship,San José,Costa Rica,True,6,0,Draw
2072,2201,2342,1941,Costa Rica,Nicaragua,7,2,CCCF Championship,San José,Costa Rica,False,9,5,Costa Rica
2073,2202,2343,1941,Costa Rica,Panama,7,0,CCCF Championship,San José,Costa Rica,False,7,7,Costa Rica
2074,2203,2344,1941,Curaçao,El Salvador,2,2,CCCF Championship,San José,Costa Rica,True,4,0,Draw
2075,2204,2345,1941,Costa Rica,Curaçao,6,2,CCCF Championship,San José,Costa Rica,False,8,4,Costa Rica
2076,2205,2346,1941,El Salvador,Nicaragua,8,0,CCCF Championship,San José,Costa Rica,True,8,8,El Salvador
2077,2206,2347,1941,Curaçao,Nicaragua,9,1,CCCF Championship,San José,Costa Rica,True,10,8,Curaçao
2078,2207,2348,1941,El Salvador,Panama,4,3,CCCF Championship,San José,Costa Rica,True,7,1,El Salvador
2079,2208,2349,1941,Costa Rica,El Salvador,3,1,CCCF Championship,San José,Costa Rica,False,4,2,Costa Rica
2080,2209,2350,1941,Nicaragua,Panama,2,5,CCCF Championship,San José,Costa Rica,True,7,-3,Panama
2081,2210,2351,1941,Romania,Germany,1,4,Friendly,Bucharest,Romania,False,5,-3,Germany
2082,2211,2352,1941,Germany,Croatia,5,1,Friendly,Vienna,Germany,False,6,4,Germany
2083,2212,2353,1941,Afghanistan,India,1,3,Friendly,Kabul,Afghanistan,False,4,-2,India
2084,2213,2354,1941,India,Iran,0,1,Friendly,Kabul,Afghanistan,True,1,-1,Iran
2085,2214,2355,1941,Martinique,Guadeloupe,5,0,Friendly,Fort-de-France,Martinique,False,5,5,Martinique
2086,2215,2356,1941,Sweden,Denmark,2,2,Friendly,Solna,Sweden,False,4,0,Draw
2087,2216,2357,1941,Croatia,Slovakia,5,2,Friendly,Zagreb,Croatia,False,7,3,Croatia
2088,2217,2358,1941,Finland,Germany,0,6,Friendly,Helsinki,Finland,False,6,-6,Germany
2089,2218,2359,1941,Sweden,Germany,4,2,Friendly,Solna,Sweden,False,6,2,Sweden
2090,2219,2360,1941,Romania,Slovakia,3,2,Friendly,Bucharest,Romania,False,5,1,Romania
2091,2220,2361,1941,Denmark,Sweden,2,1,Friendly,Copenhagen,Denmark,False,3,1,Denmark
2092,2221,2362,1941,Germany,Denmark,1,1,Friendly,Dresden,Germany,False,2,0,Draw
2093,2222,2363,1941,Switzerland,Hungary,1,2,Friendly,Zürich,Switzerland,False,3,-1,Hungary
2094,2223,2364,1941,Germany,Slovakia,4,0,Friendly,Breslau,Germany,False,4,4,Germany
2095,2224,2365,1941,Spain,Switzerland,3,2,Friendly,Valencia,Spain,False,5,1,Spain
2096,2225,2366,1942,Portugal,Switzerland,3,0,Friendly,Lisbon,Portugal,False,3,3,Portugal
2097,2226,2367,1942,Uruguay,Chile,6,1,Copa América,Montevideo,Uruguay,False,7,5,Uruguay
2098,2227,2368,1942,Argentina,Paraguay,4,3,Copa América,Montevideo,Uruguay,True,7,1,Argentina
2099,2228,2369,1942,Brazil,Chile,6,1,Copa América,Montevideo,Uruguay,True,7,5,Brazil
2100,2229,2370,1942,Argentina,Brazil,2,1,Copa América,Montevideo,Uruguay,True,3,1,Argentina
2101,2230,2371,1942,Paraguay,Peru,1,1,Copa América,Montevideo,Uruguay,True,2,0,Draw
2102,2231,2372,1942,Uruguay,Ecuador,7,0,Copa América,Montevideo,Uruguay,False,7,7,Uruguay
2103,2232,2373,1942,Brazil,Peru,2,1,Copa América,Montevideo,Uruguay,True,3,1,Brazil
2104,2233,2374,1942,Argentina,Ecuador,12,0,Copa América,Montevideo,Uruguay,True,12,12,Argentina
2105,2234,2375,1942,Chile,Paraguay,0,2,Copa América,Montevideo,Uruguay,True,2,-2,Paraguay
2106,2235,2376,1942,Uruguay,Brazil,1,0,Copa América,Montevideo,Uruguay,False,1,1,Uruguay
2107,2236,2377,1942,Argentina,Peru,3,1,Copa América,Montevideo,Uruguay,True,4,2,Argentina
2108,2237,2378,1942,Ecuador,Paraguay,1,3,Copa América,Montevideo,Uruguay,True,4,-2,Paraguay
2109,2238,2379,1942,Cuba,Puerto Rico,1,0,Friendly,Havana,Cuba,False,1,1,Cuba
2110,2239,2380,1942,Ecuador,Peru,1,2,Copa América,Montevideo,Uruguay,True,3,-1,Peru
2111,2240,2381,1942,Uruguay,Paraguay,3,1,Copa América,Montevideo,Uruguay,False,4,2,Uruguay
2112,2241,2382,1942,Cuba,Puerto Rico,1,0,Friendly,Havana,Cuba,False,1,1,Cuba
2113,2242,2383,1942,Argentina,Chile,0,0,Copa América,Montevideo,Uruguay,True,0,0,Draw
2114,2243,2384,1942,Brazil,Ecuador,5,1,Copa América,Montevideo,Uruguay,True,6,4,Brazil
2115,2244,2385,1942,Germany,Switzerland,1,2,Friendly,Vienna,Germany,False,3,-1,Switzerland
2116,2245,2386,1942,Uruguay,Peru,3,0,Copa América,Montevideo,Uruguay,False,3,3,Uruguay
2117,2246,2387,1942,Brazil,Paraguay,1,1,Copa América,Montevideo,Uruguay,True,2,0,Draw
2118,2247,2388,1942,Chile,Ecuador,2,1,Copa América,Montevideo,Uruguay,True,3,1,Chile
2119,2248,2389,1942,Chile,Peru,0,0,Copa América,Montevideo,Uruguay,True,0,0,Draw
2120,2249,2390,1942,Uruguay,Argentina,1,0,Copa América,Montevideo,Uruguay,False,1,1,Uruguay
2121,2250,2391,1942,France,Switzerland,0,2,Friendly,Marseille,France,False,2,-2,Switzerland
2122,2251,2392,1942,Spain,France,4,0,Friendly,Seville,Spain,False,4,4,Spain
2123,2252,2393,1942,Italy,Croatia,4,0,Friendly,Genoa,Italy,False,4,4,Italy
2124,2253,2394,1942,Barbados,Trinidad and Tobago,3,3,Friendly,Bridgetown,Barbados,False,6,0,Draw
2125,2254,2395,1942,Germany,Spain,1,1,Friendly,Berlin,Germany,False,2,0,Draw
2126,2255,2396,1942,Italy,Spain,4,0,Friendly,Milan,Italy,False,4,4,Italy
2127,2256,2397,1942,Hungary,Germany,3,5,Friendly,Budapest,Hungary,False,8,-2,Germany
2128,2257,2398,1942,Argentina,Uruguay,4,1,Copa Newton,Buenos Aires,Argentina,False,5,3,Argentina
2129,2258,2399,1942,Curaçao,Aruba,2,2,Friendly,Willemstad,Curaçao,False,4,0,Draw
2130,2259,2400,1942,Slovakia,Croatia,1,2,Friendly,Bratislava,Slovakia,False,3,-1,Croatia
2131,2260,2401,1942,Hungary,Croatia,1,1,Friendly,Budapest,Hungary,False,2,0,Draw
2132,2261,2402,1942,Denmark,Sweden,0,3,Friendly,Copenhagen,Denmark,False,3,-3,Sweden
2133,2262,2403,1942,Kenya,Uganda,4,3,Friendly,Nairobi,Kenya,False,7,1,Kenya
2134,2263,2404,1942,Bulgaria,Germany,0,3,Friendly,Sofia,Bulgaria,False,3,-3,Germany
2135,2264,2405,1942,Latvia,Estonia,4,0,Friendly,Riga,Soviet Union,False,4,4,Latvia
2136,2265,2408,1942,Japan,Mongolia,12,0,Friendly,Xinjing,Manchuria,True,12,12,Japan
2137,2266,2409,1942,Germany,Romania,7,0,Friendly,Beuthen,Germany,False,7,7,Germany
2138,2267,2410,1942,Estonia,Latvia,1,8,Friendly,Tallinn,Soviet Union,False,9,-7,Latvia
2139,2268,2411,1942,Slovakia,Romania,1,0,Friendly,Bratislava,Slovakia,False,1,1,Slovakia
2140,2269,2412,1942,Uruguay,Argentina,1,1,Copa Lipton,Montevideo,Uruguay,False,2,0,Draw
2141,2270,2413,1942,Croatia,Slovakia,6,1,Friendly,Zagreb,Croatia,False,7,5,Croatia
2142,2271,2414,1942,Germany,Sweden,2,3,Friendly,Berlin,Germany,False,5,-1,Sweden
2143,2272,2415,1942,Sweden,Denmark,2,1,Friendly,Solna,Sweden,False,3,1,Sweden
2144,2273,2416,1942,Romania,Croatia,2,2,Friendly,Bucharest,Romania,False,4,0,Draw
2145,2274,2417,1942,Switzerland,Germany,3,5,Friendly,Berne,Switzerland,False,8,-2,Germany
2146,2275,2418,1942,Germany,Croatia,5,1,Friendly,Stuttgart,Germany,False,6,4,Germany
2147,2276,2419,1942,Hungary,Switzerland,3,0,Friendly,Budapest,Hungary,False,3,3,Hungary
2148,2277,2420,1942,Switzerland,Sweden,3,1,Friendly,Zürich,Switzerland,False,4,2,Switzerland
2149,2278,2421,1942,Slovakia,Germany,2,5,Friendly,Bratislava,Slovakia,False,7,-3,Germany
2150,2279,2422,1943,Uganda,Kenya,2,1,Friendly,Kampala,Uganda,False,3,1,Uganda
2151,2280,2423,1943,Argentina,Uruguay,3,3,Friendly,Buenos Aires,Argentina,False,6,0,Draw
2152,2281,2424,1943,Switzerland,Croatia,1,0,Friendly,Zürich,Switzerland,False,1,1,Switzerland
2153,2282,2425,1943,Uruguay,Argentina,0,1,Friendly,Montevideo,Uruguay,False,1,-1,Argentina
2154,2283,2426,1943,Croatia,Slovakia,1,0,Friendly,Zagreb,Croatia,False,1,1,Croatia
2155,2284,2427,1943,Switzerland,Hungary,1,3,Friendly,Geneva,Switzerland,False,4,-2,Hungary
2156,2285,2428,1943,Bulgaria,Hungary,2,4,Friendly,Sofia,Bulgaria,False,6,-2,Hungary
2157,2286,2429,1943,Romania,Slovakia,2,2,Friendly,Bucharest,Romania,False,4,0,Draw
2158,2287,2430,1943,Sweden,Switzerland,1,0,Friendly,Solna,Sweden,False,1,1,Sweden
2159,2288,2431,1943,Denmark,Sweden,3,2,Friendly,Copenhagen,Denmark,False,5,1,Denmark
2160,2289,2432,1943,Paraguay,Argentina,2,5,Copa Chevallier Boutell,Asunción,Paraguay,False,7,-3,Argentina
2161,2290,2433,1943,Paraguay,Argentina,2,1,Copa Chevallier Boutell,Asunción,Paraguay,False,3,1,Paraguay
2162,2291,2434,1943,Sweden,Hungary,2,3,Friendly,Solna,Sweden,False,5,-1,Hungary
2163,2292,2435,1943,Finland,Hungary,0,3,Friendly,Helsinki,Finland,False,3,-3,Hungary
2164,2293,2436,1943,Curaçao,Aruba,3,3,Friendly,Willemstad,Curaçao,False,6,0,Draw
2165,2294,2437,1943,Curaçao,Aruba,2,2,Friendly,Willemstad,Curaçao,False,4,0,Draw
2166,2295,2438,1943,Finland,Sweden,1,1,Friendly,Helsinki,Finland,False,2,0,Draw
2167,2296,2439,1943,Hungary,Sweden,2,7,Friendly,Budapest,Hungary,False,9,-5,Sweden
2168,2297,2440,1943,Guyana,Suriname,2,0,Friendly,Georgetown,British Guyana,False,2,2,Guyana
2169,2298,2441,1943,Guyana,Suriname,0,1,Friendly,Georgetown,British Guyana,False,1,-1,Suriname
2170,2299,2442,1943,Guyana,Suriname,0,4,Friendly,Georgetown,British Guyana,False,4,-4,Suriname
2171,2300,2443,1943,Costa Rica,Nicaragua,7,0,CCCF Championship,San Salvador,El Salvador,True,7,7,Costa Rica
2172,2301,2444,1943,El Salvador,Guatemala,2,2,CCCF Championship,San Salvador,El Salvador,False,4,0,Draw
2173,2302,2445,1943,Costa Rica,Guatemala,2,3,CCCF Championship,San Salvador,El Salvador,True,5,-1,Guatemala
2174,2303,2446,1943,El Salvador,Nicaragua,8,1,CCCF Championship,San Salvador,El Salvador,False,9,7,El Salvador
2175,2304,2447,1943,El Salvador,Costa Rica,4,2,CCCF Championship,San Salvador,El Salvador,False,6,2,El Salvador
2176,2305,2448,1943,Guatemala,Nicaragua,6,2,CCCF Championship,San Salvador,El Salvador,True,8,4,Guatemala
2177,2306,2449,1943,Aruba,Curaçao,1,2,Friendly,Oranjestad,Aruba,False,3,-1,Curaçao
2178,2307,2450,1943,Aruba,Curaçao,1,1,Friendly,Oranjestad,Aruba,False,2,0,Draw
2179,2308,2451,1943,El Salvador,Guatemala,2,1,CCCF Championship,San Salvador,El Salvador,False,3,1,El Salvador
2180,2309,2452,1943,Nicaragua,Costa Rica,2,3,CCCF Championship,San Salvador,El Salvador,True,5,-1,Costa Rica
2181,2310,2453,1943,El Salvador,Nicaragua,10,1,CCCF Championship,San Salvador,El Salvador,False,11,9,El Salvador
2182,2311,2454,1943,Guatemala,Costa Rica,4,2,CCCF Championship,San Salvador,El Salvador,True,6,2,Guatemala
2183,2312,2455,1943,El Salvador,Costa Rica,2,4,CCCF Championship,San Salvador,El Salvador,False,6,-2,Costa Rica
2184,2313,2456,1943,Nicaragua,Guatemala,1,5,CCCF Championship,San Salvador,El Salvador,True,6,-4,Guatemala
2185,2314,2457,1944,Trinidad and Tobago,Barbados,5,0,Friendly,Port of Spain,Trinidad and Tobago,False,5,5,Trinidad and Tobago
2186,2315,2458,1944,Aruba,Venezuela,1,3,Friendly,Willemstad,Curaçao,True,4,-2,Venezuela
2187,2316,2459,1944,Curaçao,Haiti,5,0,Friendly,Willemstad,Curaçao,False,5,5,Curaçao
2188,2317,2460,1944,Haiti,Venezuela,0,2,Friendly,Willemstad,Curaçao,True,2,-2,Venezuela
2189,2318,2461,1944,Aruba,Haiti,1,1,Friendly,Willemstad,Curaçao,True,2,0,Draw
2190,2319,2462,1944,Croatia,Slovakia,7,3,Friendly,Zagreb,Croatia,False,10,4,Croatia
2191,2320,2463,1944,Curaçao,Venezuela,3,3,Friendly,Willemstad,Curaçao,False,6,0,Draw
2192,2321,2464,1944,Curaçao,Aruba,3,1,Friendly,Willemstad,Curaçao,False,4,2,Curaçao
2193,2322,2465,1944,Brazil,Uruguay,6,1,Friendly,Rio de Janeiro,Brazil,False,7,5,Brazil
2194,2323,2466,1944,Brazil,Uruguay,4,0,Friendly,São Paulo,Brazil,False,4,4,Brazil
2195,2324,2467,1944,Curaçao,Aruba,2,4,Friendly,Willemstad,Curaçao,False,6,-2,Aruba
2196,2325,2468,1944,Curaçao,Aruba,2,3,Friendly,Willemstad,Curaçao,False,5,-1,Aruba
2197,2326,2469,1944,Suriname,Curaçao,1,2,Friendly,Paramaribo,Netherlands Guyana,False,3,-1,Curaçao
2198,2327,2470,1944,Suriname,Aruba,5,0,Friendly,Paramaribo,Netherlands Guyana,False,5,5,Suriname
2199,2328,2471,1944,Aruba,Curaçao,1,2,Friendly,Paramaribo,Netherlands Guyana,True,3,-1,Curaçao
2200,2329,2472,1944,Suriname,Curaçao,0,2,Friendly,Paramaribo,Netherlands Guyana,False,2,-2,Curaçao
2201,2330,2473,1944,Aruba,Curaçao,1,5,Friendly,Paramaribo,Netherlands Guyana,True,6,-4,Curaçao
2202,2331,2474,1944,Suriname,Aruba,2,3,Friendly,Paramaribo,Netherlands Guyana,False,5,-1,Aruba
2203,2332,2475,1944,Trinidad and Tobago,Guyana,1,1,Friendly,Port of Spain,Trinidad and Tobago,False,2,0,Draw
2204,2333,2476,1944,Barbados,Trinidad and Tobago,1,1,Friendly,Bridgetown,Barbados,False,2,0,Draw
2205,2334,2477,1944,Trinidad and Tobago,Barbados,3,0,Friendly,Port of Spain,Trinidad and Tobago,False,3,3,Trinidad and Tobago
2206,2335,2478,1944,Barbados,Guyana,0,3,Friendly,Port of Spain,Trinidad and Tobago,True,3,-3,Guyana
2207,2336,2479,1944,Barbados,Trinidad and Tobago,1,1,Friendly,Bridgetown,Barbados,False,2,0,Draw
2208,2337,2480,1944,Trinidad and Tobago,Barbados,6,1,Friendly,Port of Spain,Trinidad and Tobago,False,7,5,Trinidad and Tobago
2209,2338,2481,1944,Barbados,Guyana,0,1,Friendly,Port of Spain,Trinidad and Tobago,True,1,-1,Guyana
2210,2339,2482,1944,Trinidad and Tobago,Guyana,3,0,Friendly,Port of Spain,Trinidad and Tobago,False,3,3,Trinidad and Tobago
2211,2340,2483,1944,Barbados,Trinidad and Tobago,1,4,Friendly,Bridgetown,Barbados,False,5,-3,Trinidad and Tobago
2212,2341,2484,1944,Trinidad and Tobago,Guyana,3,0,Friendly,Port of Spain,Trinidad and Tobago,False,3,3,Trinidad and Tobago
2213,2342,2485,1944,Kenya,Uganda,2,1,Friendly,Nairobi,Kenya,False,3,1,Kenya
2214,2343,2486,1944,France,Belgium,3,1,Friendly,Paris,France,False,4,2,France
2215,2344,2487,1945,Argentina,Paraguay,5,2,Copa Chevallier Boutell,Buenos Aires,Argentina,False,7,3,Argentina
2216,2345,2488,1945,Argentina,Paraguay,5,3,Copa Chevallier Boutell,Buenos Aires,Argentina,False,8,2,Argentina
2217,2346,2489,1945,Chile,Ecuador,6,3,Copa América,Santiago,Chile,False,9,3,Chile
2218,2347,2490,1945,Argentina,Bolivia,4,0,Copa América,Santiago,Chile,True,4,4,Argentina
2219,2348,2491,1945,Brazil,Colombia,3,0,Copa América,Santiago,Chile,True,3,3,Brazil
2220,2349,2492,1945,Chile,Bolivia,5,0,Copa América,Santiago,Chile,False,5,5,Chile
2221,2350,2493,1945,Ecuador,Uruguay,1,5,Copa América,Santiago,Chile,True,6,-4,Uruguay
2222,2351,2494,1945,Bolivia,Brazil,0,2,Copa América,Santiago,Chile,True,2,-2,Brazil
2223,2352,2495,1945,Colombia,Uruguay,0,7,Copa América,Santiago,Chile,True,7,-7,Uruguay
2224,2353,2496,1945,Argentina,Ecuador,4,2,Copa América,Santiago,Chile,True,6,2,Argentina
2225,2354,2497,1945,Chile,Colombia,2,0,Copa América,Santiago,Chile,False,2,2,Chile
2226,2355,2498,1945,Argentina,Colombia,9,1,Copa América,Santiago,Chile,True,10,8,Argentina
2227,2356,2499,1945,Brazil,Uruguay,3,0,Copa América,Santiago,Chile,True,3,3,Brazil
2228,2357,2500,1945,Bolivia,Ecuador,0,0,Copa América,Santiago,Chile,True,0,0,Draw
2229,2358,2501,1945,Chile,Argentina,1,1,Copa América,Santiago,Chile,False,2,0,Draw
2230,2359,2502,1945,Argentina,Brazil,3,1,Copa América,Santiago,Chile,True,4,2,Argentina
2231,2360,2503,1945,Bolivia,Uruguay,0,2,Copa América,Santiago,Chile,True,2,-2,Uruguay
2232,2361,2504,1945,Chile,Uruguay,1,0,Copa América,Santiago,Chile,False,1,1,Chile
2233,2362,2505,1945,Colombia,Ecuador,3,1,Copa América,Santiago,Chile,True,4,2,Colombia
2234,2363,2506,1945,Bolivia,Colombia,3,3,Copa América,Santiago,Chile,True,6,0,Draw
2235,2364,2507,1945,Brazil,Ecuador,9,2,Copa América,Santiago,Chile,True,11,7,Brazil
2236,2365,2508,1945,Argentina,Uruguay,1,0,Copa América,Santiago,Chile,True,1,1,Argentina
2237,2366,2509,1945,Chile,Brazil,0,1,Copa América,Santiago,Chile,False,1,-1,Brazil
2238,2367,2510,1945,Portugal,Spain,2,2,Friendly,Oeiras,Portugal,False,4,0,Draw
2239,2368,2511,1945,Switzerland,France,1,0,Friendly,Lausanne,Switzerland,False,1,1,Switzerland
2240,2369,2512,1945,Uganda,Kenya,4,1,Friendly,Kampala,Uganda,False,5,3,Uganda
2241,2370,2513,1945,Spain,Portugal,4,2,Friendly,La Coruña,Spain,False,6,2,Spain
2242,2371,2514,1945,Luxembourg,Belgium,4,1,Friendly,Luxembourg,Luxembourg,False,5,3,Luxembourg
2243,2372,2515,1945,Switzerland,Portugal,1,0,Friendly,Basel,Switzerland,False,1,1,Switzerland
2244,2373,2516,1945,England,France,2,2,Friendly,London,England,False,4,0,Draw
2245,2374,2517,1945,Sweden,Denmark,2,1,Friendly,Solna,Sweden,False,3,1,Sweden
2246,2375,2518,1945,Latvia,Lithuania,3,7,Friendly,Riga,Soviet Union,False,10,-4,Lithuania
2247,2376,2519,1945,Denmark,Sweden,3,4,Friendly,Copenhagen,Denmark,False,7,-1,Sweden
2248,2377,2520,1945,Paraguay,Argentina,5,1,Copa Chevallier Boutell,Asunción,Paraguay,False,6,4,Paraguay
2249,2378,2521,1945,Paraguay,Argentina,1,3,Copa Chevallier Boutell,Asunción,Paraguay,False,4,-2,Argentina
2250,2379,2522,1945,Uruguay,Argentina,2,2,Copa Lipton,Montevideo,Uruguay,False,4,0,Draw
2251,2380,2523,1945,Switzerland,England,3,1,Friendly,Berne,Switzerland,False,4,2,Switzerland
2252,2381,2524,1945,Argentina,Uruguay,6,2,Copa Newton,Buenos Aires,Argentina,False,8,4,Argentina
2253,2382,2525,1945,Hungary,Austria,2,0,Friendly,Budapest,Hungary,False,2,2,Hungary
2254,2383,2526,1945,Hungary,Austria,5,2,Friendly,Budapest,Hungary,False,7,3,Hungary
2255,2384,2527,1945,Uganda,Tanzania,7,0,Friendly,Kampala,Uganda,False,7,7,Uganda
2256,2385,2528,1945,Denmark,Norway,4,2,Friendly,Copenhagen,Denmark,False,6,2,Denmark
2257,2386,2529,1945,Suriname,Guyana,3,1,Friendly,Paramaribo,Netherlands Guyana,False,4,2,Suriname
2258,2387,2530,1945,Sweden,Finland,7,2,Friendly,Gothenburg,Sweden,False,9,5,Sweden
2259,2388,2531,1945,Suriname,Guyana,4,1,Friendly,Paramaribo,Netherlands Guyana,False,5,3,Suriname
2260,2389,2532,1945,Suriname,Guyana,6,0,Friendly,Paramaribo,Netherlands Guyana,False,6,6,Suriname
2261,2390,2533,1945,Lithuania,Estonia,2,3,Friendly,Vilnius,Soviet Union,False,5,-1,Estonia
2262,2391,2534,1945,Norway,Denmark,1,5,Friendly,Oslo,Norway,False,6,-4,Denmark
2263,2392,2535,1945,Estonia,Lithuania,1,2,Friendly,Tallinn,Soviet Union,False,3,-1,Lithuania
2264,2393,2536,1945,Finland,Sweden,1,6,Friendly,Helsinki,Finland,False,7,-5,Sweden
2265,2394,2537,1945,Hungary,Romania,7,2,Friendly,Budapest,Hungary,False,9,5,Hungary
2266,2395,2538,1945,Sweden,Denmark,4,1,Friendly,Solna,Sweden,False,5,3,Sweden
2267,2396,2539,1945,Sweden,Norway,10,0,Friendly,Solna,Sweden,False,10,10,Sweden
2268,2397,2540,1945,Switzerland,Italy,4,4,Friendly,Zürich,Switzerland,False,8,0,Draw
2269,2398,2541,1945,Switzerland,Sweden,3,0,Friendly,Geneva,Switzerland,False,3,3,Switzerland
2270,2399,2542,1945,Austria,France,4,1,Friendly,Vienna,Austria,False,5,3,Austria
2271,2400,2543,1945,Aruba,Curaçao,2,1,Friendly,Oranjestad,Aruba,False,3,1,Aruba
2272,2401,2544,1945,Aruba,Curaçao,2,1,Friendly,Oranjestad,Aruba,False,3,1,Aruba
2273,2402,2545,1945,Belgium,France,2,1,Friendly,Brussels,Belgium,False,3,1,Belgium
2274,2403,2546,1945,Brazil,Argentina,3,4,Copa Roca,São Paulo,Brazil,False,7,-1,Argentina
2275,2404,2547,1945,Brazil,Argentina,6,2,Copa Roca,Rio de Janeiro,Brazil,False,8,4,Brazil
2276,2405,2548,1945,Brazil,Argentina,3,1,Copa Roca,Rio de Janeiro,Brazil,False,4,2,Brazil
2277,2406,2549,1946,Uruguay,Brazil,4,3,Copa Rio Branco,Montevideo,Uruguay,False,7,1,Uruguay
2278,2407,2550,1946,Argentina,Paraguay,2,0,Copa América,Buenos Aires,Argentina,False,2,2,Argentina
2279,2408,2551,1946,Bolivia,Brazil,0,3,Copa América,Buenos Aires,Argentina,True,3,-3,Brazil
2280,2409,2552,1946,Chile,Uruguay,0,1,Copa América,Buenos Aires,Argentina,True,1,-1,Uruguay
2281,2410,2553,1946,Argentina,Bolivia,7,1,Copa América,Buenos Aires,Argentina,False,8,6,Argentina
2282,2411,2554,1946,Chile,Paraguay,2,1,Copa América,Buenos Aires,Argentina,True,3,1,Chile
2283,2412,2555,1946,England,Belgium,2,0,Friendly,London,England,False,2,2,England
2284,2413,2556,1946,Brazil,Uruguay,4,3,Copa América,Buenos Aires,Argentina,True,7,1,Brazil
2285,2414,2557,1946,Scotland,Belgium,2,2,Friendly,Glasgow,Scotland,False,4,0,Draw
2286,2415,2558,1946,Argentina,Chile,3,1,Copa América,Buenos Aires,Argentina,False,4,2,Argentina
2287,2416,2559,1946,Bolivia,Paraguay,2,4,Copa América,Buenos Aires,Argentina,True,6,-2,Paraguay
2288,2417,2560,1946,Bolivia,Uruguay,0,5,Copa América,Avellaneda,Argentina,True,5,-5,Uruguay
2289,2418,2561,1946,Brazil,Paraguay,1,1,Copa América,Avellaneda,Argentina,True,2,0,Draw
2290,2419,2562,1946,Argentina,Uruguay,3,1,Copa América,Buenos Aires,Argentina,False,4,2,Argentina
2291,2420,2563,1946,Brazil,Chile,5,1,Copa América,Buenos Aires,Argentina,True,6,4,Brazil
2292,2421,2564,1946,Bolivia,Chile,1,4,Copa América,Buenos Aires,Argentina,True,5,-3,Chile
2293,2422,2565,1946,Paraguay,Uruguay,2,1,Copa América,Buenos Aires,Argentina,True,3,1,Paraguay
2294,2423,2566,1946,Argentina,Brazil,2,0,Copa América,Buenos Aires,Argentina,False,2,2,Argentina
2295,2424,2567,1946,Belgium,Luxembourg,7,0,Friendly,Charleroi,Belgium,False,7,7,Belgium
2296,2425,2568,1946,El Salvador,Guatemala,1,3,CCCF Championship,San José,Costa Rica,True,4,-2,Guatemala
2297,2426,2569,1946,Panama,Honduras,1,0,CCCF Championship,San José,Costa Rica,True,1,1,Panama
2298,2427,2570,1946,Costa Rica,Nicaragua,7,1,CCCF Championship,San José,Costa Rica,False,8,6,Costa Rica
2299,2428,2571,1946,Costa Rica,Panama,7,0,CCCF Championship,San José,Costa Rica,False,7,7,Costa Rica
2300,2429,2572,1946,El Salvador,Nicaragua,7,2,CCCF Championship,San José,Costa Rica,True,9,5,El Salvador
2301,2430,2573,1946,Honduras,Guatemala,5,3,CCCF Championship,San José,Costa Rica,True,8,2,Honduras
2302,2431,2574,1946,Costa Rica,Honduras,5,1,CCCF Championship,San José,Costa Rica,False,6,4,Costa Rica
2303,2432,2575,1946,El Salvador,Panama,4,1,CCCF Championship,San José,Costa Rica,True,5,3,El Salvador
2304,2433,2576,1946,Guatemala,Nicaragua,7,0,CCCF Championship,San José,Costa Rica,True,7,7,Guatemala
2305,2434,2577,1946,Costa Rica,Guatemala,1,4,CCCF Championship,San José,Costa Rica,False,5,-3,Guatemala
2306,2435,2578,1946,El Salvador,Honduras,3,1,CCCF Championship,San José,Costa Rica,True,4,2,El Salvador
2307,2436,2579,1946,Luxembourg,Netherlands,2,6,Friendly,Luxembourg,Luxembourg,False,8,-4,Netherlands
2308,2437,2580,1946,Panama,Nicaragua,0,2,CCCF Championship,San José,Costa Rica,True,2,-2,Nicaragua
2309,2438,2581,1946,Costa Rica,El Salvador,4,0,CCCF Championship,San José,Costa Rica,False,4,4,Costa Rica
2310,2439,2582,1946,Honduras,Nicaragua,10,0,CCCF Championship,San José,Costa Rica,True,10,10,Honduras
2311,2440,2583,1946,Panama,Guatemala,3,3,CCCF Championship,San José,Costa Rica,True,6,0,Draw
2312,2442,2585,1946,Austria,Hungary,3,2,Friendly,Vienna,Austria,False,5,1,Austria
2313,2443,2586,1946,Portugal,France,2,1,Friendly,Oeiras,Portugal,False,3,1,Portugal
2314,2444,2587,1946,France,Austria,3,1,Friendly,Colombes,France,False,4,2,France
2315,2445,2589,1946,England,Switzerland,4,1,Friendly,London,England,False,5,3,England
2316,2446,2590,1946,Netherlands,Belgium,6,3,Friendly,Amsterdam,Netherlands,False,9,3,Netherlands
2317,2447,2591,1946,Scotland,Switzerland,3,1,Friendly,Glasgow,Scotland,False,4,2,Scotland
2318,2448,2592,1946,France,England,2,1,Friendly,Colombes,France,False,3,1,France
2319,2449,2593,1946,Curaçao,Aruba,2,1,Friendly,Willemstad,Curaçao,False,3,1,Curaçao
2320,2450,2594,1946,Belgium,Netherlands,2,2,Friendly,Antwerp,Belgium,False,4,0,Draw
2321,2451,2595,1946,Aruba,Suriname,8,1,Friendly,Willemstad,Curaçao,True,9,7,Aruba
2322,2452,2596,1946,Curaçao,Suriname,6,0,Friendly,Willemstad,Curaçao,False,6,6,Curaçao
2323,2453,2597,1946,Norway,Denmark,2,1,Friendly,Oslo,Norway,False,3,1,Norway
2324,2454,2598,1946,Portugal,Republic of Ireland,3,1,Friendly,Oeiras,Portugal,False,4,2,Portugal
2325,2455,2599,1946,Zimbabwe,Zambia,0,4,Friendly,Salisbury,Southern Rhodesia,False,4,-4,Zambia
2326,2456,2600,1946,Denmark,Sweden,3,1,Friendly,Copenhagen,Denmark,False,4,2,Denmark
2327,2457,2601,1946,Spain,Republic of Ireland,0,1,Friendly,Madrid,Spain,False,1,-1,Republic of Ireland
2328,2458,2602,1946,Norway,Finland,12,0,Friendly,Bergen,Norway,False,12,12,Norway
2329,2459,2603,1946,Sweden,Switzerland,7,2,Friendly,Solna,Sweden,False,9,5,Sweden
2330,2460,2604,1946,Denmark,Norway,2,0,Friendly,Copenhagen,Denmark,False,2,2,Denmark
2331,2461,2605,1946,Iceland,Denmark,0,3,Friendly,Reykjavík,Iceland,False,3,-3,Denmark
2332,2462,2606,1946,Luxembourg,Norway,3,2,Friendly,Luxembourg,Luxembourg,False,5,1,Luxembourg
2333,2463,2607,1946,Albania,Montenegro,5,0,Friendly,Shkodër,Albania,False,5,5,Albania
2334,2464,2608,1946,Finland,Denmark,2,5,Friendly,Helsinki,Finland,False,7,-3,Denmark
2335,2465,2610,1946,Finland,Sweden,0,7,Friendly,Helsinki,Finland,False,7,-7,Sweden
2336,2466,2611,1946,Norway,Sweden,0,3,Friendly,Oslo,Norway,False,3,-3,Sweden
2337,2467,2612,1946,Kenya,Tanzania,3,0,Friendly,Nairobi,Kenya,False,3,3,Kenya
2338,2468,2613,1946,Kenya,Uganda,2,1,Friendly,Nairobi,Kenya,False,3,1,Kenya
2339,2469,2614,1946,Northern Ireland,England,2,7,British Championship,Belfast,Northern Ireland,False,9,-5,England
2340,2470,2615,1946,Republic of Ireland,England,0,1,Friendly,Dublin,Éire,False,1,-1,England
2341,2471,2616,1946,Hungary,Austria,2,0,Friendly,Budapest,Hungary,False,2,2,Hungary
2342,2472,2617,1946,Sweden,Denmark,3,3,Friendly,Gothenburg,Sweden,False,6,0,Draw
2343,2474,2619,1946,Bulgaria,Romania,2,2,Balkan Cup,Tirana,Albania,True,4,0,Draw
2344,2475,2620,1946,Albania,Bulgaria,3,1,Balkan Cup,Tirana,Albania,False,4,2,Albania
2345,2477,2622,1946,Albania,Romania,1,0,Balkan Cup,Tirana,Albania,False,1,1,Albania
2346,2478,2623,1946,Wales,Scotland,3,1,British Championship,Wrexham,Wales,False,4,2,Wales
2347,2479,2624,1946,Denmark,Norway,7,1,Friendly,Copenhagen,Denmark,False,8,6,Denmark
2348,2480,2625,1946,Guyana,Suriname,0,3,Friendly,Georgetown,British Guyana,False,3,-3,Suriname
2349,2481,2626,1946,Guyana,Suriname,0,1,Friendly,Georgetown,British Guyana,False,1,-1,Suriname
2350,2483,2628,1946,Guyana,Suriname,3,1,Friendly,Georgetown,British Guyana,False,4,2,Guyana
2351,2484,2629,1946,Luxembourg,Hungary,2,7,Friendly,Esch-sur-Alzette,Luxembourg,False,9,-5,Hungary
2352,2485,2630,1946,El Salvador,Panama,2,3,Friendly,San Salvador,El Salvador,False,5,-1,Panama
2353,2486,2631,1946,El Salvador,Panama,3,3,Friendly,San Salvador,El Salvador,False,6,0,Draw
2354,2487,2632,1946,Switzerland,Austria,1,0,Friendly,Berne,Switzerland,False,1,1,Switzerland
2355,2488,2633,1946,England,Wales,3,0,British Championship,Manchester,England,False,3,3,England
2356,2489,2634,1946,Aruba,Curaçao,0,4,Friendly,Oranjestad,Aruba,False,4,-4,Curaçao
2357,2490,2635,1946,Aruba,Curaçao,3,1,Friendly,Oranjestad,Aruba,False,4,2,Aruba
2358,2491,2636,1946,England,Netherlands,8,2,Friendly,Huddersfield,England,False,10,6,England
2359,2492,2637,1946,Scotland,Northern Ireland,0,0,British Championship,Glasgow,Scotland,False,0,0,Draw
2360,2493,2638,1946,Italy,Austria,3,2,Friendly,Milan,Italy,False,5,1,Italy
2361,2494,2639,1947,Portugal,Switzerland,2,2,Friendly,Lisbon,Portugal,False,4,0,Draw
2362,2495,2640,1947,Portugal,Spain,4,1,Friendly,Oeiras,Portugal,False,5,3,Portugal
2363,2496,2641,1947,Jamaica,Trinidad and Tobago,0,0,Friendly,Kingston,Jamaica,False,0,0,Draw
2364,2497,2642,1947,Jamaica,Trinidad and Tobago,2,1,Friendly,Kingston,Jamaica,False,3,1,Jamaica
2365,2498,2643,1947,Madagascar,Mauritius,1,2,Friendly,Antananarivo,Madagascar,False,3,-1,Mauritius
2366,2499,2644,1947,Jamaica,Trinidad and Tobago,1,0,Friendly,Kingston,Jamaica,False,1,1,Jamaica
2367,2500,2645,1947,Jamaica,Trinidad and Tobago,1,2,Friendly,Kingston,Jamaica,False,3,-1,Trinidad and Tobago
2368,2501,2646,1947,Zambia,Zimbabwe,2,2,Friendly,Kitwe,Northern Rhodesia,False,4,0,Draw
2369,2502,2647,1947,Jamaica,Trinidad and Tobago,0,6,Friendly,Kingston,Jamaica,False,6,-6,Trinidad and Tobago
2370,2503,2648,1947,Curaçao,Trinidad and Tobago,4,0,Friendly,Willemstad,Curaçao,False,4,4,Curaçao
2371,2504,2649,1947,Curaçao,Trinidad and Tobago,3,0,Friendly,Willemstad,Curaçao,False,3,3,Curaçao
2372,2505,2650,1947,Republic of Ireland,Spain,3,2,Friendly,Dublin,Éire,False,5,1,Republic of Ireland
2373,2506,2651,1947,Suriname,French Guiana,9,1,Friendly,Paramaribo,Netherlands Guyana,False,10,8,Suriname
2374,2507,2652,1947,France,Portugal,1,0,Friendly,Colombes,France,False,1,1,France
2375,2508,2653,1947,Uruguay,Brazil,0,0,Copa Rio Branco,Montevideo,Uruguay,False,0,0,Draw
2376,2509,2654,1947,Brazil,Uruguay,3,2,Copa Rio Branco,Rio de Janeiro,Brazil,False,5,1,Brazil
2377,2510,2655,1947,Netherlands,Belgium,2,1,Friendly,Amsterdam,Netherlands,False,3,1,Netherlands
2378,2511,2656,1947,England,Scotland,1,1,British Championship,London,England,False,2,0,Draw
2379,2512,2657,1947,Northern Ireland,Wales,2,1,British Championship,Belfast,Northern Ireland,False,3,1,Northern Ireland
2380,2513,2658,1947,Italy,Switzerland,5,2,Friendly,Florence,Italy,False,7,3,Italy
2381,2514,2659,1947,England,France,3,0,Friendly,London,England,False,3,3,England
2382,2515,2660,1947,Belgium,Netherlands,1,2,Friendly,Antwerp,Belgium,False,3,-1,Netherlands
2383,2516,2661,1947,Hungary,Austria,5,2,Friendly,Budapest,Hungary,False,7,3,Hungary
2384,2517,2662,1947,Republic of Ireland,Portugal,0,2,Friendly,Dublin,Éire,False,2,-2,Portugal
2385,2518,2663,1947,Australia,South Africa,1,2,Friendly,Sydney,Australia,False,3,-1,South Africa
2386,2519,2665,1947,Italy,Hungary,3,2,Friendly,Turin,Italy,False,5,1,Italy
2387,2520,2666,1947,Mauritius,Réunion,2,1,Friendly,Antananarivo,Madagascar,True,3,1,Mauritius
2388,2521,2667,1947,Belgium,Scotland,2,1,Friendly,Brussels,Belgium,False,3,1,Belgium
2389,2522,2668,1947,Switzerland,England,1,0,Friendly,Zürich,Switzerland,False,1,1,Switzerland
2390,2523,2669,1947,Australia,South Africa,2,4,Friendly,Brisbane,Australia,False,6,-2,South Africa
2391,2524,2670,1947,Luxembourg,Scotland,0,6,Friendly,Luxembourg,Luxembourg,False,6,-6,Scotland
2392,2525,2671,1947,Albania,Romania,0,4,Balkan Cup,Tirana,Albania,False,4,-4,Romania
2393,2526,2672,1947,Portugal,England,0,10,Friendly,Oeiras,Portugal,False,10,-10,England
2394,2527,2673,1947,France,Netherlands,4,0,Friendly,Colombes,France,False,4,4,France
2395,2528,2674,1947,Australia,South Africa,3,3,Friendly,Sydney,Australia,False,6,0,Draw
2396,2529,2675,1947,France,Belgium,4,2,Friendly,Colombes,France,False,6,2,France
2397,2530,2676,1947,Madagascar,Réunion,4,2,Friendly,Antananarivo,Madagascar,False,6,2,Madagascar
2398,2531,2677,1947,Australia,South Africa,5,1,Friendly,Newcastle,Australia,False,6,4,Australia
2399,2532,2678,1947,Switzerland,France,1,2,Friendly,Lausanne,Switzerland,False,3,-1,France
2400,2533,2679,1947,Norway,Poland,3,1,Friendly,Oslo,Norway,False,4,2,Norway
2401,2534,2680,1947,Australia,South Africa,1,2,Friendly,Sydney,Australia,False,3,-1,South Africa
2402,2535,2681,1947,Bulgaria,Albania,2,0,Balkan Cup,Sofia,Bulgaria,False,2,2,Bulgaria
2403,2536,2682,1947,Denmark,Sweden,1,4,Nordic Championship,Copenhagen,Denmark,False,5,-3,Sweden
2404,2538,2684,1947,Curaçao,Aruba,4,1,Friendly,Willemstad,Curaçao,False,5,3,Curaçao
2405,2539,2685,1947,Curaçao,Aruba,0,0,Friendly,Willemstad,Curaçao,False,0,0,Draw
2406,2541,2687,1947,Finland,Norway,1,2,Friendly,Helsinki,Finland,False,3,-1,Norway
2407,2542,2688,1947,Sweden,Denmark,6,1,Friendly,Solna,Sweden,False,7,5,Sweden
2408,2543,2689,1947,New Zealand,South Africa,5,6,Friendly,Christchurch,New Zealand,False,11,-1,South Africa
2409,2544,2690,1947,Norway,Sweden,1,5,Friendly,Helsinki,Finland,True,6,-4,Sweden
2410,2545,2692,1947,New Zealand,South Africa,0,6,Friendly,Dunedin,New Zealand,False,6,-6,South Africa
2411,2546,2693,1947,Bulgaria,Romania,2,3,Balkan Cup,Sofia,Bulgaria,False,5,-1,Romania
2412,2547,2694,1947,New Zealand,South Africa,3,8,Friendly,Wellington,New Zealand,False,11,-5,South Africa
2413,2548,2695,1947,Mexico,United States,5,0,NAFU Championship,Havana,Cuba,True,5,5,Mexico
2414,2549,2696,1947,Cuba,Mexico,1,3,NAFU Championship,Havana,Cuba,False,4,-2,Mexico
2415,2550,2697,1947,New Zealand,South Africa,1,4,Friendly,Auckland,New Zealand,False,5,-3,South Africa
2416,2551,2698,1947,Poland,Romania,1,2,Friendly,Warsaw,Poland,False,3,-1,Romania
2417,2552,2699,1947,Cuba,United States,5,2,NAFU Championship,Havana,Cuba,False,7,3,Cuba
2418,2553,2700,1947,Iceland,Norway,2,4,Friendly,Reykjavík,Iceland,False,6,-2,Norway
2419,2554,2701,1947,Hungary,Bulgaria,9,0,Balkan Cup,Budapest,Hungary,False,9,9,Hungary
2420,2555,2702,1947,Hungary,Albania,3,0,Balkan Cup,Budapest,Hungary,False,3,3,Hungary
2421,2556,2703,1947,Sweden,Finland,7,0,Nordic Championship,Borås,Sweden,False,7,7,Sweden
2422,2557,2705,1947,Suriname,Guyana,4,0,Friendly,Paramaribo,Netherlands Guyana,False,4,4,Suriname
2423,2558,2706,1947,Suriname,Guyana,0,0,Friendly,Paramaribo,Netherlands Guyana,False,0,0,Draw
2424,2559,2707,1947,Finland,Norway,3,3,Nordic Championship,Helsinki,Finland,False,6,0,Draw
2425,2560,2708,1947,Suriname,Guyana,1,0,Friendly,Paramaribo,Netherlands Guyana,False,1,1,Suriname
2426,2562,2710,1947,Austria,Hungary,4,3,Friendly,Vienna,Austria,False,7,1,Austria
2427,2563,2711,1947,Sweden,Poland,5,4,Friendly,Solna,Sweden,False,9,1,Sweden
2428,2564,2712,1947,Finland,Poland,1,4,Friendly,Helsinki,Finland,False,5,-3,Poland
2429,2565,2713,1947,Kenya,Uganda,2,3,Friendly,Dar es Salaam,Tanganyika,True,5,-1,Uganda
2430,2567,2715,1947,Tanzania,Uganda,2,4,Friendly,Dar es Salaam,Tanganyika,False,6,-2,Uganda
2431,2568,2716,1947,Belgium,England,2,5,Friendly,Brussels,Belgium,False,7,-3,England
2432,2569,2717,1947,Netherlands,Switzerland,6,2,Friendly,Amsterdam,Netherlands,False,8,4,Netherlands
2433,2570,2718,1947,Norway,Denmark,3,5,Nordic Championship,Oslo,Norway,False,8,-2,Denmark
2434,2572,2720,1947,Latvia,Lithuania,3,2,Friendly,Riga,Soviet Union,False,5,1,Latvia
2435,2573,2721,1947,Northern Ireland,Scotland,2,0,British Championship,Belfast,Northern Ireland,False,2,2,Northern Ireland
2436,2574,2723,1947,Denmark,Finland,4,1,Nordic Championship,Århus,Denmark,False,5,3,Denmark
2437,2575,2724,1947,Lithuania,Latvia,0,3,Friendly,Vilnius,Soviet Union,False,3,-3,Latvia
2438,2576,2725,1947,Sweden,Norway,4,1,Nordic Championship,Solna,Sweden,False,5,3,Sweden
2439,2577,2726,1947,Lithuania,Estonia,0,0,Friendly,Vilnius,Soviet Union,False,0,0,Draw
2440,2578,2727,1947,Romania,Hungary,0,3,Balkan Cup,Bucharest,Romania,False,3,-3,Hungary
2441,2579,2729,1947,Wales,England,0,3,British Championship,Cardiff,Wales,False,3,-3,England
2442,2580,2732,1947,Iran,Turkey,1,3,Friendly,Teheran,Iran,False,4,-2,Turkey
2443,2581,2733,1947,Romania,Poland,0,0,Friendly,Bucharest,Romania,False,0,0,Draw
2444,2582,2734,1947,Switzerland,Belgium,4,0,Friendly,Geneva,Switzerland,False,4,4,Switzerland
2445,2583,2735,1947,England,Northern Ireland,2,2,British Championship,Liverpool,England,False,4,0,Draw
2446,2584,2736,1947,Trinidad and Tobago,Guyana,1,2,Friendly,Port of Spain,Trinidad and Tobago,False,3,-1,Guyana
2447,2585,2737,1947,Guyana,Jamaica,2,0,Friendly,Port of Spain,Trinidad and Tobago,True,2,2,Guyana
2448,2586,2738,1947,Trinidad and Tobago,Jamaica,6,0,Friendly,Port of Spain,Trinidad and Tobago,False,6,6,Trinidad and Tobago
2449,2587,2739,1947,Austria,Italy,5,1,Friendly,Vienna,Austria,False,6,4,Austria
2450,2588,2740,1947,Guyana,Jamaica,0,0,Friendly,Port of Spain,Trinidad and Tobago,True,0,0,Draw
2451,2589,2741,1947,Scotland,Wales,1,2,British Championship,Glasgow,Scotland,False,3,-1,Wales
2452,2590,2742,1947,Trinidad and Tobago,Jamaica,1,0,Friendly,San Fernando,Trinidad and Tobago,False,1,1,Trinidad and Tobago
2453,2591,2743,1947,Trinidad and Tobago,Guyana,2,0,Friendly,Port of Spain,Trinidad and Tobago,False,2,2,Trinidad and Tobago
2454,2592,2744,1947,England,Sweden,4,2,Friendly,London,England,False,6,2,England
2455,2593,2745,1947,Portugal,France,2,4,Friendly,Oeiras,Portugal,False,6,-2,France
2456,2594,2746,1947,Ecuador,Bolivia,2,2,Copa América,Guayaquil,Ecuador,False,4,0,Draw
2457,2595,2747,1947,Argentina,Paraguay,6,0,Copa América,Guayaquil,Ecuador,True,6,6,Argentina
2458,2596,2748,1947,Colombia,Uruguay,0,2,Copa América,Guayaquil,Ecuador,True,2,-2,Uruguay
2459,2597,2749,1947,Argentina,Bolivia,7,0,Copa América,Guayaquil,Ecuador,True,7,7,Argentina
2460,2598,2750,1947,Ecuador,Colombia,0,0,Copa América,Guayaquil,Ecuador,False,0,0,Draw
2461,2599,2751,1947,Djibouti,Ethiopia,0,5,Friendly,Djibouti,French Somaliland,False,5,-5,Ethiopia
2462,2600,2752,1947,Chile,Uruguay,0,6,Copa América,Guayaquil,Ecuador,True,6,-6,Uruguay
2463,2601,2753,1947,Cuba,Puerto Rico,4,0,Friendly,Havana,Cuba,False,4,4,Cuba
2464,2602,2754,1947,Paraguay,Peru,2,2,Copa América,Guayaquil,Ecuador,True,4,0,Draw
2465,2603,2755,1947,Bolivia,Uruguay,0,3,Copa América,Guayaquil,Ecuador,True,3,-3,Uruguay
2466,2604,2756,1947,Chile,Peru,2,1,Copa América,Guayaquil,Ecuador,True,3,1,Chile
2467,2605,2757,1947,Cuba,Puerto Rico,0,0,Friendly,Havana,Cuba,False,0,0,Draw
2468,2606,2758,1947,Argentina,Peru,3,2,Copa América,Guayaquil,Ecuador,True,5,1,Argentina
2469,2607,2759,1947,Ecuador,Chile,0,3,Copa América,Guayaquil,Ecuador,False,3,-3,Chile
2470,2608,2760,1947,Bolivia,Colombia,0,0,Copa América,Guayaquil,Ecuador,True,0,0,Draw
2471,2609,2761,1947,Paraguay,Uruguay,4,2,Copa América,Guayaquil,Ecuador,True,6,2,Paraguay
2472,2611,2763,1947,Argentina,Chile,1,1,Copa América,Guayaquil,Ecuador,True,2,0,Draw
2473,2612,2764,1947,Ecuador,Uruguay,1,6,Copa América,Guayaquil,Ecuador,False,7,-5,Uruguay
2474,2613,2765,1947,Argentina,Colombia,6,0,Copa América,Guayaquil,Ecuador,True,6,6,Argentina
2475,2614,2766,1947,Bolivia,Paraguay,1,3,Copa América,Guayaquil,Ecuador,True,4,-2,Paraguay
2476,2615,2767,1947,Colombia,Paraguay,0,2,Copa América,Guayaquil,Ecuador,True,2,-2,Paraguay
2477,2616,2768,1947,Ecuador,Peru,0,0,Copa América,Guayaquil,Ecuador,False,0,0,Draw
2478,2617,2769,1947,Chile,Paraguay,0,1,Copa América,Guayaquil,Ecuador,True,1,-1,Paraguay
2479,2618,2770,1947,Colombia,Peru,1,5,Copa América,Guayaquil,Ecuador,True,6,-4,Peru
2480,2619,2771,1947,Ecuador,Argentina,0,2,Copa América,Guayaquil,Ecuador,False,2,-2,Argentina
2481,2620,2772,1947,Peru,Uruguay,0,1,Copa América,Guayaquil,Ecuador,True,1,-1,Uruguay
2482,2621,2773,1947,Bolivia,Peru,0,2,Copa América,Guayaquil,Ecuador,True,2,-2,Peru
2483,2622,2774,1947,Argentina,Uruguay,3,1,Copa América,Guayaquil,Ecuador,True,4,2,Argentina
2484,2623,2775,1947,Chile,Colombia,4,1,Copa América,Guayaquil,Ecuador,True,5,3,Chile
2485,2624,2776,1947,Ecuador,Paraguay,0,4,Copa América,Guayaquil,Ecuador,False,4,-4,Paraguay
2486,2625,2777,1947,Bolivia,Chile,3,4,Copa América,Guayaquil,Ecuador,True,7,-1,Chile
2487,2626,2778,1948,Costa Rica,El Salvador,3,1,CCCF Championship,Guatemala,Guatemala,True,4,2,Costa Rica
2488,2627,2779,1948,Guatemala,El Salvador,3,0,CCCF Championship,Guatemala,Guatemala,False,3,3,Guatemala
2489,2628,2780,1948,Guatemala,Costa Rica,1,1,CCCF Championship,Guatemala,Guatemala,False,2,0,Draw
2490,2629,2781,1948,Panama,Curaçao,1,3,CCCF Championship,Guatemala,Guatemala,True,4,-2,Curaçao
2491,2630,2782,1948,Guatemala,Curaçao,2,2,CCCF Championship,Guatemala,Guatemala,False,4,0,Draw
2492,2631,2783,1948,Costa Rica,Curaçao,2,1,CCCF Championship,Guatemala,Guatemala,True,3,1,Costa Rica
2493,2632,2784,1948,El Salvador,Panama,1,2,CCCF Championship,Guatemala,Guatemala,True,3,-1,Panama
2494,2633,2785,1948,El Salvador,Curaçao,1,0,CCCF Championship,Guatemala,Guatemala,True,1,1,El Salvador
2495,2634,2786,1948,Guatemala,Panama,4,3,CCCF Championship,Guatemala,Guatemala,False,7,1,Guatemala
2496,2635,2787,1948,Wales,Northern Ireland,2,0,British Championship,Wrexham,Wales,False,2,2,Wales
2497,2636,2788,1948,Costa Rica,Panama,3,1,CCCF Championship,Guatemala,Guatemala,True,4,2,Costa Rica
2498,2637,2789,1948,Curaçao,El Salvador,0,2,CCCF Championship,Guatemala,Guatemala,True,2,-2,El Salvador
2499,2638,2790,1948,Suriname,Trinidad and Tobago,0,2,Friendly,Paramaribo,Netherlands Guyana,False,2,-2,Trinidad and Tobago
2500,2639,2791,1948,Guatemala,El Salvador,1,1,CCCF Championship,Guatemala,Guatemala,False,2,0,Draw
2501,2640,2792,1948,Belgium,Netherlands,1,1,Friendly,Antwerp,Belgium,False,2,0,Draw
2502,2641,2793,1948,Curaçao,Panama,2,5,CCCF Championship,Guatemala,Guatemala,True,7,-3,Panama
2503,2642,2794,1948,Suriname,Trinidad and Tobago,0,0,Friendly,Paramaribo,Netherlands Guyana,False,0,0,Draw
2504,2643,2795,1948,Guatemala,Costa Rica,3,2,CCCF Championship,Guatemala,Guatemala,False,5,1,Guatemala
2505,2644,2796,1948,Panama,El Salvador,2,0,CCCF Championship,Guatemala,Guatemala,True,2,2,Panama
2506,2645,2797,1948,Suriname,Trinidad and Tobago,1,0,Friendly,Paramaribo,Netherlands Guyana,False,1,1,Suriname
2507,2646,2798,1948,El Salvador,Costa Rica,0,6,CCCF Championship,Guatemala,Guatemala,True,6,-6,Costa Rica
2508,2647,2799,1948,Guatemala,Curaçao,2,2,CCCF Championship,Guatemala,Guatemala,False,4,0,Draw
2509,2648,2800,1948,Curaçao,Costa Rica,4,1,CCCF Championship,Guatemala,Guatemala,True,5,3,Curaçao
2510,2649,2801,1948,Guatemala,Panama,4,5,CCCF Championship,Guatemala,Guatemala,False,9,-1,Panama
2511,2650,2802,1948,Spain,Portugal,2,0,Friendly,Madrid,Spain,False,2,2,Spain
2512,2651,2803,1948,Bulgaria,Poland,1,1,Balkan Cup,Sofia,Bulgaria,False,2,0,Draw
2513,2652,2804,1948,France,Italy,1,3,Friendly,Colombes,France,False,4,-2,Italy
2514,2653,2805,1948,Uruguay,Brazil,1,1,Copa Rio Branco,Montevideo,Uruguay,False,2,0,Draw
2515,2654,2806,1948,Scotland,England,0,2,British Championship,Glasgow,Scotland,False,2,-2,England
2516,2655,2807,1948,Uruguay,Brazil,4,2,Copa Rio Branco,Montevideo,Uruguay,False,6,2,Uruguay
2517,2656,2808,1948,Austria,Switzerland,3,1,Friendly,Vienna,Austria,False,4,2,Austria
2518,2657,2809,1948,Netherlands,Belgium,2,2,Friendly,Rotterdam,Netherlands,False,4,0,Draw
2519,2659,2812,1948,Hungary,Switzerland,7,4,International Cup,Budapest,Hungary,False,11,3,Hungary
2520,2660,2813,1948,Greece,Turkey,1,3,Friendly,Athens,Greece,False,4,-2,Turkey
2521,2661,2814,1948,Scotland,Belgium,2,0,Friendly,Glasgow,Scotland,False,2,2,Scotland
2522,2662,2815,1948,Austria,Hungary,3,2,International Cup,Vienna,Austria,False,5,1,Austria
2523,2663,2816,1948,Romania,Albania,0,1,Balkan Cup,Bucharest,Romania,False,1,-1,Albania
2524,2664,2817,1948,Italy,England,0,4,Friendly,Turin,Italy,False,4,-4,England
2525,2665,2818,1948,Switzerland,Scotland,2,1,Friendly,Berne,Switzerland,False,3,1,Switzerland
2526,2666,2819,1948,Albania,Hungary,0,0,Balkan Cup,Tirana,Albania,False,0,0,Draw
2527,2667,2820,1948,France,Scotland,3,0,Friendly,Colombes,France,False,3,3,France
2528,2669,2822,1948,Portugal,Republic of Ireland,2,0,Friendly,Oeiras,Portugal,False,2,2,Portugal
2529,2670,2823,1948,DR Congo,Zambia,2,3,Friendly,Brazzaville,Belgian Congo,False,5,-1,Zambia
2530,2671,2824,1948,Norway,Netherlands,1,2,Friendly,Oslo,Norway,False,3,-1,Netherlands
2531,2672,2825,1948,Spain,Republic of Ireland,2,1,Friendly,Barcelona,Spain,False,3,1,Spain
2532,2673,2826,1948,Turkey,Austria,0,1,Friendly,Istanbul,Turkey,False,1,-1,Austria
2533,2674,2827,1948,Djibouti,Ethiopia,1,2,Friendly,Djibouti,French Somaliland,False,3,-1,Ethiopia
2534,2675,2828,1948,Belgium,France,4,2,Friendly,Brussels,Belgium,False,6,2,Belgium
2535,2676,2829,1948,Hungary,Romania,9,0,Balkan Cup,Budapest,Hungary,False,9,9,Hungary
2536,2677,2830,1948,Jamaica,Cuba,3,0,Friendly,Kingston,Jamaica,False,3,3,Jamaica
2537,2678,2831,1948,Netherlands,Sweden,1,0,Friendly,Amsterdam,Netherlands,False,1,1,Netherlands
2538,2679,2833,1948,Denmark,Norway,1,2,Nordic Championship,Copenhagen,Denmark,False,3,-1,Norway
2539,2680,2834,1948,Jamaica,Cuba,1,1,Friendly,Kingston,Jamaica,False,2,0,Draw
2540,2681,2835,1948,Finland,Denmark,0,3,Nordic Championship,Helsinki,Finland,False,3,-3,Denmark
2541,2682,2836,1948,Romania,Bulgaria,3,2,Balkan Cup,Bucharest,Romania,False,5,1,Romania
2542,2683,2837,1948,Switzerland,Spain,3,3,Friendly,Zürich,Switzerland,False,6,0,Draw
2543,2684,2838,1948,Denmark,Poland,8,0,Friendly,Copenhagen,Denmark,False,8,8,Denmark
2544,2685,2840,1948,Iceland,Finland,2,0,Friendly,Reykjavík,Iceland,False,2,2,Iceland
2545,2688,2843,1948,Sweden,Austria,3,2,Friendly,Solna,Sweden,False,5,1,Sweden
2546,2689,2844,1948,Madagascar,Réunion,2,1,Friendly,Curepipe,Mauritius,True,3,1,Madagascar
2547,2690,2845,1948,Mauritius,Madagascar,4,1,Friendly,Curepipe,Mauritius,False,5,3,Mauritius
2548,2691,2846,1948,Mauritius,Réunion,5,1,Friendly,Curepipe,Mauritius,False,6,4,Mauritius
2549,2692,2847,1948,Norway,United States,11,0,Friendly,Oslo,Norway,False,11,11,Norway
2550,2693,2848,1948,Northern Ireland,United States,5,0,Friendly,Belfast,Northern Ireland,False,5,5,Northern Ireland
2551,2694,2849,1948,New Zealand,Australia,0,6,Friendly,Wellington,New Zealand,False,6,-6,Australia
2552,2696,2851,1948,Zimbabwe,Zambia,4,0,Friendly,Salisbury,Southern Rhodesia,False,4,4,Zimbabwe
2553,2697,2852,1948,New Zealand,Australia,0,7,Friendly,Christchurch,New Zealand,False,7,-7,Australia
2554,2699,2854,1948,Martinique,Dominica,5,0,Friendly,Fort-de-France,Martinique,False,5,5,Martinique
2555,2700,2855,1948,New Zealand,Australia,0,4,Friendly,Wellington,New Zealand,False,4,-4,Australia
2556,2701,2856,1948,Norway,Finland,2,0,Nordic Championship,Oslo,Norway,False,2,2,Norway
2557,2702,2857,1948,New Zealand,Australia,1,8,Friendly,Auckland,New Zealand,False,9,-7,Australia
2558,2703,2858,1948,Finland,Sweden,2,2,Nordic Championship,Helsinki,Finland,False,4,0,Draw
2559,2704,2859,1948,Norway,Sweden,3,5,Nordic Championship,Oslo,Norway,False,8,-2,Sweden
2560,2705,2860,1948,Poland,Hungary,2,6,Balkan Cup,Warsaw,Poland,False,8,-4,Hungary
2561,2707,2862,1948,Uganda,Tanzania,6,0,Friendly,Kampala,Uganda,False,6,6,Uganda
2562,2708,2863,1948,Uganda,Kenya,2,1,Friendly,Kampala,Uganda,False,3,1,Uganda
2563,2709,2864,1948,Denmark,England,0,0,Friendly,Copenhagen,Denmark,False,0,0,Draw
2564,2710,2865,1948,French Guiana,Suriname,2,4,Friendly,Cayenne,French Guiana,False,6,-2,Suriname
2565,2711,2866,1948,Latvia,Lithuania,0,1,Baltic Cup,Riga,Soviet Union,True,1,-1,Lithuania
2566,2712,2867,1948,United States,Israel,3,1,Friendly,East Rutherford,United States,False,4,2,United States
2567,2713,2868,1948,Estonia,Lithuania,1,2,Baltic Cup,Riga,Soviet Union,True,3,-1,Lithuania
2568,2714,2869,1948,Suriname,Guyana,3,0,Friendly,Cayenne,French Guiana,True,3,3,Suriname
2569,2715,2870,1948,Hungary,Austria,2,1,Friendly,Budapest,Hungary,False,3,1,Hungary
2570,2716,2871,1948,Northern Ireland,England,2,6,British Championship,Belfast,Northern Ireland,False,8,-4,England
2571,2717,2872,1948,French Guiana,Guyana,3,2,Friendly,Cayenne,French Guiana,False,5,1,French Guiana
2572,2718,2873,1948,Poland,Romania,0,0,Balkan Cup,Chorzów,Poland,False,0,0,Draw
2573,2719,2874,1948,Sweden,Denmark,1,0,Nordic Championship,Solna,Sweden,False,1,1,Sweden
2574,2721,2876,1948,Jamaica,Haiti,1,0,Friendly,Kingston,Jamaica,False,1,1,Jamaica
2575,2722,2877,1948,Jamaica,Haiti,1,2,Friendly,Kingston,Jamaica,False,3,-1,Haiti
2576,2723,2878,1948,Jamaica,Haiti,3,0,Friendly,Kingston,Jamaica,False,3,3,Jamaica
2577,2724,2879,1948,France,Belgium,3,3,Friendly,Colombes,France,False,6,0,Draw
2578,2725,2880,1948,Poland,Finland,1,0,Friendly,Warsaw,Poland,False,1,1,Poland
2579,2726,2881,1948,Trinidad and Tobago,Haiti,0,0,Friendly,Port of Spain,Trinidad and Tobago,False,0,0,Draw
2580,2727,2882,1948,Wales,Scotland,1,3,British Championship,Cardiff,Wales,False,4,-2,Scotland
2581,2728,2883,1948,Romania,Hungary,1,5,Balkan Cup,Bucharest,Romania,False,6,-4,Hungary
2582,2729,2884,1948,Trinidad and Tobago,Haiti,4,0,Friendly,Port of Spain,Trinidad and Tobago,False,4,4,Trinidad and Tobago
2583,2730,2885,1948,Iran,Turkey,1,1,Friendly,Teheran,Iran,False,2,0,Draw
2584,2731,2886,1948,Trinidad and Tobago,Haiti,4,0,Friendly,Port of Spain,Trinidad and Tobago,False,4,4,Trinidad and Tobago
2585,2732,2888,1948,Bulgaria,Hungary,1,0,Balkan Cup,Sofia,Bulgaria,False,1,1,Bulgaria
2586,2733,2889,1948,England,Wales,1,0,British Championship,Birmingham,England,False,1,1,England
2587,2734,2890,1948,Austria,Sweden,2,1,Friendly,Vienna,Austria,False,3,1,Austria
2588,2735,2891,1948,Scotland,Northern Ireland,3,2,British Championship,Glasgow,Scotland,False,5,1,Scotland
2589,2736,2892,1948,Belgium,Netherlands,1,1,Friendly,Antwerp,Belgium,False,2,0,Draw
2590,2737,2893,1948,Turkey,Greece,2,1,Friendly,Istanbul,Turkey,False,3,1,Turkey
2591,2738,2894,1948,England,Switzerland,6,0,Friendly,London,England,False,6,6,England
2592,2739,2895,1948,Republic of Ireland,Switzerland,0,1,Friendly,Dublin,Éire,False,1,-1,Switzerland
2593,2740,2896,1948,Dominica,Martinique,0,6,Friendly,Basse-Terre,Guadeloupe,True,6,-6,Martinique
2594,2741,2897,1948,Guadeloupe,Haiti,1,0,Friendly,Pointe-à-Pitre,Guadeloupe,False,1,1,Guadeloupe
2595,2742,2898,1948,Guadeloupe,French Guiana,7,2,Friendly,Pointe-à-Pitre,Guadeloupe,False,9,5,Guadeloupe
2596,2743,2899,1948,Martinique,Suriname,4,3,Friendly,Basse-Terre,Guadeloupe,True,7,1,Martinique
2597,2744,2900,1948,Guadeloupe,Martinique,3,0,Friendly,Pointe-à-Pitre,Guadeloupe,False,3,3,Guadeloupe
2598,2745,2901,1948,Egypt,Norway,1,1,Friendly,Cairo,Egypt,False,2,0,Draw
2599,2746,2903,1949,Spain,Belgium,1,1,Friendly,Barcelona,Spain,False,2,0,Draw
2600,2749,2906,1949,Italy,Portugal,4,1,Friendly,Genoa,Italy,False,5,3,Italy
2601,2750,2907,1949,Northern Ireland,Wales,0,2,British Championship,Belfast,Northern Ireland,False,2,-2,Wales
2602,2751,2908,1949,Netherlands,Belgium,3,3,Friendly,Amsterdam,Netherlands,False,6,0,Draw
2603,2752,2909,1949,Austria,Turkey,1,0,Friendly,Vienna,Austria,False,1,1,Austria
2604,2753,2910,1949,Portugal,Spain,1,1,Friendly,Oeiras,Portugal,False,2,0,Draw
2605,2754,2912,1949,Spain,Italy,1,3,Friendly,Madrid,Spain,False,4,-2,Italy
2606,2755,2913,1949,Brazil,Ecuador,9,1,Copa América,Rio de Janeiro,Brazil,False,10,8,Brazil
2607,2756,2914,1949,Switzerland,Austria,1,2,International Cup,Lausanne,Switzerland,False,3,-1,Austria
2608,2757,2915,1949,Bolivia,Chile,3,2,Copa América,São Paulo,Brazil,True,5,1,Bolivia
2609,2758,2916,1949,Colombia,Paraguay,0,3,Copa América,São Paulo,Brazil,True,3,-3,Paraguay
2610,2759,2917,1949,England,Scotland,1,3,British Championship,London,England,False,4,-2,Scotland
2611,2760,2918,1949,Brazil,Bolivia,10,1,Copa América,São Paulo,Brazil,False,11,9,Brazil
2612,2761,2919,1949,Colombia,Peru,0,4,Copa América,Rio de Janeiro,Brazil,True,4,-4,Peru
2613,2762,2921,1949,Ecuador,Paraguay,0,1,Copa América,Rio de Janeiro,Brazil,True,1,-1,Paraguay
2614,2763,2922,1949,Brazil,Chile,2,1,Copa América,São Paulo,Brazil,False,3,1,Brazil
2615,2764,2923,1949,Ecuador,Uruguay,2,3,Copa América,Rio de Janeiro,Brazil,True,5,-1,Uruguay
2616,2765,2924,1949,Paraguay,Peru,3,1,Copa América,Rio de Janeiro,Brazil,True,4,2,Paraguay
2617,2766,2925,1949,Bolivia,Uruguay,3,2,Copa América,Rio de Janeiro,Brazil,True,5,1,Bolivia
2618,2767,2926,1949,Brazil,Colombia,5,0,Copa América,São Paulo,Brazil,False,5,5,Brazil
2619,2768,2927,1949,Chile,Ecuador,1,0,Copa América,São Paulo,Brazil,True,1,1,Chile
2620,2769,2928,1949,Chile,Colombia,1,1,Copa América,Rio de Janeiro,Brazil,True,2,0,Draw
2621,2770,2929,1949,Ecuador,Peru,0,4,Copa América,Rio de Janeiro,Brazil,True,4,-4,Peru
2622,2771,2930,1949,Haiti,Trinidad and Tobago,2,2,Friendly,Port-au-Prince,Haiti,False,4,0,Draw
2623,2772,2931,1949,Paraguay,Uruguay,1,2,Copa América,São Paulo,Brazil,True,3,-1,Uruguay
2624,2773,2932,1949,Haiti,Trinidad and Tobago,2,3,Friendly,Port-au-Prince,Haiti,False,5,-1,Trinidad and Tobago
2625,2774,2933,1949,Netherlands,France,4,1,Friendly,Rotterdam,Netherlands,False,5,3,Netherlands
2626,2775,2934,1949,Brazil,Peru,7,1,Copa América,Rio de Janeiro,Brazil,False,8,6,Brazil
2627,2776,2935,1949,Republic of Ireland,Belgium,0,2,Friendly,Dublin,Republic of Ireland,False,2,-2,Belgium
2628,2777,2936,1949,Bolivia,Ecuador,2,0,Copa América,São Paulo,Brazil,True,2,2,Bolivia
2629,2778,2937,1949,Haiti,Trinidad and Tobago,5,0,Friendly,Port-au-Prince,Haiti,False,5,5,Haiti
2630,2779,2938,1949,Uruguay,Colombia,2,2,Copa América,São Paulo,Brazil,True,4,0,Draw
2631,2780,2939,1949,Bolivia,Peru,0,3,Copa América,Santos,Brazil,True,3,-3,Peru
2632,2781,2940,1949,Chile,Paraguay,2,4,Copa América,São Paulo,Brazil,True,6,-2,Paraguay
2633,2782,2941,1949,Scotland,France,2,0,Friendly,Glasgow,Scotland,False,2,2,Scotland
2634,2783,2942,1949,Bolivia,Paraguay,0,7,Copa América,Rio de Janeiro,Brazil,True,7,-7,Paraguay
2635,2784,2943,1949,Brazil,Uruguay,5,1,Copa América,Rio de Janeiro,Brazil,False,6,4,Brazil
2636,2785,2944,1949,Chile,Peru,0,3,Copa América,São Paulo,Brazil,True,3,-3,Peru
2637,2786,2945,1949,Ethiopia,Djibouti,6,0,Friendly,Addis Abeba,Ethiopia,False,6,6,Ethiopia
2638,2787,2946,1949,Jamaica,Trinidad and Tobago,3,1,Friendly,Kingston,Jamaica,False,4,2,Jamaica
2639,2788,2947,1949,Colombia,Ecuador,1,4,Copa América,Rio de Janeiro,Brazil,True,5,-3,Ecuador
2640,2789,2948,1949,Jamaica,Trinidad and Tobago,2,1,Friendly,Kingston,Jamaica,False,3,1,Jamaica
2641,2790,2949,1949,Peru,Uruguay,4,3,Copa América,Rio de Janeiro,Brazil,True,7,1,Peru
2642,2791,2950,1949,Bolivia,Colombia,4,0,Copa América,Rio de Janeiro,Brazil,True,4,4,Bolivia
2643,2792,2951,1949,Jamaica,Trinidad and Tobago,1,2,Friendly,Kingston,Jamaica,False,3,-1,Trinidad and Tobago
2644,2793,2952,1949,Brazil,Paraguay,1,2,Copa América,Rio de Janeiro,Brazil,False,3,-1,Paraguay
2645,2794,2953,1949,Chile,Uruguay,3,1,Copa América,Belo Horizonte,Brazil,True,4,2,Chile
2646,2795,2954,1949,Hungary,Austria,6,1,International Cup,Budapest,Hungary,False,7,5,Hungary
2647,2796,2955,1949,Romania,Poland,2,1,Friendly,Bucharest,Romania,False,3,1,Romania
2648,2797,2956,1949,Cuba,Martinique,0,0,Friendly,Parmaribo,Suriname,True,0,0,Draw
2649,2798,2957,1949,Puerto Rico,Trinidad and Tobago,2,8,Friendly,San Juan,Puerto Rico,False,10,-6,Trinidad and Tobago
2650,2799,2958,1949,Brazil,Paraguay,7,0,Copa América,Rio de Janeiro,Brazil,False,7,7,Brazil
2651,2800,2959,1949,Puerto Rico,Trinidad and Tobago,0,7,Friendly,San Juan,Puerto Rico,False,7,-7,Trinidad and Tobago
2652,2801,2960,1949,Egypt,Turkey,2,3,Friendly,Athens,Greece,True,5,-1,Turkey
2653,2802,2961,1949,Suriname,Cuba,0,1,Friendly,Paramaribo,Suriname,False,1,-1,Cuba
2654,2803,2962,1949,Sweden,England,3,1,Friendly,Solna,Sweden,False,4,2,Sweden
2655,2804,2963,1949,Cuba,Dominican Republic,0,1,Friendly,Parmaribo,Suriname,True,1,-1,Dominican Republic
2656,2805,2964,1949,Greece,Turkey,1,2,Friendly,Athens,Greece,False,3,-1,Turkey
2657,2806,2965,1949,Portugal,Wales,3,2,Friendly,Oeiras,Portugal,False,5,1,Portugal
2658,2807,2966,1949,Greece,Egypt,1,3,Friendly,Athens,Greece,False,4,-2,Egypt
2659,2808,2967,1949,Norway,England,1,4,Friendly,Oslo,Norway,False,5,-3,England
2660,2809,2968,1949,Belgium,Wales,3,1,Friendly,Liège,Belgium,False,4,2,Belgium
2661,2810,2970,1949,France,England,1,3,Friendly,Colombes,France,False,4,-2,England
2662,2811,2971,1949,Republic of Ireland,Portugal,1,0,Friendly,Dublin,Republic of Ireland,False,1,1,Republic of Ireland
2663,2812,2972,1949,Italy,Austria,3,1,International Cup,Florence,Italy,False,4,2,Italy
2664,2813,2973,1949,Switzerland,Wales,4,0,Friendly,Berne,Switzerland,False,4,4,Switzerland
2665,2814,2974,1949,Sweden,Republic of Ireland,3,1,FIFA World Cup qualification,Solna,Sweden,False,4,2,Sweden
2666,2815,2975,1949,France,Switzerland,4,2,Friendly,Colombes,France,False,6,2,France
2667,2816,2976,1949,Denmark,Netherlands,1,2,Friendly,Copenhagen,Denmark,False,3,-1,Netherlands
2668,2817,2977,1949,Hungary,Italy,1,1,International Cup,Budapest,Hungary,False,2,0,Draw
2669,2818,2978,1949,Republic of Ireland,Spain,1,4,Friendly,Dublin,Republic of Ireland,False,5,-3,Spain
2670,2819,2979,1949,Finland,Netherlands,1,4,Friendly,Helsinki,Finland,False,5,-3,Netherlands
2671,2820,2980,1949,Madagascar,Mauritius,1,3,Friendly,Saint-Pierre,Réunion,True,4,-2,Mauritius
2672,2821,2981,1949,France,Spain,1,5,Friendly,Colombes,France,False,6,-4,Spain
2673,2823,2983,1949,Poland,Denmark,1,2,Friendly,Warsaw,Poland,False,3,-1,Denmark
2674,2824,2984,1949,Sweden,Hungary,2,2,Friendly,Solna,Sweden,False,4,0,Draw
2675,2825,2985,1949,United States,Scotland,0,4,Friendly,New York,United States,False,4,-4,Scotland
2676,2826,2986,1949,Switzerland,Luxembourg,5,2,FIFA World Cup qualification,Zürich,Switzerland,False,7,3,Switzerland
2677,2827,2987,1949,Martinique,Trinidad and Tobago,2,0,Friendly,Fort-de-France,Martinique,False,2,2,Martinique
2678,2828,2988,1949,Finland,Norway,1,1,Nordic Championship,Helsinki,Finland,False,2,0,Draw
2679,2829,2989,1949,Hungary,Poland,8,2,Friendly,Debrecen,Hungary,False,10,6,Hungary
2680,2830,2990,1949,Curaçao,Aruba,3,0,Friendly,Willemstad,Curaçao,False,3,3,Curaçao
2681,2831,2991,1949,Israel,Cyprus,3,1,Friendly,Tel Aviv,Israel,False,4,2,Israel
2682,2832,2992,1949,El Salvador,Panama,3,1,Friendly,San Salvador,El Salvador,False,4,2,El Salvador
2683,2833,2993,1949,El Salvador,Panama,2,3,Friendly,San Salvador,El Salvador,False,5,-1,Panama
2684,2834,2994,1949,Denmark,Iceland,5,1,Friendly,Århus,Denmark,False,6,4,Denmark
2685,2835,2995,1949,Suriname,French Guiana,5,0,Friendly,Paramaribo,Suriname,False,5,5,Suriname
2686,2836,2996,1949,Suriname,French Guiana,2,1,Friendly,Paramaribo,Suriname,False,3,1,Suriname
2687,2837,2999,1949,Mexico,United States,6,0,FIFA World Cup qualification,Mexico City,Mexico,False,6,6,Mexico
2688,2838,3000,1949,Republic of Ireland,Finland,3,0,FIFA World Cup qualification,Dublin,Republic of Ireland,False,3,3,Republic of Ireland
2689,2839,3001,1949,Denmark,Finland,0,2,Nordic Championship,Copenhagen,Denmark,False,2,-2,Finland
2690,2840,3002,1949,Mexico,Cuba,2,0,FIFA World Cup qualification,Mexico City,Mexico,False,2,2,Mexico
2691,2841,3003,1949,Norway,Denmark,0,2,Nordic Championship,Oslo,Norway,False,2,-2,Denmark
2692,2842,3004,1949,Cuba,United States,1,1,FIFA World Cup qualification,Mexico City,Mexico,True,2,0,Draw
2693,2844,3006,1949,Luxembourg,Switzerland,2,3,FIFA World Cup qualification,Luxembourg,Luxembourg,False,5,-1,Switzerland
2694,2845,3007,1949,Mexico,United States,6,2,FIFA World Cup qualification,Mexico City,Mexico,False,8,4,Mexico
2695,2846,3008,1949,England,Republic of Ireland,0,2,Friendly,Liverpool,England,False,2,-2,Republic of Ireland
2696,2847,3009,1949,United States,Cuba,5,2,FIFA World Cup qualification,Mexico City,Mexico,True,7,3,United States
2697,2849,3011,1949,Mexico,Cuba,3,0,FIFA World Cup qualification,Mexico City,Mexico,False,3,3,Mexico
2698,2850,3012,1949,Northern Ireland,Scotland,2,8,FIFA World Cup qualification,Belfast,Northern Ireland,False,10,-6,Scotland
2699,2851,3013,1949,Belgium,Switzerland,3,0,Friendly,Brussels,Belgium,False,3,3,Belgium
2700,2852,3014,1949,Poland,Bulgaria,3,2,Friendly,Warsaw,Poland,False,5,1,Poland
2701,2853,3015,1949,Sweden,Finland,8,1,Nordic Championship,Malmö,Sweden,False,9,7,Sweden
2702,2854,3016,1949,Sweden,Norway,3,3,Nordic Championship,Solna,Sweden,False,6,0,Draw
2703,2855,3017,1949,Réunion,Mauritius,0,6,Friendly,Saint-Pierre,Réunion,False,6,-6,Mauritius
2704,2856,3018,1949,Sierra Leone,Nigeria,0,2,Friendly,Freetown,Sierra Leone,False,2,-2,Nigeria
2705,2857,3019,1949,Finland,Republic of Ireland,1,1,FIFA World Cup qualification,Helsinki,Finland,False,2,0,Draw
2706,2858,3021,1949,Réunion,Madagascar,1,3,Friendly,Saint-Pierre,Réunion,False,4,-2,Madagascar
2707,2859,3022,1949,Wales,England,1,4,FIFA World Cup qualification,Cardiff,Wales,False,5,-3,England
2708,2860,3023,1949,Austria,Hungary,3,4,Friendly,Vienna,Austria,False,7,-1,Hungary
2709,2861,3024,1949,Denmark,Sweden,3,2,Nordic Championship,Copenhagen,Denmark,False,5,1,Denmark
2710,2862,3025,1949,Lithuania,Estonia,2,1,Baltic Cup,Vilnius,Soviet Union,True,3,1,Lithuania
2711,2863,3026,1949,Romania,Albania,1,1,Friendly,Bucharest,Romania,False,2,0,Draw
2712,2864,3027,1949,Lithuania,Latvia,1,0,Baltic Cup,Vilnius,Soviet Union,True,1,1,Lithuania
2713,2866,3030,1949,Hungary,Bulgaria,5,0,Friendly,Budapest,Hungary,False,5,5,Hungary
2714,2867,3031,1949,Netherlands,Belgium,0,1,Friendly,Rotterdam,Netherlands,False,1,-1,Belgium
2715,2868,3032,1949,Poland,Albania,2,1,Friendly,Warsaw,Poland,False,3,1,Poland
2716,2869,3033,1949,Scotland,Wales,2,0,FIFA World Cup qualification,Glasgow,Scotland,False,2,2,Scotland
2717,2871,3035,1949,Republic of Ireland,Sweden,1,3,FIFA World Cup qualification,Dublin,Republic of Ireland,False,4,-2,Sweden
2718,2872,3037,1949,England,Northern Ireland,9,2,FIFA World Cup qualification,Manchester,England,False,11,7,England
2719,2873,3038,1949,Bulgaria,Albania,0,0,Friendly,Sofia,Bulgaria,False,0,0,Draw
2720,2874,3039,1949,Hungary,Sweden,5,0,Friendly,Budapest,Hungary,False,5,5,Hungary
2721,2875,3040,1949,Turkey,Syria,7,0,FIFA World Cup qualification,Ankara,Turkey,False,7,7,Turkey
2722,2876,3041,1949,Wales,Belgium,5,1,Friendly,Cardiff,Wales,False,6,4,Wales
2723,2877,3042,1949,Greece,Syria,8,0,Friendly,Athens,Greece,False,8,8,Greece
2724,2878,3043,1949,Albania,Romania,1,4,Friendly,Tirana,Albania,False,5,-3,Romania
2725,2879,3044,1949,England,Italy,2,0,Friendly,London,England,False,2,2,England
2726,2880,3046,1949,Kenya,Tanzania,0,2,Friendly,Zanzibar,Zanzibar,True,2,-2,Tanzania
2727,2882,3048,1949,Netherlands,Denmark,0,1,Friendly,Amsterdam,Netherlands,False,1,-1,Denmark
2728,2883,3049,1949,Cuba,Jamaica,2,5,Friendly,Port-au-Prince,Haiti,True,7,-3,Jamaica
2729,2884,3050,1949,Haiti,Jamaica,2,0,Friendly,Port-au-Prince,Haiti,False,2,2,Haiti
2730,2885,3051,1949,Haiti,Cuba,3,0,Friendly,Port-au-Prince,Haiti,False,3,3,Haiti
2731,2886,3052,1950,Zambia,DR Congo,1,0,Friendly,Kitwe,Northern Rhodesia,False,1,1,Zambia
2732,2887,3053,1950,Egypt,Greece,2,0,Friendly,Cairo,Egypt,False,2,2,Egypt
2733,2888,3054,1950,Bolivia,Chile,2,0,Friendly,La Paz,Bolivia,False,2,2,Bolivia
2734,2889,3055,1950,Croatia,Serbia,4,1,Friendly,Zagreb,Yugoslavia,False,5,3,Croatia
2735,2890,3056,1950,Italy,Belgium,3,1,Friendly,Bologna,Italy,False,4,2,Italy
2736,2891,3057,1950,Wales,Northern Ireland,0,0,FIFA World Cup qualification,Cardiff,Wales,False,0,0,Draw
2737,2892,3058,1950,Chile,Bolivia,5,0,Friendly,Santiago,Chile,False,5,5,Chile
2738,2893,3059,1950,Austria,Switzerland,3,3,International Cup,Vienna,Austria,False,6,0,Draw
2739,2894,3060,1950,Guyana,Trinidad and Tobago,0,1,Friendly,Georgetown,British Guyana,False,1,-1,Trinidad and Tobago
2740,2895,3061,1950,Guyana,Trinidad and Tobago,1,4,Friendly,Georgetown,British Guyana,False,5,-3,Trinidad and Tobago
2741,2896,3062,1950,Argentina,Paraguay,2,2,Copa Chevallier Boutell,Buenos Aires,Argentina,False,4,0,Draw
2742,2897,3063,1950,Guyana,Trinidad and Tobago,1,0,Friendly,Georgetown,British Guyana,False,1,1,Guyana
2743,2898,3064,1950,Argentina,Paraguay,4,0,Copa Chevallier Boutell,Buenos Aires,Argentina,False,4,4,Argentina
2744,2899,3065,1950,Guyana,Trinidad and Tobago,1,2,Friendly,Georgetown,British Guyana,False,3,-1,Trinidad and Tobago
2745,2900,3066,1950,Austria,Italy,1,0,International Cup,Vienna,Austria,False,1,1,Austria
2746,2901,3067,1950,Spain,Portugal,5,1,FIFA World Cup qualification,Madrid,Spain,False,6,4,Spain
2747,2902,3068,1950,Chile,Uruguay,1,5,Friendly,Santiago,Chile,False,6,-4,Uruguay
2748,2903,3069,1950,Chile,Uruguay,2,1,Friendly,Santiago,Chile,False,3,1,Chile
2749,2904,3070,1950,Portugal,Spain,2,2,FIFA World Cup qualification,Oeiras,Portugal,False,4,0,Draw
2750,2905,3071,1950,Mauritius,Réunion,15,2,Friendly,Antananarivo,Madagascar,True,17,13,Mauritius
2751,2906,3072,1950,Scotland,England,0,1,FIFA World Cup qualification,Glasgow,Scotland,False,1,-1,England
2752,2907,3073,1950,Belgium,Netherlands,2,0,Friendly,Antwerp,Belgium,False,2,2,Belgium
2753,2908,3075,1950,Scotland,Switzerland,3,1,Friendly,Glasgow,Scotland,False,4,2,Scotland
2754,2910,3077,1950,Paraguay,Uruguay,3,2,Friendly,Rio de Janeiro,Brazil,True,5,1,Paraguay
2755,2911,3078,1950,Albania,Poland,0,0,Friendly,Tirana,Albania,False,0,0,Draw
2756,2912,3079,1950,Brazil,Uruguay,3,4,Copa Rio Branco,São Paulo,Brazil,False,7,-1,Uruguay
2757,2913,3080,1950,Brazil,Paraguay,2,0,Copa Oswaldo Cruz,Rio de Janeiro,Brazil,False,2,2,Brazil
2758,2914,3081,1950,Belgium,Republic of Ireland,5,1,Friendly,Brussels,Belgium,False,6,4,Belgium
2759,2915,3082,1950,Brazil,Paraguay,3,3,Copa Oswaldo Cruz,São Paulo,Brazil,False,6,0,Draw
2760,2916,3083,1950,Austria,Hungary,5,3,Friendly,Vienna,Austria,False,8,2,Austria
2761,2917,3084,1950,Brazil,Uruguay,3,2,Copa Rio Branco,Rio de Janeiro,Brazil,False,5,1,Brazil
2762,2918,3085,1950,Poland,Romania,3,3,Friendly,Wrocław,Poland,False,6,0,Draw
2763,2919,3086,1950,Portugal,England,3,5,Friendly,Oeiras,Portugal,False,8,-2,England
2764,2920,3087,1950,Belgium,England,1,4,Friendly,Brussels,Belgium,False,5,-3,England
2765,2921,3088,1950,Portugal,Scotland,2,2,Friendly,Oeiras,Portugal,False,4,0,Draw
2766,2923,3090,1950,France,Scotland,0,1,Friendly,Colombes,France,False,1,-1,Scotland
2767,2924,3091,1950,Ghana,Nigeria,1,0,Friendly,Accra,Gold Coast,False,1,1,Ghana
2768,2925,3092,1950,Turkey,Iran,6,1,Friendly,Istanbul,Turkey,False,7,5,Turkey
2769,2926,3094,1950,Albania,Bulgaria,2,1,Friendly,Tirana,Albania,False,3,1,Albania
2770,2927,3095,1950,Belgium,France,4,1,Friendly,Brussels,Belgium,False,5,3,Belgium
2771,2928,3096,1950,Poland,Hungary,2,5,Friendly,Warsaw,Poland,False,7,-3,Hungary
2772,2929,3097,1950,Sweden,Netherlands,4,1,Friendly,Solna,Sweden,False,5,3,Sweden
2773,2930,3098,1950,Finland,Netherlands,4,1,Friendly,Helsinki,Finland,False,5,3,Finland
2774,2932,3100,1950,Zimbabwe,Australia,0,5,Friendly,Salisbury,Southern Rhodesia,False,5,-5,Australia
2775,2933,3101,1950,Zimbabwe,Australia,1,4,Friendly,Bulawayo,Southern Rhodesia,False,5,-3,Australia
2776,2934,3102,1950,Denmark,Norway,4,0,Nordic Championship,Copenhagen,Denmark,False,4,4,Denmark
2777,2935,3103,1950,Brazil,Mexico,4,0,FIFA World Cup,Rio de Janeiro,Brazil,False,4,4,Brazil
2778,2936,3104,1950,South Africa,Australia,3,2,Friendly,Durban,South Africa,False,5,1,South Africa
2779,2937,3105,1950,Chile,England,0,2,FIFA World Cup,Rio de Janeiro,Brazil,True,2,-2,England
2780,2938,3106,1950,Denmark,Norway,1,4,Friendly,Århus,Denmark,False,5,-3,Norway
2781,2939,3107,1950,Italy,Sweden,2,3,FIFA World Cup,São Paulo,Brazil,True,5,-1,Sweden
2782,2940,3108,1950,Spain,United States,3,1,FIFA World Cup,Curitiba,Brazil,True,4,2,Spain
2783,2942,3110,1950,Brazil,Switzerland,2,2,FIFA World Cup,São Paulo,Brazil,False,4,0,Draw
2784,2944,3112,1950,Chile,Spain,0,2,FIFA World Cup,Rio de Janeiro,Brazil,True,2,-2,Spain
2785,2945,3113,1950,England,United States,0,1,FIFA World Cup,Belo Horizonte,Brazil,True,1,-1,United States
2786,2946,3114,1950,Paraguay,Sweden,2,2,FIFA World Cup,Curitiba,Brazil,True,4,0,Draw
2787,2948,3116,1950,South Africa,Australia,2,1,Friendly,Johannesburg,South Africa,False,3,1,South Africa
2788,2949,3117,1950,Bolivia,Uruguay,0,8,FIFA World Cup,Belo Horizonte,Brazil,True,8,-8,Uruguay
2789,2950,3118,1950,Chile,United States,5,2,FIFA World Cup,Recife,Brazil,True,7,3,Chile
2790,2951,3119,1950,England,Spain,0,1,FIFA World Cup,Rio de Janeiro,Brazil,True,1,-1,Spain
2791,2952,3120,1950,Italy,Paraguay,2,0,FIFA World Cup,São Paulo,Brazil,True,2,2,Italy
2792,2953,3121,1950,Mexico,Switzerland,1,2,FIFA World Cup,Porto Alegre,Brazil,True,3,-1,Switzerland
2793,2954,3122,1950,South Africa,Australia,1,2,Friendly,Port Elizabeth,South Africa,False,3,-1,Australia
2794,2955,3123,1950,Brazil,Sweden,7,1,FIFA World Cup,Rio de Janeiro,Brazil,False,8,6,Brazil
2795,2956,3124,1950,Spain,Uruguay,2,2,FIFA World Cup,São Paulo,Brazil,True,4,0,Draw
2796,2957,3125,1950,Madagascar,Réunion,2,3,Friendly,Antananarivo,Madagascar,False,5,-1,Réunion
2797,2958,3126,1950,Madagascar,Mauritius,1,5,Friendly,Antananarivo,Madagascar,False,6,-4,Mauritius
2798,2959,3127,1950,Brazil,Spain,6,1,FIFA World Cup,Rio de Janeiro,Brazil,False,7,5,Brazil
2799,2960,3128,1950,Sweden,Uruguay,2,3,FIFA World Cup,São Paulo,Brazil,True,5,-1,Uruguay
2800,2961,3129,1950,Brazil,Uruguay,1,2,FIFA World Cup,Rio de Janeiro,Brazil,False,3,-1,Uruguay
2801,2962,3130,1950,Spain,Sweden,1,3,FIFA World Cup,São Paulo,Brazil,True,4,-2,Sweden
2802,2963,3131,1950,Zambia,Zimbabwe,3,2,Friendly,Kitwe,Northern Rhodesia,False,5,1,Zambia
2803,2964,3132,1950,South Africa,Australia,0,2,Friendly,Cape Town,South Africa,False,2,-2,Australia
2804,2965,3133,1950,Norway,Luxembourg,2,2,Friendly,Bergen,Norway,False,4,0,Draw
2805,2967,3135,1950,Finland,Denmark,1,2,Nordic Championship,Helsinki,Finland,False,3,-1,Denmark
2806,2968,3136,1950,Suriname,Guyana,0,1,Friendly,Paramaribo,Suriname,False,1,-1,Guyana
2807,2969,3137,1950,Suriname,Guyana,3,0,Friendly,Paramaribo,Suriname,False,3,3,Suriname
2808,2970,3138,1950,El Salvador,Guatemala,2,1,Friendly,Willemstad,Netherlands Antilles,True,3,1,El Salvador
2809,2971,3139,1950,Suriname,Guyana,4,1,Friendly,Paramaribo,Suriname,False,5,3,Suriname
2810,2973,3141,1950,El Salvador,Guatemala,2,0,Friendly,Willemstad,Netherlands Antilles,True,2,2,El Salvador
2811,2976,3144,1950,Norway,Finland,4,1,Nordic Championship,Oslo,Norway,False,5,3,Norway
2812,2977,3145,1950,Finland,Sweden,0,1,Nordic Championship,Helsinki,Finland,False,1,-1,Sweden
2813,2978,3146,1950,Hungary,Albania,12,0,Friendly,Budapest,Hungary,False,12,12,Hungary
2814,2979,3147,1950,Norway,Sweden,1,3,Nordic Championship,Oslo,Norway,False,4,-2,Sweden
2815,2980,3148,1950,Northern Ireland,England,1,4,British Championship,Belfast,Northern Ireland,False,5,-3,England
2816,2982,3150,1950,Romania,Albania,6,0,Friendly,Bucharest,Romania,False,6,6,Romania
2817,2984,3152,1950,Kenya,Uganda,3,1,Friendly,Nairobi,Kenya,False,4,2,Kenya
2818,2985,3153,1950,Jamaica,Haiti,2,1,Friendly,Kingston,Jamaica,False,3,1,Jamaica
2819,2986,3154,1950,Kenya,Tanzania,1,1,Friendly,Nairobi,Kenya,False,2,0,Draw
2820,2987,3155,1950,Sweden,Denmark,4,0,Nordic Championship,Solna,Sweden,False,4,4,Sweden
2821,2988,3156,1950,Switzerland,Netherlands,7,5,Friendly,Basel,Switzerland,False,12,2,Switzerland
2822,2989,3157,1950,Kenya,Tanzania,1,2,Friendly,Nairobi,Kenya,False,3,-1,Tanzania
2823,2990,3158,1950,Wales,Scotland,1,3,British Championship,Cardiff,Wales,False,4,-2,Scotland
2824,2992,3160,1950,Iran,Afghanistan,4,0,Friendly,Teheran,Iran,False,4,4,Iran
2825,2993,3161,1950,Israel,Turkey,5,1,Friendly,Tel Aviv,Israel,False,6,4,Israel
2826,2994,3162,1950,Hungary,Austria,4,3,Friendly,Budapest,Hungary,False,7,1,Hungary
2827,2995,3163,1950,Bulgaria,Poland,0,1,Friendly,Sofia,Bulgaria,False,1,-1,Poland
2828,2996,3164,1950,France,Belgium,3,3,Friendly,Colombes,France,False,6,0,Draw
2829,2997,3165,1950,Scotland,Northern Ireland,6,1,British Championship,Glasgow,Scotland,False,7,5,Scotland
2830,2998,3166,1950,Austria,Denmark,5,1,Friendly,Vienna,Austria,False,6,4,Austria
2831,2999,3168,1950,Belgium,Netherlands,7,2,Friendly,Antwerp,Belgium,False,9,5,Belgium
2832,3000,3169,1950,Bulgaria,Hungary,1,1,Friendly,Sofia,Bulgaria,False,2,0,Draw
2833,3001,3170,1950,Switzerland,Sweden,4,2,Friendly,Geneva,Switzerland,False,6,2,Switzerland
2834,3002,3171,1950,England,Wales,4,2,British Championship,Sunderland,England,False,6,2,England
2835,3003,3172,1950,Curaçao,Suriname,2,3,Friendly,Port of Spain,Trinidad and Tobago,True,5,-1,Suriname
2836,3005,3174,1950,Germany,Switzerland,1,0,Friendly,Stuttgart,Germany,False,1,1,Germany
2837,3006,3175,1950,Trinidad and Tobago,Curaçao,3,2,Friendly,Port of Spain,Trinidad and Tobago,False,5,1,Trinidad and Tobago
2838,3007,3176,1950,Trinidad and Tobago,Suriname,5,0,Friendly,Port of Spain,Trinidad and Tobago,False,5,5,Trinidad and Tobago
2839,3008,3177,1950,Republic of Ireland,Norway,2,2,Friendly,Dublin,Republic of Ireland,False,4,0,Draw
2840,3009,3178,1950,Curaçao,Suriname,3,0,Friendly,Port of Spain,Trinidad and Tobago,True,3,3,Curaçao
2841,3010,3179,1950,Trinidad and Tobago,Suriname,1,1,Friendly,Port of Spain,Trinidad and Tobago,False,2,0,Draw
2842,3011,3180,1950,Trinidad and Tobago,Curaçao,5,1,Friendly,Port of Spain,Trinidad and Tobago,False,6,4,Trinidad and Tobago
2843,3012,3181,1950,Turkey,Israel,3,2,Friendly,Istanbul,Turkey,False,5,1,Turkey
2844,3013,3182,1950,Guadeloupe,Trinidad and Tobago,0,1,Friendly,Basse-Terre,Guadeloupe,False,1,-1,Trinidad and Tobago
2845,3014,3183,1950,France,Netherlands,5,2,Friendly,Colombes,France,False,7,3,France
2846,3015,3184,1950,Scotland,Austria,0,1,Friendly,Glasgow,Scotland,False,1,-1,Austria
2847,3017,3186,1951,Spain,Switzerland,6,3,Friendly,Madrid,Spain,False,9,3,Spain
2848,3018,3187,1951,Zimbabwe,Zambia,2,1,Friendly,Salisbury,Southern Rhodesia,False,3,1,Zimbabwe
2849,3019,3188,1951,Costa Rica,Nicaragua,8,1,CCCF Championship,Panama City,Panama,True,9,7,Costa Rica
2850,3020,3189,1951,Panama,Costa Rica,2,0,CCCF Championship,Panama City,Panama,False,2,2,Panama
2851,3021,3190,1951,Panama,Nicaragua,4,0,CCCF Championship,Panama City,Panama,False,4,4,Panama
2852,3022,3191,1951,Panama,Costa Rica,1,1,CCCF Championship,Panama City,Panama,False,2,0,Draw
2853,3023,3192,1951,Nicaragua,Costa Rica,1,4,CCCF Championship,Panama City,Panama,True,5,-3,Costa Rica
2854,3024,3193,1951,Panama,Nicaragua,6,2,CCCF Championship,Panama City,Panama,False,8,4,Panama
2855,3025,3194,1951,Northern Ireland,Wales,1,2,British Championship,Belfast,Northern Ireland,False,3,-1,Wales
2856,3026,3195,1951,Barbados,Grenada,1,3,Friendly,Bridgetown,Barbados,False,4,-2,Grenada
2857,3027,3196,1951,Martinique,Guadeloupe,3,0,Friendly,Fort-de-France,Martinique,False,3,3,Martinique
2858,3028,3197,1951,Barbados,Grenada,3,2,Friendly,Bridgetown,Barbados,False,5,1,Barbados
2859,3029,3198,1951,Portugal,Italy,1,4,Friendly,Oeiras,Portugal,False,5,-3,Italy
2860,3030,3199,1951,England,Scotland,2,3,British Championship,London,England,False,5,-1,Scotland
2861,3031,3200,1951,Netherlands,Belgium,5,4,Friendly,Amsterdam,Netherlands,False,9,1,Netherlands
2862,3032,3201,1951,Switzerland,Germany,2,3,Friendly,Zürich,Switzerland,False,5,-1,Germany
2863,3034,3203,1951,England,Argentina,2,1,Friendly,London,England,False,3,1,England
2864,3035,3204,1951,Northern Ireland,France,2,2,Friendly,Belfast,Northern Ireland,False,4,0,Draw
2865,3036,3205,1951,Scotland,Denmark,3,1,Friendly,Glasgow,Scotland,False,4,2,Scotland
2866,3037,3206,1951,Wales,Portugal,2,1,Friendly,Cardiff,Wales,False,3,1,Wales
2867,3038,3207,1951,Republic of Ireland,Argentina,0,1,Friendly,Dublin,Republic of Ireland,False,1,-1,Argentina
2868,3039,3208,1951,Scotland,France,1,0,Friendly,Glasgow,Scotland,False,1,1,Scotland
2869,3040,3209,1951,Wales,Switzerland,3,2,Friendly,Wrexham,Wales,False,5,1,Wales
2870,3041,3210,1951,Guadeloupe,Martinique,1,1,Friendly,Pointe-à-Pitre,Guadeloupe,False,2,0,Draw
2871,3042,3211,1951,England,Portugal,5,2,Friendly,Liverpool,England,False,7,3,England
2872,3043,3212,1951,Belgium,Scotland,0,5,Friendly,Brussels,Belgium,False,5,-5,Scotland
2873,3044,3214,1951,Barbados,Jamaica,3,0,Friendly,Bridgetown,Barbados,False,3,3,Barbados
2874,3045,3215,1951,Barbados,Jamaica,0,1,Friendly,Bridgetown,Barbados,False,1,-1,Jamaica
2875,3046,3216,1951,Austria,Scotland,4,0,Friendly,Vienna,Austria,False,4,4,Austria
2876,3047,3217,1951,Hungary,Poland,6,0,Friendly,Budapest,Hungary,False,6,6,Hungary
2877,3048,3218,1951,Barbados,Jamaica,5,2,Friendly,Bridgetown,Barbados,False,7,3,Barbados
2878,3049,3219,1951,Norway,Republic of Ireland,2,3,Friendly,Oslo,Norway,False,5,-1,Republic of Ireland
2879,3050,3220,1951,Italy,France,4,1,Friendly,Genoa,Italy,False,5,3,Italy
2880,3051,3221,1951,Netherlands,Norway,2,3,Friendly,Rotterdam,Netherlands,False,5,-1,Norway
2881,3052,3222,1951,Belgium,Spain,3,3,Friendly,Brussels,Belgium,False,6,0,Draw
2882,3053,3223,1951,Sweden,Turkey,3,1,Friendly,Solna,Sweden,False,4,2,Sweden
2883,3054,3224,1951,Denmark,Austria,3,3,Friendly,Copenhagen,Denmark,False,6,0,Draw
2884,3055,3225,1951,Germany,Turkey,1,2,Friendly,Berlin,Germany,False,3,-1,Turkey
2885,3056,3226,1951,Portugal,Belgium,1,1,Friendly,Oeiras,Portugal,False,2,0,Draw
2886,3057,3227,1951,Sweden,Spain,0,0,Friendly,Solna,Sweden,False,0,0,Draw
2887,3058,3229,1951,Iceland,Sweden,4,3,Friendly,Reykjavík,Iceland,False,7,1,Iceland
2888,3059,3230,1951,Madagascar,Réunion,3,1,Friendly,Curepipe,Mauritius,True,4,2,Madagascar
2889,3060,3231,1951,Mauritius,Madagascar,7,1,Friendly,Curepipe,Mauritius,False,8,6,Mauritius
2890,3061,3232,1951,Mauritius,Réunion,10,2,Friendly,Curepipe,Mauritius,False,12,8,Mauritius
2891,3062,3233,1951,Norway,Iceland,3,1,Friendly,Trondheim,Norway,False,4,2,Norway
2892,3063,3234,1951,Finland,Norway,1,1,Nordic Championship,Helsinki,Finland,False,2,0,Draw
2893,3065,3236,1951,Suriname,Guyana,6,1,Friendly,Paramaribo,Suriname,False,7,5,Suriname
2894,3066,3237,1951,Suriname,Guyana,5,0,Friendly,Paramaribo,Suriname,False,5,5,Suriname
2895,3067,3238,1951,Sweden,Finland,3,2,Nordic Championship,Solna,Sweden,False,5,1,Sweden
2896,3068,3240,1951,Suriname,Guyana,4,0,Friendly,Paramaribo,Suriname,False,4,4,Suriname
2897,3069,3241,1951,Norway,Denmark,2,0,Nordic Championship,Oslo,Norway,False,2,2,Norway
2898,3070,3242,1951,New Caledonia,New Zealand,2,0,Friendly,Nouméa,New Caledonia,False,2,2,New Caledonia
2899,3071,3243,1951,New Caledonia,New Zealand,4,6,Friendly,Nouméa,New Caledonia,False,10,-2,New Zealand
2900,3072,3244,1951,Austria,Germany,0,2,Friendly,Vienna,Austria,False,2,-2,Germany
2901,3073,3245,1951,New Caledonia,New Zealand,2,0,Friendly,Nouméa,New Caledonia,False,2,2,New Caledonia
2902,3074,3246,1951,Kenya,Uganda,2,1,Friendly,Dar es Salaam,Tanganyika,True,3,1,Kenya
2903,3076,3248,1951,Tanzania,Kenya,3,2,Friendly,Dar es Salaam,Tanganyika,False,5,1,Tanzania
2904,3077,3249,1951,Denmark,Finland,1,0,Nordic Championship,Copenhagen,Denmark,False,1,1,Denmark
2905,3078,3250,1951,New Caledonia,New Zealand,1,3,Friendly,Nouméa,New Caledonia,False,4,-2,New Zealand
2906,3079,3251,1951,Sweden,Norway,3,4,Nordic Championship,Gothenburg,Sweden,False,7,-1,Norway
2907,3080,3252,1951,England,France,2,2,Friendly,London,England,False,4,0,Draw
2908,3081,3253,1951,New Zealand,Vanuatu,9,0,Friendly,Nouméa,New Caledonia,True,9,9,New Zealand
2909,3082,3254,1951,Northern Ireland,Scotland,0,3,British Championship,Belfast,Northern Ireland,False,3,-3,Scotland
2910,3083,3255,1951,Fiji,New Zealand,4,6,Friendly,Suva,Fiji,False,10,-2,New Zealand
2911,3084,3256,1951,Belgium,Austria,1,8,Friendly,Brussels,Belgium,False,9,-7,Austria
2912,3085,3258,1951,Switzerland,France,1,2,Friendly,Geneva,Switzerland,False,3,-1,France
2913,3086,3259,1951,Republic of Ireland,Germany,3,2,Friendly,Dublin,Republic of Ireland,False,5,1,Republic of Ireland
2914,3087,3260,1951,Nigeria,Ghana,5,0,Friendly,Lagos,Nigeria,False,5,5,Nigeria
2915,3088,3261,1951,Wales,England,1,1,British Championship,Cardiff,Wales,False,2,0,Draw
2916,3089,3262,1951,Denmark,Sweden,3,1,Nordic Championship,Copenhagen,Denmark,False,4,2,Denmark
2917,3090,3263,1951,Netherlands,Finland,4,4,Friendly,Rotterdam,Netherlands,False,8,0,Draw
2918,3091,3264,1951,France,Austria,2,2,Friendly,Colombes,France,False,4,0,Draw
2919,3092,3265,1951,Luxembourg,Finland,3,0,Friendly,Luxembourg,Luxembourg,False,3,3,Luxembourg
2920,3093,3266,1951,Italy,Sweden,1,1,Friendly,Florence,Italy,False,2,0,Draw
2921,3094,3267,1951,England,Northern Ireland,2,0,British Championship,London,England,False,2,2,England
2922,3095,3268,1951,Scotland,Wales,0,1,British Championship,Glasgow,Scotland,False,1,-1,Wales
2923,3096,3269,1951,Turkey,Sweden,1,0,Friendly,Istanbul,Turkey,False,1,1,Turkey
2924,3097,3270,1951,Hungary,Finland,8,0,Friendly,Budapest,Hungary,False,8,8,Hungary
2925,3098,3271,1951,Turkey,Germany,0,2,Friendly,Istanbul,Turkey,False,2,-2,Germany
2926,3099,3272,1951,Greece,Egypt,1,0,Friendly,Athens,Greece,False,1,1,Greece
2927,3100,3273,1951,Netherlands,Belgium,6,7,Friendly,Rotterdam,Netherlands,False,13,-1,Belgium
2928,3101,3274,1951,Switzerland,Italy,1,1,International Cup,Lugano,Switzerland,False,2,0,Draw
2929,3102,3275,1951,England,Austria,2,2,Friendly,London,England,False,4,0,Draw
2930,3103,3276,1951,Venezuela,Panama,4,1,Friendly,Caracas,Venezuela,False,5,3,Venezuela
2931,3104,3277,1951,Guadeloupe,Trinidad and Tobago,0,2,Friendly,Basse-Terre,Guadeloupe,False,2,-2,Trinidad and Tobago
2932,3105,3278,1951,Germany,Luxembourg,4,1,Friendly,Essen,Germany,False,5,3,Germany
2933,3106,3279,1951,Jamaica,Haiti,2,2,Friendly,Kingston,Jamaica,False,4,0,Draw
2934,3107,3280,1951,Jamaica,Haiti,0,1,Friendly,Kingston,Jamaica,False,1,-1,Haiti
2935,3108,3281,1951,Jamaica,Haiti,2,1,Friendly,Kingston,Jamaica,False,3,1,Jamaica
2936,3109,3282,1952,Curaçao,Aruba,3,0,Friendly,Willemstad,Netherlands Antilles,False,3,3,Curaçao
2937,3110,3283,1952,Curaçao,Aruba,3,1,Friendly,Willemstad,Netherlands Antilles,False,4,2,Curaçao
2938,3111,3284,1952,Aruba,Suriname,2,1,Friendly,Oranjestad,Aruba,False,3,1,Aruba
2939,3112,3285,1952,Guyana,Suriname,0,9,Friendly,Oranjestad,Netherlands Antilles,True,9,-9,Suriname
2940,3113,3286,1952,Belgium,Italy,2,0,Friendly,Brussels,Belgium,False,2,2,Belgium
2941,3114,3287,1952,Guadeloupe,Martinique,4,0,Friendly,Basse-Terre,Guadeloupe,False,4,4,Guadeloupe
2942,3115,3288,1952,Martinique,Guadeloupe,1,2,Friendly,Fort-de-France,Martinique,False,3,-1,Guadeloupe
2943,3116,3289,1952,Burma,India,0,4,Friendly,Colombo,Ceylon,True,4,-4,India
2944,3117,3290,1952,Chile,Panama,6,1,Pan American Championship,Santiago,Chile,False,7,5,Chile
2945,3118,3291,1952,Burma,Pakistan,0,1,Friendly,Colombo,Ceylon,True,1,-1,Pakistan
2946,3119,3292,1952,Wales,Northern Ireland,3,0,British Championship,Swansea,Wales,False,3,3,Wales
2947,3120,3293,1952,Austria,Belgium,2,0,Friendly,Vienna,Austria,False,2,2,Austria
2948,3121,3294,1952,India,Pakistan,0,0,Friendly,Colombo,Ceylon,True,0,0,Draw
2949,3122,3295,1952,Mexico,Uruguay,1,3,Pan American Championship,Santiago,Chile,True,4,-2,Uruguay
2950,3123,3296,1952,Panama,Peru,1,7,Pan American Championship,Santiago,Chile,True,8,-6,Peru
2951,3124,3297,1952,Sri Lanka,India,1,2,Friendly,Colombo,Ceylon,False,3,-1,India
2952,3125,3298,1952,Chile,Mexico,4,0,Pan American Championship,Santiago,Chile,False,4,4,Chile
2953,3126,3299,1952,France,Sweden,0,1,Friendly,Paris,France,False,1,-1,Sweden
2954,3127,3300,1952,Sri Lanka,Pakistan,0,2,Friendly,Colombo,Ceylon,False,2,-2,Pakistan
2955,3128,3301,1952,Peru,Uruguay,2,5,Pan American Championship,Santiago,Chile,True,7,-3,Uruguay
2956,3129,3302,1952,Chile,Peru,3,2,Pan American Championship,Santiago,Chile,False,5,1,Chile
2957,3130,3303,1952,Scotland,England,1,2,British Championship,Glasgow,Scotland,False,3,-1,England
2958,3131,3304,1952,Belgium,Netherlands,4,2,Friendly,Antwerp,Belgium,False,6,2,Belgium
2959,3132,3305,1952,Brazil,Mexico,2,0,Pan American Championship,Santiago,Chile,True,2,2,Brazil
2960,3133,3306,1952,Panama,Uruguay,1,6,Pan American Championship,Santiago,Chile,True,7,-5,Uruguay
2961,3134,3307,1952,Brazil,Peru,0,0,Pan American Championship,Santiago,Chile,True,0,0,Draw
2962,3135,3308,1952,Mexico,Panama,4,2,Pan American Championship,Santiago,Chile,True,6,2,Mexico
2963,3136,3309,1952,Brazil,Panama,5,0,Pan American Championship,Santiago,Chile,True,5,5,Brazil
2964,3137,3310,1952,Chile,Uruguay,2,0,Pan American Championship,Santiago,Chile,False,2,2,Chile
2965,3138,3311,1952,Brazil,Uruguay,4,2,Pan American Championship,Santiago,Chile,True,6,2,Brazil
2966,3139,3312,1952,Chile,Brazil,0,3,Pan American Championship,Santiago,Chile,False,3,-3,Brazil
2967,3140,3313,1952,France,Portugal,3,0,Friendly,Colombes,France,False,3,3,France
2968,3141,3314,1952,Luxembourg,Germany,0,3,Friendly,Luxembourg,Luxembourg,False,3,-3,Germany
2969,3142,3315,1952,Mexico,Peru,0,3,Pan American Championship,Santiago,Chile,True,3,-3,Peru
2970,3143,3316,1952,Scotland,United States,6,0,Friendly,Glasgow,Scotland,False,6,6,Scotland
2971,3144,3317,1952,Germany,Republic of Ireland,3,0,Friendly,Cologne,Germany,False,3,3,Germany
2972,3145,3318,1952,Austria,Republic of Ireland,6,0,Friendly,Vienna,Austria,False,6,6,Austria
2973,3147,3320,1952,Netherlands,Sweden,0,0,Friendly,Amsterdam,Netherlands,False,0,0,Draw
2974,3149,3322,1952,Italy,England,1,1,Friendly,Florence,Italy,False,2,0,Draw
2975,3150,3323,1952,Poland,Bulgaria,0,1,Friendly,Warsaw,Poland,False,1,-1,Bulgaria
2976,3151,3324,1952,Belgium,France,1,2,Friendly,Brussels,Belgium,False,3,-1,France
2977,3152,3325,1952,Russia,Hungary,1,1,Friendly,Moscow,Soviet Union,False,2,0,Draw
2978,3153,3326,1952,Austria,England,2,3,Friendly,Vienna,Austria,False,5,-1,England
2979,3154,3327,1952,Denmark,Scotland,1,2,Friendly,Copenhagen,Denmark,False,3,-1,Scotland
2980,3155,3328,1952,Romania,Poland,1,0,Friendly,Bucharest,Romania,False,1,1,Romania
2981,3156,3329,1952,Russia,Hungary,2,1,Friendly,Moscow,Soviet Union,False,3,1,Russia
2982,3157,3330,1952,Switzerland,England,0,3,Friendly,Zürich,Switzerland,False,3,-3,England
2983,3158,3331,1952,Sweden,Scotland,3,1,Friendly,Solna,Sweden,False,4,2,Sweden
2984,3159,3332,1952,Spain,Republic of Ireland,6,0,Friendly,Madrid,Spain,False,6,6,Spain
2985,3160,3333,1952,Turkey,Switzerland,1,5,Friendly,Ankara,Turkey,False,6,-4,Switzerland
2986,3161,3334,1952,Turkey,Spain,0,0,Friendly,Istanbul,Turkey,False,0,0,Draw
2987,3162,3335,1952,Norway,Finland,1,2,Friendly,Oslo,Norway,False,3,-1,Finland
2988,3163,3336,1952,Denmark,Sweden,0,2,Friendly,Oslo,Norway,True,2,-2,Sweden
2989,3164,3337,1952,Finland,Sweden,3,1,Friendly,Oslo,Norway,True,4,2,Finland
2990,3165,3338,1952,Poland,Hungary,1,5,Friendly,Warsaw,Poland,False,6,-4,Hungary
2991,3166,3339,1952,Finland,Hungary,1,6,Friendly,Helsinki,Finland,False,7,-5,Hungary
2992,3167,3340,1952,Sweden,Denmark,4,3,Nordic Championship,Solna,Sweden,False,7,1,Sweden
2993,3168,3341,1952,Switzerland,Austria,1,1,Friendly,Geneva,Switzerland,False,2,0,Draw
2994,3169,3343,1952,Netherlands,Curaçao,3,3,Friendly,Amsterdam,Netherlands,False,6,0,Draw
2995,3170,3344,1952,Haiti,Jamaica,4,1,Friendly,Port-au-Prince,Haiti,False,5,3,Haiti
2996,3171,3345,1952,Haiti,Jamaica,3,3,Friendly,Port-au-Prince,Haiti,False,6,0,Draw
2997,3172,3346,1952,Haiti,Jamaica,2,0,Friendly,Port-au-Prince,Haiti,False,2,2,Haiti
2998,3173,3347,1952,Réunion,Madagascar,0,1,Friendly,Saint-Pierre,Réunion,False,1,-1,Madagascar
2999,3174,3348,1952,Haiti,Jamaica,3,2,Friendly,Port-au-Prince,Haiti,False,5,1,Haiti
3000,3175,3349,1952,Réunion,Mauritius,0,6,Friendly,Saint-Pierre,Réunion,False,6,-6,Mauritius
3001,3176,3350,1952,Madagascar,Mauritius,0,7,Friendly,Saint-Pierre,Réunion,True,7,-7,Mauritius
3002,3178,3352,1952,Netherlands,Egypt,1,1,Friendly,Amsterdam,Netherlands,False,2,0,Draw
3003,3179,3354,1952,Norway,Finland,7,2,Nordic Championship,Oslo,Norway,False,9,5,Norway
3004,3180,3355,1952,Zambia,Zimbabwe,1,4,Friendly,Kitwe,Northern Rhodesia,False,5,-3,Zimbabwe
3005,3181,3356,1952,Fiji,New Zealand,0,2,Friendly,Suva,Fiji,False,2,-2,New Zealand
3006,3182,3357,1952,Zambia,Zimbabwe,3,2,Friendly,Kitwe,Northern Rhodesia,False,5,1,Zambia
3007,3183,3359,1952,Fiji,New Zealand,0,9,Friendly,Lautoka,Fiji,False,9,-9,New Zealand
3008,3184,3360,1952,Fiji,New Zealand,2,5,Friendly,Suva,Fiji,False,7,-3,New Zealand
3009,3185,3361,1952,Switzerland,Hungary,2,4,International Cup,Berne,Switzerland,False,6,-2,Hungary
3010,3186,3362,1952,Denmark,Netherlands,3,2,Friendly,Copenhagen,Denmark,False,5,1,Denmark
3011,3187,3363,1952,Finland,Sweden,1,8,Nordic Championship,Helsinki,Finland,False,9,-7,Sweden
3012,3189,3367,1952,Uganda,Tanzania,4,0,Friendly,Kampala,Uganda,False,4,4,Uganda
3013,3192,3370,1952,Uganda,Kenya,6,3,Friendly,Kampala,Uganda,False,9,3,Uganda
3014,3193,3372,1952,Northern Ireland,England,2,2,British Championship,Belfast,Northern Ireland,False,4,0,Draw
3015,3194,3373,1952,Finland,Denmark,2,1,Nordic Championship,Helsinki,Finland,False,3,1,Finland
3016,3195,3374,1952,France,Germany,3,1,Friendly,Colombes,France,False,4,2,France
3017,3196,3375,1952,Norway,Sweden,1,2,Nordic Championship,Oslo,Norway,False,3,-1,Sweden
3018,3197,3376,1952,Wales,Scotland,1,2,British Championship,Cardiff,Wales,False,3,-1,Scotland
3019,3198,3377,1952,Austria,France,1,2,Friendly,Vienna,Austria,False,3,-1,France
3020,3199,3378,1952,Belgium,Netherlands,2,1,Friendly,Antwerp,Belgium,False,3,1,Belgium
3021,3200,3379,1952,Denmark,Norway,1,3,Nordic Championship,Copenhagen,Denmark,False,4,-2,Norway
3022,3203,3382,1952,Sweden,Italy,1,1,Friendly,Solna,Sweden,False,2,0,Draw
3023,3204,3384,1952,Scotland,Northern Ireland,1,1,British Championship,Glasgow,Scotland,False,2,0,Draw
3024,3205,3385,1952,Germany,Switzerland,5,1,Friendly,Augsburg,Germany,False,6,4,Germany
3025,3206,3386,1952,France,Northern Ireland,3,1,Friendly,Colombes,France,False,4,2,France
3026,3207,3387,1952,England,Wales,5,2,British Championship,London,England,False,7,3,England
3027,3208,3388,1952,Republic of Ireland,France,1,1,Friendly,Dublin,Republic of Ireland,False,2,0,Draw
3028,3209,3389,1952,Portugal,Austria,1,1,Friendly,Porto,Portugal,False,2,0,Draw
3029,3210,3390,1952,England,Belgium,5,0,Friendly,London,England,False,5,5,England
3030,3212,3392,1952,Spain,Argentina,0,1,Friendly,Madrid,Spain,False,1,-1,Argentina
3031,3213,3393,1952,Portugal,Argentina,1,3,Friendly,Oeiras,Portugal,False,4,-2,Argentina
3032,3215,3395,1952,France,Belgium,0,1,Friendly,Colombes,France,False,1,-1,Belgium
3033,3216,3396,1952,Italy,Switzerland,2,0,International Cup,Palermo,Italy,False,2,2,Italy
3034,3217,3397,1952,Spain,Germany,2,2,Friendly,Madrid,Spain,False,4,0,Draw
3035,3219,3399,1953,Gambia,Sierra Leone,2,1,Friendly,Banjul,Gambia,False,3,1,Gambia
3036,3220,3400,1953,Peru,Bolivia,0,1,Copa América,Lima,Peru,False,1,-1,Bolivia
3037,3221,3401,1953,Bolivia,Uruguay,0,2,Copa América,Lima,Peru,True,2,-2,Uruguay
3038,3222,3402,1953,Chile,Paraguay,0,3,Copa América,Lima,Peru,True,3,-3,Paraguay
3039,3223,3403,1953,Peru,Ecuador,1,0,Copa América,Lima,Peru,False,1,1,Peru
3040,3224,3404,1953,Bolivia,Brazil,1,8,Copa América,Lima,Peru,True,9,-7,Brazil
3041,3225,3405,1953,Chile,Uruguay,3,2,Copa América,Lima,Peru,True,5,1,Chile
3042,3226,3406,1953,Ecuador,Paraguay,0,0,Copa América,Lima,Peru,True,0,0,Draw
3043,3227,3407,1953,Peru,Chile,0,0,Copa América,Lima,Peru,False,0,0,Draw
3044,3228,3408,1953,Netherlands,Denmark,1,2,Friendly,Rotterdam,Netherlands,False,3,-1,Denmark
3045,3229,3409,1953,Bolivia,Ecuador,1,1,Copa América,Lima,Peru,True,2,0,Draw
3046,3230,3410,1953,Costa Rica,El Salvador,5,1,CCCF Championship,San José,Costa Rica,False,6,4,Costa Rica
3047,3231,3411,1953,Honduras,Nicaragua,2,1,CCCF Championship,San José,Costa Rica,True,3,1,Honduras
3048,3232,3412,1953,Peru,Paraguay,2,2,Copa América,Lima,Peru,False,4,0,Draw
3049,3233,3413,1953,Guatemala,Curaçao,1,1,CCCF Championship,San José,Costa Rica,True,2,0,Draw
3050,3234,3414,1953,Costa Rica,Panama,3,0,CCCF Championship,San José,Costa Rica,False,3,3,Costa Rica
3051,3235,3415,1953,El Salvador,Nicaragua,4,1,CCCF Championship,San José,Costa Rica,True,5,3,El Salvador
3052,3236,3416,1953,Curaçao,Nicaragua,8,0,CCCF Championship,San José,Costa Rica,True,8,8,Curaçao
3053,3237,3417,1953,Guatemala,Honduras,1,0,CCCF Championship,San José,Costa Rica,True,1,1,Guatemala
3054,3238,3418,1953,Brazil,Ecuador,2,0,Copa América,Lima,Peru,True,2,2,Brazil
3055,3239,3419,1953,Panama,Curaçao,2,4,CCCF Championship,San José,Costa Rica,True,6,-2,Curaçao
3056,3240,3420,1953,Paraguay,Uruguay,2,2,Copa América,Lima,Peru,True,4,0,Draw
3057,3241,3421,1953,Costa Rica,Honduras,4,1,CCCF Championship,San José,Costa Rica,False,5,3,Costa Rica
3058,3242,3422,1953,Guatemala,El Salvador,3,2,CCCF Championship,San José,Costa Rica,True,5,1,Guatemala
3059,3243,3423,1953,Panama,Nicaragua,0,2,CCCF Championship,San José,Costa Rica,True,2,-2,Nicaragua
3060,3244,3424,1953,Brazil,Uruguay,1,0,Copa América,Lima,Peru,True,1,1,Brazil
3061,3245,3425,1953,Costa Rica,Curaçao,1,0,CCCF Championship,San José,Costa Rica,False,1,1,Costa Rica
3062,3246,3426,1953,El Salvador,Honduras,0,3,CCCF Championship,San José,Costa Rica,True,3,-3,Honduras
3063,3247,3427,1953,Bolivia,Paraguay,1,2,Copa América,Lima,Peru,True,3,-1,Paraguay
3064,3248,3428,1953,Costa Rica,Nicaragua,3,0,CCCF Championship,San José,Costa Rica,False,3,3,Costa Rica
3065,3249,3429,1953,Panama,Guatemala,2,2,CCCF Championship,San José,Costa Rica,True,4,0,Draw
3066,3250,3430,1953,Chile,Ecuador,3,0,Copa América,Lima,Peru,True,3,3,Chile
3067,3251,3431,1953,Curaçao,Honduras,3,4,CCCF Championship,San José,Costa Rica,True,7,-1,Honduras
3068,3252,3432,1953,El Salvador,Panama,2,1,CCCF Championship,San José,Costa Rica,True,3,1,El Salvador
3069,3253,3433,1953,Guatemala,Nicaragua,1,0,CCCF Championship,San José,Costa Rica,True,1,1,Guatemala
3070,3254,3434,1953,Peru,Brazil,1,0,Copa América,Lima,Peru,False,1,1,Peru
3071,3255,3435,1953,Spain,Belgium,3,1,Friendly,Barcelona,Spain,False,4,2,Spain
3072,3256,3436,1953,Costa Rica,Guatemala,3,0,CCCF Championship,San José,Costa Rica,False,3,3,Costa Rica
3073,3257,3437,1953,El Salvador,Curaçao,1,1,CCCF Championship,San José,Costa Rica,True,2,0,Draw
3074,3258,3438,1953,Honduras,Panama,3,1,CCCF Championship,San José,Costa Rica,True,4,2,Honduras
3075,3259,3439,1953,Germany,Austria,0,0,Friendly,Cologne,Germany,False,0,0,Draw
3076,3260,3440,1953,Netherlands,Switzerland,1,2,Friendly,Amsterdam,Netherlands,False,3,-1,Switzerland
3077,3261,3441,1953,Brazil,Chile,3,2,Copa América,Lima,Peru,True,5,1,Brazil
3078,3262,3442,1953,Ecuador,Uruguay,0,6,Copa América,Lima,Peru,True,6,-6,Uruguay
3079,3263,3443,1953,Republic of Ireland,Austria,4,0,Friendly,Dublin,Republic of Ireland,False,4,4,Republic of Ireland
3080,3264,3444,1953,Brazil,Paraguay,1,2,Copa América,Lima,Peru,True,3,-1,Paraguay
3081,3265,3445,1953,Bolivia,Chile,2,2,Copa América,Lima,Peru,True,4,0,Draw
3082,3266,3446,1953,Peru,Uruguay,0,3,Copa América,Lima,Peru,False,3,-3,Uruguay
3083,3267,3447,1953,Brazil,Paraguay,2,3,Copa América,Lima,Peru,True,5,-1,Paraguay
3084,3270,3451,1953,Northern Ireland,Wales,2,3,British Championship,Belfast,Northern Ireland,False,5,-1,Wales
3085,3272,3453,1953,Martinique,Guadeloupe,4,3,Friendly,Fort-de-France,Martinique,False,7,1,Martinique
3086,3273,3454,1953,England,Scotland,2,2,British Championship,London,England,False,4,0,Draw
3087,3275,3456,1953,Netherlands,Belgium,0,2,Friendly,Amsterdam,Netherlands,False,2,-2,Belgium
3088,3278,3460,1953,Hungary,Austria,1,1,Friendly,Budapest,Hungary,False,2,0,Draw
3089,3280,3463,1953,Scotland,Sweden,1,2,Friendly,Glasgow,Scotland,False,3,-1,Sweden
3090,3282,3466,1953,Argentina,England,3,1,Friendly,Buenos Aires,Argentina,False,4,2,Argentina
3091,3284,3468,1953,France,Wales,6,1,Friendly,Colombes,France,False,7,5,France
3092,3285,3469,1953,Argentina,England,0,0,Friendly,Buenos Aires,Argentina,False,0,0,Draw
3093,3286,3470,1953,Guadeloupe,Martinique,0,2,Friendly,Pointe-à-Pitre,Guadeloupe,False,2,-2,Martinique
3094,3287,3471,1953,Italy,Hungary,0,3,International Cup,Rome,Italy,False,3,-3,Hungary
3095,3288,3473,1953,Chile,England,1,2,Friendly,Santiago,Chile,False,3,-1,England
3096,3289,3474,1953,Finland,Belgium,2,4,FIFA World Cup qualification,Helsinki,Finland,False,6,-2,Belgium
3097,3290,3475,1953,Switzerland,Turkey,1,2,Friendly,Berne,Switzerland,False,3,-1,Turkey
3098,3291,3476,1953,Sweden,Belgium,2,3,FIFA World Cup qualification,Solna,Sweden,False,5,-1,Belgium
3099,3292,3477,1953,Uruguay,England,2,1,Friendly,Montevideo,Uruguay,False,3,1,Uruguay
3100,3293,3478,1953,Gambia,Guinea-Bissau,1,3,Friendly,Bathurst,Gambia,False,4,-2,Guinea-Bissau
3101,3295,3480,1953,Guinea-Bissau,Gambia,1,0,Friendly,Bissau,Portuguese Guinea,False,1,1,Guinea-Bissau
3102,3296,3481,1953,United States,England,3,6,Friendly,New York,United States,False,9,-3,England
3103,3297,3482,1953,Sweden,France,1,0,Friendly,Solna,Sweden,False,1,1,Sweden
3104,3298,3484,1953,Singapore,Philippines,3,1,Friendly,Kallang,Singapore,False,4,2,Singapore
3105,3299,3485,1953,Denmark,Sweden,1,3,Nordic Championship,Copenhagen,Denmark,False,4,-2,Sweden
3106,3301,3487,1953,Switzerland,Denmark,1,4,Friendly,Basel,Switzerland,False,5,-3,Denmark
3107,3302,3488,1953,Romania,Bulgaria,3,1,FIFA World Cup qualification,Bucharest,Romania,False,4,2,Romania
3108,3303,3489,1953,Argentina,Spain,1,0,Friendly,Buenos Aires,Argentina,False,1,1,Argentina
3109,3304,3490,1953,Sweden,Hungary,2,4,Friendly,Solna,Sweden,False,6,-2,Hungary
3110,3305,3491,1953,Chile,Spain,1,2,Friendly,Santiago,Chile,False,3,-1,Spain
3111,3306,3492,1953,Mauritius,Réunion,9,4,Friendly,Antananarivo,Madagascar,True,13,5,Mauritius
3112,3307,3493,1953,Madagascar,Réunion,6,4,Friendly,Antananarivo,Madagascar,False,10,2,Madagascar
3113,3308,3494,1953,Mexico,Haiti,8,0,FIFA World Cup qualification,Mexico City,Mexico,False,8,8,Mexico
3114,3309,3495,1953,Madagascar,Mauritius,2,3,Friendly,Antananarivo,Madagascar,False,5,-1,Mauritius
3115,3310,3496,1953,Peru,Chile,1,2,Copa del Pacífico,Lima,Peru,False,3,-1,Chile
3116,3311,3497,1953,Peru,Chile,5,0,Copa del Pacífico,Lima,Peru,False,5,5,Peru
3117,3312,3498,1953,Finland,Sweden,3,3,FIFA World Cup qualification,Helsinki,Finland,False,6,0,Draw
3118,3313,3499,1953,Denmark,Iceland,4,0,Friendly,Copenhagen,Denmark,False,4,4,Denmark
3119,3314,3501,1953,Jamaica,Trinidad and Tobago,3,2,Friendly,Kingston,Jamaica,False,5,1,Jamaica
3120,3315,3502,1953,Jamaica,Trinidad and Tobago,0,1,Friendly,Kingston,Jamaica,False,1,-1,Trinidad and Tobago
3121,3316,3503,1953,Norway,Iceland,3,1,Friendly,Bergen,Norway,False,4,2,Norway
3122,3317,3504,1953,Sweden,Finland,4,0,FIFA World Cup qualification,Solna,Sweden,False,4,4,Sweden
3123,3318,3505,1953,Norway,Germany,1,1,FIFA World Cup qualification,Oslo,Norway,False,2,0,Draw
3124,3319,3506,1953,Suriname,Aruba,3,3,Friendly,Paramaribo,Suriname,False,6,0,Draw
3125,3320,3507,1953,Finland,Norway,1,4,Nordic Championship,Helsinki,Finland,False,5,-3,Norway
3126,3321,3508,1953,Suriname,Aruba,3,3,Friendly,Paramaribo,Suriname,False,6,0,Draw
3127,3324,3511,1953,Bulgaria,Poland,2,2,Friendly,Sofia,Bulgaria,False,4,0,Draw
3128,3325,3512,1953,Norway,Denmark,0,1,Nordic Championship,Oslo,Norway,False,1,-1,Denmark
3129,3327,3515,1953,Uganda,Burundi,9,1,Friendly,Kampala,Uganda,False,10,8,Uganda
3130,3328,3517,1953,Luxembourg,France,1,6,FIFA World Cup qualification,Luxembourg,Luxembourg,False,7,-5,France
3131,3330,3519,1953,Belgium,Finland,2,2,FIFA World Cup qualification,Brussels,Belgium,False,4,0,Draw
3132,3332,3521,1953,Austria,Portugal,9,1,FIFA World Cup qualification,Vienna,Austria,False,10,8,Austria
3133,3334,3524,1953,Norway,Netherlands,4,0,Friendly,Oslo,Norway,False,4,4,Norway
3134,3335,3526,1953,Kenya,Tanzania,7,1,Friendly,Zanzibar,Zanzibar,True,8,6,Kenya
3135,3336,3528,1953,Kenya,Uganda,6,2,Friendly,Zanzibar,Zanzibar,True,8,4,Kenya
3136,3337,3529,1953,Northern Ireland,Scotland,1,3,FIFA World Cup qualification,Belfast,Northern Ireland,False,4,-2,Scotland
3137,3338,3531,1953,Bulgaria,Hungary,1,1,Friendly,Sofia,Bulgaria,False,2,0,Draw
3138,3339,3533,1953,Denmark,Finland,6,1,Nordic Championship,Copenhagen,Denmark,False,7,5,Denmark
3139,3340,3534,1953,Republic of Ireland,France,3,5,FIFA World Cup qualification,Dublin,Republic of Ireland,False,8,-2,France
3140,3341,3535,1953,Belgium,Sweden,2,0,FIFA World Cup qualification,Brussels,Belgium,False,2,2,Belgium
3141,3342,3536,1953,Wales,England,1,4,FIFA World Cup qualification,Cardiff,Wales,False,5,-3,England
3142,3343,3537,1953,Austria,Hungary,2,3,Friendly,Vienna,Austria,False,5,-1,Hungary
3143,3344,3538,1953,Bulgaria,Romania,1,2,FIFA World Cup qualification,Sofia,Bulgaria,False,3,-1,Romania
3144,3346,3540,1953,Ghana,Nigeria,1,0,Friendly,Accra,Gold Coast,False,1,1,Ghana
3145,3347,3541,1953,Zambia,Zimbabwe,1,0,Friendly,Kitwe,Northern Rhodesia,False,1,1,Zambia
3146,3348,3542,1953,Sweden,Norway,0,0,Nordic Championship,Solna,Sweden,False,0,0,Draw
3147,3349,3544,1953,Burma,Sri Lanka,3,2,Friendly,Rangoon,Burma,False,5,1,Burma
3148,3350,3545,1953,Netherlands,Belgium,1,0,Friendly,Rotterdam,Netherlands,False,1,1,Netherlands
3149,3352,3547,1953,Sri Lanka,India,0,2,Friendly,Rangoon,Burma,True,2,-2,India
3150,3353,3548,1953,Burma,Pakistan,1,1,Friendly,Rangoon,Burma,False,2,0,Draw
3151,3354,3549,1953,Republic of Ireland,Luxembourg,4,0,FIFA World Cup qualification,Dublin,Republic of Ireland,False,4,4,Republic of Ireland
3152,3355,3550,1953,Burma,India,2,4,Friendly,Rangoon,Burma,False,6,-2,India
3153,3356,3551,1953,Greece,Israel,1,0,FIFA World Cup qualification,Athens,Greece,False,1,1,Greece
3154,3357,3552,1953,Scotland,Wales,3,3,FIFA World Cup qualification,Glasgow,Scotland,False,6,0,Draw
3155,3358,3555,1953,Spain,Sweden,2,2,Friendly,Bilbao,Spain,False,4,0,Draw
3156,3359,3557,1953,England,Northern Ireland,3,1,FIFA World Cup qualification,Liverpool,England,False,4,2,England
3157,3360,3558,1953,France,Switzerland,2,4,Friendly,Colombes,France,False,6,-2,Switzerland
3158,3361,3559,1953,Egypt,Italy,1,2,FIFA World Cup qualification,Cairo,Egypt,False,3,-1,Italy
3159,3362,3560,1953,Haiti,Jamaica,4,1,Friendly,Port-au-Prince,Haiti,False,5,3,Haiti
3160,3363,3561,1953,Hungary,Sweden,2,2,Friendly,Budapest,Hungary,False,4,0,Draw
3161,3364,3562,1953,Haiti,Jamaica,1,0,Friendly,Port-au-Prince,Haiti,False,1,1,Haiti
3162,3365,3563,1953,Germany,Norway,5,1,FIFA World Cup qualification,Hamburg,Germany,False,6,4,Germany
3163,3366,3564,1953,Portugal,South Africa,3,1,Friendly,Oeiras,Portugal,False,4,2,Portugal
3164,3367,3565,1953,Switzerland,Belgium,2,2,Friendly,Zürich,Switzerland,False,4,0,Draw
3165,3368,3566,1953,England,Hungary,3,6,Friendly,London,England,False,9,-3,Hungary
3166,3369,3567,1953,France,Republic of Ireland,1,0,FIFA World Cup qualification,Paris,France,False,1,1,France
3167,3370,3568,1953,Albania,Poland,2,0,Friendly,Tirana,Albania,False,2,2,Albania
3168,3371,3569,1953,Portugal,Austria,0,0,FIFA World Cup qualification,Oeiras,Portugal,False,0,0,Draw
3169,3373,3571,1953,France,Luxembourg,8,0,FIFA World Cup qualification,Paris,France,False,8,8,France
3170,3374,3572,1953,Haiti,Mexico,0,4,FIFA World Cup qualification,Port-au-Prince,Haiti,False,4,-4,Mexico
3171,3375,3573,1954,Spain,Turkey,4,1,FIFA World Cup qualification,Madrid,Spain,False,5,3,Spain
3172,3376,3574,1954,Mexico,United States,4,0,FIFA World Cup qualification,Mexico City,Mexico,False,4,4,Mexico
3173,3377,3575,1954,Mexico,United States,3,1,FIFA World Cup qualification,Mexico City,Mexico,False,4,2,Mexico
3174,3378,3576,1954,Italy,Egypt,5,1,FIFA World Cup qualification,Milan,Italy,False,6,4,Italy
3175,3379,3577,1954,Egypt,Hungary,0,3,Friendly,Cairo,Egypt,False,3,-3,Hungary
3176,3380,3578,1954,Paraguay,Chile,4,0,FIFA World Cup qualification,Asunción,Paraguay,False,4,4,Paraguay
3177,3381,3579,1954,Chile,Paraguay,1,3,FIFA World Cup qualification,Santiago,Chile,False,4,-2,Paraguay
3178,3382,3580,1954,Chile,Brazil,0,2,FIFA World Cup qualification,Santiago,Chile,False,2,-2,Brazil
3179,3384,3582,1954,Luxembourg,Republic of Ireland,0,1,FIFA World Cup qualification,Luxembourg,Luxembourg,False,1,-1,Republic of Ireland
3180,3385,3583,1954,Paraguay,Brazil,0,1,FIFA World Cup qualification,Asunción,Paraguay,False,1,-1,Brazil
3181,3386,3584,1954,Israel,Greece,0,2,FIFA World Cup qualification,Ramat-Gan,Israel,False,2,-2,Greece
3182,3387,3585,1954,Belgium,Portugal,0,0,Friendly,Brussels,Belgium,False,0,0,Draw
3183,3388,3586,1954,Brazil,Chile,1,0,FIFA World Cup qualification,Rio de Janeiro,Brazil,False,1,1,Brazil
3184,3390,3588,1954,Turkey,Spain,1,0,FIFA World Cup qualification,Istanbul,Turkey,False,1,1,Turkey
3185,3391,3589,1954,Turkey,Spain,2,2,FIFA World Cup qualification,Rome,Italy,True,4,0,Draw
3186,3392,3590,1954,Martinique,Guadeloupe,2,2,Friendly,Fort-de-France,Martinique,False,4,0,Draw
3187,3395,3594,1954,Wales,Northern Ireland,1,2,FIFA World Cup qualification,Wrexham,Wales,False,3,-1,Northern Ireland
3188,3396,3595,1954,Haiti,United States,2,3,FIFA World Cup qualification,Port-au-Prince,Haiti,False,5,-1,United States
3189,3397,3596,1954,Scotland,England,2,4,FIFA World Cup qualification,Glasgow,Scotland,False,6,-2,England
3190,3398,3597,1954,Belgium,Netherlands,4,0,Friendly,Antwerp,Belgium,False,4,4,Belgium
3191,3399,3598,1954,Haiti,United States,0,3,FIFA World Cup qualification,Port-au-Prince,Haiti,False,3,-3,United States
3192,3400,3599,1954,Uruguay,Paraguay,1,4,Friendly,Montevideo,Uruguay,False,5,-3,Paraguay
3193,3401,3600,1954,Austria,Hungary,0,1,Friendly,Vienna,Austria,False,1,-1,Hungary
3194,3402,3601,1954,France,Italy,1,3,Friendly,Colombes,France,False,4,-2,Italy
3195,3403,3602,1954,Paraguay,Uruguay,1,1,Friendly,Asunción,Paraguay,False,2,0,Draw
3196,3404,3603,1954,Singapore,Pakistan,2,2,Friendly,Kallang,Singapore,False,4,0,Draw
3197,3405,3604,1954,Switzerland,Germany,3,5,Friendly,Basel,Switzerland,False,8,-2,Germany
3198,3406,3605,1954,Ethiopia,Djibouti,10,2,Friendly,Addis Abeba,Ethiopia,False,12,8,Ethiopia
3199,3407,3606,1954,South Africa,Israel,2,1,Friendly,Johannesburg,South Africa,False,3,1,South Africa
3200,3408,3607,1954,Zambia,Israel,0,0,Friendly,Kitwe,Northern Rhodesia,False,0,0,Draw
3201,3409,3608,1954,Scotland,Norway,1,0,Friendly,Glasgow,Scotland,False,1,1,Scotland
3202,3410,3609,1954,Zimbabwe,Israel,2,1,Friendly,Salisbury,Southern Rhodesia,False,3,1,Zimbabwe
3203,3411,3611,1954,Austria,Wales,2,0,Friendly,Vienna,Austria,False,2,2,Austria
3204,3412,3613,1954,Zimbabwe,Israel,1,2,Friendly,Bulawayo,Southern Rhodesia,False,3,-1,Israel
3205,3413,3615,1954,Norway,Scotland,1,1,Friendly,Oslo,Norway,False,2,0,Draw
3206,3414,3616,1954,Sweden,Netherlands,6,1,Friendly,Solna,Sweden,False,7,5,Sweden
3207,3415,3617,1954,Guadeloupe,Martinique,2,4,Friendly,Basse-Terre,Guadeloupe,False,6,-2,Martinique
3208,3416,3618,1954,Hungary,England,7,1,Friendly,Budapest,Hungary,False,8,6,Hungary
3209,3417,3619,1954,Switzerland,Uruguay,3,3,Friendly,Lausanne,Switzerland,False,6,0,Draw
3210,3418,3620,1954,Zimbabwe,Zambia,1,0,Friendly,Salisbury,Southern Rhodesia,False,1,1,Zimbabwe
3211,3419,3621,1954,Finland,Scotland,1,2,Friendly,Helsinki,Finland,False,3,-1,Scotland
3212,3420,3622,1954,Austria,Norway,5,0,Friendly,Vienna,Austria,False,5,5,Austria
3213,3421,3623,1954,Belgium,France,3,3,Friendly,Brussels,Belgium,False,6,0,Draw
3214,3422,3624,1954,Switzerland,Netherlands,3,1,Friendly,Zürich,Switzerland,False,4,2,Switzerland
3215,3423,3625,1954,Djibouti,Ethiopia,0,2,Friendly,Djibouti,French Somaliland,False,2,-2,Ethiopia
3216,3424,3626,1954,Ghana,Sierra Leone,2,0,Friendly,Accra,Gold Coast,False,2,2,Ghana
3217,3425,3627,1954,Djibouti,Ethiopia,1,2,Friendly,Djibouti,French Somaliland,False,3,-1,Ethiopia
3218,3427,3629,1954,Denmark,Norway,1,2,Friendly,Malmö,Sweden,True,3,-1,Norway
3219,3428,3630,1954,Sweden,Finland,6,0,Friendly,Gothenburg,Sweden,False,6,6,Sweden
3220,3429,3632,1954,Sweden,Norway,3,0,Friendly,Solna,Sweden,False,3,3,Sweden
3221,3430,3633,1954,Finland,Denmark,2,2,Nordic Championship,Helsinki,Finland,False,4,0,Draw
3222,3431,3634,1954,Austria,Scotland,1,0,FIFA World Cup,Zürich,Switzerland,True,1,1,Austria
3223,3432,3635,1954,Brazil,Mexico,5,0,FIFA World Cup,Geneva,Switzerland,True,5,5,Brazil
3224,3434,3638,1954,Belgium,England,4,4,FIFA World Cup,Basel,Switzerland,True,8,0,Draw
3225,3435,3639,1954,Germany,Turkey,4,1,FIFA World Cup,Berne,Switzerland,True,5,3,Germany
3226,3437,3641,1954,Switzerland,Italy,2,1,FIFA World Cup,Lausanne,Switzerland,False,3,1,Switzerland
3227,3440,3644,1954,France,Mexico,3,2,FIFA World Cup,Geneva,Switzerland,True,5,1,France
3228,3441,3645,1954,Scotland,Uruguay,0,7,FIFA World Cup,Basel,Switzerland,True,7,-7,Uruguay
3229,3442,3646,1954,Belgium,Italy,1,4,FIFA World Cup,Lugano,Switzerland,True,5,-3,Italy
3230,3443,3647,1954,Germany,Hungary,3,8,FIFA World Cup,Basel,Switzerland,True,11,-5,Hungary
3231,3444,3649,1954,Switzerland,England,0,2,FIFA World Cup,Berne,Switzerland,False,2,-2,England
3232,3445,3650,1954,Germany,Turkey,7,2,FIFA World Cup,Zürich,Switzerland,True,9,5,Germany
3233,3446,3651,1954,Switzerland,Italy,4,1,FIFA World Cup,Basel,Switzerland,False,5,3,Switzerland
3234,3447,3652,1954,England,Uruguay,2,4,FIFA World Cup,Basel,Switzerland,True,6,-2,Uruguay
3235,3448,3653,1954,Switzerland,Austria,5,7,FIFA World Cup,Lausanne,Switzerland,False,12,-2,Austria
3236,3449,3654,1954,Brazil,Hungary,2,4,FIFA World Cup,Berne,Switzerland,True,6,-2,Hungary
3237,3451,3656,1954,Austria,Germany,1,6,FIFA World Cup,Basel,Switzerland,True,7,-5,Germany
3238,3452,3657,1954,Hungary,Uruguay,4,2,FIFA World Cup,Lausanne,Switzerland,True,6,2,Hungary
3239,3453,3658,1954,Austria,Uruguay,3,1,FIFA World Cup,Zürich,Switzerland,True,4,2,Austria
3240,3454,3659,1954,Germany,Hungary,3,2,FIFA World Cup,Berne,Switzerland,True,5,1,Germany
3241,3455,3660,1954,Iceland,Norway,1,0,Friendly,Reykjavík,Iceland,False,1,1,Iceland
3242,3456,3661,1954,Madagascar,Réunion,2,6,Friendly,Curepipe,Mauritius,True,8,-4,Réunion
3243,3457,3662,1954,Mauritius,Madagascar,4,1,Friendly,Curepipe,Mauritius,False,5,3,Mauritius
3244,3458,3663,1954,Mauritius,Réunion,11,0,Friendly,Curepipe,Mauritius,False,11,11,Mauritius
3245,3459,3664,1954,Curaçao,Netherlands,2,0,Friendly,Willemstad,Netherlands Antilles,False,2,2,Curaçao
3246,3460,3665,1954,Aruba,Netherlands,2,2,Friendly,Oranjestad,Netherlands Antilles,False,4,0,Draw
3247,3461,3666,1954,Curaçao,Netherlands,2,1,Friendly,Willemstad,Netherlands Antilles,False,3,1,Curaçao
3248,3462,3667,1954,Suriname,Netherlands,3,4,Friendly,Paramaribo,Suriname,False,7,-1,Netherlands
3249,3463,3668,1954,Suriname,Netherlands,0,2,Friendly,Paramaribo,Suriname,False,2,-2,Netherlands
3250,3464,3669,1954,Poland,Bulgaria,2,2,Friendly,Warsaw,Poland,False,4,0,Draw
3251,3465,3670,1954,Australia,New Zealand,1,2,Friendly,Melbourne,Australia,False,3,-1,New Zealand
3252,3466,3671,1954,Finland,Sweden,1,10,Nordic Championship,Helsinki,Finland,False,11,-9,Sweden
3253,3467,3672,1954,Zimbabwe,Zambia,2,4,Friendly,Salisbury,Southern Rhodesia,False,6,-2,Zambia
3254,3468,3673,1954,Sweden,Iceland,3,2,Friendly,Kalmar,Sweden,False,5,1,Sweden
3255,3469,3674,1954,Australia,New Zealand,4,1,Friendly,Brisbane,Australia,False,5,3,Australia
3256,3470,3675,1954,Norway,Finland,3,1,Nordic Championship,Oslo,Norway,False,4,2,Norway
3257,3471,3676,1954,Australia,New Zealand,4,1,Friendly,Sydney,Australia,False,5,3,Australia
3258,3472,3677,1954,Russia,Sweden,7,0,Friendly,Moscow,Soviet Union,False,7,7,Russia
3259,3473,3678,1954,Chile,Peru,2,1,Copa del Pacífico,Santiago,Chile,False,3,1,Chile
3260,3474,3679,1954,Chile,Peru,2,4,Copa del Pacífico,Santiago,Chile,False,6,-2,Peru
3261,3475,3680,1954,Denmark,Switzerland,1,1,Friendly,Copenhagen,Denmark,False,2,0,Draw
3262,3476,3681,1954,Hungary,Romania,5,1,Friendly,Budapest,Hungary,False,6,4,Hungary
3263,3477,3682,1954,Norway,Sweden,1,1,Nordic Championship,Oslo,Norway,False,2,0,Draw
3264,3479,3684,1954,Belgium,Germany,2,0,Friendly,Brussels,Belgium,False,2,2,Belgium
3265,3480,3686,1954,Russia,Hungary,1,1,Friendly,Moscow,Soviet Union,False,2,0,Draw
3266,3481,3688,1954,Northern Ireland,England,0,2,British Championship,Belfast,Northern Ireland,False,2,-2,England
3267,3484,3691,1954,Tanzania,Uganda,3,5,Friendly,Nairobi,Kenya,True,8,-2,Uganda
3268,3485,3692,1954,Kenya,Uganda,2,2,Friendly,Nairobi,Kenya,False,4,0,Draw
3269,3486,3693,1954,Hungary,Switzerland,3,0,Friendly,Budapest,Hungary,False,3,3,Hungary
3270,3487,3694,1954,Kenya,Uganda,1,4,Friendly,Nairobi,Kenya,False,5,-3,Uganda
3271,3488,3695,1954,Sweden,Denmark,5,2,Nordic Championship,Solna,Sweden,False,7,3,Sweden
3272,3489,3696,1954,Germany,France,1,3,Friendly,Hanover,Germany,False,4,-2,France
3273,3490,3697,1954,Wales,Scotland,0,1,British Championship,Cardiff,Wales,False,1,-1,Scotland
3274,3491,3699,1954,Belgium,Netherlands,4,3,Friendly,Antwerp,Belgium,False,7,1,Belgium
3275,3494,3702,1954,Nigeria,Ghana,3,0,Friendly,Lagos,Nigeria,False,3,3,Nigeria
3276,3495,3703,1954,Denmark,Norway,0,1,Nordic Championship,Copenhagen,Denmark,False,1,-1,Norway
3277,3496,3704,1954,Sweden,Austria,2,1,Friendly,Solna,Sweden,False,3,1,Sweden
3278,3497,3705,1954,Cambodia,Thailand,7,1,Friendly,Phnom Penh,Cambodia,False,8,6,Cambodia
3279,3498,3706,1954,Scotland,Northern Ireland,2,2,British Championship,Glasgow,Scotland,False,4,0,Draw
3280,3499,3707,1954,Greece,Egypt,1,1,Friendly,Athens,Greece,False,2,0,Draw
3281,3500,3708,1954,Republic of Ireland,Norway,2,1,Friendly,Dublin,Republic of Ireland,False,3,1,Republic of Ireland
3282,3501,3709,1954,England,Wales,3,2,British Championship,London,England,False,5,1,England
3283,3502,3710,1954,France,Belgium,2,2,Friendly,Colombes,France,False,4,0,Draw
3284,3503,3711,1954,Hungary,Austria,4,1,Friendly,Budapest,Hungary,False,5,3,Hungary
3285,3504,3712,1954,Portugal,Argentina,1,3,Friendly,Oeiras,Portugal,False,4,-2,Argentina
3286,3505,3713,1954,England,Germany,3,1,Friendly,London,England,False,4,2,England
3287,3506,3714,1954,Italy,Argentina,2,0,Friendly,Rome,Italy,False,2,2,Italy
3288,3507,3715,1954,Scotland,Hungary,2,4,Friendly,Glasgow,Scotland,False,6,-2,Hungary
3289,3508,3716,1954,Sri Lanka,Pakistan,1,2,Friendly,Calcutta,India,True,3,-1,Pakistan
3290,3509,3717,1954,India,Burma,2,1,Friendly,Calcutta,India,False,3,1,India
3291,3510,3718,1954,Portugal,Germany,0,3,Friendly,Oeiras,Portugal,False,3,-3,Germany
3292,3511,3719,1954,India,Sri Lanka,1,1,Friendly,Calcutta,India,False,2,0,Draw
3293,3512,3720,1954,Burma,Pakistan,1,1,Friendly,Calcutta,India,True,2,0,Draw
3294,3513,3721,1954,Burma,Sri Lanka,1,2,Friendly,Calcutta,India,True,3,-1,Sri Lanka
3295,3514,3722,1955,Egypt,Bulgaria,1,0,Friendly,Cairo,Egypt,False,1,1,Egypt
3296,3515,3723,1955,Burma,Japan,0,1,Friendly,Rangoon,Burma,False,1,-1,Japan
3297,3516,3724,1955,Italy,Belgium,1,0,Friendly,Bari,Italy,False,1,1,Italy
3298,3517,3725,1955,Lebanon,Bulgaria,2,3,Friendly,Beirut,Lebanon,False,5,-1,Bulgaria
3299,3518,3726,1955,Chile,Ecuador,7,1,Copa América,Santiago,Chile,False,8,6,Chile
3300,3519,3727,1955,Martinique,Guadeloupe,4,1,Friendly,Fort-de-France,Martinique,False,5,3,Martinique
3301,3520,3728,1955,Argentina,Paraguay,5,3,Copa América,Santiago,Chile,True,8,2,Argentina
3302,3521,3729,1955,Chile,Peru,5,4,Copa América,Santiago,Chile,False,9,1,Chile
3303,3522,3730,1955,Argentina,Ecuador,4,0,Copa América,Santiago,Chile,True,4,4,Argentina
3304,3523,3731,1955,Paraguay,Uruguay,1,3,Copa América,Santiago,Chile,True,4,-2,Uruguay
3305,3524,3732,1955,Chile,Uruguay,2,2,Copa América,Santiago,Chile,False,4,0,Draw
3306,3525,3733,1955,Ecuador,Peru,2,4,Copa América,Santiago,Chile,True,6,-2,Peru
3307,3526,3734,1955,Netherlands,Denmark,1,1,Friendly,Amsterdam,Netherlands,False,2,0,Draw
3308,3527,3735,1955,Ecuador,Paraguay,0,2,Copa América,Santiago,Chile,True,2,-2,Paraguay
3309,3528,3736,1955,Spain,France,1,2,Friendly,Madrid,Spain,False,3,-1,France
3310,3529,3737,1955,Chile,Paraguay,5,0,Copa América,Santiago,Chile,False,5,5,Chile
3311,3530,3738,1955,Ecuador,Uruguay,1,5,Copa América,Santiago,Chile,True,6,-4,Uruguay
3312,3531,3739,1955,Paraguay,Peru,1,1,Copa América,Santiago,Chile,True,2,0,Draw
3313,3532,3740,1955,Argentina,Uruguay,6,1,Copa América,Santiago,Chile,True,7,5,Argentina
3314,3533,3742,1955,Chile,Argentina,0,1,Copa América,Santiago,Chile,False,1,-1,Argentina
3315,3534,3743,1955,Germany,Italy,1,2,Friendly,Stuttgart,Germany,False,3,-1,Italy
3316,3535,3744,1955,Peru,Uruguay,2,1,Copa América,Santiago,Chile,True,3,1,Peru
3317,3536,3745,1955,England,Scotland,7,2,British Championship,London,England,False,9,5,England
3318,3537,3746,1955,France,Sweden,2,0,Friendly,Colombes,France,False,2,2,France
3319,3538,3747,1955,Netherlands,Belgium,1,0,Friendly,Amsterdam,Netherlands,False,1,1,Netherlands
3320,3539,3748,1955,Northern Ireland,Wales,2,3,British Championship,Belfast,Northern Ireland,False,5,-1,Wales
3321,3540,3749,1955,Austria,Hungary,2,2,International Cup,Vienna,Austria,False,4,0,Draw
3322,3541,3750,1955,Argentina,Peru,2,2,Copa América,Santiago,Chile,True,4,0,Draw
3323,3542,3751,1955,Republic of Ireland,Netherlands,1,0,Friendly,Dublin,Republic of Ireland,False,1,1,Republic of Ireland
3324,3543,3752,1955,Switzerland,Austria,2,3,International Cup,Berne,Switzerland,False,5,-1,Austria
3325,3544,3753,1955,Scotland,Portugal,3,0,Friendly,Glasgow,Scotland,False,3,3,Scotland
3326,3545,3754,1955,Martinique,Guadeloupe,1,1,Friendly,Fort-de-France,Martinique,False,2,0,Draw
3327,3546,3755,1955,Norway,Hungary,0,5,Friendly,Oslo,Norway,False,5,-5,Hungary
3328,3547,3756,1955,Sweden,Hungary,3,7,Friendly,Solna,Sweden,False,10,-4,Hungary
3329,3548,3757,1955,Denmark,Hungary,0,6,Friendly,Copenhagen,Denmark,False,6,-6,Hungary
3330,3549,3758,1955,France,England,1,0,Friendly,Colombes,France,False,1,1,France
3331,3550,3760,1955,Spain,England,1,1,Friendly,Madrid,Spain,False,2,0,Draw
3332,3551,3761,1955,Austria,Scotland,1,4,Friendly,Vienna,Austria,False,5,-3,Scotland
3333,3552,3762,1955,Finland,Hungary,1,9,Friendly,Helsinki,Finland,False,10,-8,Hungary
3334,3553,3763,1955,Netherlands,Switzerland,4,1,Friendly,Rotterdam,Netherlands,False,5,3,Netherlands
3335,3554,3764,1955,Bulgaria,Egypt,2,1,Friendly,Sofia,Bulgaria,False,3,1,Bulgaria
3336,3555,3765,1955,Portugal,England,3,1,Friendly,Porto,Portugal,False,4,2,Portugal
3337,3556,3766,1955,Norway,Republic of Ireland,1,3,Friendly,Oslo,Norway,False,4,-2,Republic of Ireland
3338,3557,3767,1955,Germany,Republic of Ireland,2,1,Friendly,Hamburg,Germany,False,3,1,Germany
3339,3558,3768,1955,Ghana,Nigeria,1,0,Friendly,Accra,Gold Coast,False,1,1,Ghana
3340,3559,3769,1955,Hungary,Scotland,3,1,Friendly,Budapest,Hungary,False,4,2,Hungary
3341,3561,3771,1955,Romania,Poland,2,2,Friendly,Bucharest,Romania,False,4,0,Draw
3342,3563,3773,1955,Norway,Romania,0,1,Friendly,Oslo,Norway,False,1,-1,Romania
3343,3564,3774,1955,Sweden,Romania,4,1,Friendly,Gothenburg,Sweden,False,5,3,Sweden
3344,3565,3775,1955,El Salvador,Honduras,2,2,Friendly,San Salvador,El Salvador,False,4,0,Draw
3345,3566,3776,1955,Denmark,Finland,2,1,Nordic Championship,Copenhagen,Denmark,False,3,1,Denmark
3346,3567,3777,1955,El Salvador,Honduras,0,0,Friendly,San Salvador,El Salvador,False,0,0,Draw
3347,3568,3778,1955,Switzerland,Spain,0,3,Friendly,Geneva,Switzerland,False,3,-3,Spain
3348,3569,3779,1955,Bulgaria,Poland,1,1,Friendly,Sofia,Bulgaria,False,2,0,Draw
3349,3570,3780,1955,Sweden,Russia,0,6,Friendly,Solna,Sweden,False,6,-6,Russia
3350,3571,3782,1955,Iceland,Denmark,0,4,Friendly,Reykjavík,Iceland,False,4,-4,Denmark
3351,3572,3783,1955,Réunion,Mauritius,1,3,Friendly,Saint-Pierre,Réunion,False,4,-2,Mauritius
3352,3573,3784,1955,Réunion,Madagascar,2,4,Friendly,Saint-Pierre,Réunion,False,6,-2,Madagascar
3353,3574,3786,1955,Madagascar,Mauritius,2,1,Friendly,Saint-Pierre,Réunion,True,3,1,Madagascar
3354,3575,3787,1955,Costa Rica,Guatemala,9,1,Friendly,San José,Costa Rica,False,10,8,Costa Rica
3355,3576,3788,1955,Guatemala,Costa Rica,3,1,Friendly,Guatemala,Guatemala,False,4,2,Guatemala
3356,3577,3789,1955,Costa Rica,Aruba,3,2,CCCF Championship,Tegucigalpa,Honduras,True,5,1,Costa Rica
3357,3578,3790,1955,Finland,Norway,1,3,Nordic Championship,Helsinki,Finland,False,4,-2,Norway
3358,3579,3791,1955,Honduras,Cuba,3,0,CCCF Championship,Tegucigalpa,Honduras,False,3,3,Honduras
3359,3580,3792,1955,Guatemala,El Salvador,2,3,CCCF Championship,Tegucigalpa,Honduras,True,5,-1,El Salvador
3360,3581,3793,1955,Costa Rica,Cuba,6,0,CCCF Championship,Tegucigalpa,Honduras,True,6,6,Costa Rica
3361,3582,3794,1955,Curaçao,Aruba,2,1,CCCF Championship,Tegucigalpa,Honduras,True,3,1,Curaçao
3362,3583,3795,1955,Honduras,El Salvador,3,1,CCCF Championship,Tegucigalpa,Honduras,False,4,2,Honduras
3363,3584,3796,1955,Guatemala,Curaçao,4,1,CCCF Championship,Tegucigalpa,Honduras,True,5,3,Guatemala
3364,3585,3797,1955,Aruba,Cuba,4,1,CCCF Championship,Tegucigalpa,Honduras,True,5,3,Aruba
3365,3586,3798,1955,Costa Rica,El Salvador,4,0,CCCF Championship,Tegucigalpa,Honduras,True,4,4,Costa Rica
3366,3587,3799,1955,El Salvador,Cuba,2,1,CCCF Championship,Tegucigalpa,Honduras,True,3,1,El Salvador
3367,3588,3800,1955,Honduras,Curaçao,0,2,CCCF Championship,Tegucigalpa,Honduras,False,2,-2,Curaçao
3368,3589,3801,1955,Guatemala,Costa Rica,0,2,CCCF Championship,Tegucigalpa,Honduras,True,2,-2,Costa Rica
3369,3590,3802,1955,Russia,Germany,3,2,Friendly,Moscow,Soviet Union,False,5,1,Russia
3370,3591,3803,1955,Honduras,Aruba,1,1,CCCF Championship,Tegucigalpa,Honduras,False,2,0,Draw
3371,3592,3804,1955,Costa Rica,Curaçao,2,1,CCCF Championship,Tegucigalpa,Honduras,True,3,1,Costa Rica
3372,3593,3805,1955,El Salvador,Aruba,2,0,CCCF Championship,Tegucigalpa,Honduras,True,2,2,El Salvador
3373,3594,3806,1955,Iceland,United States,3,2,Friendly,Reykjavík,Iceland,False,5,1,Iceland
3374,3595,3807,1955,Curaçao,El Salvador,3,0,CCCF Championship,Tegucigalpa,Honduras,True,3,3,Curaçao
3375,3596,3808,1955,Curaçao,Cuba,2,0,CCCF Championship,Tegucigalpa,Honduras,True,2,2,Curaçao
3376,3597,3809,1955,Honduras,Costa Rica,1,2,CCCF Championship,Tegucigalpa,Honduras,False,3,-1,Costa Rica
3377,3598,3810,1955,Sweden,Finland,3,0,Nordic Championship,Helsingborg,Sweden,False,3,3,Sweden
3378,3599,3811,1955,Australia,South Africa,0,3,Friendly,Brisbane,Australia,False,3,-3,South Africa
3379,3600,3812,1955,Australia,South Africa,0,2,Friendly,Melbourne,Australia,False,2,-2,South Africa
3380,3601,3813,1955,Finland,Poland,1,3,Friendly,Helsinki,Finland,False,4,-2,Poland
3381,3602,3814,1955,Norway,Denmark,1,1,Nordic Championship,Oslo,Norway,False,2,0,Draw
3382,3603,3815,1955,Russia,India,11,1,Friendly,Moscow,Soviet Union,False,12,10,Russia
3383,3604,3816,1955,Australia,South Africa,0,8,Friendly,Adelaide,Australia,False,8,-8,South Africa
3384,3605,3817,1955,Switzerland,Hungary,4,5,International Cup,Lausanne,Switzerland,False,9,-1,Hungary
3385,3606,3818,1955,Brazil,Chile,1,1,Copa Bernardo O'Higgins,Rio de Janeiro,Brazil,False,2,0,Draw
3386,3608,3820,1955,Brazil,Chile,2,1,Copa Bernardo O'Higgins,São Paulo,Brazil,False,3,1,Brazil
3387,3609,3821,1955,Australia,South Africa,0,6,Friendly,Sydney,Australia,False,6,-6,South Africa
3388,3610,3823,1955,Hungary,Russia,1,1,Friendly,Budapest,Hungary,False,2,0,Draw
3389,3611,3824,1955,Sweden,Norway,1,1,Nordic Championship,Solna,Sweden,False,2,0,Draw
3390,3612,3826,1955,Romania,Belgium,1,0,Friendly,Bucharest,Romania,False,1,1,Romania
3391,3613,3827,1955,Australia,South Africa,1,4,Friendly,Newcastle,Australia,False,5,-3,South Africa
3392,3614,3829,1955,Denmark,England,1,5,Friendly,Copenhagen,Denmark,False,6,-4,England
3393,3615,3830,1955,Northern Ireland,Scotland,2,1,British Championship,Belfast,Northern Ireland,False,3,1,Northern Ireland
3394,3616,3831,1955,Japan,Burma,0,0,Friendly,Tokyo,Japan,False,0,0,Draw
3395,3617,3832,1955,Romania,Bulgaria,1,1,Friendly,Bucharest,Romania,False,2,0,Draw
3396,3618,3833,1955,Switzerland,France,1,2,Friendly,Basel,Switzerland,False,3,-1,France
3397,3619,3834,1955,Kenya,Uganda,0,1,Friendly,Dar es Salaam,Tanganyika,True,1,-1,Uganda
3398,3621,3836,1955,Tanzania,Uganda,1,5,Friendly,Dar es Salaam,Tanganyika,False,6,-4,Uganda
3399,3622,3837,1955,Denmark,Sweden,3,3,Nordic Championship,Copenhagen,Denmark,False,6,0,Draw
3400,3623,3838,1955,Hungary,Austria,6,1,International Cup,Budapest,Hungary,False,7,5,Hungary
3401,3624,3839,1955,Netherlands,Belgium,2,2,Friendly,Rotterdam,Netherlands,False,4,0,Draw
3402,3626,3841,1955,Wales,England,2,1,British Championship,Cardiff,Wales,False,3,1,Wales
3403,3627,3842,1955,Russia,France,2,2,Friendly,Moscow,Soviet Union,False,4,0,Draw
3404,3629,3844,1955,Ghana,Nigeria,7,0,Friendly,Accra,Gold Coast,False,7,7,Ghana
3405,3630,3845,1955,England,Northern Ireland,3,0,British Championship,London,England,False,3,3,England
3406,3631,3846,1955,Netherlands,Norway,3,0,Friendly,Amsterdam,Netherlands,False,3,3,Netherlands
3407,3632,3847,1955,Scotland,Wales,2,0,British Championship,Glasgow,Scotland,False,2,2,Scotland
3408,3634,3849,1955,Brazil,Paraguay,3,0,Copa Oswaldo Cruz,Rio de Janeiro,Brazil,False,3,3,Brazil
3409,3636,3851,1955,Hungary,Sweden,4,2,Friendly,Budapest,Hungary,False,6,2,Hungary
3410,3637,3852,1955,Germany,Norway,2,0,Friendly,Karlsruhe,Germany,False,2,2,Germany
3411,3638,3854,1955,Brazil,Paraguay,3,3,Copa Oswaldo Cruz,Rio de Janeiro,Brazil,False,6,0,Draw
3412,3639,3856,1955,Portugal,Sweden,2,6,Friendly,Oeiras,Portugal,False,8,-4,Sweden
3413,3640,3857,1955,Wales,Austria,1,2,Friendly,Wrexham,Wales,False,3,-1,Austria
3414,3641,3858,1955,Hungary,Italy,2,0,International Cup,Budapest,Hungary,False,2,2,Hungary
3415,3642,3859,1955,Republic of Ireland,Spain,2,2,Friendly,Dublin,Republic of Ireland,False,4,0,Draw
3416,3643,3860,1955,England,Spain,4,1,Friendly,London,England,False,5,3,England
3417,3644,3861,1955,Suriname,Trinidad and Tobago,5,2,Friendly,Paramaribo,Suriname,False,7,3,Suriname
3418,3645,3862,1955,Suriname,Trinidad and Tobago,3,1,Friendly,Paramaribo,Suriname,False,4,2,Suriname
3419,3646,3863,1955,Pakistan,Burma,4,2,Friendly,Dhaka,Pakistan,False,6,2,Pakistan
3420,3647,3864,1955,Italy,Germany,2,1,Friendly,Rome,Italy,False,3,1,Italy
3421,3648,3865,1955,Sri Lanka,India,3,4,Friendly,Dhaka,Pakistan,True,7,-1,India
3422,3649,3866,1955,Suriname,Trinidad and Tobago,3,0,Friendly,Paramaribo,Suriname,False,3,3,Suriname
3423,3650,3867,1955,Turkey,Portugal,3,1,Friendly,Istanbul,Turkey,False,4,2,Turkey
3424,3651,3868,1955,Burma,India,1,2,Friendly,Dhaka,Pakistan,True,3,-1,India
3425,3652,3869,1955,Egypt,Portugal,0,4,Friendly,Cairo,Egypt,False,4,-4,Portugal
3426,3653,3870,1955,Belgium,France,2,1,Friendly,Brussels,Belgium,False,3,1,Belgium
3427,3654,3871,1955,Burma,Sri Lanka,3,1,Friendly,Dhaka,Pakistan,True,4,2,Burma
3428,3655,3872,1956,Curaçao,Martinique,3,1,Friendly,Willemstad,Netherlands Antilles,False,4,2,Curaçao
3429,3656,3873,1956,Curaçao,Martinique,3,1,Friendly,Willemstad,Netherlands Antilles,False,4,2,Curaçao
3430,3657,3874,1956,Uruguay,Paraguay,4,2,Copa América,Montevideo,Uruguay,False,6,2,Uruguay
3431,3658,3875,1956,Argentina,Peru,2,1,Copa América,Montevideo,Uruguay,True,3,1,Argentina
3432,3659,3876,1956,Brazil,Chile,1,4,Copa América,Montevideo,Uruguay,True,5,-3,Chile
3433,3660,3877,1956,Uruguay,Peru,2,0,Copa América,Montevideo,Uruguay,False,2,2,Uruguay
3434,3661,3878,1956,Argentina,Chile,2,0,Copa América,Montevideo,Uruguay,True,2,2,Argentina
3435,3662,3879,1956,Brazil,Paraguay,0,0,Copa América,Montevideo,Uruguay,True,0,0,Draw
3436,3663,3880,1956,Argentina,Paraguay,1,0,Copa América,Montevideo,Uruguay,True,1,1,Argentina
3437,3664,3881,1956,Brazil,Peru,2,1,Copa América,Montevideo,Uruguay,True,3,1,Brazil
3438,3665,3882,1956,Argentina,Brazil,0,1,Copa América,Montevideo,Uruguay,True,1,-1,Brazil
3439,3666,3883,1956,Paraguay,Peru,1,1,Copa América,Montevideo,Uruguay,True,2,0,Draw
3440,3667,3884,1956,Uruguay,Chile,2,1,Copa América,Montevideo,Uruguay,False,3,1,Uruguay
3441,3668,3885,1956,Chile,Peru,4,3,Copa América,Montevideo,Uruguay,True,7,1,Chile
3442,3669,3886,1956,Uruguay,Brazil,0,0,Copa América,Montevideo,Uruguay,False,0,0,Draw
3443,3670,3887,1956,Chile,Paraguay,2,0,Copa América,Montevideo,Uruguay,True,2,2,Chile
3444,3671,3888,1956,Italy,France,2,0,Friendly,Bologna,Italy,False,2,2,Italy
3445,3672,3889,1956,Uruguay,Argentina,1,0,Copa América,Montevideo,Uruguay,False,1,1,Uruguay
3446,3673,3890,1956,Turkey,Hungary,3,1,Friendly,Istanbul,Turkey,False,4,2,Turkey
3447,3675,3892,1956,Mexico,Costa Rica,1,1,Pan American Championship,Mexico City,Mexico,False,2,0,Draw
3448,3676,3893,1956,Argentina,Peru,0,0,Pan American Championship,Mexico City,Mexico,True,0,0,Draw
3449,3677,3894,1956,Lebanon,Hungary,1,4,Friendly,Beirut,Lebanon,False,5,-3,Hungary
3450,3678,3895,1956,Brazil,Chile,2,1,Pan American Championship,Mexico City,Mexico,True,3,1,Brazil
3451,3679,3896,1956,Mexico,Peru,0,2,Pan American Championship,Mexico City,Mexico,False,2,-2,Peru
3452,3680,3897,1956,Argentina,Costa Rica,4,3,Pan American Championship,Mexico City,Mexico,True,7,1,Argentina
3453,3681,3898,1956,Brazil,Peru,1,0,Pan American Championship,Mexico City,Mexico,True,1,1,Brazil
3454,3682,3899,1956,Chile,Costa Rica,1,2,Pan American Championship,Mexico City,Mexico,True,3,-1,Costa Rica
3455,3683,3900,1956,Haiti,Panama,3,2,Friendly,Port-au-Prince,Haiti,False,5,1,Haiti
3456,3684,3901,1956,Mexico,Brazil,1,2,Pan American Championship,Mexico City,Mexico,False,3,-1,Brazil
3457,3685,3902,1956,Panama,Venezuela,0,1,Friendly,Port-au-Prince,Haiti,True,1,-1,Venezuela
3458,3686,3903,1956,Haiti,Venezuela,1,1,Friendly,Port-au-Prince,Haiti,False,2,0,Draw
3459,3687,3904,1956,Argentina,Chile,3,0,Pan American Championship,Mexico City,Mexico,True,3,3,Argentina
3460,3688,3905,1956,Belgium,Switzerland,1,3,Friendly,Brussels,Belgium,False,4,-2,Switzerland
3461,3689,3906,1956,Haiti,Panama,2,1,Friendly,Port-au-Prince,Haiti,False,3,1,Haiti
3462,3690,3907,1956,Brazil,Costa Rica,7,1,Pan American Championship,Mexico City,Mexico,True,8,6,Brazil
3463,3691,3908,1956,Mexico,Argentina,0,0,Pan American Championship,Mexico City,Mexico,False,0,0,Draw
3464,3692,3909,1956,Germany,Netherlands,1,2,Friendly,Düsseldorf,Germany,False,3,-1,Netherlands
3465,3693,3910,1956,Panama,Venezuela,2,4,Friendly,Port-au-Prince,Haiti,True,6,-2,Venezuela
3466,3694,3911,1956,Chile,Peru,2,2,Pan American Championship,Mexico City,Mexico,True,4,0,Draw
3467,3695,3912,1956,Haiti,Venezuela,3,0,Friendly,Port-au-Prince,Haiti,False,3,3,Haiti
3468,3696,3913,1956,Costa Rica,Peru,4,2,Pan American Championship,Mexico City,Mexico,True,6,2,Costa Rica
3469,3697,3914,1956,Malaysia,Cambodia,9,2,AFC Asian Cup qualification,Kuala Lumpur,Malaya,True,11,7,Malaysia
3470,3698,3915,1956,Argentina,Brazil,2,2,Pan American Championship,Mexico City,Mexico,True,4,0,Draw
3471,3699,3916,1956,France,Austria,3,1,Friendly,Colombes,France,False,4,2,France
3472,3700,3917,1956,Portugal,Turkey,3,1,Friendly,Oeiras,Portugal,False,4,2,Portugal
3473,3701,3918,1956,Guadeloupe,Curaçao,1,2,Friendly,Fort-de-France,Martinique,True,3,-1,Curaçao
3474,3702,3919,1956,Martinique,Curaçao,0,1,Friendly,Fort-de-France,Martinique,False,1,-1,Curaçao
3475,3703,3920,1956,Belgium,Netherlands,0,1,Friendly,Antwerp,Belgium,False,1,-1,Netherlands
3476,3704,3921,1956,Portugal,Brazil,0,1,Friendly,Oeiras,Portugal,False,1,-1,Brazil
3477,3705,3922,1956,Switzerland,Brazil,1,1,Friendly,Zürich,Switzerland,False,2,0,Draw
3478,3706,3923,1956,Wales,Northern Ireland,1,1,British Championship,Cardiff,Wales,False,2,0,Draw
3479,3707,3924,1956,Scotland,England,1,1,British Championship,Glasgow,Scotland,False,2,0,Draw
3480,3708,3925,1956,Austria,Brazil,2,3,Friendly,Vienna,Austria,False,5,-1,Brazil
3481,3709,3929,1956,Cambodia,Malaysia,3,2,AFC Asian Cup qualification,Phnom Penh,Cambodia,False,5,1,Cambodia
3482,3710,3930,1956,Italy,Brazil,3,0,Friendly,Milan,Italy,False,3,3,Italy
3483,3711,3931,1956,Martinique,Guadeloupe,3,0,Friendly,Fort-de-France,Martinique,False,3,3,Martinique
3484,3713,3934,1956,Turkey,Brazil,0,1,Friendly,Istanbul,Turkey,False,1,-1,Brazil
3485,3714,3935,1956,Scotland,Austria,1,1,Friendly,Glasgow,Scotland,False,2,0,Draw
3486,3715,3937,1956,England,Brazil,4,2,Friendly,London,England,False,6,2,England
3487,3716,3938,1956,Netherlands,Republic of Ireland,1,4,Friendly,Rotterdam,Netherlands,False,5,-3,Republic of Ireland
3488,3718,3940,1956,Sweden,England,0,0,Friendly,Solna,Sweden,False,0,0,Draw
3489,3719,3941,1956,Finland,England,1,5,Friendly,Helsinki,Finland,False,6,-4,England
3490,3720,3942,1956,Guadeloupe,Martinique,2,2,Friendly,Basse-Terre,Guadeloupe,False,4,0,Draw
3491,3722,3944,1956,Russia,Denmark,5,1,Friendly,Moscow,Soviet Union,False,6,4,Russia
3492,3724,3946,1956,Norway,Poland,0,0,Friendly,Oslo,Norway,False,0,0,Draw
3493,3725,3947,1956,Belgium,Hungary,5,4,Friendly,Brussels,Belgium,False,9,1,Belgium
3494,3726,3948,1956,Portugal,Spain,3,1,Friendly,Oeiras,Portugal,False,4,2,Portugal
3495,3728,3950,1956,Portugal,Hungary,2,2,Friendly,Oeiras,Portugal,False,4,0,Draw
3496,3729,3951,1956,Finland,Sweden,1,3,Nordic Championship,Helsinki,Finland,False,4,-2,Sweden
3497,3730,3952,1956,Paraguay,Brazil,0,2,Copa Oswaldo Cruz,Asunción,Paraguay,False,2,-2,Brazil
3498,3731,3953,1956,Norway,Germany,1,3,Friendly,Oslo,Norway,False,4,-2,Germany
3499,3733,3955,1956,Paraguay,Brazil,2,5,Copa Oswaldo Cruz,Asunción,Paraguay,False,7,-3,Brazil
3500,3734,3956,1956,Romania,Sweden,0,2,Friendly,Bucharest,Romania,False,2,-2,Sweden
3501,3735,3958,1956,Argentina,Italy,1,0,Friendly,Avellaneda,Argentina,False,1,1,Argentina
3502,3736,3959,1956,Brazil,Uruguay,2,0,Atlantic Cup,Rio de Janeiro,Brazil,False,2,2,Brazil
3503,3737,3960,1956,Denmark,Norway,2,3,Nordic Championship,Copenhagen,Denmark,False,5,-1,Norway
3504,3739,3962,1956,Romania,Norway,2,0,Friendly,Bucharest,Romania,False,2,2,Romania
3505,3740,3963,1956,Finland,Iceland,2,1,Friendly,Helsinki,Finland,False,3,1,Finland
3506,3741,3964,1956,Mauritius,Réunion,8,3,Friendly,Antananarivo,Madagascar,True,11,5,Mauritius
3507,3742,3965,1956,Sweden,Germany,2,2,Friendly,Solna,Sweden,False,4,0,Draw
3508,3743,3966,1956,Brazil,Italy,2,0,Friendly,Rio de Janeiro,Brazil,False,2,2,Brazil
3509,3744,3967,1956,Denmark,Russia,2,5,Friendly,Copenhagen,Denmark,False,7,-3,Russia
3510,3745,3968,1956,Uruguay,Argentina,1,2,Atlantic Cup,Montevideo,Uruguay,False,3,-1,Argentina
3511,3746,3969,1956,Madagascar,Réunion,4,2,Friendly,Antananarivo,Madagascar,False,6,2,Madagascar
3512,3747,3970,1956,Argentina,Brazil,0,0,Atlantic Cup,Avellaneda,Argentina,False,0,0,Draw
3513,3748,3971,1956,Madagascar,Mauritius,3,3,Friendly,Antananarivo,Madagascar,False,6,0,Draw
3514,3749,3972,1956,Hungary,Poland,4,1,Friendly,Budapest,Hungary,False,5,3,Hungary
3515,3750,3973,1956,Paraguay,Uruguay,2,2,Friendly,Asunción,Paraguay,False,4,0,Draw
3516,3752,3975,1956,Belarus,Kyrgyzstan,1,0,Friendly,Moscow,Soviet Union,True,1,1,Belarus
3517,3753,3976,1956,Estonia,Lithuania,0,1,Friendly,Moscow,Soviet Union,True,1,-1,Lithuania
3518,3755,3978,1956,Russia,Lithuania,2,0,Friendly,Moscow,Soviet Union,False,2,2,Russia
3519,3757,3980,1956,Russia,Belarus,5,1,Friendly,Moscow,Soviet Union,False,6,4,Russia
3520,3758,3982,1956,Estonia,Lithuania,0,2,Friendly,Moscow,Soviet Union,True,2,-2,Lithuania
3521,3759,3983,1956,Russia,Belarus,4,2,Friendly,Moscow,Soviet Union,False,6,2,Russia
3522,3760,3984,1956,Lithuania,Moldova,1,4,Friendly,Moscow,Soviet Union,True,5,-3,Moldova
3523,3762,3986,1956,Paraguay,Argentina,0,1,Copa Chevallier Boutell,Asunción,Paraguay,False,1,-1,Argentina
3524,3765,3990,1956,Norway,Finland,1,1,Nordic Championship,Oslo,Norway,False,2,0,Draw
3525,3766,3991,1956,Poland,Bulgaria,1,2,Friendly,Wrocław,Poland,False,3,-1,Bulgaria
3526,3767,3992,1956,Hong Kong,Israel,2,3,AFC Asian Cup,So Kon Po,Hong Kong,False,5,-1,Israel
3527,3771,3997,1956,Bulgaria,Romania,2,0,Friendly,Sofia,Bulgaria,False,2,2,Bulgaria
3528,3772,3998,1956,Croatia,Indonesia,5,2,Friendly,Zagreb,Yugoslavia,False,7,3,Croatia
3529,3774,4000,1956,Singapore,Pakistan,1,1,Friendly,Kallang,Singapore,False,2,0,Draw
3530,3775,4001,1956,Germany,Russia,1,2,Friendly,Hanover,Germany,False,3,-1,Russia
3531,3776,4003,1956,Switzerland,Netherlands,2,3,Friendly,Lausanne,Switzerland,False,5,-1,Netherlands
3532,3777,4004,1956,Finland,Denmark,0,4,Nordic Championship,Helsinki,Finland,False,4,-4,Denmark
3533,3778,4005,1956,Norway,Sweden,3,1,Nordic Championship,Oslo,Norway,False,4,2,Norway
3534,3780,4009,1956,Russia,Hungary,0,1,Friendly,Moscow,Soviet Union,False,1,-1,Hungary
3535,3781,4010,1956,Guyana,Suriname,1,1,Friendly,Georgetown,British Guyana,False,2,0,Draw
3536,3782,4011,1956,Guyana,Suriname,2,1,Friendly,Georgetown,British Guyana,False,3,1,Guyana
3537,3783,4012,1956,Austria,Luxembourg,7,0,FIFA World Cup qualification,Vienna,Austria,False,7,7,Austria
3538,3784,4013,1956,Guyana,Suriname,1,2,Friendly,Georgetown,British Guyana,False,3,-1,Suriname
3539,3785,4015,1956,Republic of Ireland,Denmark,2,1,FIFA World Cup qualification,Dublin,Republic of Ireland,False,3,1,Republic of Ireland
3540,3786,4017,1956,Nigeria,Togo,1,1,Friendly,Lagos,Nigeria,False,2,0,Draw
3541,3787,4018,1956,Northern Ireland,England,1,1,British Championship,Belfast,Northern Ireland,False,2,0,Draw
3542,3788,4020,1956,France,Hungary,1,2,Friendly,Colombes,France,False,3,-1,Hungary
3543,3789,4022,1956,Uruguay,Argentina,1,2,Friendly,Paysandú,Uruguay,False,3,-1,Argentina
3544,3790,4023,1956,Austria,Hungary,0,2,Friendly,Vienna,Austria,False,2,-2,Hungary
3545,3791,4024,1956,Belgium,Netherlands,2,3,Friendly,Antwerp,Belgium,False,5,-1,Netherlands
3546,3793,4027,1956,Togo,Ghana,1,1,Friendly,Lomé,Togo,False,2,0,Draw
3547,3794,4028,1956,Wales,Scotland,2,2,British Championship,Cardiff,Wales,False,4,0,Draw
3548,3795,4029,1956,France,Russia,2,1,Friendly,Colombes,France,False,3,1,France
3549,3796,4030,1956,Sweden,Denmark,1,1,Nordic Championship,Solna,Sweden,False,2,0,Draw
3550,3797,4032,1956,Nigeria,Ghana,3,0,Friendly,Lagos,Nigeria,False,3,3,Nigeria
3551,3798,4033,1956,Poland,Norway,5,3,Friendly,Warsaw,Poland,False,8,2,Poland
3552,3799,4035,1956,Denmark,Netherlands,2,2,Friendly,Copenhagen,Denmark,False,4,0,Draw
3553,3800,4036,1956,Poland,Finland,5,0,Friendly,Cracow,Poland,False,5,5,Poland
3554,3801,4037,1956,Scotland,Northern Ireland,1,0,British Championship,Glasgow,Scotland,False,1,1,Scotland
3555,3802,4038,1956,Philippines,United States,0,4,Friendly,Manila,Philippines,False,4,-4,United States
3556,3803,4039,1956,Sierra Leone,Gambia,1,0,Friendly,Freetown,Sierra Leone,False,1,1,Sierra Leone
3557,3804,4040,1956,France,Belgium,6,3,FIFA World Cup qualification,Colombes,France,False,9,3,France
3558,3805,4041,1956,Switzerland,Italy,1,1,International Cup,Berne,Switzerland,False,2,0,Draw
3559,3806,4042,1956,Argentina,Uruguay,2,2,Friendly,Buenos Aires,Argentina,False,4,0,Draw
3560,3807,4043,1956,England,Wales,3,1,British Championship,London,England,False,4,2,England
3561,3808,4044,1956,Ethiopia,Sudan,2,1,Friendly,Addis Abeba,Ethiopia,False,3,1,Ethiopia
3562,3809,4045,1956,Indonesia,United States,7,5,Friendly,Jakarta,Indonesia,False,12,2,Indonesia
3563,3810,4046,1956,Turkey,Poland,1,1,Friendly,Istanbul,Turkey,False,2,0,Draw
3564,3811,4047,1956,Germany,Switzerland,1,3,Friendly,Frankfurt am Main,Germany,False,4,-2,Switzerland
3565,3813,4050,1956,Republic of Ireland,Germany,3,0,Friendly,Dublin,Republic of Ireland,False,3,3,Republic of Ireland
3566,3814,4051,1956,Tanzania,Kenya,0,9,Friendly,Kampala,Uganda,True,9,-9,Kenya
3567,3818,4055,1956,Uganda,Kenya,3,2,Friendly,Kampala,Uganda,False,5,1,Uganda
3568,3819,4056,1956,England,Denmark,5,2,FIFA World Cup qualification,Wolverhampton,England,False,7,3,England
3569,3820,4057,1956,Italy,Austria,2,1,International Cup,Genoa,Italy,False,3,1,Italy
3570,3821,4058,1956,Australia,India,1,7,Friendly,Sydney,Australia,False,8,-6,India
3571,3822,4059,1956,Singapore,Bulgaria,2,10,Friendly,Kallang,Singapore,False,12,-8,Bulgaria
3572,3823,4060,1956,Ghana,Sierra Leone,4,3,Friendly,Accra,Gold Coast,False,7,1,Ghana
3573,3824,4061,1956,Germany,Belgium,4,1,Friendly,Cologne,Germany,False,5,3,Germany
3574,3827,4064,1957,Portugal,Northern Ireland,1,1,FIFA World Cup qualification,Lisbon,Portugal,False,2,0,Draw
3575,3828,4065,1957,Jamaica,Trinidad and Tobago,2,0,Friendly,Kingston,Jamaica,False,2,2,Jamaica
3576,3829,4066,1957,Jamaica,Trinidad and Tobago,1,0,Friendly,Kingston,Jamaica,False,1,1,Jamaica
3577,3830,4067,1957,Jamaica,Trinidad and Tobago,2,1,Friendly,Kingston,Jamaica,False,3,1,Jamaica
3578,3831,4068,1957,Spain,Netherlands,5,1,Friendly,Madrid,Spain,False,6,4,Spain
3579,3832,4069,1957,Singapore,India,2,3,Friendly,Kallang,Singapore,False,5,-1,India
3580,3833,4070,1957,Guatemala,Costa Rica,2,6,FIFA World Cup qualification,Guatemala,Guatemala,False,8,-4,Costa Rica
3581,3834,4071,1957,Sudan,Egypt,1,2,African Cup of Nations,Khartoum,Sudan,False,3,-1,Egypt
3582,3835,4072,1957,Egypt,Ethiopia,4,0,African Cup of Nations,Khartoum,Sudan,True,4,4,Egypt
3583,3836,4073,1957,Malaysia,India,2,3,Friendly,Kuala Lumpur,Malaya,False,5,-1,India
3584,3837,4074,1957,Costa Rica,Guatemala,3,1,FIFA World Cup qualification,San José,Costa Rica,False,4,2,Costa Rica
3585,3838,4075,1957,Sudan,Egypt,3,4,Friendly,Khartoum,Sudan,False,7,-1,Egypt
3586,3839,4076,1957,Malta,Austria,2,3,Friendly,Gżira,Malta,False,5,-1,Austria
3587,3840,4077,1957,Costa Rica,Curaçao,4,0,FIFA World Cup qualification,San José,Costa Rica,False,4,4,Costa Rica
3588,3841,4078,1957,Ecuador,Uruguay,2,5,Copa América,Lima,Peru,True,7,-3,Uruguay
3589,3842,4079,1957,Sudan,Syria,1,0,FIFA World Cup qualification,Khartoum,Sudan,False,1,1,Sudan
3590,3843,4080,1957,Austria,Germany,2,3,Friendly,Vienna,Austria,False,5,-1,Germany
3591,3844,4082,1957,Guatemala,Curaçao,1,3,FIFA World Cup qualification,Guatemala,Guatemala,False,4,-2,Curaçao
3592,3845,4083,1957,Peru,Ecuador,2,1,Copa América,Lima,Peru,False,3,1,Peru
3593,3846,4084,1957,Spain,Switzerland,2,2,FIFA World Cup qualification,Madrid,Spain,False,4,0,Draw
3594,3847,4085,1957,Argentina,Colombia,8,2,Copa América,Lima,Peru,True,10,6,Argentina
3595,3848,4086,1957,Brazil,Chile,4,2,Copa América,Lima,Peru,True,6,2,Brazil
3596,3849,4087,1957,Peru,Chile,1,0,Copa América,Lima,Peru,False,1,1,Peru
3597,3850,4088,1957,Argentina,Ecuador,3,0,Copa América,Lima,Peru,True,3,3,Argentina
3598,3851,4089,1957,Colombia,Uruguay,1,0,Copa América,Lima,Peru,True,1,1,Colombia
3599,3852,4090,1957,Argentina,Uruguay,4,0,Copa América,Lima,Peru,True,4,4,Argentina
3600,3853,4091,1957,Netherlands,Luxembourg,4,1,FIFA World Cup qualification,Rotterdam,Netherlands,False,5,3,Netherlands
3601,3854,4092,1957,Brazil,Ecuador,7,1,Copa América,Lima,Peru,True,8,6,Brazil
3602,3855,4093,1957,Chile,Colombia,3,2,Copa América,Lima,Peru,True,5,1,Chile
3603,3856,4094,1957,Peru,Uruguay,3,5,Copa América,Lima,Peru,False,8,-2,Uruguay
3604,3857,4095,1957,Brazil,Colombia,9,0,Copa América,Lima,Peru,True,9,9,Brazil
3605,3858,4096,1957,Chile,Ecuador,2,2,Copa América,Lima,Peru,True,4,0,Draw
3606,3859,4097,1957,Peru,Colombia,4,1,Copa América,Lima,Peru,False,5,3,Peru
3607,3860,4098,1957,Argentina,Chile,6,2,Copa América,Lima,Peru,True,8,4,Argentina
3608,3861,4099,1957,Brazil,Uruguay,2,3,Copa América,Lima,Peru,True,5,-1,Uruguay
3609,3862,4100,1957,Belgium,Spain,0,5,Friendly,Brussels,Belgium,False,5,-5,Spain
3610,3863,4101,1957,Peru,Brazil,0,1,Copa América,Lima,Peru,False,1,-1,Brazil
3611,3864,4102,1957,Chile,Uruguay,0,2,Copa América,Lima,Peru,True,2,-2,Uruguay
3612,3865,4103,1957,Colombia,Ecuador,4,1,Copa América,Lima,Peru,True,5,3,Colombia
3613,3866,4104,1957,Argentina,Brazil,3,0,Copa América,Lima,Peru,True,3,3,Argentina
3614,3867,4105,1957,Netherlands,Germany,1,2,Friendly,Amsterdam,Netherlands,False,3,-1,Germany
3615,3868,4106,1957,England,Scotland,2,1,British Championship,London,England,False,3,1,England
3616,3869,4107,1957,Peru,Argentina,2,1,Copa América,Lima,Peru,False,3,1,Peru
3617,3870,4108,1957,Mexico,United States,6,0,FIFA World Cup qualification,Mexico City,Mexico,False,6,6,Mexico
3618,3871,4109,1957,Peru,Argentina,1,4,Friendly,Lima,Peru,False,5,-3,Argentina
3619,3872,4110,1957,Northern Ireland,Wales,0,0,British Championship,Belfast,Northern Ireland,False,0,0,Draw
3620,3873,4111,1957,Peru,Brazil,1,1,FIFA World Cup qualification,Lima,Peru,False,2,0,Draw
3621,3874,4112,1957,Austria,Switzerland,4,0,International Cup,Vienna,Austria,False,4,4,Austria
3622,3875,4113,1957,Mauritius,Réunion,1,0,Friendly,Curepipe,Mauritius,False,1,1,Mauritius
3623,3876,4114,1957,Martinique,Guadeloupe,6,1,Friendly,Fort-de-France,Martinique,False,7,5,Martinique
3624,3877,4115,1957,Brazil,Peru,1,0,FIFA World Cup qualification,Rio de Janeiro,Brazil,False,1,1,Brazil
3625,3878,4116,1957,Italy,Northern Ireland,1,0,FIFA World Cup qualification,Rome,Italy,False,1,1,Italy
3626,3879,4117,1957,Netherlands,Belgium,1,1,Friendly,Amsterdam,Netherlands,False,2,0,Draw
3627,3880,4118,1957,United States,Mexico,2,7,FIFA World Cup qualification,Long Beach,United States,False,9,-5,Mexico
3628,3881,4119,1957,Northern Ireland,Portugal,3,0,FIFA World Cup qualification,Belfast,Northern Ireland,False,3,3,Northern Ireland
3629,3883,4121,1957,Austria,Sweden,1,0,Friendly,Vienna,Austria,False,1,1,Austria
3630,3885,4123,1957,England,Republic of Ireland,5,1,FIFA World Cup qualification,London,England,False,6,4,England
3631,3886,4124,1957,Scotland,Spain,4,2,FIFA World Cup qualification,Glasgow,Scotland,False,6,2,Scotland
3632,3888,4127,1957,Denmark,England,1,4,FIFA World Cup qualification,Copenhagen,Denmark,False,5,-3,England
3633,3889,4128,1957,Guadeloupe,Martinique,5,2,Friendly,Basse-Terre,Guadeloupe,False,7,3,Guadeloupe
3634,3890,4131,1957,Republic of Ireland,England,1,1,FIFA World Cup qualification,Dublin,Republic of Ireland,False,2,0,Draw
3635,3891,4132,1957,Poland,Turkey,0,1,Friendly,Warsaw,Poland,False,1,-1,Turkey
3636,3892,4133,1957,Switzerland,Scotland,1,2,FIFA World Cup qualification,Basel,Switzerland,False,3,-1,Scotland
3637,3893,4134,1957,Germany,Scotland,1,3,Friendly,Stuttgart,Germany,False,4,-2,Scotland
3638,3894,4135,1957,Norway,Bulgaria,1,2,FIFA World Cup qualification,Oslo,Norway,False,3,-1,Bulgaria
3639,3895,4136,1957,Uruguay,Argentina,0,0,Copa Newton,Montevideo,Uruguay,False,0,0,Draw
3640,3896,4137,1957,Syria,Sudan,1,1,FIFA World Cup qualification,Damascus,Syria,False,2,0,Draw
3641,3897,4138,1957,Austria,Netherlands,3,2,FIFA World Cup qualification,Vienna,Austria,False,5,1,Austria
3642,3898,4139,1957,Belgium,Romania,1,0,Friendly,Brussels,Belgium,False,1,1,Belgium
3643,3899,4141,1957,Denmark,Bulgaria,1,1,Friendly,Copenhagen,Denmark,False,2,0,Draw
3644,3900,4142,1957,Portugal,Italy,3,0,FIFA World Cup qualification,Oeiras,Portugal,False,3,3,Portugal
3645,3901,4143,1957,Spain,Scotland,4,1,FIFA World Cup qualification,Madrid,Spain,False,5,3,Spain
3646,3902,4144,1957,Russia,Romania,1,1,Friendly,Moscow,Soviet Union,False,2,0,Draw
3647,3903,4146,1957,France,Iceland,8,0,FIFA World Cup qualification,Nantes,France,False,8,8,France
3648,3904,4147,1957,Tunisia,Libya,4,2,Friendly,Tunis,Tunisia,False,6,2,Tunisia
3649,3905,4148,1957,Argentina,Uruguay,1,1,Copa Lipton,Buenos Aires,Argentina,False,2,0,Draw
3650,3906,4149,1957,Belgium,Iceland,8,3,FIFA World Cup qualification,Brussels,Belgium,False,11,5,Belgium
3651,3907,4150,1957,Paraguay,Bolivia,5,2,Copa Paz del Chaco,Asunción,Paraguay,False,7,3,Paraguay
3652,3908,4151,1957,Brazil,Portugal,2,1,Friendly,Rio de Janeiro,Brazil,False,3,1,Brazil
3653,3909,4152,1957,Norway,Hungary,2,1,FIFA World Cup qualification,Oslo,Norway,False,3,1,Norway
3654,3910,4153,1957,Paraguay,Bolivia,0,1,Copa Paz del Chaco,Asunción,Paraguay,False,1,-1,Bolivia
3655,3911,4154,1957,Brazil,Portugal,3,0,Friendly,São Paulo,Brazil,False,3,3,Brazil
3656,3912,4155,1957,Colombia,Uruguay,1,1,FIFA World Cup qualification,Bogotá,Colombia,False,2,0,Draw
3657,3913,4157,1957,Greece,Romania,1,2,FIFA World Cup qualification,Athens,Greece,False,3,-1,Romania
3658,3914,4158,1957,Sweden,Hungary,0,0,Friendly,Solna,Sweden,False,0,0,Draw
3659,3915,4159,1957,Finland,Denmark,2,0,Friendly,Helsinki,Finland,False,2,2,Finland
3660,3916,4160,1957,Norway,Sweden,0,0,Friendly,Turku,Finland,True,0,0,Draw
3661,3917,4161,1957,Denmark,Norway,2,0,Friendly,Tampere,Finland,True,2,2,Denmark
3662,3918,4162,1957,Finland,Sweden,1,5,Friendly,Helsinki,Finland,False,6,-4,Sweden
3663,3919,4163,1957,Colombia,Paraguay,2,3,FIFA World Cup qualification,Bogotá,Colombia,False,5,-1,Paraguay
3664,3920,4164,1957,Canada,United States,5,1,FIFA World Cup qualification,Toronto,Canada,False,6,4,Canada
3665,3921,4166,1957,Colombia,Paraguay,1,2,Friendly,Medellín,Colombia,False,3,-1,Paraguay
3666,3922,4167,1957,Hungary,Bulgaria,4,1,FIFA World Cup qualification,Budapest,Hungary,False,5,3,Hungary
3667,3923,4168,1957,Russia,Poland,3,0,FIFA World Cup qualification,Moscow,Soviet Union,True,3,3,Russia
3668,3925,4170,1957,Denmark,Sweden,1,2,Nordic Championship,Copenhagen,Denmark,False,3,-1,Sweden
3669,3926,4171,1957,Mexico,Canada,3,0,FIFA World Cup qualification,Mexico City,Mexico,False,3,3,Mexico
3670,3927,4172,1957,Uruguay,Colombia,1,0,FIFA World Cup qualification,Montevideo,Uruguay,False,1,1,Uruguay
3671,3928,4173,1957,Mexico,Canada,2,0,FIFA World Cup qualification,Mexico City,Mexico,False,2,2,Mexico
3672,3929,4174,1957,Finland,Poland,1,3,FIFA World Cup qualification,Helsinki,Finland,False,4,-2,Poland
3673,3930,4175,1957,United States,Canada,2,3,FIFA World Cup qualification,St. Louis,United States,False,5,-1,Canada
3674,3931,4176,1957,Brazil,Argentina,1,2,Copa Roca,Rio de Janeiro,Brazil,False,3,-1,Argentina
3675,3932,4177,1957,Paraguay,Colombia,3,0,FIFA World Cup qualification,Asunción,Paraguay,False,3,3,Paraguay
3676,3933,4178,1957,Iceland,Norway,0,3,Friendly,Reykjavík,Iceland,False,3,-3,Norway
3677,3934,4179,1957,Brazil,Argentina,2,0,Copa Roca,São Paulo,Brazil,False,2,2,Brazil
3678,3935,4180,1957,Iceland,Denmark,2,6,Friendly,Reykjavík,Iceland,False,8,-4,Denmark
3679,3936,4181,1957,Denmark,Norway,1,3,Friendly,Reykjavík,Iceland,True,4,-2,Norway
3680,3937,4182,1957,Paraguay,Uruguay,5,0,FIFA World Cup qualification,Asunción,Paraguay,False,5,5,Paraguay
3681,3938,4183,1957,Bulgaria,Russia,0,4,Friendly,Sofia,Bulgaria,False,4,-4,Russia
3682,3939,4185,1957,Russia,Finland,2,1,FIFA World Cup qualification,Moscow,Soviet Union,True,3,1,Russia
3683,3940,4186,1957,Uruguay,Paraguay,2,0,FIFA World Cup qualification,Montevideo,Uruguay,False,2,2,Uruguay
3684,3941,4187,1957,Curaçao,Costa Rica,1,2,FIFA World Cup qualification,Willemstad,Netherlands Antilles,True,3,-1,Costa Rica
3685,3942,4188,1957,Curaçao,Haiti,1,3,CCCF Championship,Willemstad,Netherlands Antilles,False,4,-2,Haiti
3686,3943,4189,1957,Cuba,Panama,0,1,CCCF Championship,Willemstad,Netherlands Antilles,True,1,-1,Panama
3687,3944,4190,1957,Finland,Russia,0,10,FIFA World Cup qualification,Helsinki,Finland,False,10,-10,Russia
3688,3945,4191,1957,Bolivia,Paraguay,3,3,Copa Paz del Chaco,La Paz,Bolivia,False,6,0,Draw
3689,3946,4192,1957,Curaçao,Cuba,2,0,CCCF Championship,Willemstad,Netherlands Antilles,False,2,2,Curaçao
3690,3947,4193,1957,Bolivia,Paraguay,2,1,Copa Paz del Chaco,La Paz,Bolivia,False,3,1,Bolivia
3691,3948,4194,1957,Cuba,Honduras,0,2,CCCF Championship,Willemstad,Netherlands Antilles,True,2,-2,Honduras
3692,3949,4195,1957,Curaçao,Panama,3,0,CCCF Championship,Willemstad,Netherlands Antilles,False,3,3,Curaçao
3693,3950,4196,1957,Cuba,Haiti,1,6,CCCF Championship,Willemstad,Netherlands Antilles,True,7,-5,Haiti
3694,3951,4197,1957,Sierra Leone,Ghana,2,3,Friendly,Freetown,Sierra Leone,False,5,-1,Ghana
3695,3952,4198,1957,Curaçao,Honduras,1,1,CCCF Championship,Willemstad,Netherlands Antilles,False,2,0,Draw
3696,3953,4199,1957,Aruba,Panama,2,2,Friendly,Oranjestad,Aruba,False,4,0,Draw
3697,3954,4200,1957,Malawi,Zambia,0,5,Friendly,Blantyre,Nyasaland,False,5,-5,Zambia
3698,3955,4201,1957,Cambodia,Hong Kong,2,6,Merdeka Tournament,Kuala Lumpur,Malaya,True,8,-4,Hong Kong
3699,3956,4202,1957,Indonesia,Thailand,4,0,Merdeka Tournament,Kuala Lumpur,Malaya,True,4,4,Indonesia
3700,3958,4204,1957,Cambodia,Thailand,0,3,Merdeka Tournament,Kuala Lumpur,Malaya,True,3,-3,Thailand
3701,3959,4205,1957,Finland,Norway,0,4,Nordic Championship,Helsinki,Finland,False,4,-4,Norway
3702,3960,4206,1957,Iceland,France,1,5,FIFA World Cup qualification,Reykjavík,Iceland,False,6,-4,France
3703,3961,4207,1957,Malaysia,Burma,5,2,Merdeka Tournament,Kuala Lumpur,Malaya,True,7,3,Malaysia
3704,3963,4209,1957,Hong Kong,Indonesia,2,1,Merdeka Tournament,Kuala Lumpur,Malaya,True,3,1,Hong Kong
3705,3964,4210,1957,Burma,Cambodia,2,0,Merdeka Tournament,Kuala Lumpur,Malaya,True,2,2,Burma
3706,3966,4212,1957,Singapore,Thailand,6,0,Merdeka Tournament,Kuala Lumpur,Malaya,True,6,6,Singapore
3707,3967,4213,1957,Tanzania,Uganda,2,4,Friendly,Zanzibar,Zanzibar,True,6,-2,Uganda
3708,3968,4214,1957,Iceland,Belgium,2,5,FIFA World Cup qualification,Reykjavík,Iceland,False,7,-3,Belgium
3709,3969,4215,1957,Malaysia,Hong Kong,3,3,Merdeka Tournament,Kuala Lumpur,Malaya,True,6,0,Draw
3710,3970,4217,1957,Burma,Thailand,5,2,Merdeka Tournament,Kuala Lumpur,Malaya,True,7,3,Burma
3711,3971,4218,1957,Cambodia,Singapore,1,1,Merdeka Tournament,Kuala Lumpur,Malaya,True,2,0,Draw
3712,3973,4221,1957,Burma,Singapore,2,3,Merdeka Tournament,Kuala Lumpur,Malaya,True,5,-1,Singapore
3713,3975,4223,1957,Kenya,Uganda,1,2,Friendly,Zanzibar,Zanzibar,True,3,-1,Uganda
3714,3976,4225,1957,Netherlands,Luxembourg,5,2,FIFA World Cup qualification,Rotterdam,Netherlands,False,7,3,Netherlands
3715,3977,4226,1957,Bulgaria,Hungary,1,2,FIFA World Cup qualification,Sofia,Bulgaria,False,3,-1,Hungary
3716,3978,4227,1957,Chile,Brazil,1,0,Copa Bernardo O'Higgins,Santiago,Chile,False,1,1,Chile
3717,3980,4231,1957,Chile,Brazil,1,1,Copa Bernardo O'Higgins,Santiago,Chile,False,2,0,Draw
3718,3982,4233,1957,Chile,Bolivia,2,1,FIFA World Cup qualification,Santiago,Chile,False,3,1,Chile
3719,3983,4234,1957,Hungary,Russia,1,2,Friendly,Budapest,Hungary,False,3,-1,Russia
3720,3984,4235,1957,Norway,Denmark,2,2,Nordic Championship,Oslo,Norway,False,4,0,Draw
3721,3985,4236,1957,Sweden,Finland,5,1,Nordic Championship,Solna,Sweden,False,6,4,Sweden
3722,3986,4237,1957,Netherlands,Austria,1,1,FIFA World Cup qualification,Amsterdam,Netherlands,False,2,0,Draw
3723,3989,4240,1957,Bolivia,Chile,3,0,FIFA World Cup qualification,La Paz,Bolivia,False,3,3,Bolivia
3724,3990,4241,1957,Bulgaria,Poland,1,1,Friendly,Sofia,Bulgaria,False,2,0,Draw
3725,3991,4242,1957,Luxembourg,Austria,0,3,FIFA World Cup qualification,Luxembourg,Luxembourg,False,3,-3,Austria
3726,3993,4244,1957,Denmark,Republic of Ireland,0,2,FIFA World Cup qualification,Copenhagen,Denmark,False,2,-2,Republic of Ireland
3727,3994,4245,1957,Northern Ireland,Scotland,1,1,British Championship,Belfast,Northern Ireland,False,2,0,Draw
3728,3995,4246,1957,Bolivia,Argentina,2,0,FIFA World Cup qualification,La Paz,Bolivia,False,2,2,Bolivia
3729,3996,4247,1957,Hungary,France,2,0,Friendly,Budapest,Hungary,False,2,2,Hungary
3730,3998,4249,1957,Chile,Argentina,0,2,FIFA World Cup qualification,Santiago,Chile,False,2,-2,Argentina
3731,3999,4250,1957,Denmark,Finland,3,0,Nordic Championship,Copenhagen,Denmark,False,3,3,Denmark
3732,4000,4251,1957,Sweden,Norway,5,2,Nordic Championship,Solna,Sweden,False,7,3,Sweden
3733,4001,4252,1957,Wales,England,0,4,British Championship,Cardiff,Wales,False,4,-4,England
3734,4002,4253,1957,Argentina,Chile,4,0,FIFA World Cup qualification,Buenos Aires,Argentina,False,4,4,Argentina
3735,4003,4254,1957,Madagascar,Réunion,0,1,Friendly,Curepipe,Mauritius,True,1,-1,Réunion
3736,4004,4255,1957,Mexico,Costa Rica,2,0,FIFA World Cup qualification,Mexico City,Mexico,False,2,2,Mexico
3737,4005,4256,1957,Poland,Russia,2,1,FIFA World Cup qualification,Chorzów,Poland,False,3,1,Poland
3738,4006,4257,1957,Mauritius,Madagascar,4,0,Friendly,Curepipe,Mauritius,False,4,4,Mauritius
3739,4007,4258,1957,Argentina,Bolivia,4,0,FIFA World Cup qualification,Avellaneda,Argentina,False,4,4,Argentina
3740,4008,4259,1957,Belgium,France,0,0,FIFA World Cup qualification,Brussels,Belgium,False,0,0,Draw
3741,4009,4260,1957,Costa Rica,Mexico,1,1,FIFA World Cup qualification,San José,Costa Rica,False,2,0,Draw
3742,4010,4262,1957,Ghana,Nigeria,3,3,Friendly,Accra,Ghana,False,6,0,Draw
3743,4011,4263,1957,Mauritius,Réunion,1,0,Friendly,Curepipe,Mauritius,False,1,1,Mauritius
3744,4012,4264,1957,Cambodia,Malaysia,1,3,Friendly,Phnom Penh,Cambodia,False,4,-2,Malaysia
3745,4013,4265,1957,Bulgaria,Norway,7,0,FIFA World Cup qualification,Sofia,Bulgaria,False,7,7,Bulgaria
3746,4014,4266,1957,Poland,Finland,4,0,FIFA World Cup qualification,Warsaw,Poland,False,4,4,Poland
3747,4015,4267,1957,Romania,Greece,3,0,FIFA World Cup qualification,Bucharest,Romania,False,3,3,Romania
3748,4016,4268,1957,England,Northern Ireland,2,3,British Championship,London,England,False,5,-1,Northern Ireland
3749,4017,4269,1957,Scotland,Switzerland,3,2,FIFA World Cup qualification,Glasgow,Scotland,False,5,1,Scotland
3750,4018,4270,1957,Hungary,Norway,5,0,FIFA World Cup qualification,Budapest,Hungary,False,5,5,Hungary
3751,4019,4272,1957,Scotland,Wales,1,1,British Championship,Glasgow,Scotland,False,2,0,Draw
3752,4020,4273,1957,Netherlands,Belgium,5,2,Friendly,Rotterdam,Netherlands,False,7,3,Netherlands
3753,4021,4275,1957,Germany,Sweden,1,0,Friendly,Hamburg,Germany,False,1,1,Germany
3754,4022,4276,1957,Poland,Russia,0,2,FIFA World Cup qualification,Leipzig,German DR,True,2,-2,Russia
3755,4023,4277,1957,Switzerland,Spain,1,4,FIFA World Cup qualification,Lausanne,Switzerland,False,5,-3,Spain
3756,4024,4278,1957,England,France,4,0,Friendly,London,England,False,4,4,England
3757,4025,4279,1957,Northern Ireland,Italy,2,2,Friendly,Belfast,Northern Ireland,False,4,0,Draw
3758,4026,4280,1957,Turkey,Belgium,1,1,Friendly,Ankara,Turkey,False,2,0,Draw
3759,4028,4282,1957,Germany,Hungary,1,0,Friendly,Hanover,Germany,False,1,1,Germany
3760,4029,4283,1957,Italy,Portugal,3,0,FIFA World Cup qualification,Milan,Italy,False,3,3,Italy
3761,4030,4284,1957,France,Bulgaria,2,2,Friendly,Colombes,France,False,4,0,Draw
3762,4031,4285,1958,Israel,Wales,0,2,FIFA World Cup qualification,Ramat-Gan,Israel,False,2,-2,Wales
3763,4032,4286,1958,Northern Ireland,Italy,2,1,FIFA World Cup qualification,Belfast,Northern Ireland,False,3,1,Northern Ireland
3764,4033,4287,1958,Malta,Denmark,3,0,Friendly,Gżira,Malta,False,3,3,Malta
3765,4034,4288,1958,Wales,Israel,2,0,FIFA World Cup qualification,Cardiff,Wales,False,2,2,Wales
3766,4036,4290,1958,Ghana,Togo,5,2,Friendly,Accra,Ghana,False,7,3,Ghana
3767,4038,4292,1958,Malaysia,Singapore,5,2,Friendly,Kuala Lumpur,Malaya,False,7,3,Malaysia
3768,4039,4293,1958,Belgium,Germany,0,2,Friendly,Brussels,Belgium,False,2,-2,Germany
3769,4040,4294,1958,Malaysia,Singapore,3,1,Friendly,Kuala Lumpur,Malaya,False,4,2,Malaysia
3770,4041,4295,1958,France,Spain,2,2,Friendly,Paris,France,False,4,0,Draw
3771,4042,4296,1958,Germany,Spain,2,0,Friendly,Frankfurt am Main,Germany,False,2,2,Germany
3772,4043,4297,1958,Austria,Italy,3,2,International Cup,Vienna,Austria,False,5,1,Austria
3773,4044,4299,1958,Morocco,Libya,3,1,Friendly,Casablanca,Morocco,False,4,2,Morocco
3774,4045,4300,1958,Uruguay,Argentina,1,0,Friendly,Montevideo,Uruguay,False,1,1,Uruguay
3775,4046,4301,1958,Belgium,Netherlands,2,7,Friendly,Antwerp,Belgium,False,9,-5,Netherlands
3776,4047,4302,1958,Spain,Portugal,1,0,Friendly,Madrid,Spain,False,1,1,Spain
3777,4048,4303,1958,Martinique,Guadeloupe,1,1,Friendly,Fort-de-France,Martinique,False,2,0,Draw
3778,4049,4304,1958,France,Switzerland,0,0,Friendly,Paris,France,False,0,0,Draw
3779,4050,4305,1958,Wales,Northern Ireland,1,1,British Championship,Cardiff,Wales,False,2,0,Draw
3780,4051,4306,1958,Scotland,England,0,4,British Championship,Glasgow,Scotland,False,4,-4,England
3781,4053,4308,1958,Paraguay,Argentina,1,0,Friendly,Asunción,Paraguay,False,1,1,Paraguay
3782,4054,4309,1958,Zimbabwe,Zambia,0,2,Friendly,Salisbury,Southern Rhodesia,False,2,-2,Zambia
3783,4055,4310,1958,Netherlands,Curaçao,8,1,Friendly,Rotterdam,Netherlands,False,9,7,Netherlands
3784,4056,4311,1958,Argentina,Paraguay,2,0,Friendly,Avellaneda,Argentina,False,2,2,Argentina
3785,4057,4312,1958,Argentina,Uruguay,2,0,Friendly,Buenos Aires,Argentina,False,2,2,Argentina
3786,4058,4313,1958,Singapore,Malaysia,3,3,Friendly,Kallang,Singapore,False,6,0,Draw
3787,4060,4315,1958,Brazil,Paraguay,5,1,Copa Oswaldo Cruz,Rio de Janeiro,Brazil,False,6,4,Brazil
3788,4061,4316,1958,Netherlands,Turkey,1,2,Friendly,Amsterdam,Netherlands,False,3,-1,Turkey
3789,4062,4317,1958,Singapore,Malaysia,0,3,Friendly,Kallang,Singapore,False,3,-3,Malaysia
3790,4063,4318,1958,Trinidad and Tobago,Jamaica,1,0,Friendly,Port of Spain,Trinidad and Tobago,False,1,1,Trinidad and Tobago
3791,4064,4319,1958,Brazil,Paraguay,0,0,Copa Oswaldo Cruz,São Paulo,Brazil,False,0,0,Draw
3792,4065,4320,1958,England,Portugal,2,1,Friendly,London,England,False,3,1,England
3793,4066,4321,1958,Scotland,Hungary,1,1,Friendly,Glasgow,Scotland,False,2,0,Draw
3794,4067,4322,1958,Sweden,Switzerland,3,2,Friendly,Helsingborg,Sweden,False,5,1,Sweden
3795,4068,4323,1958,Philippines,Indonesia,1,2,Friendly,Manila,Philippines,False,3,-1,Indonesia
3796,4069,4324,1958,Tunisia,Libya,4,1,Friendly,Tunis,Tunisia,False,5,3,Tunisia
3797,4070,4325,1958,Poland,Republic of Ireland,2,2,Friendly,Chorzów,Poland,False,4,0,Draw
3798,4071,4326,1958,Trinidad and Tobago,Jamaica,4,0,Friendly,Port of Spain,Trinidad and Tobago,False,4,4,Trinidad and Tobago
3799,4072,4328,1958,Philippines,Indonesia,0,3,Friendly,Manila,Philippines,False,3,-3,Indonesia
3800,4073,4329,1958,Trinidad and Tobago,Jamaica,0,1,Friendly,Port of Spain,Trinidad and Tobago,False,1,-1,Jamaica
3801,4074,4330,1958,Austria,Republic of Ireland,3,1,Friendly,Vienna,Austria,False,4,2,Austria
3802,4075,4331,1958,Brazil,Bulgaria,4,0,Friendly,Rio de Janeiro,Brazil,False,4,4,Brazil
3803,4077,4333,1958,Malaysia,Pakistan,4,2,Friendly,Kuala Lumpur,Malaya,False,6,2,Malaysia
3804,4078,4334,1958,Denmark,Curaçao,3,2,Friendly,Århus,Denmark,False,5,1,Denmark
3805,4079,4335,1958,Singapore,Pakistan,4,4,Friendly,Kallang,Singapore,False,8,0,Draw
3806,4080,4336,1958,Brazil,Bulgaria,3,1,Friendly,São Paulo,Brazil,False,4,2,Brazil
3807,4081,4337,1958,Russia,England,1,1,Friendly,Moscow,Soviet Union,False,2,0,Draw
3808,4082,4338,1958,Denmark,Poland,3,2,Friendly,Copenhagen,Denmark,False,5,1,Denmark
3809,4083,4339,1958,Switzerland,Belgium,0,2,Friendly,Zürich,Switzerland,False,2,-2,Belgium
3810,4084,4340,1958,Norway,Netherlands,0,0,Friendly,Oslo,Norway,False,0,0,Draw
3811,4085,4341,1958,Poland,Scotland,1,2,Friendly,Warsaw,Poland,False,3,-1,Scotland
3812,4086,4342,1958,Hong Kong,Malaysia,2,2,Friendly,Victoria,Hong Kong,False,4,0,Draw
3813,4087,4343,1958,Argentina,Germany,1,3,FIFA World Cup,Malmö,Sweden,True,4,-2,Germany
3814,4088,4344,1958,Austria,Brazil,0,3,FIFA World Cup,Uddevalla,Sweden,True,3,-3,Brazil
3815,4089,4346,1958,England,Russia,2,2,FIFA World Cup,Gothenburg,Sweden,True,4,0,Draw
3816,4090,4347,1958,France,Paraguay,7,3,FIFA World Cup,Norrköping,Sweden,True,10,4,France
3817,4091,4348,1958,Hungary,Wales,1,1,FIFA World Cup,Sandviken,Sweden,True,2,0,Draw
3818,4093,4350,1958,Sweden,Mexico,3,0,FIFA World Cup,Solna,Sweden,False,3,3,Sweden
3819,4094,4351,1958,Argentina,Northern Ireland,3,1,FIFA World Cup,Halmstad,Sweden,True,4,2,Argentina
3820,4095,4352,1958,Austria,Russia,0,2,FIFA World Cup,Borås,Sweden,True,2,-2,Russia
3821,4096,4353,1958,Brazil,England,0,0,FIFA World Cup,Gothenburg,Sweden,True,0,0,Draw
3822,4098,4356,1958,Mexico,Wales,1,1,FIFA World Cup,Solna,Sweden,True,2,0,Draw
3823,4099,4357,1958,Paraguay,Scotland,3,2,FIFA World Cup,Norrköping,Sweden,True,5,1,Paraguay
3824,4100,4358,1958,Sweden,Hungary,2,1,FIFA World Cup,Solna,Sweden,False,3,1,Sweden
3825,4102,4360,1958,Austria,England,2,2,FIFA World Cup,Borås,Sweden,True,4,0,Draw
3826,4103,4361,1958,Brazil,Russia,2,0,FIFA World Cup,Gothenburg,Sweden,True,2,2,Brazil
3827,4104,4362,1958,France,Scotland,2,1,FIFA World Cup,Örebro,Sweden,True,3,1,France
3828,4105,4363,1958,Germany,Northern Ireland,2,2,FIFA World Cup,Malmö,Sweden,True,4,0,Draw
3829,4106,4364,1958,Hungary,Mexico,4,0,FIFA World Cup,Sandviken,Sweden,True,4,4,Hungary
3830,4107,4365,1958,Norway,Finland,2,0,Nordic Championship,Oslo,Norway,False,2,2,Norway
3831,4109,4367,1958,Sweden,Wales,0,0,FIFA World Cup,Solna,Sweden,False,0,0,Draw
3832,4110,4369,1958,England,Russia,0,1,FIFA World Cup,Gothenburg,Sweden,True,1,-1,Russia
3833,4111,4370,1958,Hungary,Wales,1,2,FIFA World Cup,Solna,Sweden,True,3,-1,Wales
3834,4112,4371,1958,Brazil,Wales,1,0,FIFA World Cup,Gothenburg,Sweden,True,1,1,Brazil
3835,4113,4372,1958,France,Northern Ireland,4,0,FIFA World Cup,Norrköping,Sweden,True,4,4,France
3836,4115,4374,1958,Sweden,Russia,2,0,FIFA World Cup,Solna,Sweden,False,2,2,Sweden
3837,4116,4375,1958,Brazil,France,5,2,FIFA World Cup,Solna,Sweden,True,7,3,Brazil
3838,4117,4376,1958,Sweden,Germany,3,1,FIFA World Cup,Gothenburg,Sweden,False,4,2,Sweden
3839,4118,4377,1958,France,Germany,6,3,FIFA World Cup,Gothenburg,Sweden,True,9,3,France
3840,4119,4379,1958,Denmark,Norway,1,2,Nordic Championship,Copenhagen,Denmark,False,3,-1,Norway
3841,4120,4380,1958,Sweden,Brazil,2,5,FIFA World Cup,Solna,Sweden,False,7,-3,Brazil
3842,4121,4381,1958,Singapore,Indonesia,0,5,Friendly,Kallang,Singapore,False,5,-5,Indonesia
3843,4122,4382,1958,Malaysia,Indonesia,2,4,Friendly,Kallang,Singapore,True,6,-2,Indonesia
3844,4124,4384,1958,New Zealand,Australia,2,3,Friendly,Wellington,New Zealand,False,5,-1,Australia
3845,4125,4385,1958,Finland,Sweden,1,7,Nordic Championship,Helsinki,Finland,False,8,-6,Sweden
3846,4126,4386,1958,New Zealand,Australia,2,2,Friendly,Auckland,New Zealand,False,4,0,Draw
3847,4129,4390,1958,Indonesia,Singapore,2,0,Merdeka Tournament,Kuala Lumpur,Malaya,True,2,2,Indonesia
3848,4130,4391,1958,New Caledonia,New Zealand,1,2,Friendly,Nouméa,New Caledonia,False,3,-1,New Zealand
3849,4132,4393,1958,Hong Kong,Singapore,2,0,Merdeka Tournament,Kuala Lumpur,Malaya,True,2,2,Hong Kong
3850,4133,4394,1958,Hong Kong,Indonesia,2,1,Merdeka Tournament,Kuala Lumpur,Malaya,True,3,1,Hong Kong
3851,4135,4396,1958,New Caledonia,New Zealand,1,5,Friendly,Nouméa,New Caledonia,False,6,-4,New Zealand
3852,4136,4397,1958,Zimbabwe,Zambia,4,2,Friendly,Salisbury,Southern Rhodesia,False,6,2,Zimbabwe
3853,4138,4399,1958,Finland,Denmark,1,4,Nordic Championship,Helsinki,Finland,False,5,-3,Denmark
3854,4139,4401,1958,New Caledonia,New Zealand,1,2,Friendly,Nouméa,New Caledonia,False,3,-1,New Zealand
3855,4140,4402,1958,Norway,Sweden,0,2,Nordic Championship,Oslo,Norway,False,2,-2,Sweden
3856,4141,4403,1958,Poland,Hungary,1,3,Friendly,Chorzów,Poland,False,4,-2,Hungary
3857,4142,4405,1958,Denmark,Germany,1,1,Friendly,Copenhagen,Denmark,False,2,0,Draw
3858,4143,4406,1958,Belgium,Netherlands,2,3,Friendly,Antwerp,Belgium,False,5,-1,Netherlands
3859,4144,4407,1958,Russia,Hungary,3,1,UEFA Euro qualification,Moscow,Soviet Union,False,4,2,Russia
3860,4145,4408,1958,France,Greece,7,1,UEFA Euro qualification,Paris,France,False,8,6,France
3861,4146,4409,1958,Northern Ireland,England,3,3,British Championship,Belfast,Northern Ireland,False,6,0,Draw
3862,4148,4411,1958,Austria,France,1,2,Friendly,Vienna,Austria,False,3,-1,France
3863,4149,4413,1958,Republic of Ireland,Poland,2,2,Friendly,Dublin,Republic of Ireland,False,4,0,Draw
3864,4150,4414,1958,Kenya,Tanzania,3,1,Friendly,Nairobi,Kenya,False,4,2,Kenya
3865,4151,4416,1958,Uganda,Tanzania,2,0,Friendly,Nairobi,Kenya,True,2,2,Uganda
3866,4154,4419,1958,Kenya,Uganda,2,0,Friendly,Nairobi,Kenya,False,2,2,Kenya
3867,4155,4421,1958,Netherlands,Denmark,5,1,Friendly,Rotterdam,Netherlands,False,6,4,Netherlands
3868,4156,4422,1958,Spain,Northern Ireland,6,2,Friendly,Madrid,Spain,False,8,4,Spain
3869,4157,4423,1958,Réunion,Mauritius,0,2,Friendly,Saint-Pierre,Réunion,False,2,-2,Mauritius
3870,4158,4424,1958,Wales,Scotland,0,3,British Championship,Cardiff,Wales,False,3,-3,Scotland
3871,4159,4425,1958,Réunion,Madagascar,1,3,Friendly,Saint-Pierre,Réunion,False,4,-2,Madagascar
3872,4160,4426,1958,England,Russia,5,0,Friendly,London,England,False,5,5,England
3873,4161,4427,1958,Madagascar,Mauritius,3,2,Friendly,Saint-Pierre,Réunion,True,5,1,Madagascar
3874,4162,4428,1958,Nigeria,Ghana,3,2,Friendly,Lagos,Nigeria,False,5,1,Nigeria
3875,4163,4429,1958,Belgium,Turkey,1,1,Friendly,Brussels,Belgium,False,2,0,Draw
3876,4164,4430,1958,France,Germany,2,2,Friendly,Colombes,France,False,4,0,Draw
3877,4165,4431,1958,Romania,Hungary,1,2,Friendly,Bucharest,Romania,False,3,-1,Hungary
3878,4166,4432,1958,Sweden,Denmark,4,4,Nordic Championship,Solna,Sweden,False,8,0,Draw
3879,4167,4434,1958,Netherlands,Switzerland,2,0,Friendly,Rotterdam,Netherlands,False,2,2,Netherlands
3880,4168,4435,1958,Romania,Turkey,3,0,UEFA Euro qualification,Bucharest,Romania,False,3,3,Romania
3881,4169,4436,1958,Scotland,Northern Ireland,2,2,British Championship,Glasgow,Scotland,False,4,0,Draw
3882,4170,4437,1958,France,Italy,2,2,Friendly,Colombes,France,False,4,0,Draw
3883,4171,4438,1958,Netherlands,South Africa,9,3,Friendly,Eindhoven,Netherlands,False,12,6,Netherlands
3884,4172,4439,1958,Germany,Austria,2,2,Friendly,Berlin,Germany,False,4,0,Draw
3885,4173,4440,1958,Hungary,Belgium,3,1,Friendly,Budapest,Hungary,False,4,2,Hungary
3886,4174,4441,1958,England,Wales,2,2,British Championship,Birmingham,England,False,4,0,Draw
3887,4175,4442,1958,Greece,France,1,1,UEFA Euro qualification,Athens,Greece,False,2,0,Draw
3888,4176,4443,1958,Turkey,Bulgaria,0,0,Friendly,Ankara,Turkey,False,0,0,Draw
3889,4179,4446,1958,Germany,Bulgaria,3,0,Friendly,Augsburg,Germany,False,3,3,Germany
3890,4180,4447,1958,Hong Kong,Japan,5,2,Friendly,So Kon Po,Hong Kong,False,7,3,Hong Kong
3891,4181,4448,1958,Egypt,Germany,2,1,Friendly,Cairo,United Arab Republic,True,3,1,Egypt
3892,4182,4449,1958,Malaysia,Japan,6,2,Friendly,Kuala Lumpur,Malaya,False,8,4,Malaysia
3893,4183,4450,1959,Malaysia,Japan,1,3,Friendly,George Town,Malaya,True,4,-2,Japan
3894,4184,4451,1959,Singapore,Japan,3,4,Friendly,Kallang,Singapore,False,7,-1,Japan
3895,4185,4452,1959,Singapore,Japan,3,2,Friendly,Kallang,Singapore,False,5,1,Singapore
3896,4187,4454,1959,Italy,Spain,1,1,Friendly,Rome,Italy,False,2,0,Draw
3897,4188,4455,1959,France,Belgium,2,2,Friendly,Colombes,France,False,4,0,Draw
3898,4189,4456,1959,Guyana,Jamaica,2,2,Friendly,Port of Spain,Trinidad and Tobago,True,4,0,Draw
3899,4190,4457,1959,Mexico,Costa Rica,3,1,Friendly,Mexico City,Mexico,False,4,2,Mexico
3900,4191,4458,1959,Trinidad and Tobago,Barbados,2,0,Friendly,Port of Spain,Trinidad and Tobago,False,2,2,Trinidad and Tobago
3901,4192,4459,1959,Barbados,Jamaica,1,3,Friendly,Port of Spain,Trinidad and Tobago,True,4,-2,Jamaica
3902,4193,4460,1959,Trinidad and Tobago,Guyana,2,1,Friendly,San Fernando,Trinidad and Tobago,False,3,1,Trinidad and Tobago
3903,4194,4461,1959,Argentina,Chile,6,1,Copa América,Buenos Aires,Argentina,False,7,5,Argentina
3904,4195,4462,1959,Bolivia,Uruguay,0,7,Copa América,Buenos Aires,Argentina,True,7,-7,Uruguay
3905,4196,4463,1959,Costa Rica,Mexico,1,2,Friendly,San José,Costa Rica,False,3,-1,Mexico
3906,4197,4464,1959,Tunisia,Malta,0,0,Friendly,Tunis,Tunisia,False,0,0,Draw
3907,4198,4465,1959,Barbados,Guyana,2,1,Friendly,Port of Spain,Trinidad and Tobago,True,3,1,Barbados
3908,4199,4466,1959,Brazil,Peru,2,2,Copa América,Buenos Aires,Argentina,True,4,0,Draw
3909,4200,4467,1959,Trinidad and Tobago,Jamaica,2,1,Friendly,Port of Spain,Trinidad and Tobago,False,3,1,Trinidad and Tobago
3910,4201,4468,1959,Argentina,Bolivia,2,0,Copa América,Buenos Aires,Argentina,False,2,2,Argentina
3911,4202,4469,1959,Chile,Paraguay,1,2,Copa América,Buenos Aires,Argentina,True,3,-1,Paraguay
3912,4203,4470,1959,Martinique,Guadeloupe,3,0,Friendly,Fort-de-France,Martinique,False,3,3,Martinique
3913,4204,4471,1959,Peru,Uruguay,5,3,Copa América,Buenos Aires,Argentina,True,8,2,Peru
3914,4205,4472,1959,Bolivia,Paraguay,0,5,Copa América,Buenos Aires,Argentina,True,5,-5,Paraguay
3915,4206,4473,1959,Brazil,Chile,3,0,Copa América,Buenos Aires,Argentina,True,3,3,Brazil
3916,4207,4474,1959,Argentina,Peru,3,1,Copa América,Buenos Aires,Argentina,False,4,2,Argentina
3917,4208,4475,1959,Paraguay,Uruguay,1,3,Copa América,Buenos Aires,Argentina,True,4,-2,Uruguay
3918,4209,4476,1959,Bolivia,Brazil,2,4,Copa América,Buenos Aires,Argentina,True,6,-2,Brazil
3919,4210,4477,1959,Chile,Peru,1,1,Copa América,Buenos Aires,Argentina,True,2,0,Draw
3920,4211,4478,1959,Argentina,Paraguay,3,1,Copa América,Buenos Aires,Argentina,False,4,2,Argentina
3921,4212,4479,1959,Bolivia,Chile,2,5,Copa América,Buenos Aires,Argentina,True,7,-3,Chile
3922,4213,4480,1959,Brazil,Uruguay,3,1,Copa América,Buenos Aires,Argentina,True,4,2,Brazil
3923,4214,4481,1959,Bolivia,Peru,0,0,Copa América,Buenos Aires,Argentina,True,0,0,Draw
3924,4215,4482,1959,Brazil,Paraguay,4,1,Copa América,Buenos Aires,Argentina,True,5,3,Brazil
3925,4216,4483,1959,Philippines,Hong Kong,0,7,AFC Asian Cup qualification,Manila,Philippines,False,7,-7,Hong Kong
3926,4217,4484,1959,Argentina,Uruguay,4,1,Copa América,Buenos Aires,Argentina,False,5,3,Argentina
3927,4219,4486,1959,Chile,Uruguay,1,0,Copa América,Buenos Aires,Argentina,True,1,1,Chile
3928,4220,4487,1959,Paraguay,Peru,2,1,Copa América,Buenos Aires,Argentina,True,3,1,Paraguay
3929,4221,4488,1959,Argentina,Brazil,1,1,Copa América,Buenos Aires,Argentina,False,2,0,Draw
3930,4223,4490,1959,England,Scotland,1,0,British Championship,London,England,False,1,1,England
3931,4224,4491,1959,Kenya,Réunion,1,0,Friendly,Nairobi,Kenya,False,1,1,Kenya
3932,4226,4493,1959,Netherlands,Belgium,2,2,Friendly,Amsterdam,Netherlands,False,4,0,Draw
3933,4227,4494,1959,Northern Ireland,Wales,4,1,British Championship,Belfast,Northern Ireland,False,5,3,Northern Ireland
3934,4229,4496,1959,Turkey,Romania,2,0,UEFA Euro qualification,Istanbul,Turkey,False,2,2,Turkey
3935,4230,4498,1959,Uruguay,Paraguay,1,3,Friendly,Montevideo,Uruguay,False,4,-2,Paraguay
3936,4231,4499,1959,England,Italy,2,2,Friendly,London,England,False,4,0,Draw
3937,4232,4500,1959,Scotland,Germany,3,2,Friendly,Glasgow,Scotland,False,5,1,Scotland
3938,4234,4503,1959,Turkey,Netherlands,0,0,Friendly,Istanbul,Turkey,False,0,0,Draw
3939,4235,4504,1959,Singapore,Malaysia,2,5,AFC Asian Cup qualification,Kallang,Singapore,False,7,-3,Malaysia
3940,4236,4505,1959,Brazil,England,2,0,Friendly,Rio de Janeiro,Brazil,False,2,2,Brazil
3941,4237,4506,1959,Bulgaria,Netherlands,3,2,Friendly,Sofia,Bulgaria,False,5,1,Bulgaria
3942,4239,4508,1959,Switzerland,Portugal,4,3,Friendly,Geneva,Switzerland,False,7,1,Switzerland
3943,4240,4509,1959,Peru,England,4,1,Friendly,Lima,Peru,False,5,3,Peru
3944,4241,4510,1959,Germany,Poland,1,1,Friendly,Hamburg,Germany,False,2,0,Draw
3945,4242,4511,1959,Norway,Austria,0,1,UEFA Euro qualification,Oslo,Norway,False,1,-1,Austria
3946,4243,4512,1959,Martinique,Guadeloupe,1,2,Friendly,Fort-de-France,Martinique,False,3,-1,Guadeloupe
3947,4244,4513,1959,Sweden,Portugal,2,0,Friendly,Gothenburg,Sweden,False,2,2,Sweden
3948,4245,4514,1959,Egypt,Ethiopia,4,0,African Cup of Nations,Cairo,United Arab Republic,True,4,4,Egypt
3949,4246,4515,1959,Belgium,Austria,0,2,Friendly,Brussels,Belgium,False,2,-2,Austria
3950,4247,4516,1959,Mexico,England,2,1,Friendly,Mexico City,Mexico,False,3,1,Mexico
3951,4248,4517,1959,Ethiopia,Sudan,0,1,African Cup of Nations,Cairo,United Arab Republic,True,1,-1,Sudan
3952,4249,4518,1959,Netherlands,Scotland,1,2,Friendly,Amsterdam,Netherlands,False,3,-1,Scotland
3953,4250,4519,1959,United States,England,1,8,Friendly,Los Angeles,United States,False,9,-7,England
3954,4251,4520,1959,Egypt,Sudan,2,1,African Cup of Nations,Cairo,United Arab Republic,True,3,1,Egypt
3955,4252,4521,1959,Martinique,Suriname,3,1,Friendly,Fort-de-France,Martinique,False,4,2,Martinique
3956,4253,4522,1959,Martinique,Suriname,3,0,Friendly,Fort-de-France,Martinique,False,3,3,Martinique
3957,4254,4524,1959,Portugal,Scotland,1,0,Friendly,Lisbon,Portugal,False,1,1,Portugal
3958,4255,4525,1959,Guadeloupe,Suriname,3,3,Friendly,Basse-Terre,Guadeloupe,False,6,0,Draw
3959,4256,4526,1959,Guadeloupe,Suriname,3,1,Friendly,Basse-Terre,Guadeloupe,False,4,2,Guadeloupe
3960,4257,4527,1959,Austria,Belgium,4,2,Friendly,Vienna,Austria,False,6,2,Austria
3961,4258,4528,1959,Norway,Luxembourg,1,0,Friendly,Oslo,Norway,False,1,1,Norway
3962,4259,4529,1959,Denmark,Sweden,0,6,Nordic Championship,Copenhagen,Denmark,False,6,-6,Sweden
3963,4260,4531,1959,Poland,Israel,7,2,Friendly,Wrocław,Poland,False,9,5,Poland
3964,4261,4532,1959,Finland,Norway,2,4,Nordic Championship,Helsinki,Finland,False,6,-2,Norway
3965,4262,4533,1959,Hungary,Sweden,3,2,Friendly,Budapest,Hungary,False,5,1,Hungary
3966,4263,4534,1959,Poland,Spain,2,4,UEFA Euro qualification,Chorzów,Poland,False,6,-2,Spain
3967,4265,4538,1959,Sweden,Finland,3,1,Nordic Championship,Malmö,Sweden,False,4,2,Sweden
3968,4267,4542,1959,Poland,Romania,2,3,Friendly,Warsaw,Poland,False,5,-1,Romania
3969,4268,4543,1959,Hong Kong,Japan,1,1,Merdeka Tournament,Kuala Lumpur,Malaya,True,2,0,Draw
3970,4269,4544,1959,India,Singapore,2,0,Merdeka Tournament,Kuala Lumpur,Malaya,True,2,2,India
3971,4270,4545,1959,Hong Kong,Japan,4,2,Merdeka Tournament,Kuala Lumpur,Malaya,True,6,2,Hong Kong
3972,4272,4548,1959,Hong Kong,India,0,2,Merdeka Tournament,Kuala Lumpur,Malaya,True,2,-2,India
3973,4273,4549,1959,Japan,Singapore,4,1,Merdeka Tournament,Kuala Lumpur,Malaya,True,5,3,Japan
3974,4284,4560,1959,Singapore,India,2,3,Friendly,Kallang,Singapore,False,5,-1,India
3975,4286,4562,1959,Brazil,Chile,7,0,Copa Bernardo O'Higgins,Rio de Janeiro,Brazil,False,7,7,Brazil
3976,4287,4563,1959,Brazil,Chile,1,0,Copa Bernardo O'Higgins,Rio de Janeiro,Brazil,False,1,1,Brazil
3977,4288,4564,1959,Suriname,Martinique,1,0,Friendly,Paramaribo,Suriname,False,1,1,Suriname
3978,4289,4565,1959,Austria,Norway,5,2,UEFA Euro qualification,Vienna,Austria,False,7,3,Austria
3979,4291,4567,1959,Suriname,Martinique,4,1,Friendly,Paramaribo,Suriname,False,5,3,Suriname
3980,4292,4568,1959,Hungary,Russia,0,1,UEFA Euro qualification,Budapest,Hungary,False,1,-1,Russia
3981,4293,4570,1959,Northern Ireland,Scotland,0,4,British Championship,Belfast,Northern Ireland,False,4,-4,Scotland
3982,4295,4572,1959,Denmark,Finland,4,0,Nordic Championship,Copenhagen,Denmark,False,4,4,Denmark
3983,4296,4573,1959,Kenya,Uganda,0,0,Friendly,Dar es Salaam,Tanganyika,True,0,0,Draw
3984,4297,4574,1959,Netherlands,Belgium,9,1,Friendly,Rotterdam,Netherlands,False,10,8,Netherlands
3985,4298,4575,1959,Switzerland,Germany,0,4,Friendly,Berne,Switzerland,False,4,-4,Germany
3986,4299,4576,1959,Tanzania,Uganda,2,2,Friendly,Dar es Salaam,Tanganyika,False,4,0,Draw
3987,4301,4579,1959,Tanzania,Kenya,0,2,Friendly,Dar es Salaam,Tanganyika,False,2,-2,Kenya
3988,4302,4580,1959,Bulgaria,France,1,0,Friendly,Sofia,Bulgaria,False,1,1,Bulgaria
3989,4303,4582,1959,Spain,Poland,3,0,UEFA Euro qualification,Madrid,Spain,False,3,3,Spain
3990,4304,4583,1959,Wales,England,1,1,British Championship,Cardiff,Wales,False,2,0,Draw
3991,4305,4585,1959,Sweden,Norway,6,2,Nordic Championship,Gothenburg,Sweden,False,8,4,Sweden
3992,4306,4586,1959,Germany,Netherlands,7,0,Friendly,Cologne,Germany,False,7,7,Germany
3993,4308,4589,1959,Hungary,Switzerland,8,0,International Cup,Budapest,Hungary,False,8,8,Hungary
3994,4309,4592,1959,England,Sweden,2,3,Friendly,London,England,False,5,-1,Sweden
3995,4310,4594,1959,Republic of Ireland,Sweden,3,2,Friendly,Dublin,Republic of Ireland,False,5,1,Republic of Ireland
3996,4311,4595,1959,Netherlands,Norway,7,1,Friendly,Rotterdam,Netherlands,False,8,6,Netherlands
3997,4312,4596,1959,Benin,Nigeria,0,1,Friendly,Cotonou,Dahomey,False,1,-1,Nigeria
3998,4313,4597,1959,Hungary,Germany,4,3,Friendly,Budapest,Hungary,False,7,1,Hungary
3999,4314,4598,1959,France,Portugal,5,3,Friendly,Colombes,France,False,8,2,France
4000,4315,4599,1959,Chile,Argentina,4,2,Friendly,Santiago,Chile,False,6,2,Chile
4001,4316,4600,1959,England,Northern Ireland,2,1,British Championship,London,England,False,3,1,England
4002,4317,4601,1959,Ghana,Nigeria,5,2,Friendly,Accra,Ghana,False,7,3,Ghana
4003,4318,4602,1959,Spain,Austria,6,3,Friendly,Valencia,Spain,False,9,3,Spain
4004,4319,4603,1959,Nigeria,Benin,10,1,Friendly,Lagos,Nigeria,False,11,9,Nigeria
4005,4320,4604,1959,Israel,Poland,1,1,Friendly,Ramat-Gan,Israel,False,2,0,Draw
4006,4321,4605,1959,Italy,Hungary,1,1,International Cup,Florence,Italy,False,2,0,Draw
4007,4322,4606,1959,Greece,Denmark,1,3,Friendly,Athens,Greece,False,4,-2,Denmark
4008,4323,4607,1959,Brazil,Paraguay,3,2,Copa América,Guayaquil,Ecuador,True,5,1,Brazil
4009,4324,4608,1959,Iran,Israel,3,0,AFC Asian Cup qualification,Ernakulam,India,True,3,3,Iran
4010,4325,4609,1959,Bulgaria,Denmark,2,1,Friendly,Sofia,Bulgaria,False,3,1,Bulgaria
4011,4326,4610,1959,Ecuador,Uruguay,0,4,Copa América,Guayaquil,Ecuador,False,4,-4,Uruguay
4012,4327,4611,1959,India,Pakistan,1,0,AFC Asian Cup qualification,Ernakulam,India,False,1,1,India
4013,4328,4612,1959,India,Israel,1,3,AFC Asian Cup qualification,Ernakulam,India,False,4,-2,Israel
4014,4329,4613,1959,Argentina,Paraguay,4,2,Copa América,Guayaquil,Ecuador,True,6,2,Argentina
4015,4330,4614,1959,Israel,Pakistan,2,0,AFC Asian Cup qualification,Ernakulam,India,True,2,2,Israel
4016,4331,4615,1959,Brazil,Uruguay,0,3,Copa América,Guayaquil,Ecuador,True,3,-3,Uruguay
4017,4332,4616,1959,Ecuador,Argentina,1,1,Copa América,Guayaquil,Ecuador,False,2,0,Draw
4018,4333,4617,1959,Israel,Iran,1,1,AFC Asian Cup qualification,Ernakulam,India,True,2,0,Draw
4019,4334,4618,1959,El Salvador,Honduras,1,0,Friendly,San Salvador,El Salvador,False,1,1,El Salvador
4020,4335,4619,1959,France,Austria,5,2,UEFA Euro qualification,Colombes,France,False,7,3,France
4021,4336,4620,1959,Costa Rica,Honduras,6,1,Friendly,San Salvador,El Salvador,True,7,5,Costa Rica
4022,4337,4621,1959,Argentina,Uruguay,0,5,Copa América,Guayaquil,Ecuador,True,5,-5,Uruguay
4023,4338,4622,1959,France,Spain,4,3,Friendly,Paris,France,False,7,1,France
4024,4339,4623,1959,Pakistan,Israel,2,2,AFC Asian Cup qualification,Ernakulam,India,True,4,0,Draw
4025,4340,4624,1959,Ecuador,Brazil,1,3,Copa América,Guayaquil,Ecuador,False,4,-2,Brazil
4026,4343,4627,1959,Argentina,Brazil,4,1,Copa América,Guayaquil,Ecuador,True,5,3,Argentina
4027,4344,4628,1959,Paraguay,Uruguay,1,1,Copa América,Guayaquil,Ecuador,True,2,0,Draw
4028,4345,4629,1959,Ecuador,Paraguay,3,1,Copa América,Guayaquil,Ecuador,False,4,2,Ecuador
4029,4346,4630,1959,Ecuador,Brazil,1,2,Friendly,Guayaquil,Ecuador,False,3,-1,Brazil
4030,4349,4633,1960,Italy,Switzerland,3,0,International Cup,Naples,Italy,False,3,3,Italy
4031,4351,4635,1960,Guinea-Bissau,Gambia,3,2,Friendly,Bissau,Guinea-Bissau,False,5,1,Guinea-Bissau
4032,4352,4636,1960,Guinea-Bissau,Sierra Leone,3,4,Friendly,Kumasi,Ghana,True,7,-1,Sierra Leone
4033,4353,4637,1960,Ghana,Sierra Leone,6,2,Friendly,Accra,Ghana,False,8,4,Ghana
4034,4354,4638,1960,Costa Rica,Curaçao,1,1,CCCF Championship,Havana,Cuba,True,2,0,Draw
4035,4355,4639,1960,Honduras,Curaçao,3,3,CCCF Championship,Havana,Cuba,True,6,0,Draw
4036,4356,4640,1960,Martinique,Guadeloupe,2,2,Friendly,Fort-de-France,Martinique,False,4,0,Draw
4037,4357,4641,1960,Cuba,Curaçao,3,4,CCCF Championship,Havana,Cuba,False,7,-1,Curaçao
4038,4358,4642,1960,Curaçao,Suriname,1,0,CCCF Championship,Havana,Cuba,True,1,1,Curaçao
4039,4359,4643,1960,Belgium,France,1,0,Friendly,Brussels,Belgium,False,1,1,Belgium
4040,4360,4644,1960,Costa Rica,Curaçao,4,0,CCCF Championship,Havana,Cuba,True,4,4,Costa Rica
4041,4361,4645,1960,Brazil,Mexico,2,2,Pan American Championship,San José,Costa Rica,True,4,0,Draw
4042,4362,4646,1960,Costa Rica,Argentina,0,0,Pan American Championship,San José,Costa Rica,False,0,0,Draw
4043,4363,4647,1960,Argentina,Mexico,3,2,Pan American Championship,San José,Costa Rica,True,5,1,Argentina
4044,4364,4648,1960,Costa Rica,Brazil,3,0,Pan American Championship,San José,Costa Rica,False,3,3,Costa Rica
4045,4365,4649,1960,Argentina,Brazil,2,1,Pan American Championship,San José,Costa Rica,True,3,1,Argentina
4046,4366,4650,1960,Spain,Italy,3,1,Friendly,Barcelona,Spain,False,4,2,Spain
4047,4367,4651,1960,Brazil,Mexico,2,1,Pan American Championship,San José,Costa Rica,True,3,1,Brazil
4048,4368,4652,1960,Costa Rica,Argentina,0,2,Pan American Championship,San José,Costa Rica,False,2,-2,Argentina
4049,4369,4653,1960,France,Chile,6,0,Friendly,Paris,France,False,6,6,France
4050,4370,4654,1960,Argentina,Mexico,2,0,Pan American Championship,San José,Costa Rica,True,2,2,Argentina
4051,4371,4655,1960,Costa Rica,Brazil,0,4,Pan American Championship,San José,Costa Rica,False,4,-4,Brazil
4052,4372,4656,1960,Argentina,Brazil,0,1,Pan American Championship,San José,Costa Rica,True,1,-1,Brazil
4053,4373,4657,1960,Germany,Chile,2,1,Friendly,Stuttgart,Germany,False,3,1,Germany
4054,4374,4658,1960,Austria,France,2,4,UEFA Euro qualification,Vienna,Austria,False,6,-2,France
4055,4375,4659,1960,Belgium,Switzerland,3,1,Friendly,Brussels,Belgium,False,4,2,Belgium
4056,4376,4660,1960,Republic of Ireland,Chile,2,0,Friendly,Dublin,Republic of Ireland,False,2,2,Republic of Ireland
4057,4377,4661,1960,Netherlands,Bulgaria,4,2,Friendly,Amsterdam,Netherlands,False,6,2,Netherlands
4058,4378,4662,1960,Switzerland,Chile,4,2,Friendly,Basel,Switzerland,False,6,2,Switzerland
4059,4379,4663,1960,Wales,Northern Ireland,3,2,British Championship,Wrexham,Wales,False,5,1,Wales
4060,4380,4664,1960,Scotland,England,1,1,British Championship,Glasgow,Scotland,False,2,0,Draw
4061,4381,4665,1960,Belgium,Chile,1,1,Friendly,Brussels,Belgium,False,2,0,Draw
4062,4382,4666,1960,Cameroon,Djibouti,9,2,Friendly,Antananarivo,Madagascar,True,11,7,Cameroon
4063,4383,4667,1960,Central African Republic,Mali,3,4,Friendly,Antananarivo,Madagascar,True,7,-1,Mali
4064,4384,4668,1960,Gabon,Burkina Faso,4,5,Friendly,Antananarivo,Madagascar,True,9,-1,Burkina Faso
4065,4385,4669,1960,Ivory Coast,Benin,3,2,Friendly,Antananarivo,Madagascar,True,5,1,Ivory Coast
4066,4386,4670,1960,Cameroon,Mali,3,2,Friendly,Antananarivo,Madagascar,True,5,1,Cameroon
4067,4387,4671,1960,Congo,Ivory Coast,3,2,Friendly,Antananarivo,Madagascar,True,5,1,Congo
4068,4388,4672,1960,Madagascar,Burkina Faso,6,1,Friendly,Antananarivo,Madagascar,False,7,5,Madagascar
4069,4389,4673,1960,Congo,Cameroon,4,5,Friendly,Antananarivo,Madagascar,True,9,-1,Cameroon
4070,4390,4674,1960,Indonesia,Malaysia,5,0,Friendly,Surakarta,Indonesia,False,5,5,Indonesia
4071,4391,4675,1960,Belgium,Netherlands,2,1,Friendly,Antwerp,Belgium,False,3,1,Belgium
4072,4392,4676,1960,Togo,Nigeria,1,1,Friendly,Lomé,Togo,False,2,0,Draw
4073,4393,4677,1960,Cameroon,Nigeria,0,0,Friendly,Lomé,Togo,True,0,0,Draw
4074,4394,4678,1960,Germany,Portugal,2,1,Friendly,Ludwigshafen,Germany,False,3,1,Germany
4075,4395,4679,1960,Egypt,Brazil,0,5,Friendly,Cairo,United Arab Republic,True,5,-5,Brazil
4076,4396,4681,1960,Egypt,Brazil,1,3,Friendly,Alexandria,United Arab Republic,True,4,-2,Brazil
4077,4397,4682,1960,Togo,Ghana,2,3,Friendly,Lomé,Togo,False,5,-1,Ghana
4078,4398,4683,1960,Scotland,Poland,2,3,Friendly,Glasgow,Scotland,False,5,-1,Poland
4079,4399,4684,1960,Singapore,India,3,0,Friendly,Kallang,Singapore,False,3,3,Singapore
4080,4400,4685,1960,Egypt,Brazil,0,3,Friendly,Cairo,United Arab Republic,True,3,-3,Brazil
4081,4401,4686,1960,Malaysia,India,0,0,Friendly,Kuala Lumpur,Malaya,False,0,0,Draw
4082,4403,4688,1960,Denmark,Brazil,3,4,Friendly,Esbjerg,Denmark,False,7,-1,Brazil
4083,4405,4690,1960,Germany,Republic of Ireland,0,1,Friendly,Düsseldorf,Germany,False,1,-1,Republic of Ireland
4084,4406,4691,1960,Spain,England,3,0,Friendly,Madrid,Spain,False,3,3,Spain
4085,4407,4692,1960,Sweden,Republic of Ireland,4,1,Friendly,Malmö,Sweden,False,5,3,Sweden
4086,4408,4693,1960,Switzerland,Netherlands,3,1,Friendly,Zürich,Switzerland,False,4,2,Switzerland
4087,4409,4694,1960,Russia,Poland,7,1,Friendly,Moscow,Soviet Union,False,8,6,Russia
4088,4410,4695,1960,Bulgaria,Belgium,4,1,Friendly,Sofia,Bulgaria,False,5,3,Bulgaria
4089,4411,4696,1960,Hungary,England,2,0,Friendly,Budapest,Hungary,False,2,2,Hungary
4090,4413,4699,1960,Argentina,Brazil,4,2,Copa Roca,Buenos Aires,Argentina,False,6,2,Argentina
4091,4414,4700,1960,Denmark,Norway,3,0,Nordic Championship,Copenhagen,Denmark,False,3,3,Denmark
4092,4415,4701,1960,Argentina,Brazil,1,4,Copa Roca,Buenos Aires,Argentina,False,5,-3,Brazil
4093,4416,4702,1960,Austria,Scotland,4,1,Friendly,Vienna,Austria,False,5,3,Austria
4094,4417,4704,1960,Chile,Uruguay,2,3,Friendly,Santiago,Chile,False,5,-1,Uruguay
4095,4418,4705,1960,Mali,Nigeria,3,2,Friendly,Bamako,Mali Federation,False,5,1,Mali
4096,4419,4706,1960,Hungary,Scotland,3,3,Friendly,Budapest,Hungary,False,6,0,Draw
4097,4420,4707,1960,Tunisia,Iraq,2,1,Friendly,Tunis,Tunisia,False,3,1,Tunisia
4098,4421,4708,1960,Uruguay,Chile,2,2,Friendly,Montevideo,Uruguay,False,4,0,Draw
4099,4422,4709,1960,Turkey,Scotland,4,2,Friendly,Ankara,Turkey,False,6,2,Turkey
4100,4423,4710,1960,Norway,Iceland,4,0,Friendly,Oslo,Norway,False,4,4,Norway
4101,4424,4711,1960,Martinique,Guadeloupe,1,0,Friendly,Fort-de-France,Martinique,False,1,1,Martinique
4102,4425,4712,1960,Finland,Sweden,0,3,Nordic Championship,Helsinki,Finland,False,3,-3,Sweden
4103,4426,4713,1960,Norway,Austria,1,2,Friendly,Oslo,Norway,False,3,-1,Austria
4104,4427,4714,1960,Mexico,Netherlands,3,1,Friendly,Mexico City,Mexico,False,4,2,Mexico
4105,4428,4715,1960,Poland,Bulgaria,4,0,Friendly,Chorzów,Poland,False,4,4,Poland
4106,4429,4716,1960,Brazil,Chile,4,0,Friendly,Rio de Janeiro,Brazil,False,4,4,Brazil
4107,4430,4717,1960,Curaçao,Netherlands,0,0,Friendly,Willemstad,Netherlands Antilles,False,0,0,Draw
4108,4431,4718,1960,Denmark,Greece,7,2,Friendly,Copenhagen,Denmark,False,9,5,Denmark
4109,4432,4719,1960,Ghana,Egypt,2,2,Friendly,Accra,Ghana,False,4,0,Draw
4110,4433,4720,1960,Paraguay,Brazil,1,2,Atlantic Cup,Asunción,Paraguay,False,3,-1,Brazil
4111,4434,4721,1960,Suriname,Netherlands,3,4,Friendly,Paramaribo,Suriname,False,7,-1,Netherlands
4112,4436,4724,1960,Argentina,Paraguay,1,0,Atlantic Cup,Buenos Aires,Argentina,False,1,1,Argentina
4113,4438,4726,1960,Uruguay,Brazil,1,0,Atlantic Cup,Montevideo,Uruguay,False,1,1,Uruguay
4114,4440,4728,1960,Mali,Sierra Leone,1,0,Friendly,Bamako,Mali,False,1,1,Mali
4115,4441,4729,1960,Peru,Spain,1,3,Friendly,Lima,Peru,False,4,-2,Spain
4116,4443,4731,1960,Brazil,Argentina,5,1,Atlantic Cup,Rio de Janeiro,Brazil,False,6,4,Brazil
4117,4444,4732,1960,Uruguay,Paraguay,2,1,Atlantic Cup,Montevideo,Uruguay,False,3,1,Uruguay
4118,4445,4733,1960,Chile,Spain,0,4,Friendly,Santiago,Chile,False,4,-4,Spain
4119,4446,4734,1960,Chile,Spain,1,4,Friendly,Santiago,Chile,False,5,-3,Spain
4120,4447,4735,1960,Argentina,Spain,2,0,Friendly,Buenos Aires,Argentina,False,2,2,Argentina
4121,4448,4736,1960,Iceland,Germany,0,5,Friendly,Reykjavík,Iceland,False,5,-5,Germany
4122,4449,4737,1960,Pakistan,Thailand,7,0,Merdeka Tournament,Kuala Lumpur,Malaya,True,7,7,Pakistan
4123,4451,4743,1960,Denmark,Finland,2,1,Nordic Championship,Copenhagen,Denmark,False,3,1,Denmark
4124,4452,4746,1960,Hong Kong,Singapore,3,2,Merdeka Tournament,Kuala Lumpur,Malaya,True,5,1,Hong Kong
4125,4454,4748,1960,Indonesia,Pakistan,4,0,Merdeka Tournament,Kuala Lumpur,Malaya,True,4,4,Indonesia
4126,4456,4750,1960,Argentina,Uruguay,4,0,Atlantic Cup,Buenos Aires,Argentina,False,4,4,Argentina
4127,4459,4754,1960,Singapore,Pakistan,4,1,Friendly,Kallang,Singapore,False,5,3,Singapore
4128,4460,4755,1960,Costa Rica,Guatemala,3,2,FIFA World Cup qualification,San José,Costa Rica,False,5,1,Costa Rica
4129,4461,4756,1960,India,Tunisia,2,2,Friendly,Rome,Italy,True,4,0,Draw
4130,4462,4757,1960,Indonesia,Pakistan,5,2,Friendly,Jakarta,Indonesia,False,7,3,Indonesia
4131,4463,4758,1960,Ghana,Nigeria,4,1,FIFA World Cup qualification,Accra,Ghana,False,5,3,Ghana
4132,4464,4759,1960,Guatemala,Costa Rica,4,4,FIFA World Cup qualification,Guatemala,Guatemala,False,8,0,Draw
4133,4465,4760,1960,Norway,Finland,6,3,Nordic Championship,Oslo,Norway,False,9,3,Norway
4134,4466,4761,1960,Austria,Russia,3,1,Friendly,Vienna,Austria,False,4,2,Austria
4135,4467,4762,1960,Honduras,Costa Rica,2,1,FIFA World Cup qualification,Tegucigalpa,Honduras,False,3,1,Honduras
4136,4468,4764,1960,Nigeria,Ghana,2,2,FIFA World Cup qualification,Lagos,Nigeria,False,4,0,Draw
4137,4469,4765,1960,Costa Rica,Honduras,5,0,FIFA World Cup qualification,San José,Costa Rica,False,5,5,Costa Rica
4138,4470,4767,1960,Norway,Sweden,3,1,Nordic Championship,Oslo,Norway,False,4,2,Norway
4139,4471,4768,1960,Trinidad and Tobago,Martinique,1,1,Friendly,Port of Spain,Trinidad and Tobago,False,2,0,Draw
4140,4472,4769,1960,Trinidad and Tobago,Martinique,1,1,Friendly,Port of Spain,Trinidad and Tobago,False,2,0,Draw
4141,4473,4770,1960,Trinidad and Tobago,Martinique,3,1,Friendly,Port of Spain,Trinidad and Tobago,False,4,2,Trinidad and Tobago
4142,4474,4771,1960,Trinidad and Tobago,Martinique,0,0,Friendly,Port of Spain,Trinidad and Tobago,False,0,0,Draw
4143,4475,4772,1960,Finland,France,1,2,FIFA World Cup qualification,Helsinki,Finland,False,3,-1,France
4144,4476,4773,1960,Honduras,Guatemala,1,1,FIFA World Cup qualification,Tegucigalpa,Honduras,False,2,0,Draw
4145,4477,4774,1960,Republic of Ireland,Wales,2,3,Friendly,Dublin,Republic of Ireland,False,5,-1,Wales
4146,4478,4775,1960,Poland,France,2,2,Friendly,Warsaw,Poland,False,4,0,Draw
4147,4479,4776,1960,Belgium,Netherlands,1,4,Friendly,Antwerp,Belgium,False,5,-3,Netherlands
4148,4480,4777,1960,Ghana,Mali,5,1,Friendly,Ibadan,Nigeria,True,6,4,Ghana
4149,4481,4778,1960,Nigeria,Guinea-Bissau,4,1,Friendly,Lagos,Nigeria,False,5,3,Nigeria
4150,4482,4779,1960,Suriname,Curaçao,1,2,FIFA World Cup qualification,Paramaribo,Suriname,False,3,-1,Curaçao
4151,4483,4782,1960,Nigeria,Mali,2,3,Friendly,Lagos,Nigeria,False,5,-1,Mali
4152,4484,4785,1960,Northern Ireland,England,2,5,British Championship,Belfast,Northern Ireland,False,7,-3,England
4153,4485,4786,1960,Uganda,Tanzania,1,0,Friendly,Kampala,Uganda,False,1,1,Uganda
4154,4487,4788,1960,Nigeria,Ghana,0,3,Friendly,Lagos,Nigeria,False,3,-3,Ghana
4155,4491,4793,1960,Kenya,Tanzania,5,0,Friendly,Kampala,Uganda,True,5,5,Kenya
4156,4492,4794,1960,Switzerland,France,6,2,Friendly,Basel,Switzerland,False,8,4,Switzerland
4157,4494,4797,1960,Uganda,Kenya,1,1,Friendly,Kampala,Uganda,False,2,0,Draw
4158,4496,4801,1960,Luxembourg,England,0,9,FIFA World Cup qualification,Luxembourg,Luxembourg,False,9,-9,England
4159,4497,4802,1960,Sweden,Belgium,2,0,FIFA World Cup qualification,Solna,Sweden,False,2,2,Sweden
4160,4499,4805,1960,Wales,Scotland,2,0,British Championship,Cardiff,Wales,False,2,2,Wales
4161,4500,4806,1960,Sweden,Denmark,2,0,Nordic Championship,Gothenburg,Sweden,False,2,2,Sweden
4162,4501,4807,1960,England,Spain,4,2,Friendly,London,England,False,6,2,England
4163,4502,4808,1960,Northern Ireland,Germany,3,4,FIFA World Cup qualification,Belfast,Northern Ireland,False,7,-1,Germany
4164,4503,4809,1960,Nigeria,Ghana,1,1,Friendly,Lagos,Nigeria,False,2,0,Draw
4165,4504,4810,1960,Austria,Spain,3,0,Friendly,Vienna,Austria,False,3,3,Austria
4166,4505,4811,1960,Belgium,Hungary,2,1,Friendly,Brussels,Belgium,False,3,1,Belgium
4167,4506,4814,1960,Morocco,Tunisia,2,1,FIFA World Cup qualification,Casablanca,Morocco,False,3,1,Morocco
4168,4507,4815,1960,Sweden,France,1,0,Friendly,Solna,Sweden,False,1,1,Sweden
4169,4508,4816,1960,Republic of Ireland,Norway,3,1,Friendly,Dublin,Republic of Ireland,False,4,2,Republic of Ireland
4170,4509,4818,1960,United States,Mexico,3,3,FIFA World Cup qualification,Los Angeles,United States,False,6,0,Draw
4171,4510,4819,1960,Scotland,Northern Ireland,5,2,British Championship,Glasgow,Scotland,False,7,3,Scotland
4172,4511,4820,1960,Cyprus,Israel,1,1,FIFA World Cup qualification,Nicosia,Cyprus,False,2,0,Draw
4173,4512,4821,1960,Hungary,Poland,4,1,Friendly,Budapest,Hungary,False,5,3,Hungary
4174,4513,4822,1960,Mexico,United States,3,0,FIFA World Cup qualification,Mexico City,Mexico,False,3,3,Mexico
4175,4514,4823,1960,Tunisia,Morocco,2,1,FIFA World Cup qualification,Tunis,Tunisia,False,3,1,Tunisia
4176,4515,4824,1960,Belgium,Switzerland,2,4,FIFA World Cup qualification,Brussels,Belgium,False,6,-2,Switzerland
4177,4516,4825,1960,Greece,Germany,0,3,FIFA World Cup qualification,Athens,Greece,False,3,-3,Germany
4178,4517,4826,1960,Hungary,Austria,2,0,Friendly,Budapest,Hungary,False,2,2,Hungary
4179,4518,4827,1960,Bulgaria,Germany,2,1,Friendly,Sofia,Bulgaria,False,3,1,Bulgaria
4180,4519,4828,1960,England,Wales,5,1,British Championship,London,England,False,6,4,England
4181,4520,4829,1960,Bulgaria,Turkey,2,1,Friendly,Sofia,Bulgaria,False,3,1,Bulgaria
4182,4521,4830,1960,Curaçao,Suriname,0,0,FIFA World Cup qualification,Willemstad,Netherlands Antilles,True,0,0,Draw
4183,4522,4831,1960,Israel,Cyprus,6,1,FIFA World Cup qualification,Ramat-Gan,Israel,False,7,5,Israel
4184,4523,4832,1960,Ecuador,Argentina,3,6,FIFA World Cup qualification,Guayaquil,Ecuador,False,9,-3,Argentina
4185,4525,4834,1960,Malta,Tunisia,1,0,Friendly,Gżira,Malta,False,1,1,Malta
4186,4526,4835,1960,Italy,Austria,1,2,Friendly,Naples,Italy,False,3,-1,Austria
4187,4527,4836,1960,France,Bulgaria,3,0,FIFA World Cup qualification,Colombes,France,False,3,3,France
4188,4529,4838,1960,Argentina,Ecuador,5,0,FIFA World Cup qualification,Buenos Aires,Argentina,False,5,5,Argentina
4189,4530,4839,1960,Chile,Paraguay,4,1,Friendly,Santiago,Chile,False,5,3,Chile
4190,4531,4840,1960,Chile,Paraguay,3,1,Friendly,Santiago,Chile,False,4,2,Chile
4191,4532,4841,1960,Iraq,Tunisia,3,2,Friendly,Baghdad,Iraq,False,5,1,Iraq
4192,4533,4842,1961,Costa Rica,Honduras,1,0,FIFA World Cup qualification,Guatemala,Guatemala,True,1,1,Costa Rica
4193,4534,4843,1961,Saint Lucia,Dominica,4,1,Windward Islands Tournament,Castries,Saint Lucia,False,5,3,Saint Lucia
4194,4535,4844,1961,Grenada,Saint Vincent and the Grenadines,3,6,Windward Islands Tournament,Castries,Saint Lucia,True,9,-3,Saint Vincent and the Grenadines
4195,4536,4845,1961,Saint Lucia,Grenada,0,4,Windward Islands Tournament,Castries,Saint Lucia,False,4,-4,Grenada
4196,4537,4846,1961,Dominica,Saint Vincent and the Grenadines,1,1,Windward Islands Tournament,Castries,Saint Lucia,True,2,0,Draw
4197,4538,4847,1961,Dominica,Grenada,1,8,Windward Islands Tournament,Castries,Saint Lucia,True,9,-7,Grenada
4198,4539,4848,1961,Saint Lucia,Saint Vincent and the Grenadines,2,2,Windward Islands Tournament,Castries,Saint Lucia,False,4,0,Draw
4199,4540,4849,1961,Colombia,United States,2,0,Friendly,Bogotá,Colombia,False,2,2,Colombia
4200,4541,4850,1961,Egypt,Hungary,0,2,Friendly,Cairo,Egypt,False,2,-2,Hungary
4201,4542,4851,1961,Morocco,Tunisia,1,1,FIFA World Cup qualification,Palermo,Italy,True,2,0,Draw
4202,4543,4852,1961,Costa Rica,Cuba,4,1,CCCF Championship,San José,Costa Rica,False,5,3,Costa Rica
4203,4544,4853,1961,Ghana,Mali,3,0,Friendly,Accra,Ghana,False,3,3,Ghana
4204,4545,4854,1961,Curaçao,El Salvador,0,0,CCCF Championship,San José,Costa Rica,True,0,0,Draw
4205,4546,4855,1961,Cuba,Haiti,1,2,CCCF Championship,San José,Costa Rica,True,3,-1,Haiti
4206,4547,4856,1961,Germany,Belgium,1,0,Friendly,Frankfurt am Main,Germany,False,1,1,Germany
4207,4548,4857,1961,Guatemala,Haiti,1,3,CCCF Championship,San José,Costa Rica,True,4,-2,Haiti
4208,4549,4858,1961,Cuba,Panama,0,1,CCCF Championship,San José,Costa Rica,True,1,-1,Panama
4209,4550,4859,1961,Curaçao,Honduras,2,4,CCCF Championship,San José,Costa Rica,True,6,-2,Honduras
4210,4551,4860,1961,Cuba,Guatemala,0,2,CCCF Championship,San José,Costa Rica,True,2,-2,Guatemala
4211,4552,4861,1961,Curaçao,Nicaragua,2,1,CCCF Championship,San José,Costa Rica,True,3,1,Curaçao
4212,4553,4862,1961,Haiti,Panama,3,1,CCCF Championship,San José,Costa Rica,True,4,2,Haiti
4213,4554,4863,1961,Israel,Ethiopia,1,0,FIFA World Cup qualification,Ramat-Gan,Israel,False,1,1,Israel
4214,4555,4864,1961,France,Belgium,1,1,Friendly,Paris,France,False,2,0,Draw
4215,4556,4865,1961,Haiti,Honduras,0,2,CCCF Championship,San José,Costa Rica,True,2,-2,Honduras
4216,4557,4866,1961,Chile,Peru,5,2,Friendly,Santiago,Chile,False,7,3,Chile
4217,4558,4867,1961,Israel,Ethiopia,3,2,FIFA World Cup qualification,Ramat-Gan,Israel,False,5,1,Israel
4218,4559,4868,1961,Panama,Paraguay,0,0,Friendly,Panama City,Panama,False,0,0,Draw
4219,4560,4869,1961,Portugal,Luxembourg,6,0,FIFA World Cup qualification,Oeiras,Portugal,False,6,6,Portugal
4220,4561,4870,1961,Costa Rica,Mexico,1,0,FIFA World Cup qualification,San José,Costa Rica,False,1,1,Costa Rica
4221,4562,4871,1961,Netherlands,Belgium,6,2,Friendly,Rotterdam,Netherlands,False,8,4,Netherlands
4222,4563,4872,1961,Panama,Haiti,0,3,Friendly,Panama City,Panama,False,3,-3,Haiti
4223,4564,4873,1961,Panama,Haiti,0,2,Friendly,Panama City,Panama,False,2,-2,Haiti
4224,4565,4874,1961,Chile,Germany,3,1,Friendly,Santiago,Chile,False,4,2,Chile
4225,4566,4876,1961,Costa Rica,Curaçao,6,0,FIFA World Cup qualification,San José,Costa Rica,False,6,6,Costa Rica
4226,4567,4877,1961,Ghana,Morocco,0,0,FIFA World Cup qualification,Accra,Ghana,False,0,0,Draw
4227,4568,4878,1961,Spain,France,2,0,Friendly,Madrid,Spain,False,2,2,Spain
4228,4569,4879,1961,Mexico,Curaçao,7,0,FIFA World Cup qualification,Mexico City,Mexico,False,7,7,Mexico
4229,4570,4880,1961,Nigeria,Ghana,0,0,African Cup of Nations qualification,Lagos,Nigeria,False,0,0,Draw
4230,4571,4881,1961,Martinique,Guadeloupe,2,2,Friendly,Fort-de-France,Martinique,False,4,0,Draw
4231,4572,4882,1961,Mexico,Costa Rica,4,1,FIFA World Cup qualification,Mexico City,Mexico,False,5,3,Mexico
4232,4573,4883,1961,Northern Ireland,Wales,1,5,British Championship,Belfast,Northern Ireland,False,6,-4,Wales
4233,4574,4884,1961,England,Scotland,9,3,British Championship,London,England,False,12,6,England
4234,4576,4886,1961,Netherlands,Mexico,1,2,Friendly,Amsterdam,Netherlands,False,3,-1,Mexico
4235,4577,4887,1961,Wales,Spain,1,2,FIFA World Cup qualification,Cardiff,Wales,False,3,-1,Spain
4236,4578,4888,1961,Sierra Leone,Nigeria,1,4,Friendly,Freetown,Sierra Leone,False,5,-3,Nigeria
4237,4579,4889,1961,Curaçao,Costa Rica,2,0,FIFA World Cup qualification,Willemstad,Netherlands Antilles,True,2,2,Curaçao
4238,4580,4890,1961,Italy,Northern Ireland,3,2,Friendly,Bologna,Italy,False,5,1,Italy
4239,4581,4892,1961,Colombia,Peru,1,0,FIFA World Cup qualification,Bogotá,Colombia,False,1,1,Colombia
4240,4582,4893,1961,Ghana,Nigeria,2,2,African Cup of Nations qualification,Accra,Ghana,False,4,0,Draw
4241,4583,4894,1961,Netherlands,Hungary,0,3,FIFA World Cup qualification,Rotterdam,Netherlands,False,3,-3,Hungary
4242,4584,4895,1961,Paraguay,Brazil,0,2,Copa Oswaldo Cruz,Asunción,Paraguay,False,2,-2,Brazil
4243,4585,4896,1961,Greece,Northern Ireland,2,1,FIFA World Cup qualification,Athens,Greece,False,3,1,Greece
4244,4586,4897,1961,Paraguay,Brazil,2,3,Copa Oswaldo Cruz,Asunción,Paraguay,False,5,-1,Brazil
4245,4587,4898,1961,Scotland,Republic of Ireland,4,1,FIFA World Cup qualification,Glasgow,Scotland,False,5,3,Scotland
4246,4588,4899,1961,Chile,Brazil,1,2,Copa Bernardo O'Higgins,Santiago,Chile,False,3,-1,Brazil
4247,4589,4900,1961,Republic of Ireland,Scotland,0,3,FIFA World Cup qualification,Dublin,Republic of Ireland,False,3,-3,Scotland
4248,4590,4901,1961,Peru,Colombia,1,1,FIFA World Cup qualification,Lima,Peru,False,2,0,Draw
4249,4591,4903,1961,England,Mexico,8,0,Friendly,London,England,False,8,8,England
4250,4592,4904,1961,Germany,Northern Ireland,2,1,FIFA World Cup qualification,Berlin,Germany,False,3,1,Germany
4251,4593,4905,1961,Chile,Brazil,0,1,Copa Bernardo O'Higgins,Santiago,Chile,False,1,-1,Brazil
4252,4594,4908,1961,Turkey,Romania,0,1,Friendly,Ankara,Turkey,False,1,-1,Romania
4253,4595,4909,1961,Norway,Mexico,1,1,Friendly,Bergen,Norway,False,2,0,Draw
4254,4596,4910,1961,Paraguay,Argentina,0,0,Friendly,Asunción,Paraguay,False,0,0,Draw
4255,4597,4911,1961,Spain,Wales,1,1,FIFA World Cup qualification,Madrid,Spain,False,2,0,Draw
4256,4598,4912,1961,Switzerland,Belgium,2,1,FIFA World Cup qualification,Lausanne,Switzerland,False,3,1,Switzerland
4257,4599,4913,1961,Curaçao,Mexico,0,0,FIFA World Cup qualification,Willemstad,Netherlands Antilles,True,0,0,Draw
4258,4600,4914,1961,Poland,Russia,1,0,Friendly,Warsaw,Poland,False,1,1,Poland
4259,4601,4915,1961,Portugal,England,1,1,FIFA World Cup qualification,Oeiras,Portugal,False,2,0,Draw
4260,4602,4916,1961,Italy,England,2,3,Friendly,Rome,Italy,False,5,-1,England
4261,4603,4917,1961,Austria,England,3,1,Friendly,Vienna,Austria,False,4,2,Austria
4262,4605,4919,1961,Hungary,Wales,3,2,Friendly,Budapest,Hungary,False,5,1,Hungary
4263,4606,4920,1961,Japan,Malaysia,3,2,Friendly,Tokyo,Japan,False,5,1,Japan
4264,4607,4921,1961,Morocco,Ghana,1,0,FIFA World Cup qualification,Casablanca,Morocco,False,1,1,Morocco
4265,4608,4922,1961,Sweden,Switzerland,4,0,FIFA World Cup qualification,Solna,Sweden,False,4,4,Sweden
4266,4609,4923,1961,Ghana,Nigeria,3,0,Friendly,Accra,Ghana,False,3,3,Ghana
4267,4610,4924,1961,Norway,Turkey,0,1,FIFA World Cup qualification,Oslo,Norway,False,1,-1,Turkey
4268,4611,4925,1961,Portugal,Argentina,0,2,Friendly,Oeiras,Portugal,False,2,-2,Argentina
4269,4612,4927,1961,Hungary,Austria,1,2,Friendly,Budapest,Hungary,False,3,-1,Austria
4270,4614,4929,1961,Spain,Argentina,2,0,Friendly,Seville,Spain,False,2,2,Spain
4271,4615,4930,1961,Italy,Argentina,4,1,Friendly,Florence,Italy,False,5,3,Italy
4272,4616,4931,1961,Finland,Bulgaria,0,2,FIFA World Cup qualification,Helsinki,Finland,False,2,-2,Bulgaria
4273,4617,4932,1961,Denmark,Sweden,1,2,Nordic Championship,Copenhagen,Denmark,False,3,-1,Sweden
4274,4618,4933,1961,Russia,Turkey,1,0,FIFA World Cup qualification,Moscow,Soviet Union,True,1,1,Russia
4275,4619,4937,1961,Russia,Argentina,0,0,Friendly,Moscow,Soviet Union,False,0,0,Draw
4276,4621,4939,1961,Finland,Norway,4,1,Nordic Championship,Helsinki,Finland,False,5,3,Finland
4277,4622,4940,1961,Brazil,Paraguay,3,2,Friendly,Rio de Janeiro,Brazil,False,5,1,Brazil
4278,4623,4941,1961,Russia,Norway,5,2,FIFA World Cup qualification,Moscow,Soviet Union,True,7,3,Russia
4279,4624,4942,1961,Bolivia,Uruguay,1,1,FIFA World Cup qualification,La Paz,Bolivia,False,2,0,Draw
4280,4625,4943,1961,Uruguay,Bolivia,2,1,FIFA World Cup qualification,Montevideo,Uruguay,False,3,1,Uruguay
4281,4626,4944,1961,Indonesia,Singapore,1,0,Merdeka Tournament,Kuala Lumpur,Malaya,True,1,1,Indonesia
4282,4628,4946,1961,Hong Kong,Indonesia,2,2,Merdeka Tournament,Kuala Lumpur,Malaya,True,4,0,Draw
4283,4629,4947,1961,Kenya,Uganda,0,1,African Cup of Nations qualification,Nairobi,Kenya,False,1,-1,Uganda
4284,4631,4949,1961,Hong Kong,Thailand,2,1,Merdeka Tournament,Kuala Lumpur,Malaya,True,3,1,Hong Kong
4285,4632,4950,1961,India,Japan,1,3,Merdeka Tournament,Kuala Lumpur,Malaya,True,4,-2,Japan
4286,4633,4951,1961,Indonesia,Thailand,2,1,Merdeka Tournament,Kuala Lumpur,Malaya,True,3,1,Indonesia
4287,4634,4952,1961,Sweden,Finland,4,0,Nordic Championship,Norrköping,Sweden,False,4,4,Sweden
4288,4635,4953,1961,Hong Kong,Singapore,3,4,Merdeka Tournament,Kuala Lumpur,Malaya,True,7,-1,Singapore
4289,4637,4955,1961,Singapore,Thailand,5,3,Merdeka Tournament,Kuala Lumpur,Malaya,True,8,2,Singapore
4290,4638,4956,1961,Malaysia,Indonesia,1,2,Merdeka Tournament,Kuala Lumpur,Malaya,True,3,-1,Indonesia
4291,4640,4958,1961,Indonesia,Japan,2,0,Friendly,Kallang,Singapore,True,2,2,Indonesia
4292,4643,4961,1961,Norway,Russia,0,3,FIFA World Cup qualification,Oslo,Norway,False,3,-3,Russia
4293,4646,4965,1961,Russia,Austria,0,1,Friendly,Moscow,Soviet Union,False,1,-1,Austria
4294,4647,4966,1961,Norway,Denmark,0,4,Nordic Championship,Oslo,Norway,False,4,-4,Denmark
4295,4648,4967,1961,Germany,Denmark,5,1,Friendly,Düsseldorf,Germany,False,6,4,Germany
4296,4650,4969,1961,Uganda,Kenya,0,1,African Cup of Nations qualification,Kampala,Uganda,False,1,-1,Kenya
4297,4652,4971,1961,England,Luxembourg,4,1,FIFA World Cup qualification,London,England,False,5,3,England
4298,4653,4972,1961,France,Finland,5,1,FIFA World Cup qualification,Paris,France,False,6,4,France
4299,4655,4974,1961,Kenya,Tanzania,0,0,Friendly,Mombasa,Kenya,False,0,0,Draw
4300,4656,4975,1961,Tanzania,Uganda,3,1,Friendly,Mombasa,Kenya,True,4,2,Tanzania
4301,4657,4976,1961,Belgium,Sweden,0,2,FIFA World Cup qualification,Brussels,Belgium,False,2,-2,Sweden
4302,4660,4979,1961,Kenya,Uganda,2,1,Friendly,Mombasa,Kenya,False,3,1,Kenya
4303,4661,4980,1961,Northern Ireland,Scotland,1,6,British Championship,Belfast,Northern Ireland,False,7,-5,Scotland
4304,4662,4981,1961,Austria,Hungary,2,1,Friendly,Vienna,Austria,False,3,1,Austria
4305,4664,4983,1961,Luxembourg,Portugal,4,2,FIFA World Cup qualification,Luxembourg,Luxembourg,False,6,2,Luxembourg
4306,4665,4984,1961,Poland,Germany,0,2,Friendly,Warsaw,Poland,False,2,-2,Germany
4307,4666,4985,1961,Romania,Turkey,4,0,Friendly,Bucharest,Romania,False,4,4,Romania
4308,4667,4987,1961,Argentina,Paraguay,5,1,Friendly,Avellaneda,Argentina,False,6,4,Argentina
4309,4668,4988,1961,Chile,Uruguay,2,3,Friendly,Santiago,Chile,False,5,-1,Uruguay
4310,4669,4989,1961,Wales,England,1,1,British Championship,Cardiff,Wales,False,2,0,Draw
4311,4670,4990,1961,Denmark,Finland,9,1,Nordic Championship,Copenhagen,Denmark,False,10,8,Denmark
4312,4671,4991,1961,Israel,Italy,2,4,FIFA World Cup qualification,Ramat-Gan,Israel,False,6,-2,Italy
4313,4672,4992,1961,Northern Ireland,Greece,2,0,FIFA World Cup qualification,Belfast,Northern Ireland,False,2,2,Northern Ireland
4314,4673,4993,1961,Belgium,France,3,0,Friendly,Brussels,Belgium,False,3,3,Belgium
4315,4675,4996,1961,Germany,Greece,2,1,FIFA World Cup qualification,Augsburg,Germany,False,3,1,Germany
4316,4676,4997,1961,Hungary,Netherlands,3,3,FIFA World Cup qualification,Budapest,Hungary,False,6,0,Draw
4317,4679,5000,1961,Sweden,Norway,2,0,Nordic Championship,Gothenburg,Sweden,False,2,2,Sweden
4318,4680,5001,1961,Indonesia,Malaysia,1,3,Vietnam Independence Cup,Saigon,Vietnam Republic,True,4,-2,Malaysia
4319,4681,5002,1961,England,Portugal,2,0,FIFA World Cup qualification,London,England,False,2,2,England
4320,4683,5005,1961,Bulgaria,Finland,3,1,FIFA World Cup qualification,Sofia,Bulgaria,False,4,2,Bulgaria
4321,4684,5007,1961,Mexico,Paraguay,1,0,FIFA World Cup qualification,Mexico City,Mexico,False,1,1,Mexico
4322,4685,5008,1961,Switzerland,Sweden,3,2,FIFA World Cup qualification,Berne,Switzerland,False,5,1,Switzerland
4323,4686,5009,1961,Turkey,Norway,2,1,FIFA World Cup qualification,Istanbul,Turkey,False,3,1,Turkey
4324,4687,5010,1961,Uganda,Kenya,2,0,African Cup of Nations qualification,Kampala,Uganda,False,2,2,Uganda
4325,4688,5011,1961,Italy,Israel,6,0,FIFA World Cup qualification,Turin,Italy,False,6,6,Italy
4326,4689,5012,1961,Malta,Norway,1,1,Friendly,Gżira,Malta,False,2,0,Draw
4327,4690,5013,1961,Paraguay,Mexico,0,0,FIFA World Cup qualification,Asunción,Paraguay,False,0,0,Draw
4328,4691,5014,1961,Poland,Denmark,5,0,Friendly,Chorzów,Poland,False,5,5,Poland
4329,4692,5015,1961,Scotland,Wales,2,0,British Championship,Glasgow,Scotland,False,2,2,Scotland
4330,4693,5016,1961,Bulgaria,France,1,0,FIFA World Cup qualification,Sofia,Bulgaria,False,1,1,Bulgaria
4331,4694,5017,1961,Morocco,Spain,0,1,FIFA World Cup qualification,Casablanca,Morocco,False,1,-1,Spain
4332,4695,5018,1961,Netherlands,Belgium,0,4,Friendly,Amsterdam,Netherlands,False,4,-4,Belgium
4333,4696,5019,1961,Switzerland,Sweden,2,1,FIFA World Cup qualification,Berlin,Germany,True,3,1,Switzerland
4334,4697,5020,1961,Turkey,Russia,1,2,FIFA World Cup qualification,Istanbul,Turkey,False,3,-1,Russia
4335,4698,5021,1961,Argentina,Russia,1,2,Friendly,Buenos Aires,Argentina,False,3,-1,Russia
4336,4699,5023,1961,Chile,Russia,0,1,Friendly,Santiago,Chile,False,1,-1,Russia
4337,4700,5024,1961,England,Northern Ireland,1,1,British Championship,London,England,False,2,0,Draw
4338,4701,5025,1961,Spain,Morocco,3,2,FIFA World Cup qualification,Madrid,Spain,False,5,1,Spain
4339,4702,5026,1961,Nigeria,Tunisia,2,1,African Cup of Nations qualification,Lagos,Nigeria,False,3,1,Nigeria
4340,4703,5029,1961,Uruguay,Russia,1,2,Friendly,Montevideo,Uruguay,False,3,-1,Russia
4341,4706,5032,1961,Panama,Venezuela,2,6,Friendly,Barranquilla,Colombia,True,8,-4,Venezuela
4342,4707,5033,1961,Senegal,Gambia,2,3,Friendly,Dakar,Senegal,False,5,-1,Gambia
4343,4710,5036,1961,Kenya,Uganda,4,1,Friendly,Dar es Salaam,Tanganyika,True,5,3,Kenya
4344,4711,5037,1961,Chile,Hungary,5,1,Friendly,Santiago,Chile,False,6,4,Chile
4345,4712,5038,1961,Tanzania,Kenya,1,3,Friendly,Dar es Salaam,Tanganyika,False,4,-2,Kenya
4346,4713,5039,1961,France,Spain,1,1,Friendly,Colombes,France,False,2,0,Draw
4347,4715,5041,1961,Tunisia,Nigeria,2,0,African Cup of Nations qualification,Tunis,Tunisia,False,2,2,Tunisia
4348,4716,5042,1961,Panama,Venezuela,0,3,Friendly,Barranquilla,Colombia,True,3,-3,Venezuela
4349,4717,5043,1961,Chile,Hungary,0,0,Friendly,Santiago,Chile,False,0,0,Draw
4350,4719,5045,1961,Bulgaria,France,1,0,FIFA World Cup qualification,Milan,Italy,True,1,1,Bulgaria
4351,4720,5046,1961,Ghana,Nigeria,5,1,Friendly,Accra,Ghana,False,6,4,Ghana
4352,4721,5047,1961,Uruguay,Hungary,1,1,Friendly,Montevideo,Uruguay,False,2,0,Draw
4353,4722,5048,1961,Belgium,Bulgaria,4,0,Friendly,Brussels,Belgium,False,4,4,Belgium
4354,4723,5049,1961,Ethiopia,Kenya,4,3,Friendly,Addis Abeba,Ethiopia,False,7,1,Ethiopia
4355,4724,5050,1962,Egypt,Austria,1,0,Friendly,Cairo,Egypt,False,1,1,Egypt
4356,4725,5051,1962,Ethiopia,Kenya,6,1,Friendly,Addis Abeba,Ethiopia,False,7,5,Ethiopia
4357,4726,5052,1962,Ethiopia,Tunisia,4,2,African Cup of Nations,Addis Abeba,Ethiopia,False,6,2,Ethiopia
4358,4727,5053,1962,Egypt,Uganda,2,1,African Cup of Nations,Addis Abeba,Ethiopia,True,3,1,Egypt
4359,4728,5054,1962,Tunisia,Uganda,3,0,African Cup of Nations,Addis Abeba,Ethiopia,True,3,3,Tunisia
4360,4729,5055,1962,Ethiopia,Egypt,4,2,African Cup of Nations,Addis Abeba,Ethiopia,False,6,2,Ethiopia
4361,4730,5056,1962,Mali,Ivory Coast,4,0,Friendly,Bamako,Mali,False,4,4,Mali
4362,4731,5057,1962,Mali,Ivory Coast,0,2,Friendly,Bamako,Mali,False,2,-2,Ivory Coast
4363,4732,5058,1962,Mali,Ghana,0,1,Friendly,Bamako,Mali,False,1,-1,Ghana
4364,4734,5060,1962,Libya,Tunisia,6,3,Friendly,Tripoli,Libya,False,9,3,Libya
4365,4735,5061,1962,Uruguay,Argentina,1,1,Friendly,Montevideo,Uruguay,False,2,0,Draw
4366,4736,5062,1962,Ghana,Mali,0,0,Friendly,Accra,Ghana,False,0,0,Draw
4367,4737,5063,1962,Curaçao,Suriname,1,0,Friendly,Willemstad,Netherlands Antilles,False,1,1,Curaçao
4368,4738,5064,1962,Argentina,Mexico,1,0,Friendly,Buenos Aires,Argentina,False,1,1,Argentina
4369,4739,5065,1962,Belgium,Netherlands,3,1,Friendly,Antwerp,Belgium,False,4,2,Belgium
4370,4740,5066,1962,Colombia,Mexico,0,1,Friendly,Bogotá,Colombia,False,1,-1,Mexico
4371,4741,5067,1962,Colombia,Mexico,2,2,Friendly,Cali,Colombia,False,4,0,Draw
4372,4742,5068,1962,England,Austria,3,1,Friendly,London,England,False,4,2,England
4373,4744,5070,1962,Republic of Ireland,Austria,2,3,Friendly,Dublin,Republic of Ireland,False,5,-1,Austria
4374,4745,5071,1962,France,Poland,1,3,Friendly,Paris,France,False,4,-2,Poland
4375,4746,5072,1962,Germany,Uruguay,3,0,Friendly,Hamburg,Germany,False,3,3,Germany
4376,4747,5073,1962,Luxembourg,Russia,1,3,Friendly,Luxembourg,Luxembourg,False,4,-2,Russia
4377,4748,5074,1962,Wales,Northern Ireland,4,0,British Championship,Cardiff,Wales,False,4,4,Wales
4378,4749,5075,1962,Scotland,England,2,0,British Championship,Glasgow,Scotland,False,2,2,Scotland
4379,4750,5076,1962,Morocco,Poland,1,3,Friendly,Casablanca,Morocco,False,4,-2,Poland
4380,4751,5077,1962,Hungary,Uruguay,1,1,Friendly,Budapest,Hungary,False,2,0,Draw
4381,4752,5078,1962,Sweden,Russia,0,2,Friendly,Solna,Sweden,False,2,-2,Russia
4382,4753,5079,1962,Guadeloupe,Martinique,1,0,Friendly,Basse-Terre,Guadeloupe,False,1,1,Guadeloupe
4383,4754,5080,1962,Brazil,Paraguay,6,0,Copa Oswaldo Cruz,Rio de Janeiro,Brazil,False,6,6,Brazil
4384,4755,5082,1962,Brazil,Paraguay,4,0,Copa Oswaldo Cruz,São Paulo,Brazil,False,4,4,Brazil
4385,4756,5083,1962,Mexico,Colombia,1,0,Friendly,Mexico City,Mexico,False,1,1,Mexico
4386,4757,5084,1962,Russia,Uruguay,5,0,Friendly,Moscow,Soviet Union,False,5,5,Russia
4387,4758,5085,1962,Hungary,Turkey,2,1,Friendly,Budapest,Hungary,False,3,1,Hungary
4388,4759,5086,1962,Scotland,Uruguay,2,3,Friendly,Glasgow,Scotland,False,5,-1,Uruguay
4389,4761,5088,1962,Italy,France,2,1,Friendly,Florence,Italy,False,3,1,Italy
4390,4762,5089,1962,Austria,Bulgaria,2,0,Friendly,Vienna,Austria,False,2,2,Austria
4391,4763,5090,1962,Brazil,Portugal,2,1,Friendly,São Paulo,Brazil,False,3,1,Brazil
4392,4764,5091,1962,Brazil,Portugal,1,0,Friendly,Rio de Janeiro,Brazil,False,1,1,Brazil
4393,4765,5092,1962,England,Switzerland,3,1,Friendly,London,England,False,4,2,England
4394,4766,5093,1962,Netherlands,Northern Ireland,4,0,Friendly,Rotterdam,Netherlands,False,4,4,Netherlands
4395,4767,5094,1962,Togo,Guinea,2,1,Friendly,Lomé,Togo,False,3,1,Togo
4396,4768,5095,1962,Brazil,Wales,3,1,Friendly,Rio de Janeiro,Brazil,False,4,2,Brazil
4397,4769,5096,1962,Belgium,Italy,1,3,Friendly,Brussels,Belgium,False,4,-2,Italy
4398,4770,5097,1962,Brazil,Wales,3,1,Friendly,São Paulo,Brazil,False,4,2,Brazil
4399,4771,5098,1962,Norway,Netherlands,2,1,Friendly,Oslo,Norway,False,3,1,Norway
4400,4772,5099,1962,Turkey,Israel,1,0,Friendly,Istanbul,Turkey,False,1,1,Turkey
4401,4773,5101,1962,Portugal,Belgium,1,2,Friendly,Lisbon,Portugal,False,3,-1,Belgium
4402,4774,5102,1962,Jamaica,Haiti,3,4,Friendly,Kingston,Jamaica,False,7,-1,Haiti
4403,4775,5103,1962,Peru,England,0,4,Friendly,Lima,Peru,False,4,-4,England
4404,4776,5104,1962,Jamaica,Haiti,1,3,Friendly,Kingston,Jamaica,False,4,-2,Haiti
4405,4777,5105,1962,Mexico,Wales,2,1,Friendly,Mexico City,Mexico,False,3,1,Mexico
4406,4778,5107,1962,Jamaica,Haiti,2,5,Friendly,Kingston,Jamaica,False,7,-3,Haiti
4407,4779,5108,1962,Poland,Belgium,2,0,Friendly,Warsaw,Poland,False,2,2,Poland
4408,4780,5109,1962,Argentina,Bulgaria,1,0,FIFA World Cup,Rancagua,Chile,True,1,1,Argentina
4409,4781,5110,1962,Brazil,Mexico,2,0,FIFA World Cup,Viña del Mar,Chile,True,2,2,Brazil
4410,4782,5111,1962,Chile,Switzerland,3,1,FIFA World Cup,Santiago,Chile,False,4,2,Chile
4411,4783,5112,1962,Colombia,Uruguay,1,2,FIFA World Cup,Arica,Chile,True,3,-1,Uruguay
4412,4784,5114,1962,England,Hungary,1,2,FIFA World Cup,Rancagua,Chile,True,3,-1,Hungary
4413,4785,5115,1962,Germany,Italy,0,0,FIFA World Cup,Santiago,Chile,True,0,0,Draw
4414,4787,5117,1962,Argentina,England,1,3,FIFA World Cup,Rancagua,Chile,True,4,-2,England
4415,4789,5119,1962,Chile,Italy,2,0,FIFA World Cup,Santiago,Chile,False,2,2,Chile
4416,4790,5120,1962,New Zealand,New Caledonia,4,1,Friendly,Christchurch,New Zealand,False,5,3,New Zealand
4417,4792,5122,1962,Bulgaria,Hungary,1,6,FIFA World Cup,Rancagua,Chile,True,7,-5,Hungary
4418,4793,5123,1962,Colombia,Russia,4,4,FIFA World Cup,Arica,Chile,True,8,0,Draw
4419,4794,5124,1962,Germany,Switzerland,2,1,FIFA World Cup,Santiago,Chile,True,3,1,Germany
4420,4795,5125,1962,Mexico,Spain,0,1,FIFA World Cup,Viña del Mar,Chile,True,1,-1,Spain
4421,4796,5126,1962,Tunisia,Libya,2,2,Friendly,Tunis,Tunisia,False,4,0,Draw
4422,4797,5127,1962,New Zealand,New Caledonia,4,2,Friendly,Wellington,New Zealand,False,6,2,New Zealand
4423,4798,5128,1962,Argentina,Hungary,0,0,FIFA World Cup,Rancagua,Chile,True,0,0,Draw
4424,4799,5129,1962,Brazil,Spain,2,1,FIFA World Cup,Viña del Mar,Chile,True,3,1,Brazil
4425,4800,5130,1962,Chile,Germany,0,2,FIFA World Cup,Santiago,Chile,False,2,-2,Germany
4426,4801,5131,1962,Russia,Uruguay,2,1,FIFA World Cup,Arica,Chile,True,3,1,Russia
4427,4802,5132,1962,Bulgaria,England,0,0,FIFA World Cup,Rancagua,Chile,True,0,0,Draw
4428,4804,5135,1962,Italy,Switzerland,3,0,FIFA World Cup,Santiago,Chile,True,3,3,Italy
4429,4805,5136,1962,Singapore,Hong Kong,2,6,Friendly,Kallang,Singapore,False,8,-4,Hong Kong
4430,4806,5137,1962,Brazil,England,3,1,FIFA World Cup,Viña del Mar,Chile,True,4,2,Brazil
4431,4807,5138,1962,Chile,Russia,2,1,FIFA World Cup,Arica,Chile,False,3,1,Chile
4432,4809,5141,1962,Denmark,Norway,6,1,Nordic Championship,Copenhagen,Denmark,False,7,5,Denmark
4433,4810,5142,1962,Chile,Brazil,2,4,FIFA World Cup,Santiago,Chile,False,6,-2,Brazil
4434,4813,5146,1962,Finland,Sweden,0,3,Nordic Championship,Helsinki,Finland,False,3,-3,Sweden
4435,4814,5147,1962,Norway,Sweden,0,2,UEFA Euro qualification,Oslo,Norway,False,2,-2,Sweden
4436,4815,5148,1962,Austria,Hungary,1,2,Friendly,Vienna,Austria,False,3,-1,Hungary
4437,4816,5149,1962,Denmark,Malta,6,1,UEFA Euro qualification,Copenhagen,Denmark,False,7,5,Denmark
4438,4817,5150,1962,Norway,Malta,5,0,Friendly,Trondheim,Norway,False,5,5,Norway
4439,4819,5152,1962,Jamaica,Curaçao,4,4,Friendly,Kingston,Jamaica,False,8,0,Draw
4440,4820,5153,1962,Iceland,Norway,1,3,Friendly,Reykjavík,Iceland,False,4,-2,Norway
4441,4821,5154,1962,Jamaica,Curaçao,2,1,Friendly,Kingston,Jamaica,False,3,1,Jamaica
4442,4822,5155,1962,Jamaica,Curaçao,1,2,Friendly,Kingston,Jamaica,False,3,-1,Curaçao
4443,4823,5156,1962,Singapore,Indonesia,1,2,Friendly,Kallang,Singapore,False,3,-1,Indonesia
4444,4824,5157,1962,Gabon,Congo,3,1,Friendly,Libreville,Gabon,False,4,2,Gabon
4445,4827,5161,1962,Kenya,Tanzania,4,3,Friendly,Nairobi,Kenya,False,7,1,Kenya
4446,4828,5162,1962,Bolivia,Paraguay,3,1,Copa Paz del Chaco,Cochabamba,Bolivia,False,4,2,Bolivia
4447,4829,5163,1962,Bolivia,Paraguay,3,2,Copa Paz del Chaco,La Paz,Bolivia,False,5,1,Bolivia
4448,4830,5164,1962,Republic of Ireland,Iceland,4,2,UEFA Euro qualification,Dublin,Republic of Ireland,False,6,2,Republic of Ireland
4449,4831,5165,1962,Argentina,Uruguay,3,1,Copa Lipton,Buenos Aires,Argentina,False,4,2,Argentina
4450,4832,5166,1962,Gabon,Cameroon,1,1,Friendly,Libreville,Gabon,False,2,0,Draw
4451,4833,5167,1962,Norway,Finland,2,1,Nordic Championship,Bergen,Norway,False,3,1,Norway
4452,4834,5168,1962,Suriname,Guadeloupe,3,1,Friendly,Paramaribo,Suriname,False,4,2,Suriname
4453,4835,5169,1962,Uganda,Kenya,3,1,Friendly,Kampala,Uganda,False,4,2,Uganda
4454,4836,5170,1962,Iceland,Republic of Ireland,1,1,UEFA Euro qualification,Reykjavík,Iceland,False,2,0,Draw
4455,4837,5171,1962,Poland,Hungary,0,2,Friendly,Poznań,Poland,False,2,-2,Hungary
4456,4838,5172,1962,Netherlands,Curaçao,8,0,Friendly,Amsterdam,Netherlands,False,8,8,Netherlands
4457,4839,5173,1962,Malaysia,Japan,2,2,Merdeka Tournament,Kuala Lumpur,Malaya,True,4,0,Draw
4458,4840,5174,1962,Burma,Pakistan,0,1,Merdeka Tournament,Kuala Lumpur,Malaya,True,1,-1,Pakistan
4459,4841,5175,1962,Denmark,Curaçao,3,1,Friendly,Odense,Denmark,False,4,2,Denmark
4460,4842,5176,1962,Indonesia,Singapore,2,0,Merdeka Tournament,Kuala Lumpur,Malaya,True,2,2,Indonesia
4461,4843,5177,1962,Indonesia,Philippines,9,0,Merdeka Tournament,Kuala Lumpur,Malaya,True,9,9,Indonesia
4462,4844,5178,1962,Japan,Pakistan,1,1,Merdeka Tournament,Kuala Lumpur,Malaya,True,2,0,Draw
4463,4845,5179,1962,Malaysia,Burma,3,2,Merdeka Tournament,Kuala Lumpur,Malaya,True,5,1,Malaysia
4464,4846,5180,1962,Philippines,Singapore,0,5,Merdeka Tournament,Kuala Lumpur,Malaya,True,5,-5,Singapore
4465,4848,5182,1962,Burma,Japan,3,1,Merdeka Tournament,Kuala Lumpur,Malaya,True,4,2,Burma
4466,4850,5184,1962,Congo,Gabon,3,1,Friendly,Brazzaville,Congo,False,4,2,Congo
4467,4851,5185,1962,Finland,Denmark,1,6,Nordic Championship,Helsinki,Finland,False,7,-5,Denmark
4468,4852,5187,1962,Malaysia,Pakistan,0,0,Merdeka Tournament,Kuala Lumpur,Malaya,True,0,0,Draw
4469,4853,5188,1962,Norway,Sweden,2,1,Nordic Championship,Oslo,Norway,False,3,1,Norway
4470,4855,5190,1962,Trinidad and Tobago,Suriname,1,1,Friendly,Port of Spain,Trinidad and Tobago,False,2,0,Draw
4471,4857,5192,1962,Trinidad and Tobago,Suriname,1,0,Friendly,Port of Spain,Trinidad and Tobago,False,1,1,Trinidad and Tobago
4472,4858,5193,1962,Indonesia,Pakistan,2,1,Merdeka Tournament,Kuala Lumpur,Malaya,True,3,1,Indonesia
4473,4859,5195,1962,Trinidad and Tobago,Suriname,1,1,Friendly,Port of Spain,Trinidad and Tobago,False,2,0,Draw
4474,4860,5196,1962,Singapore,Japan,2,1,Friendly,Kallang,Singapore,False,3,1,Singapore
4475,4861,5197,1962,Trinidad and Tobago,Suriname,1,1,Friendly,Port of Spain,Trinidad and Tobago,False,2,0,Draw
4476,4862,5198,1962,Denmark,Netherlands,4,1,Friendly,Copenhagen,Denmark,False,5,3,Denmark
4477,4863,5199,1962,Ghana,Kenya,6,3,Friendly,Kampala,Uganda,True,9,3,Ghana
4478,4864,5200,1962,Bulgaria,Poland,2,1,Friendly,Sofia,Bulgaria,False,3,1,Bulgaria
4479,4865,5201,1962,Romania,Morocco,4,0,Friendly,Bucharest,Romania,False,4,4,Romania
4480,4866,5203,1962,England,France,1,1,UEFA Euro qualification,Sheffield,England,False,2,0,Draw
4481,4867,5204,1962,Poland,Northern Ireland,0,2,UEFA Euro qualification,Chorzów,Poland,False,2,-2,Northern Ireland
4482,4868,5205,1962,Turkey,Ethiopia,3,0,Friendly,Ankara,Turkey,False,3,3,Turkey
4483,4869,5206,1962,Uganda,Ghana,1,4,Friendly,Kampala,Uganda,False,5,-3,Ghana
4484,4870,5207,1962,Poland,Morocco,1,1,Friendly,Warsaw,Poland,False,2,0,Draw
4485,4871,5208,1962,Kenya,Ghana,0,4,Friendly,Nairobi,Kenya,False,4,-4,Ghana
4486,4872,5210,1962,Suriname,Guadeloupe,3,3,Friendly,Parmaribo,Suriname,False,6,0,Draw
4487,4873,5211,1962,Belgium,Netherlands,2,0,Friendly,Antwerp,Belgium,False,2,2,Belgium
4488,4875,5215,1962,Malawi,Ghana,0,12,Friendly,Blantyre,Nyasaland,False,12,-12,Ghana
4489,4876,5216,1962,Suriname,French Guiana,4,2,Friendly,Paramaribo,Suriname,False,6,2,Suriname
4490,4877,5217,1962,Israel,Austria,1,1,Friendly,Ramat-Gan,Israel,False,2,0,Draw
4491,4878,5218,1962,Greece,Ethiopia,3,2,Friendly,Athens,Greece,False,5,1,Greece
4492,4879,5219,1962,Tanzania,Ghana,2,6,Friendly,Dar es Salaam,Tanganyika,False,8,-4,Ghana
4493,4880,5220,1962,Northern Ireland,England,1,3,British Championship,Belfast,Northern Ireland,False,4,-2,England
4494,4881,5221,1962,Wales,Scotland,2,3,British Championship,Cardiff,Wales,False,5,-1,Scotland
4495,4882,5222,1962,Germany,France,2,2,Friendly,Stuttgart,Germany,False,4,0,Draw
4496,4883,5224,1962,Malaysia,Thailand,4,2,Vietnam Independence Cup,Saigon,Vietnam Republic,True,6,2,Malaysia
4497,4884,5226,1962,Hungary,Austria,2,0,Friendly,Budapest,Hungary,False,2,2,Hungary
4498,4885,5227,1962,Indonesia,Malaysia,2,1,Vietnam Independence Cup,Saigon,Vietnam Republic,True,3,1,Indonesia
4499,4886,5228,1962,Sweden,Denmark,4,2,Nordic Championship,Solna,Sweden,False,6,2,Sweden
4500,4887,5230,1962,Indonesia,Thailand,7,0,Vietnam Independence Cup,Saigon,Vietnam Republic,True,7,7,Indonesia
4501,4888,5233,1962,Spain,Romania,6,0,UEFA Euro qualification,Madrid,Spain,False,6,6,Spain
4502,4889,5234,1962,Sweden,Norway,1,1,UEFA Euro qualification,Malmö,Sweden,False,2,0,Draw
4503,4890,5235,1962,Tanzania,Uganda,3,1,Friendly,Dar es Salaam,Tanzania,False,4,2,Tanzania
4504,4891,5237,1962,Kenya,Uganda,4,1,Friendly,Nairobi,Kenya,False,5,3,Kenya
4505,4892,5238,1962,Bulgaria,Portugal,3,1,UEFA Euro qualification,Sofia,Bulgaria,False,4,2,Bulgaria
4506,4893,5239,1962,Chile,Argentina,1,1,Copa Carlos Dittborn,Santiago,Chile,False,2,0,Draw
4507,4894,5240,1962,Hungary,Wales,3,1,UEFA Euro qualification,Budapest,Hungary,False,4,2,Hungary
4508,4895,5241,1962,Scotland,Northern Ireland,5,1,British Championship,Glasgow,Scotland,False,6,4,Scotland
4509,4896,5242,1962,Nigeria,Ghana,0,0,Friendly,Lagos,Nigeria,False,0,0,Draw
4510,4897,5243,1962,Austria,Italy,1,2,Friendly,Vienna,Austria,False,3,-1,Italy
4511,4898,5244,1962,France,Hungary,2,3,Friendly,Colombes,France,False,5,-1,Hungary
4512,4899,5245,1962,Guadeloupe,Martinique,3,1,Friendly,San Juan,Puerto Rico,True,4,2,Guadeloupe
4513,4900,5246,1962,Netherlands,Switzerland,3,1,UEFA Euro qualification,Amsterdam,Netherlands,False,4,2,Netherlands
4514,4901,5247,1962,Thailand,Sweden,1,2,Friendly,Bangkok,Thailand,False,3,-1,Sweden
4515,4902,5248,1962,Puerto Rico,Martinique,1,6,Friendly,San Juan,Puerto Rico,False,7,-5,Martinique
4516,4903,5249,1962,Argentina,Chile,1,0,Copa Carlos Dittborn,Buenos Aires,Argentina,False,1,1,Argentina
4517,4904,5250,1962,England,Wales,4,0,British Championship,London,England,False,4,4,England
4518,4905,5252,1962,Malaysia,Sweden,0,1,Friendly,Kuala Lumpur,Malaya,False,1,-1,Sweden
4519,4906,5253,1962,Grenada,Saint Vincent and the Grenadines,2,1,Windward Islands Tournament,St. George's,Grenada,False,3,1,Grenada
4520,4907,5254,1962,Puerto Rico,Guadeloupe,0,3,Friendly,San Juan,Puerto Rico,False,3,-3,Guadeloupe
4521,4908,5255,1962,Bulgaria,Austria,1,1,Friendly,Sofia,Bulgaria,False,2,0,Draw
4522,4909,5256,1962,Israel,Turkey,0,2,Friendly,Ramat-Gan,Israel,False,2,-2,Turkey
4523,4910,5257,1962,Romania,Spain,3,1,UEFA Euro qualification,Bucharest,Romania,False,4,2,Romania
4524,4911,5258,1962,Indonesia,Sweden,0,3,Friendly,Jakarta,Indonesia,False,3,-3,Sweden
4525,4912,5259,1962,Northern Ireland,Poland,2,0,UEFA Euro qualification,Belfast,Northern Ireland,False,2,2,Northern Ireland
4526,4913,5260,1962,Senegal,Ivory Coast,1,1,Friendly,Dakar,Senegal,False,2,0,Draw
4527,4914,5261,1962,Belgium,Spain,1,1,Friendly,Brussels,Belgium,False,2,0,Draw
4528,4915,5262,1962,Italy,Turkey,6,0,UEFA Euro qualification,Bologna,Italy,False,6,6,Italy
4529,4916,5263,1962,Malta,Denmark,1,3,UEFA Euro qualification,Gżira,Malta,False,4,-2,Denmark
4530,4917,5264,1962,Nigeria,Cameroon,3,1,Friendly,Lagos,Nigeria,False,4,2,Nigeria
4531,4918,5265,1962,Tanzania,Malawi,6,2,Friendly,Dar es Salaam,Tanganyika,False,8,4,Tanzania
4532,4920,5267,1962,Turkey,Denmark,1,1,Friendly,Istanbul,Turkey,False,2,0,Draw
4533,4922,5269,1962,Ethiopia,Turkey,0,0,Friendly,Addis Abeba,Ethiopia,False,0,0,Draw
4534,4924,5271,1962,Portugal,Bulgaria,3,1,UEFA Euro qualification,Oeiras,Portugal,False,4,2,Portugal
4535,4925,5272,1962,Germany,Switzerland,5,1,Friendly,Karlsruhe,Germany,False,6,4,Germany
4536,4926,5273,1962,Morocco,Romania,3,1,Friendly,Casablanca,Morocco,False,4,2,Morocco
4537,4927,5274,1962,Central African Republic,Cameroon,1,4,Friendly,Bangui,Central African Republic,False,5,-3,Cameroon
4538,4928,5275,1962,Congo,Madagascar,6,1,Friendly,Bangui,Central African Republic,True,7,5,Congo
4539,4929,5276,1962,Cameroon,Congo,0,3,Friendly,Bangui,Central African Republic,True,3,-3,Congo
4540,4930,5277,1962,Central African Republic,Madagascar,4,1,Friendly,Bangui,Central African Republic,False,5,3,Central African Republic
4541,4931,5278,1963,Cameroon,Nigeria,1,2,Friendly,Yaoundé,Cameroon,False,3,-1,Nigeria
4542,4932,5279,1963,Algeria,Bulgaria,2,1,Friendly,Algiers,Algeria,False,3,1,Algeria
4543,4933,5280,1963,Kuwait,Jordan,2,1,Friendly,Kuwait City,Kuwait,False,3,1,Kuwait
4544,4934,5281,1963,Spain,France,0,0,Friendly,Barcelona,Spain,False,0,0,Draw
4545,4935,5282,1963,Morocco,Switzerland,1,0,Friendly,Casablanca,Morocco,False,1,1,Morocco
4546,4939,5286,1963,Bulgaria,Portugal,1,0,UEFA Euro qualification,Rome,Italy,True,1,1,Bulgaria
4547,4941,5288,1963,Benin,Nigeria,1,1,Friendly,Cotonou,Dahomey,False,2,0,Draw
4548,4943,5290,1963,Mali,Burkina Faso,1,0,Friendly,Bamako,Mali,False,1,1,Mali
4549,4944,5291,1963,Nigeria,Benin,4,1,Friendly,Benin City,Nigeria,False,5,3,Nigeria
4550,4947,5294,1963,Paraguay,Bolivia,3,0,Copa Paz del Chaco,Asunción,Paraguay,False,3,3,Paraguay
4551,4948,5295,1963,Paraguay,Bolivia,5,1,Copa Paz del Chaco,Asunción,Paraguay,False,6,4,Paraguay
4552,4949,5296,1963,Jamaica,Haiti,3,2,Friendly,Kingston,Jamaica,False,5,1,Jamaica
4553,4950,5297,1963,Mali,Senegal,3,1,Friendly,Kumasi,Ghana,True,4,2,Mali
4554,4951,5298,1963,France,England,5,2,UEFA Euro qualification,Paris,France,False,7,3,France
4555,4952,5299,1963,Jamaica,Curaçao,1,2,Friendly,Kingston,Jamaica,False,3,-1,Curaçao
4556,4953,5300,1963,Nigeria,Senegal,4,0,Friendly,Kumasi,Ghana,True,4,4,Nigeria
4557,4954,5301,1963,Guatemala,Honduras,1,2,Friendly,Guatemala,Guatemala,False,3,-1,Honduras
4558,4955,5302,1963,Haiti,Curaçao,0,0,Friendly,Kingston,Jamaica,True,0,0,Draw
4559,4956,5303,1963,Ghana,Mali,4,0,Friendly,Accra,Ghana,False,4,4,Ghana
4560,4957,5304,1963,Netherlands,Belgium,0,1,Friendly,Rotterdam,Netherlands,False,1,-1,Belgium
4561,4958,5305,1963,Paraguay,Brazil,2,2,Friendly,Asunción,Paraguay,False,4,0,Draw
4562,4959,5306,1963,Tunisia,Kuwait,2,1,Friendly,Tunis,Tunisia,False,3,1,Tunisia
4563,4960,5307,1963,Jamaica,Curaçao,1,2,Friendly,Kingston,Jamaica,False,3,-1,Curaçao
4564,4961,5308,1963,Jamaica,Haiti,0,3,Friendly,Kingston,Jamaica,False,3,-3,Haiti
4565,4962,5309,1963,Argentina,Colombia,4,2,Copa América,Cochabamba,Bolivia,True,6,2,Argentina
4566,4963,5310,1963,Bolivia,Ecuador,4,4,Copa América,La Paz,Bolivia,False,8,0,Draw
4567,4964,5311,1963,Brazil,Peru,1,0,Copa América,Cochabamba,Bolivia,True,1,1,Brazil
4568,4965,5312,1963,Guatemala,Honduras,2,1,Friendly,Guatemala,Guatemala,False,3,1,Guatemala
4569,4966,5313,1963,Ivory Coast,Tunisia,3,0,Friendly,Abidjan,Ivory Coast,False,3,3,Ivory Coast
4570,4967,5314,1963,Argentina,Peru,1,2,Copa América,Cochabamba,Bolivia,True,3,-1,Peru
4571,4968,5315,1963,Brazil,Colombia,5,1,Copa América,La Paz,Bolivia,True,6,4,Brazil
4572,4969,5316,1963,Ecuador,Paraguay,1,3,Copa América,La Paz,Bolivia,True,4,-2,Paraguay
4573,4970,5317,1963,Bolivia,Colombia,2,1,Copa América,Cochabamba,Bolivia,False,3,1,Bolivia
4574,4971,5318,1963,Brazil,Paraguay,0,2,Copa América,La Paz,Bolivia,True,2,-2,Paraguay
4575,4972,5319,1963,Ecuador,Peru,1,2,Copa América,La Paz,Bolivia,True,3,-1,Peru
4576,4973,5320,1963,Argentina,Ecuador,4,2,Copa América,Cochabamba,Bolivia,True,6,2,Argentina
4577,4974,5321,1963,Colombia,Paraguay,2,3,Copa América,Cochabamba,Bolivia,True,5,-1,Paraguay
4578,4975,5322,1963,Wales,Hungary,1,1,UEFA Euro qualification,Cardiff,Wales,False,2,0,Draw
4579,4976,5323,1963,Bolivia,Peru,3,2,Copa América,La Paz,Bolivia,False,5,1,Bolivia
4580,4977,5324,1963,Guatemala,Panama,2,2,CONCACAF Championship,San Salvador,El Salvador,True,4,0,Draw
4581,4978,5325,1963,Uruguay,Chile,3,2,Copa Juan Pinto Durán,Montevideo,Uruguay,False,5,1,Uruguay
4582,4979,5326,1963,Argentina,Brazil,3,0,Copa América,La Paz,Bolivia,True,3,3,Argentina
4583,4980,5327,1963,Bolivia,Paraguay,2,0,Copa América,Cochabamba,Bolivia,False,2,2,Bolivia
4584,4981,5328,1963,Colombia,Peru,1,1,Copa América,La Paz,Bolivia,True,2,0,Draw
4585,4982,5329,1963,Costa Rica,Jamaica,6,0,CONCACAF Championship,Santa Ana,El Salvador,True,6,6,Costa Rica
4586,4983,5330,1963,Mexico,Curaçao,1,2,CONCACAF Championship,Santa Ana,El Salvador,True,3,-1,Curaçao
4587,4984,5331,1963,Uganda,Ethiopia,1,7,Friendly,Kampala,Uganda,False,8,-6,Ethiopia
4588,4985,5332,1963,Brazil,Ecuador,2,2,Copa América,Cochabamba,Bolivia,True,4,0,Draw
4589,4986,5333,1963,Guatemala,Nicaragua,3,1,CONCACAF Championship,San Salvador,El Salvador,True,4,2,Guatemala
4590,4987,5334,1963,Paraguay,Peru,4,1,Copa América,Cochabamba,Bolivia,True,5,3,Paraguay
4591,4988,5335,1963,Turkey,Italy,0,1,UEFA Euro qualification,Istanbul,Turkey,False,1,-1,Italy
4592,4989,5336,1963,Bolivia,Argentina,3,2,Copa América,La Paz,Bolivia,False,5,1,Bolivia
4593,4990,5337,1963,Costa Rica,Curaçao,1,0,CONCACAF Championship,Santa Ana,El Salvador,True,1,1,Costa Rica
4594,4991,5338,1963,Jamaica,Mexico,0,8,CONCACAF Championship,Santa Ana,El Salvador,True,8,-8,Mexico
4595,4992,5339,1963,Guatemala,Honduras,1,2,CONCACAF Championship,San Salvador,El Salvador,True,3,-1,Honduras
4596,4993,5340,1963,Nicaragua,Panama,0,5,CONCACAF Championship,San Salvador,El Salvador,True,5,-5,Panama
4597,4994,5341,1963,Costa Rica,Mexico,0,0,CONCACAF Championship,Santa Ana,El Salvador,True,0,0,Draw
4598,4995,5342,1963,Jamaica,Curaçao,1,2,CONCACAF Championship,Santa Ana,El Salvador,True,3,-1,Curaçao
4599,4996,5343,1963,Argentina,Paraguay,1,1,Copa América,La Paz,Bolivia,True,2,0,Draw
4600,4998,5345,1963,Bolivia,Brazil,5,4,Copa América,Cochabamba,Bolivia,False,9,1,Bolivia
4601,4999,5346,1963,Colombia,Ecuador,3,4,Copa América,La Paz,Bolivia,True,7,-1,Ecuador
4602,5000,5348,1963,Lebanon,Kuwait,6,0,UAFA Cup,Beirut,Lebanon,False,6,6,Lebanon
4603,5001,5349,1963,Suriname,Trinidad and Tobago,3,1,Friendly,Paramaribo,Suriname,False,4,2,Suriname
4604,5002,5350,1963,Switzerland,Netherlands,1,1,UEFA Euro qualification,Berne,Switzerland,False,2,0,Draw
4605,5003,5351,1963,Suriname,Trinidad and Tobago,1,2,Friendly,Paramaribo,Suriname,False,3,-1,Trinidad and Tobago
4606,5004,5352,1963,Syria,Tunisia,0,1,UAFA Cup,Beirut,Lebanon,True,1,-1,Tunisia
4607,5005,5353,1963,Honduras,Curaçao,1,4,CONCACAF Championship,San Salvador,El Salvador,True,5,-3,Curaçao
4608,5006,5354,1963,Northern Ireland,Wales,1,4,British Championship,Belfast,Northern Ireland,False,5,-3,Wales
4609,5007,5355,1963,Jordan,Tunisia,0,4,UAFA Cup,Beirut,Lebanon,True,4,-4,Tunisia
4610,5008,5356,1963,Suriname,Trinidad and Tobago,4,3,Friendly,Paramaribo,Suriname,False,7,1,Suriname
4611,5009,5357,1963,Costa Rica,Curaçao,1,0,CONCACAF Championship,San Salvador,El Salvador,True,1,1,Costa Rica
4612,5010,5358,1963,England,Scotland,1,2,British Championship,London,England,False,3,-1,Scotland
4613,5011,5359,1963,Kuwait,Tunisia,1,5,UAFA Cup,Beirut,Lebanon,True,6,-4,Tunisia
4614,5012,5360,1963,Lebanon,Jordan,5,0,UAFA Cup,Beirut,Lebanon,False,5,5,Lebanon
4615,5013,5361,1963,El Salvador,Curaçao,3,2,CONCACAF Championship,San Salvador,El Salvador,False,5,1,El Salvador
4616,5014,5362,1963,Kuwait,Syria,0,4,UAFA Cup,Beirut,Lebanon,True,4,-4,Syria
4617,5015,5363,1963,Lebanon,Tunisia,0,1,UAFA Cup,Beirut,Lebanon,False,1,-1,Tunisia
4618,5016,5364,1963,Brazil,Argentina,2,3,Copa Roca,São Paulo,Brazil,False,5,-1,Argentina
4619,5017,5365,1963,Brazil,Argentina,5,2,Copa Roca,Rio de Janeiro,Brazil,False,7,3,Brazil
4620,5018,5366,1963,Guadeloupe,Martinique,3,0,Friendly,Basse-Terre,Guadeloupe,False,3,3,Guadeloupe
4621,5019,5367,1963,Netherlands,France,1,0,Friendly,Rotterdam,Netherlands,False,1,1,Netherlands
4622,5020,5368,1963,Guadeloupe,Puerto Rico,3,0,Friendly,Basse-Terre,Guadeloupe,False,3,3,Guadeloupe
4623,5021,5369,1963,Portugal,Brazil,1,0,Friendly,Lisbon,Portugal,False,1,1,Portugal
4624,5023,5371,1963,Belgium,Brazil,5,1,Friendly,Brussels,Belgium,False,6,4,Belgium
4625,5025,5374,1963,Indonesia,Egypt,1,3,Friendly,Jakarta,Indonesia,False,4,-2,Egypt
4626,5027,5376,1963,Indonesia,Egypt,2,2,Friendly,Jakarta,Indonesia,False,4,0,Draw
4627,5029,5378,1963,France,Brazil,2,3,Friendly,Colombes,France,False,5,-1,Brazil
4628,5032,5381,1963,Netherlands,Brazil,1,0,Friendly,Amsterdam,Netherlands,False,1,1,Netherlands
4629,5033,5382,1963,Tanzania,Ethiopia,0,2,Friendly,Dar es Salaam,Tanganyika,False,2,-2,Ethiopia
4630,5034,5383,1963,Germany,Brazil,1,2,Friendly,Hamburg,Germany,False,3,-1,Brazil
4631,5035,5384,1963,Sweden,Hungary,2,1,Friendly,Solna,Sweden,False,3,1,Sweden
4632,5036,5385,1963,England,Brazil,1,1,Friendly,London,England,False,2,0,Draw
4633,5037,5386,1963,Scotland,Austria,4,1,Friendly,Glasgow,Scotland,False,5,3,Scotland
4634,5038,5387,1963,Italy,Brazil,3,0,Friendly,Milan,Italy,False,3,3,Italy
4635,5040,5389,1963,Norway,Poland,2,5,Friendly,Oslo,Norway,False,7,-3,Poland
4636,5041,5390,1963,Egypt,Brazil,0,1,Friendly,Cairo,Egypt,False,1,-1,Brazil
4637,5042,5391,1963,Hungary,Denmark,6,0,Friendly,Budapest,Hungary,False,6,6,Hungary
4638,5044,5393,1963,Israel,Brazil,0,5,Friendly,Ramat-Gan,Israel,False,5,-5,Brazil
4639,5045,5394,1963,Poland,Greece,4,0,Friendly,Warsaw,Poland,False,4,4,Poland
4640,5046,5395,1963,Russia,Sweden,0,1,Friendly,Moscow,Soviet Union,False,1,-1,Sweden
4641,5047,5398,1963,Spain,Northern Ireland,1,1,UEFA Euro qualification,Bilbao,Spain,False,2,0,Draw
4642,5048,5399,1963,Kenya,Sudan,0,1,African Cup of Nations qualification,Nairobi,Kenya,False,1,-1,Sudan
4643,5049,5402,1963,Poland,Romania,1,1,Friendly,Chorzów,Poland,False,2,0,Draw
4644,5050,5403,1963,Denmark,Finland,1,1,Nordic Championship,Copenhagen,Denmark,False,2,0,Draw
4645,5051,5404,1963,Kenya,Ethiopia,1,2,Friendly,Nairobi,Kenya,False,3,-1,Ethiopia
4646,5052,5405,1963,Norway,Scotland,4,3,Friendly,Bergen,Norway,False,7,1,Norway
4647,5053,5406,1963,Switzerland,England,1,8,Friendly,Basel,Switzerland,False,9,-7,England
4648,5054,5407,1963,Austria,Italy,0,1,Friendly,Vienna,Austria,False,1,-1,Italy
4649,5055,5408,1963,Republic of Ireland,Scotland,1,0,Friendly,Dublin,Republic of Ireland,False,1,1,Republic of Ireland
4650,5056,5409,1963,Tunisia,Lebanon,2,0,Friendly,Tunis,Tunisia,False,2,2,Tunisia
4651,5057,5410,1963,Spain,Scotland,2,6,Friendly,Madrid,Spain,False,8,-4,Scotland
4652,5058,5411,1963,Ethiopia,Sudan,4,0,Friendly,Addis Abeba,Ethiopia,False,4,4,Ethiopia
4653,5059,5413,1963,Finland,Norway,2,0,Nordic Championship,Helsinki,Finland,False,2,2,Finland
4654,5060,5414,1963,Denmark,Albania,4,0,UEFA Euro qualification,Copenhagen,Denmark,False,4,4,Denmark
4655,5061,5415,1963,Sudan,Kenya,5,0,African Cup of Nations qualification,Khartoum,Sudan,False,5,5,Sudan
4656,5062,5416,1963,Morocco,Tunisia,4,2,African Cup of Nations qualification,Casablanca,Morocco,False,6,2,Morocco
4657,5063,5417,1963,Zambia,Malawi,5,1,Friendly,Kitwe,Northern Rhodesia,False,6,4,Zambia
4658,5064,5418,1963,Algeria,Egypt,2,2,Friendly,Oran,Algeria,False,4,0,Draw
4659,5065,5419,1963,Chile,Uruguay,0,0,Copa Juan Pinto Durán,Santiago,Chile,False,0,0,Draw
4660,5066,5420,1963,Nigeria,Guinea,2,2,African Cup of Nations qualification,Lagos,Nigeria,False,4,0,Draw
4661,5067,5421,1963,Jamaica,El Salvador,0,1,Friendly,Kingston,Jamaica,False,1,-1,El Salvador
4662,5068,5422,1963,Jamaica,El Salvador,0,0,Friendly,Kingston,Jamaica,False,0,0,Draw
4663,5069,5423,1963,Malaysia,Japan,3,4,Merdeka Tournament,Kuala Lumpur,Malaya,True,7,-1,Japan
4664,5070,5424,1963,Jamaica,El Salvador,1,1,Friendly,Kingston,Jamaica,False,2,0,Draw
4665,5071,5425,1963,Thailand,Japan,1,4,Merdeka Tournament,Kuala Lumpur,Malaya,True,5,-3,Japan
4666,5074,5432,1963,Malaysia,Thailand,2,2,Merdeka Tournament,Kuala Lumpur,Malaya,True,4,0,Draw
4667,5075,5433,1963,Sweden,Finland,0,0,Nordic Championship,Solna,Sweden,False,0,0,Draw
4668,5076,5434,1963,Sweden,Norway,0,0,Nordic Championship,Gothenburg,Sweden,False,0,0,Draw
4669,5079,5437,1963,Fiji,Papua New Guinea,3,1,South Pacific Games,Suva,Fiji,False,4,2,Fiji
4670,5080,5438,1963,Solomon Islands,Vanuatu,6,3,South Pacific Games,Suva,Fiji,True,9,3,Solomon Islands
4671,5081,5439,1963,Colombia,Costa Rica,4,5,Friendly,Bogotá,Colombia,False,9,-1,Costa Rica
4672,5082,5440,1963,Fiji,Solomon Islands,5,0,South Pacific Games,Suva,Lautoka,False,5,5,Fiji
4673,5084,5443,1963,Colombia,Costa Rica,1,0,Friendly,Cali,Colombia,False,1,1,Colombia
4674,5085,5445,1963,Poland,Norway,9,0,Friendly,Szczecin,Poland,False,9,9,Poland
4675,5087,5447,1963,Fiji,New Caledonia,2,8,South Pacific Games,Suva,Fiji,False,10,-6,New Caledonia
4676,5088,5448,1963,Mauritius,Réunion,0,2,Friendly,Antananarivo,Madagascar,True,2,-2,Réunion
4677,5089,5449,1963,Netherlands,Luxembourg,1,1,UEFA Euro qualification,Amsterdam,Netherlands,False,2,0,Draw
4678,5090,5450,1963,Madagascar,Réunion,6,1,Friendly,Antananarivo,Madagascar,False,7,5,Madagascar
4679,5091,5451,1963,Norway,Denmark,0,4,Nordic Championship,Oslo,Norway,False,4,-4,Denmark
4680,5092,5452,1963,Bulgaria,Sudan,1,1,Friendly,Sofia,Bulgaria,False,2,0,Draw
4681,5094,5454,1963,Poland,Turkey,0,0,Friendly,Poznań,Poland,False,0,0,Draw
4682,5095,5455,1963,Russia,Hungary,1,1,Friendly,Moscow,Soviet Union,False,2,0,Draw
4683,5096,5456,1963,Austria,Republic of Ireland,0,0,UEFA Euro qualification,Vienna,Austria,False,0,0,Draw
4684,5097,5457,1963,Martinique,Puerto Rico,6,0,Friendly,Basse-Terre,Guadeloupe,True,6,6,Martinique
4685,5098,5458,1963,Germany,Turkey,3,0,Friendly,Frankfurt am Main,Germany,False,3,3,Germany
4686,5099,5459,1963,Kenya,Tanzania,4,1,Friendly,Nairobi,Kenya,False,5,3,Kenya
4687,5100,5460,1963,Bulgaria,France,1,0,UEFA Euro qualification,Sofia,Bulgaria,False,1,1,Bulgaria
4688,5103,5463,1963,Tanzania,Uganda,1,1,Friendly,Nairobi,Kenya,True,2,0,Draw
4689,5105,5465,1963,Kenya,Uganda,1,2,Friendly,Nairobi,Kenya,False,3,-1,Uganda
4690,5106,5466,1963,Denmark,Sweden,2,2,Nordic Championship,Copenhagen,Denmark,False,4,0,Draw
4691,5107,5467,1963,Guinea,Nigeria,1,0,African Cup of Nations qualification,Conakry,Guinea,False,1,1,Guinea
4692,5108,5469,1963,Liberia,Nigeria,2,2,Friendly,Monrovia,Liberia,False,4,0,Draw
4693,5109,5470,1963,Turkey,Romania,0,0,Friendly,Ankara,Turkey,False,0,0,Draw
4694,5111,5472,1963,Northern Ireland,Scotland,2,1,British Championship,Belfast,Northern Ireland,False,3,1,Northern Ireland
4695,5112,5473,1963,Wales,England,0,4,British Championship,Cardiff,Wales,False,4,-4,England
4696,5113,5474,1963,Republic of Ireland,Austria,3,2,UEFA Euro qualification,Dublin,Republic of Ireland,False,5,1,Republic of Ireland
4697,5114,5475,1963,Russia,Italy,2,0,UEFA Euro qualification,Moscow,Soviet Union,False,2,2,Russia
4698,5115,5476,1963,Paraguay,Argentina,0,4,Copa Chevallier Boutell,Asunción,Paraguay,False,4,-4,Argentina
4699,5116,5477,1963,Suriname,Curaçao,2,3,Friendly,Paramaribo,Suriname,False,5,-1,Curaçao
4700,5117,5478,1963,Greece,Poland,3,1,Friendly,Athens,Greece,False,4,2,Greece
4701,5118,5480,1963,Zambia,Kenya,0,1,Friendly,Kitwe,Northern Rhodesia,False,1,-1,Kenya
4702,5119,5481,1963,Netherlands,Belgium,1,1,Friendly,Amsterdam,Netherlands,False,2,0,Draw
4703,5120,5482,1963,France,Bulgaria,3,1,UEFA Euro qualification,Paris,France,False,4,2,France
4704,5121,5483,1963,Nigeria,Liberia,3,0,Friendly,Lagos,Nigeria,False,3,3,Nigeria
4705,5122,5484,1963,Hungary,Austria,2,1,Friendly,Budapest,Hungary,False,3,1,Hungary
4706,5124,5486,1963,Argentina,Paraguay,2,3,Copa Chevallier Boutell,Buenos Aires,Argentina,False,5,-1,Paraguay
4707,5125,5487,1963,Albania,Denmark,1,0,UEFA Euro qualification,Tirana,Albania,False,1,1,Albania
4708,5126,5488,1963,Netherlands,Luxembourg,1,2,UEFA Euro qualification,Rotterdam,Netherlands,False,3,-1,Luxembourg
4709,5127,5489,1963,Northern Ireland,Spain,0,1,UEFA Euro qualification,Belfast,Northern Ireland,False,1,-1,Spain
4710,5128,5490,1963,Cameroon,Togo,2,1,Friendly,Yaoundé,Cameroon,False,3,1,Cameroon
4711,5130,5492,1963,Sweden,Germany,2,1,Friendly,Solna,Sweden,False,3,1,Sweden
4712,5131,5493,1963,Switzerland,Norway,0,2,Friendly,Zürich,Switzerland,False,2,-2,Norway
4713,5132,5495,1963,Scotland,Norway,6,1,Friendly,Glasgow,Scotland,False,7,5,Scotland
4714,5133,5496,1963,Italy,Russia,1,1,UEFA Euro qualification,Rome,Italy,False,2,0,Draw
4715,5134,5497,1963,France,Switzerland,2,2,Friendly,Paris,France,False,4,0,Draw
4716,5137,5502,1963,Indonesia,Mali,3,2,Friendly,Jakarta,Indonesia,False,5,1,Indonesia
4717,5138,5503,1963,Egypt,Laos,15,0,Friendly,Jakarta,Indonesia,True,15,15,Egypt
4718,5140,5505,1963,Egypt,Saudi Arabia,7,0,Friendly,Jakarta,Indonesia,True,7,7,Egypt
4719,5142,5508,1963,England,Northern Ireland,8,3,British Championship,London,England,False,11,5,England
4720,5143,5509,1963,Hong Kong,Singapore,3,4,Friendly,So Kon Po,Hong Kong,False,7,-1,Singapore
4721,5144,5510,1963,Scotland,Wales,2,1,British Championship,Glasgow,Scotland,False,3,1,Scotland
4722,5145,5511,1963,Senegal,Ethiopia,1,2,Friendly,Dakar,Senegal,False,3,-1,Ethiopia
4723,5147,5513,1963,Egypt,Nigeria,6,3,African Cup of Nations,Kumasi,Ghana,True,9,3,Egypt
4724,5148,5514,1963,Ghana,Tunisia,1,1,African Cup of Nations,Accra,Ghana,False,2,0,Draw
4725,5149,5515,1963,Egypt,Sudan,2,2,African Cup of Nations,Kumasi,Ghana,True,4,0,Draw
4726,5150,5516,1963,Ghana,Ethiopia,2,0,African Cup of Nations,Accra,Ghana,False,2,2,Ghana
4727,5151,5517,1963,Cyprus,Greece,3,1,Friendly,Nicosia,Cyprus,False,4,2,Cyprus
4728,5152,5518,1963,Ethiopia,Tunisia,4,2,African Cup of Nations,Accra,Ghana,True,6,2,Ethiopia
4729,5153,5519,1963,Nigeria,Sudan,0,4,African Cup of Nations,Kumasi,Ghana,True,4,-4,Sudan
4730,5154,5520,1963,Egypt,Ethiopia,3,0,African Cup of Nations,Accra,Ghana,True,3,3,Egypt
4731,5155,5521,1963,Ghana,Sudan,3,0,African Cup of Nations,Accra,Ghana,False,3,3,Ghana
4732,5156,5522,1963,Morocco,Russia,1,1,Friendly,Casablanca,Morocco,False,2,0,Draw
4733,5157,5523,1963,Spain,Belgium,1,2,Friendly,Valencia,Spain,False,3,-1,Belgium
4734,5158,5524,1963,Luxembourg,Denmark,3,3,UEFA Euro qualification,Luxembourg,Luxembourg,False,6,0,Draw
4735,5159,5525,1963,Hong Kong,Thailand,3,3,AFC Asian Cup qualification,Saigon,Vietnam Republic,True,6,0,Draw
4736,5160,5526,1963,Kenya,Tanzania,6,2,Friendly,Nairobi,Kenya,False,8,4,Kenya
4737,5161,5528,1963,Denmark,Luxembourg,2,2,UEFA Euro qualification,Copenhagen,Denmark,False,4,0,Draw
4738,5162,5529,1963,Kenya,Uganda,1,1,Friendly,Nairobi,Kenya,False,2,0,Draw
4739,5163,5530,1963,Malaysia,Thailand,3,1,AFC Asian Cup qualification,Saigon,Vietnam Republic,True,4,2,Malaysia
4740,5164,5532,1963,Tanzania,Uganda,0,5,Friendly,Nairobi,Kenya,True,5,-5,Uganda
4741,5165,5533,1963,Hong Kong,Malaysia,4,3,AFC Asian Cup qualification,Saigon,Vietnam Republic,True,7,1,Hong Kong
4742,5166,5534,1963,Italy,Austria,1,0,Friendly,Turin,Italy,False,1,1,Italy
4743,5167,5536,1963,Senegal,Guinea,1,1,Friendly,Dakar,Senegal,False,2,0,Draw
4744,5168,5537,1963,Tunisia,Algeria,0,0,Friendly,Tunis,Tunisia,False,0,0,Draw
4745,5171,5540,1963,Denmark,Luxembourg,1,0,UEFA Euro qualification,Amsterdam,Netherlands,True,1,1,Denmark
4746,5172,5541,1963,France,Belgium,1,2,Friendly,Paris,France,False,3,-1,Belgium
4747,5173,5542,1963,Morocco,Germany,1,4,Friendly,Casablanca,Morocco,False,5,-3,Germany
4748,5174,5543,1963,Cameroon,Guinea,1,5,Friendly,Yaoundé,Cameroon,False,6,-4,Guinea
4749,5175,5544,1964,Algeria,Germany,2,0,Friendly,Algiers,Algeria,False,2,2,Algeria
4750,5176,5545,1964,Hong Kong,Israel,0,3,Friendly,So Kon Po,Hong Kong,False,3,-3,Israel
4751,5177,5546,1964,Saint Lucia,Saint Vincent and the Grenadines,2,2,Windward Islands Tournament,Castries,Saint Lucia,False,4,0,Draw
4752,5178,5547,1964,Dominica,Saint Vincent and the Grenadines,2,2,Windward Islands Tournament,Castries,Saint Lucia,True,4,0,Draw
4753,5179,5548,1964,Saint Lucia,Dominica,4,2,Windward Islands Tournament,Castries,Saint Lucia,False,6,2,Saint Lucia
4754,5180,5549,1964,Saint Lucia,Saint Vincent and the Grenadines,0,0,Windward Islands Tournament,Castries,Saint Lucia,False,0,0,Draw
4755,5181,5550,1964,Dominica,Saint Vincent and the Grenadines,1,1,Windward Islands Tournament,Castries,Saint Lucia,True,2,0,Draw
4756,5183,5552,1964,Saint Lucia,Dominica,5,0,Windward Islands Tournament,Castries,Saint Lucia,False,5,5,Saint Lucia
4757,5184,5553,1964,Cameroon,Benin,2,4,Friendly,Yaoundé,Cameroon,False,6,-2,Benin
4758,5185,5554,1964,Cameroon,Congo,7,1,Friendly,Yaoundé,Cameroon,False,8,6,Cameroon
4759,5186,5555,1964,Congo,Cameroon,4,4,Friendly,Brazzaville,Congo,False,8,0,Draw
4760,5188,5557,1964,Sri Lanka,Indonesia,3,9,Friendly,Colombo,Ceylon,False,12,-6,Indonesia
4761,5189,5558,1964,Congo,DR Congo,0,0,Friendly,Brazzaville,Congo,False,0,0,Draw
4762,5190,5559,1964,Sri Lanka,Indonesia,1,4,Friendly,Colombo,Ceylon,False,5,-3,Indonesia
4763,5191,5560,1964,Singapore,Japan,1,2,Friendly,Kallang,Singapore,False,3,-1,Japan
4764,5192,5561,1964,Libya,Lebanon,0,1,Friendly,Tripoli,Libya,False,1,-1,Lebanon
4765,5193,5562,1964,Spain,Republic of Ireland,5,1,UEFA Euro qualification,Seville,Spain,False,6,4,Spain
4766,5194,5563,1964,Ivory Coast,Mali,1,1,Friendly,Abidjan,Ivory Coast,False,2,0,Draw
4767,5195,5564,1964,Libya,Malta,2,2,Friendly,Tripoli,Libya,False,4,0,Draw
4768,5197,5566,1964,Egypt,Algeria,1,0,Friendly,Cairo,Egypt,False,1,1,Egypt
4769,5198,5567,1964,Belgium,Netherlands,0,0,Friendly,Antwerp,Belgium,False,0,0,Draw
4770,5199,5568,1964,Congo,Chad,11,0,Friendly,Brazzaville,Congo,False,11,11,Congo
4771,5200,5570,1964,Guyana,Trinidad and Tobago,1,2,Friendly,Georgetown,British Guyana,False,3,-1,Trinidad and Tobago
4772,5201,5571,1964,Republic of Ireland,Spain,0,2,UEFA Euro qualification,Dublin,Republic of Ireland,False,2,-2,Spain
4773,5202,5572,1964,Guyana,Trinidad and Tobago,1,6,Friendly,Georgetown,British Guyana,False,7,-5,Trinidad and Tobago
4774,5204,5574,1964,Scotland,England,1,0,British Championship,Glasgow,Scotland,False,1,1,Scotland
4775,5205,5575,1964,Guyana,Trinidad and Tobago,1,4,Friendly,Georgetown,British Guyana,False,5,-3,Trinidad and Tobago
4776,5206,5576,1964,Netherlands,Austria,1,1,Friendly,Amsterdam,Netherlands,False,2,0,Draw
4777,5207,5577,1964,Switzerland,Belgium,2,0,Friendly,Geneva,Switzerland,False,2,2,Switzerland
4778,5208,5578,1964,Wales,Northern Ireland,2,3,British Championship,Swansea,Wales,False,5,-1,Northern Ireland
4779,5209,5579,1964,Cameroon,DR Congo,2,2,Friendly,Yaoundé,Cameroon,False,4,0,Draw
4780,5210,5580,1964,France,Hungary,1,3,UEFA Euro qualification,Colombes,France,False,4,-2,Hungary
4781,5212,5582,1964,Netherlands,Sweden,0,1,Friendly,Rotterdam,Netherlands,False,1,-1,Sweden
4782,5213,5583,1964,Northern Ireland,Uruguay,3,0,Friendly,Belfast,Northern Ireland,False,3,3,Northern Ireland
4783,5214,5584,1964,Switzerland,Portugal,2,3,Friendly,Zürich,Switzerland,False,5,-1,Portugal
4784,5215,5585,1964,Austria,Hungary,1,0,Friendly,Vienna,Austria,False,1,1,Austria
4785,5216,5586,1964,Belgium,Portugal,1,2,Friendly,Brussels,Belgium,False,3,-1,Portugal
4786,5217,5587,1964,England,Uruguay,2,1,Friendly,London,England,False,3,1,England
4787,5218,5588,1964,Poland,Republic of Ireland,3,1,Friendly,Cracow,Poland,False,4,2,Poland
4788,5219,5589,1964,Switzerland,Italy,1,3,Friendly,Lausanne,Switzerland,False,4,-2,Italy
4789,5220,5590,1964,Germany,Scotland,2,2,Friendly,Hanover,Germany,False,4,0,Draw
4790,5221,5591,1964,Greece,Ethiopia,3,1,Friendly,Athens,Greece,False,4,2,Greece
4791,5222,5592,1964,Norway,Republic of Ireland,1,4,Friendly,Oslo,Norway,False,5,-3,Republic of Ireland
4792,5223,5593,1964,Sweden,Russia,1,1,UEFA Euro qualification,Solna,Sweden,False,2,0,Draw
4793,5224,5594,1964,Austria,Uruguay,0,2,Friendly,Vienna,Austria,False,2,-2,Uruguay
4794,5225,5596,1964,Portugal,England,3,4,Friendly,Oeiras,Portugal,False,7,-1,England
4795,5226,5597,1964,Tunisia,Ethiopia,3,2,Friendly,Tunis,Tunisia,False,5,1,Tunisia
4796,5227,5598,1964,Russia,Uruguay,1,0,Friendly,Moscow,Soviet Union,False,1,1,Russia
4797,5228,5599,1964,Hungary,France,2,1,UEFA Euro qualification,Budapest,Hungary,False,3,1,Hungary
4798,5229,5600,1964,Republic of Ireland,England,1,3,Friendly,Dublin,Republic of Ireland,False,4,-2,England
4799,5230,5601,1964,Netherlands,Albania,2,0,FIFA World Cup qualification,Rotterdam,Netherlands,False,2,2,Netherlands
4800,5231,5602,1964,Israel,Hong Kong,1,0,AFC Asian Cup,Ramat-Gan,Israel,False,1,1,Israel
4801,5233,5604,1964,Russia,Sweden,3,1,UEFA Euro qualification,Moscow,Soviet Union,False,4,2,Russia
4802,5234,5605,1964,United States,England,0,10,Friendly,New York,United States,False,10,-10,England
4803,5235,5606,1964,Israel,India,2,0,AFC Asian Cup,Jaffa,Israel,False,2,2,Israel
4804,5236,5607,1964,Brazil,England,5,1,Friendly,Rio de Janeiro,Brazil,False,6,4,Brazil
4805,5237,5608,1964,Argentina,Portugal,2,0,Friendly,Rio de Janeiro,Brazil,True,2,2,Argentina
4806,5239,5610,1964,Hong Kong,India,1,3,AFC Asian Cup,Jaffa,Israel,True,4,-2,India
4807,5240,5611,1964,Brazil,Argentina,0,3,Friendly,São Paulo,Brazil,False,3,-3,Argentina
4808,5242,5613,1964,England,Portugal,1,1,Friendly,São Paulo,Brazil,True,2,0,Draw
4809,5243,5614,1964,French Guiana,Suriname,3,1,Friendly,Cayenne,French Guiana,False,4,2,French Guiana
4810,5244,5615,1964,French Guiana,Suriname,3,3,Friendly,Cayenne,French Guiana,False,6,0,Draw
4811,5245,5616,1964,Argentina,England,1,0,Friendly,Rio de Janeiro,Brazil,True,1,1,Argentina
4812,5246,5617,1964,Brazil,Portugal,4,1,Friendly,Rio de Janeiro,Brazil,False,5,3,Brazil
4813,5247,5618,1964,Finland,Germany,1,4,Friendly,Helsinki,Finland,False,5,-3,Germany
4814,5248,5619,1964,Denmark,Russia,0,3,UEFA Euro,Barcelona,Spain,True,3,-3,Russia
4815,5249,5620,1964,Spain,Hungary,2,1,UEFA Euro,Madrid,Spain,False,3,1,Spain
4816,5250,5622,1964,Congo,Guinea,1,2,Friendly,Brazzaville,Congo,False,3,-1,Guinea
4817,5251,5623,1964,Hungary,Denmark,3,1,UEFA Euro,Barcelona,Spain,True,4,2,Hungary
4818,5252,5624,1964,Spain,Russia,2,1,UEFA Euro,Madrid,Spain,False,3,1,Spain
4819,5253,5625,1964,Sweden,Denmark,4,1,Nordic Championship,Malmö,Sweden,False,5,3,Sweden
4820,5254,5627,1964,Norway,Switzerland,3,2,Friendly,Bergen,Norway,False,5,1,Norway
4821,5255,5628,1964,Zambia,Tanzania,3,0,Friendly,Zomba,Nyasaland,True,3,3,Zambia
4822,5256,5629,1964,Malawi,Zambia,0,5,Friendly,Blantyre,Nyasaland,False,5,-5,Zambia
4823,5257,5630,1964,Singapore,Hong Kong,1,1,Friendly,Kallang,Singapore,False,2,0,Draw
4824,5258,5631,1964,Singapore,Hong Kong,2,1,Friendly,Kallang,Singapore,False,3,1,Singapore
4825,5259,5632,1964,Cameroon,DR Congo,1,1,Friendly,Yaoundé,Cameroon,False,2,0,Draw
4826,5260,5633,1964,Cameroon,Central African Republic,2,1,Friendly,Yaoundé,Cameroon,False,3,1,Cameroon
4827,5261,5634,1964,Cameroon,Congo,3,1,Friendly,Yaoundé,Cameroon,False,4,2,Cameroon
4828,5262,5635,1964,Cameroon,DR Congo,2,1,Friendly,Yaoundé,Cameroon,False,3,1,Cameroon
4829,5263,5636,1964,Finland,Sweden,1,0,Nordic Championship,Helsinki,Finland,False,1,1,Finland
4830,5264,5637,1964,Iceland,Bermuda,4,3,Friendly,Reykjavík,Iceland,False,7,1,Iceland
4831,5265,5638,1964,Congo,Mali,1,0,Friendly,Brazzaville,Congo,False,1,1,Congo
4832,5266,5639,1964,Norway,Finland,2,0,Nordic Championship,Trondheim,Norway,False,2,2,Norway
4833,5268,5641,1964,Iceland,Finland,0,2,Friendly,Reykjavík,Iceland,False,2,-2,Finland
4834,5269,5642,1964,Cambodia,India,0,4,Merdeka Tournament,Kuala Lumpur,Malaysia,True,4,-4,India
4835,5270,5643,1964,Malaysia,Burma,0,3,Merdeka Tournament,Kuala Lumpur,Malaysia,False,3,-3,Burma
4836,5271,5644,1964,India,Thailand,2,1,Merdeka Tournament,Ipoh,Malaysia,True,3,1,India
4837,5274,5647,1964,Cambodia,Thailand,0,1,Merdeka Tournament,Kuala Lumpur,Malaysia,True,1,-1,Thailand
4838,5277,5650,1964,Guyana,Trinidad and Tobago,1,1,Friendly,Georgetown,British Guyana,False,2,0,Draw
4839,5278,5651,1964,Guyana,Trinidad and Tobago,1,2,Friendly,Georgetown,British Guyana,False,3,-1,Trinidad and Tobago
4840,5279,5652,1964,Malaysia,Thailand,1,1,Merdeka Tournament,Ipoh,Malaysia,False,2,0,Draw
4841,5280,5653,1964,Burma,India,1,0,Merdeka Tournament,Kuala Lumpur,Malaysia,True,1,1,Burma
4842,5281,5654,1964,Finland,Denmark,2,1,Nordic Championship,Helsinki,Finland,False,3,1,Finland
4843,5285,5659,1964,Martinique,Puerto Rico,4,0,Friendly,Fort-de-France,Martinique,False,4,4,Martinique
4844,5286,5660,1964,Martinique,Guadeloupe,1,0,Friendly,Fort-de-France,Martinique,False,1,1,Martinique
4845,5287,5661,1964,Norway,Sweden,1,1,Nordic Championship,Oslo,Norway,False,2,0,Draw
4846,5288,5663,1964,Guadeloupe,Puerto Rico,4,0,Friendly,Fort-de-France,Martinique,True,4,4,Guadeloupe
4847,5289,5664,1964,Argentina,Chile,5,0,Copa Carlos Dittborn,Buenos Aires,Argentina,False,5,5,Argentina
4848,5290,5665,1964,Tanzania,Kenya,1,0,Friendly,Dar es Salaam,Tanganyika,False,1,1,Tanzania
4849,5292,5668,1964,Turkey,Poland,2,3,Friendly,Istanbul,Turkey,False,5,-1,Poland
4850,5295,5671,1964,Belgium,Netherlands,1,0,Friendly,Antwerp,Belgium,False,1,1,Belgium
4851,5296,5672,1964,Kenya,Uganda,0,1,Friendly,Dar es Salaam,Tanganyika,True,1,-1,Uganda
4852,5297,5673,1964,Northern Ireland,England,3,4,British Championship,Belfast,Northern Ireland,False,7,-1,England
4853,5298,5674,1964,Tanzania,Uganda,3,0,Friendly,Dar es Salaam,Tanganyika,False,3,3,Tanzania
4854,5299,5675,1964,Wales,Scotland,3,2,British Championship,Cardiff,Wales,False,5,1,Wales
4855,5300,5676,1964,Luxembourg,France,0,2,FIFA World Cup qualification,Luxembourg,Luxembourg,False,2,-2,France
4856,5301,5677,1964,Switzerland,Hungary,0,2,Friendly,Berne,Switzerland,False,2,-2,Hungary
4857,5302,5679,1964,Sweden,Poland,3,3,Friendly,Solna,Sweden,False,6,0,Draw
4858,5303,5680,1964,Uganda,Burundi,7,5,Friendly,Kampala,Uganda,False,12,2,Uganda
4859,5304,5681,1964,Austria,Russia,1,0,Friendly,Vienna,Austria,False,1,1,Austria
4860,5305,5682,1964,Denmark,Norway,2,0,Nordic Championship,Copenhagen,Denmark,False,2,2,Denmark
4861,5307,5684,1964,Chile,Argentina,1,1,Copa Carlos Dittborn,Santiago,Chile,False,2,0,Draw
4862,5308,5685,1964,Northern Ireland,Switzerland,1,0,FIFA World Cup qualification,Belfast,Northern Ireland,False,1,1,Northern Ireland
4863,5309,5686,1964,Uganda,Kenya,3,2,Friendly,Lusaka,Northern Rhodesia,True,5,1,Uganda
4864,5310,5687,1964,Zambia,Uganda,0,2,Friendly,Luanshya,Northern Rhodesia,False,2,-2,Uganda
4865,5311,5688,1964,Denmark,Wales,1,0,FIFA World Cup qualification,Copenhagen,Denmark,False,1,1,Denmark
4866,5312,5689,1964,England,Belgium,2,2,Friendly,London,England,False,4,0,Draw
4867,5313,5690,1964,Ghana,Kenya,7,1,Friendly,Chingola,Northern Rhodesia,True,8,6,Ghana
4868,5314,5691,1964,Scotland,Finland,3,1,FIFA World Cup qualification,Glasgow,Scotland,False,4,2,Scotland
4869,5315,5692,1964,Ghana,Uganda,2,0,Friendly,Kitwe,Northern Rhodesia,True,2,2,Ghana
4870,5316,5693,1964,Zambia,Kenya,2,3,Friendly,Ndola,Northern Rhodesia,False,5,-1,Kenya
4871,5317,5694,1964,Albania,Netherlands,0,2,FIFA World Cup qualification,Tirana,Albania,False,2,-2,Netherlands
4872,5319,5696,1964,Republic of Ireland,Poland,3,2,Friendly,Dublin,Republic of Ireland,False,5,1,Republic of Ireland
4873,5320,5697,1964,Zambia,Ghana,3,4,Friendly,Lusaka,Northern Rhodesia,False,7,-1,Ghana
4874,5322,5699,1964,Turkey,Tunisia,4,1,Friendly,Ankara,Turkey,False,5,3,Turkey
4875,5323,5700,1964,Algeria,Russia,2,2,Friendly,Algiers,Algeria,False,4,0,Draw
4876,5324,5701,1964,Germany,Sweden,1,1,FIFA World Cup qualification,Berlin,Germany,False,2,0,Draw
4877,5325,5702,1964,Italy,Finland,6,1,FIFA World Cup qualification,Genoa,Italy,False,7,5,Italy
4878,5326,5703,1964,Luxembourg,Norway,0,2,FIFA World Cup qualification,Luxembourg,Luxembourg,False,2,-2,Norway
4879,5327,5704,1964,France,Norway,1,0,FIFA World Cup qualification,Paris,France,False,1,1,France
4880,5328,5705,1964,Jordan,Lebanon,0,0,UAFA Cup,Kuwait City,Kuwait,True,0,0,Draw
4881,5329,5706,1964,Kuwait,Iraq,0,1,UAFA Cup,Kuwait City,Kuwait,False,1,-1,Iraq
4882,5330,5707,1964,Switzerland,Northern Ireland,2,1,FIFA World Cup qualification,Lausanne,Switzerland,False,3,1,Switzerland
4883,5331,5708,1964,Kuwait,Jordan,2,0,UAFA Cup,Kuwait City,Kuwait,False,2,2,Kuwait
4884,5332,5709,1964,Libya,Lebanon,2,1,UAFA Cup,Kuwait City,Kuwait,True,3,1,Libya
4885,5333,5710,1964,Portugal,Spain,2,1,Friendly,Porto,Portugal,False,3,1,Portugal
4886,5334,5711,1964,Kuwait,Libya,1,1,UAFA Cup,Kuwait City,Kuwait,False,2,0,Draw
4887,5335,5712,1964,Iraq,Lebanon,1,0,UAFA Cup,Kuwait City,Kuwait,True,1,1,Iraq
4888,5336,5713,1964,Jordan,Libya,2,5,UAFA Cup,Kuwait City,Kuwait,True,7,-3,Libya
4889,5337,5714,1964,England,Wales,2,1,British Championship,London,England,False,3,1,England
4890,5338,5715,1964,Kuwait,Lebanon,2,3,UAFA Cup,Kuwait City,Kuwait,False,5,-1,Lebanon
4891,5339,5717,1964,Paraguay,Argentina,3,0,Copa Chevallier Boutell,Asunción,Paraguay,False,3,3,Paraguay
4892,5340,5718,1964,Scotland,Northern Ireland,3,2,British Championship,Glasgow,Scotland,False,5,1,Scotland
4893,5341,5719,1964,Bulgaria,Russia,0,0,Friendly,Sofia,Bulgaria,False,0,0,Draw
4894,5342,5720,1964,Greece,Denmark,4,2,FIFA World Cup qualification,Athens,Greece,False,6,2,Greece
4895,5343,5721,1964,Israel,Denmark,0,1,Friendly,Jaffa,Israel,False,1,-1,Denmark
4896,5344,5722,1964,Belgium,France,3,0,Friendly,Brussels,Belgium,False,3,3,Belgium
4897,5345,5723,1964,Italy,Denmark,3,1,Friendly,Bologna,Italy,False,4,2,Italy
4898,5346,5724,1964,Argentina,Paraguay,8,1,Copa Chevallier Boutell,Buenos Aires,Argentina,False,9,7,Argentina
4899,5347,5725,1964,Greece,Wales,2,0,FIFA World Cup qualification,Athens,Greece,False,2,2,Greece
4900,5348,5726,1964,Netherlands,England,1,1,Friendly,Amsterdam,Netherlands,False,2,0,Draw
4901,5349,5727,1964,Kenya,Zambia,4,2,Friendly,Nairobi,Kenya,False,6,2,Kenya
4902,5350,5728,1964,Kenya,Zambia,2,8,Friendly,Nairobi,Kenya,False,10,-6,Zambia
4903,5351,5729,1964,Turkey,Bulgaria,0,0,Friendly,Istanbul,Turkey,False,0,0,Draw
4904,5353,5731,1965,Togo,DR Congo,0,3,Friendly,Lomé,Togo,False,3,-3,DR Congo
4905,5354,5732,1965,Jamaica,Cuba,2,0,FIFA World Cup qualification,Kingston,Jamaica,False,2,2,Jamaica
4906,5355,5733,1965,Ivory Coast,DR Congo,2,0,African Cup of Nations qualification,Abidjan,Ivory Coast,False,2,2,Ivory Coast
4907,5356,5734,1965,Cuba,Curaçao,1,1,FIFA World Cup qualification,Kingston,Jamaica,True,2,0,Draw
4908,5357,5735,1965,Jamaica,Curaçao,2,0,FIFA World Cup qualification,Kingston,Jamaica,False,2,2,Jamaica
4909,5358,5736,1965,Portugal,Turkey,5,1,FIFA World Cup qualification,Oeiras,Portugal,False,6,4,Portugal
4910,5359,5737,1965,Israel,Netherlands,0,1,Friendly,Jaffa,Israel,False,1,-1,Netherlands
4911,5360,5738,1965,Cuba,Curaçao,0,1,FIFA World Cup qualification,Havana,Cuba,False,1,-1,Curaçao
4912,5361,5739,1965,Congo,DR Congo,0,3,Friendly,Brazzaville,Congo,False,3,-3,DR Congo
4913,5362,5740,1965,Curaçao,Jamaica,0,0,FIFA World Cup qualification,Havana,Cuba,True,0,0,Draw
4914,5363,5741,1965,Cuba,Jamaica,2,1,FIFA World Cup qualification,Havana,Cuba,False,3,1,Cuba
4915,5364,5742,1965,Trinidad and Tobago,Suriname,4,1,FIFA World Cup qualification,Port of Spain,Trinidad and Tobago,False,5,3,Trinidad and Tobago
4916,5365,5743,1965,Costa Rica,Suriname,1,0,FIFA World Cup qualification,San José,Costa Rica,False,1,1,Costa Rica
4917,5366,5744,1965,Kenya,Ethiopia,3,2,African Cup of Nations qualification,Nairobi,Kenya,False,5,1,Kenya
4918,5367,5745,1965,Costa Rica,Trinidad and Tobago,4,0,FIFA World Cup qualification,San José,Costa Rica,False,4,4,Costa Rica
4919,5368,5746,1965,Uganda,Ethiopia,1,2,African Cup of Nations qualification,Kampala,Uganda,False,3,-1,Ethiopia
4920,5369,5747,1965,Costa Rica,Trinidad and Tobago,1,0,Friendly,San José,Costa Rica,False,1,1,Costa Rica
4921,5370,5748,1965,Honduras,Mexico,0,1,FIFA World Cup qualification,San Pedro Sula,Honduras,False,1,-1,Mexico
4922,5371,5749,1965,Kenya,Uganda,3,0,African Cup of Nations qualification,Nairobi,Kenya,False,3,3,Kenya
4923,5372,5750,1965,Suriname,Costa Rica,1,3,FIFA World Cup qualification,Paramaribo,Suriname,False,4,-2,Costa Rica
4924,5373,5751,1965,Tunisia,Morocco,0,0,Friendly,Tunis,Tunisia,False,0,0,Draw
4925,5374,5752,1965,Mexico,Honduras,3,0,FIFA World Cup qualification,Mexico City,Mexico,False,3,3,Mexico
4926,5375,5753,1965,Trinidad and Tobago,Costa Rica,0,1,FIFA World Cup qualification,Port of Spain,Trinidad and Tobago,False,1,-1,Costa Rica
4927,5376,5754,1965,United States,Mexico,2,2,FIFA World Cup qualification,Los Angeles,United States,False,4,0,Draw
4928,5377,5755,1965,Curaçao,Costa Rica,1,2,Friendly,Willemstad,Netherlands Antilles,False,3,-1,Costa Rica
4929,5378,5756,1965,El Salvador,Nicaragua,4,0,CONCACAF Championship qualification,San Salvador,El Salvador,False,4,4,El Salvador
4930,5379,5757,1965,Guatemala,Paraguay,1,4,Friendly,Guatemala,Guatemala,False,5,-3,Paraguay
4931,5380,5758,1965,Hong Kong,Japan,1,4,Friendly,So Kon Po,Hong Kong,False,5,-3,Japan
4932,5381,5759,1965,Honduras,Nicaragua,0,2,CONCACAF Championship qualification,San Salvador,El Salvador,True,2,-2,Nicaragua
4933,5382,5760,1965,Kuwait,Morocco,0,2,Friendly,Tripoli,Libya,True,2,-2,Morocco
4934,5383,5761,1965,Mexico,United States,2,0,FIFA World Cup qualification,Mexico City,Mexico,False,2,2,Mexico
4935,5384,5762,1965,Germany,Italy,1,1,Friendly,Hamburg,Germany,False,2,0,Draw
4936,5385,5763,1965,Uganda,Kenya,3,1,African Cup of Nations qualification,Kampala,Uganda,False,4,2,Uganda
4937,5386,5764,1965,El Salvador,Honduras,3,1,CONCACAF Championship qualification,San Salvador,El Salvador,False,4,2,El Salvador
4938,5387,5765,1965,Guatemala,Paraguay,0,3,Friendly,Guatemala,Guatemala,False,3,-3,Paraguay
4939,5388,5766,1965,Libya,Kuwait,4,1,Friendly,Tripoli,Libya,False,5,3,Libya
4940,5389,5767,1965,Suriname,Trinidad and Tobago,6,1,FIFA World Cup qualification,Paramaribo,Suriname,False,7,5,Suriname
4941,5390,5768,1965,Hong Kong,Japan,1,2,Friendly,So Kon Po,Hong Kong,False,3,-1,Japan
4942,5391,5769,1965,Costa Rica,Paraguay,1,0,Friendly,San José,Costa Rica,False,1,1,Costa Rica
4943,5392,5770,1965,Honduras,United States,0,1,FIFA World Cup qualification,San Pedro Sula,Honduras,False,1,-1,United States
4944,5393,5771,1965,Israel,Switzerland,0,0,Friendly,Jaffa,Israel,False,0,0,Draw
4945,5394,5772,1965,Northern Ireland,Netherlands,2,1,FIFA World Cup qualification,Belfast,Northern Ireland,False,3,1,Northern Ireland
4946,5395,5773,1965,Wales,Greece,4,1,FIFA World Cup qualification,Cardiff,Wales,False,5,3,Wales
4947,5396,5774,1965,Costa Rica,Paraguay,0,0,Friendly,San José,Costa Rica,False,0,0,Draw
4948,5397,5775,1965,Libya,Morocco,1,0,Friendly,Tripoli,Libya,False,1,1,Libya
4949,5398,5776,1965,Cyprus,Lebanon,2,0,Friendly,Nicosia,Cyprus,False,2,2,Cyprus
4950,5399,5777,1965,Honduras,United States,1,1,FIFA World Cup qualification,Tegucigalpa,Honduras,False,2,0,Draw
4951,5400,5778,1965,Burma,Japan,1,1,Friendly,Rangoon,Burma,False,2,0,Draw
4952,5401,5779,1965,France,Austria,1,2,Friendly,Paris,France,False,3,-1,Austria
4953,5402,5780,1965,Republic of Ireland,Belgium,0,2,Friendly,Dublin,Republic of Ireland,False,2,-2,Belgium
4954,5403,5781,1965,Singapore,Japan,1,4,Friendly,Kallang,Singapore,False,5,-3,Japan
4955,5404,5782,1965,Malaysia,Japan,1,1,Friendly,Kuala Lumpur,Malaysia,False,2,0,Draw
4956,5405,5783,1965,Costa Rica,Curaçao,6,0,CONCACAF Championship,Guatemala,Guatemala,True,6,6,Costa Rica
4957,5406,5784,1965,El Salvador,Mexico,0,2,CONCACAF Championship,Guatemala,Guatemala,True,2,-2,Mexico
4958,5407,5785,1965,Guinea,Senegal,3,1,African Cup of Nations qualification,Conakry,Guinea,False,4,2,Guinea
4959,5408,5786,1965,El Salvador,Curaçao,1,1,CONCACAF Championship,Guatemala,Guatemala,True,2,0,Draw
4960,5409,5787,1965,Northern Ireland,Wales,0,5,British Championship,Belfast,Northern Ireland,False,5,-5,Wales
4961,5410,5788,1965,Mexico,Curaçao,5,0,CONCACAF Championship,Guatemala,Guatemala,True,5,5,Mexico
4962,5411,5789,1965,Peru,Paraguay,0,1,Friendly,Lima,Peru,False,1,-1,Paraguay
4963,5412,5790,1965,Ethiopia,Kenya,2,1,African Cup of Nations qualification,Addis Abeba,Ethiopia,False,3,1,Ethiopia
4964,5413,5791,1965,Haiti,Mexico,0,3,CONCACAF Championship,Guatemala,Guatemala,True,3,-3,Mexico
4965,5414,5792,1965,Costa Rica,Mexico,1,1,CONCACAF Championship,Guatemala,Guatemala,True,2,0,Draw
4966,5415,5793,1965,Guatemala,Curaçao,3,2,CONCACAF Championship,Guatemala,Guatemala,False,5,1,Guatemala
4967,5416,5794,1965,Belgium,Poland,0,0,Friendly,Brussels,Belgium,False,0,0,Draw
4968,5417,5795,1965,Netherlands,Northern Ireland,0,0,FIFA World Cup qualification,Rotterdam,Netherlands,False,0,0,Draw
4969,5418,5796,1965,Costa Rica,El Salvador,1,2,CONCACAF Championship,Guatemala,Guatemala,True,3,-1,El Salvador
4970,5419,5797,1965,Haiti,Curaçao,1,1,CONCACAF Championship,Guatemala,Guatemala,True,2,0,Draw
4971,5420,5798,1965,England,Scotland,2,2,British Championship,London,England,False,4,0,Draw
4972,5421,5799,1965,Albania,Switzerland,0,2,FIFA World Cup qualification,Tirana,Albania,False,2,-2,Switzerland
4973,5422,5800,1965,Guatemala,Mexico,1,2,CONCACAF Championship,Guatemala,Guatemala,False,3,-1,Mexico
4974,5423,5801,1965,Ghana,DR Congo,4,1,Friendly,Accra,Ghana,False,5,3,Ghana
4975,5424,5802,1965,Chile,Peru,4,1,Copa del Pacífico,Santiago,Chile,False,5,3,Chile
4976,5425,5803,1965,Ethiopia,Sudan,1,0,African Cup of Nations qualification,Addis Abeba,Ethiopia,False,1,1,Ethiopia
4977,5426,5804,1965,Mali,Senegal,0,2,African Cup of Nations qualification,Bamako,Mali,False,2,-2,Senegal
4978,5427,5805,1965,Poland,Italy,0,0,FIFA World Cup qualification,Warsaw,Poland,False,0,0,Draw
4979,5428,5807,1965,Turkey,Portugal,0,1,FIFA World Cup qualification,Ankara,Turkey,False,1,-1,Portugal
4980,5429,5808,1965,Germany,Cyprus,5,0,FIFA World Cup qualification,Karlsruhe,Germany,False,5,5,Germany
4981,5431,5810,1965,Costa Rica,Mexico,0,0,FIFA World Cup qualification,San José,Costa Rica,False,0,0,Draw
4982,5432,5812,1965,Kenya,Sudan,1,1,African Cup of Nations qualification,Nairobi,Kenya,False,2,0,Draw
4983,5433,5813,1965,Paraguay,Uruguay,2,1,Copa Artigas,Asunción,Paraguay,False,3,1,Paraguay
4984,5434,5814,1965,Peru,Chile,0,1,Copa del Pacífico,Lima,Peru,False,1,-1,Chile
4985,5435,5815,1965,Indonesia,Sri Lanka,5,0,Friendly,Jakarta,Indonesia,False,5,5,Indonesia
4986,5436,5816,1965,Italy,Wales,4,1,Friendly,Florence,Italy,False,5,3,Italy
4987,5437,5817,1965,Uganda,Sudan,1,3,African Cup of Nations qualification,Kampala,Uganda,False,4,-2,Sudan
4988,5438,5818,1965,Uruguay,Paraguay,4,0,Copa Artigas,Montevideo,Uruguay,False,4,4,Uruguay
4989,5439,5819,1965,Morocco,Tunisia,0,1,Friendly,Casablanca,Morocco,False,1,-1,Tunisia
4990,5440,5820,1965,Romania,Turkey,3,0,FIFA World Cup qualification,Bucharest,Romania,False,3,3,Romania
4991,5441,5821,1965,Switzerland,Albania,1,0,FIFA World Cup qualification,Geneva,Switzerland,False,1,1,Switzerland
4992,5442,5822,1965,Jamaica,Mexico,2,3,FIFA World Cup qualification,Kingston,Jamaica,False,5,-1,Mexico
4993,5443,5823,1965,Mali,Congo,1,1,Friendly,Bamako,Mali,False,2,0,Draw
4994,5444,5824,1965,England,Hungary,1,0,Friendly,London,England,False,1,1,England
4995,5445,5825,1965,Republic of Ireland,Spain,1,0,FIFA World Cup qualification,Dublin,Republic of Ireland,False,1,1,Republic of Ireland
4996,5446,5826,1965,Senegal,Mali,3,1,African Cup of Nations qualification,Dakar,Senegal,False,4,2,Senegal
4997,5447,5827,1965,Sweden,Cyprus,3,0,FIFA World Cup qualification,Norrköping,Sweden,False,3,3,Sweden
4998,5448,5828,1965,Mexico,Jamaica,8,0,FIFA World Cup qualification,Mexico City,Mexico,False,8,8,Mexico
4999,5449,5829,1965,Northern Ireland,Albania,4,1,FIFA World Cup qualification,Belfast,Northern Ireland,False,5,3,Northern Ireland
5000,5450,5830,1965,Scotland,Spain,0,0,Friendly,Glasgow,Scotland,False,0,0,Draw
5001,5451,5831,1965,Belgium,Israel,1,0,FIFA World Cup qualification,Brussels,Belgium,False,1,1,Belgium
5002,5452,5832,1965,Bulgaria,Turkey,4,1,Friendly,Sofia,Bulgaria,False,5,3,Bulgaria
5003,5453,5833,1965,Chile,Uruguay,0,0,Copa Juan Pinto Durán,Santiago,Chile,False,0,0,Draw
5004,5454,5835,1965,Costa Rica,Jamaica,7,0,FIFA World Cup qualification,San José,Costa Rica,False,7,7,Costa Rica
5005,5455,5836,1965,Germany,England,0,1,Friendly,Nuremberg,Germany,False,1,-1,England
5006,5456,5837,1965,Mexico,Costa Rica,1,0,FIFA World Cup qualification,Mexico City,Mexico,False,1,1,Mexico
5007,5457,5838,1965,Peru,Venezuela,1,0,FIFA World Cup qualification,Lima,Peru,False,1,1,Peru
5008,5458,5839,1965,Poland,Bulgaria,1,1,Friendly,Cracow,Poland,False,2,0,Draw
5009,5459,5840,1965,Russia,Austria,0,0,Friendly,Moscow,Soviet Union,False,0,0,Draw
5010,5460,5841,1965,Sweden,England,1,2,Friendly,Gothenburg,Sweden,False,3,-1,England
5011,5461,5842,1965,Uruguay,Chile,1,1,Copa Juan Pinto Durán,Montevideo,Uruguay,False,2,0,Draw
5012,5462,5843,1965,Norway,Thailand,7,0,Friendly,Bergen,Norway,False,7,7,Norway
5013,5463,5844,1965,Iran,Turkey,1,2,Friendly,Teheran,Iran,False,3,-1,Turkey
5014,5464,5845,1965,Jamaica,Costa Rica,1,1,FIFA World Cup qualification,Kingston,Jamaica,False,2,0,Draw
5015,5465,5847,1965,Mali,Guinea,2,1,African Cup of Nations qualification,Bamako,Mali,False,3,1,Mali
5016,5466,5848,1965,Poland,Scotland,1,1,FIFA World Cup qualification,Chorzów,Poland,False,2,0,Draw
5017,5467,5849,1965,Russia,Greece,3,1,FIFA World Cup qualification,Moscow,Soviet Union,True,4,2,Russia
5018,5468,5850,1965,Uruguay,Venezuela,5,0,FIFA World Cup qualification,Montevideo,Uruguay,False,5,5,Uruguay
5019,5469,5851,1965,Iran,Turkey,2,1,Friendly,Teheran,Iran,False,3,1,Iran
5020,5470,5852,1965,Switzerland,Germany,0,1,Friendly,Basel,Switzerland,False,1,-1,Germany
5021,5471,5853,1965,Finland,Scotland,1,2,FIFA World Cup qualification,Helsinki,Finland,False,3,-1,Scotland
5022,5472,5854,1965,Norway,Luxembourg,4,2,FIFA World Cup qualification,Trondheim,Norway,False,6,2,Norway
5023,5473,5855,1965,Liberia,Ivory Coast,0,1,African Cup of Nations qualification,Monrovia,Liberia,False,1,-1,Ivory Coast
5024,5475,5857,1965,Russia,Wales,2,1,FIFA World Cup qualification,Moscow,Soviet Union,True,3,1,Russia
5025,5476,5858,1965,Venezuela,Uruguay,1,3,FIFA World Cup qualification,Caracas,Venezuela,False,4,-2,Uruguay
5026,5477,5859,1965,Brazil,Belgium,5,0,Friendly,Rio de Janeiro,Brazil,False,5,5,Brazil
5027,5478,5860,1965,Venezuela,Peru,3,6,FIFA World Cup qualification,Caracas,Venezuela,False,9,-3,Peru
5028,5479,5861,1965,France,Argentina,0,0,Friendly,Paris,France,False,0,0,Draw
5029,5480,5862,1965,Brazil,Germany,2,0,Friendly,Rio de Janeiro,Brazil,False,2,2,Brazil
5030,5481,5863,1965,Guinea,Mali,2,1,African Cup of Nations qualification,Conakry,Guinea,False,3,1,Guinea
5031,5482,5864,1965,Peru,Uruguay,0,1,FIFA World Cup qualification,Lima,Peru,False,1,-1,Uruguay
5032,5483,5865,1965,Brazil,Argentina,0,0,Friendly,Rio de Janeiro,Brazil,False,0,0,Draw
5033,5484,5866,1965,Denmark,Finland,3,1,Nordic Championship,Copenhagen,Denmark,False,4,2,Denmark
5034,5485,5867,1965,Austria,Hungary,0,1,FIFA World Cup qualification,Vienna,Austria,False,1,-1,Hungary
5035,5486,5868,1965,Bulgaria,Israel,4,0,FIFA World Cup qualification,Sofia,Bulgaria,False,4,4,Bulgaria
5036,5487,5869,1965,Portugal,Romania,2,1,FIFA World Cup qualification,Oeiras,Portugal,False,3,1,Portugal
5037,5488,5870,1965,Uruguay,Peru,2,1,FIFA World Cup qualification,Montevideo,Uruguay,False,3,1,Uruguay
5038,5490,5872,1965,Sweden,Italy,2,2,Friendly,Malmö,Sweden,False,4,0,Draw
5039,5491,5873,1965,Algeria,Brazil,0,3,Friendly,Oran,Algeria,False,3,-3,Brazil
5040,5492,5874,1965,Denmark,Sweden,2,1,Nordic Championship,Copenhagen,Denmark,False,3,1,Denmark
5041,5493,5875,1965,Finland,Italy,0,2,FIFA World Cup qualification,Helsinki,Finland,False,2,-2,Italy
5042,5494,5876,1965,Portugal,Brazil,0,0,Friendly,Porto,Portugal,False,0,0,Draw
5043,5495,5877,1965,Congo,Benin,1,6,Friendly,Brazzaville,Congo,False,7,-5,Benin
5044,5496,5878,1965,Hungary,Italy,2,1,Friendly,Budapest,Hungary,False,3,1,Hungary
5045,5497,5879,1965,Ivory Coast,Liberia,4,0,African Cup of Nations qualification,Abidjan,Ivory Coast,False,4,4,Ivory Coast
5046,5498,5880,1965,Russia,Denmark,6,0,FIFA World Cup qualification,Moscow,Soviet Union,True,6,6,Russia
5047,5499,5881,1965,Sweden,Brazil,1,2,Friendly,Solna,Sweden,False,3,-1,Brazil
5048,5500,5882,1965,Russia,Brazil,0,3,Friendly,Moscow,Soviet Union,False,3,-3,Brazil
5049,5501,5883,1965,Iceland,Denmark,1,3,Friendly,Reykjavík,Iceland,False,4,-2,Denmark
5050,5502,5884,1965,Honduras,Costa Rica,1,1,Friendly,Tegucigalpa,Honduras,False,2,0,Draw
5051,5503,5885,1965,Argentina,Chile,1,0,Copa Carlos Dittborn,Buenos Aires,Argentina,False,1,1,Argentina
5052,5504,5886,1965,Colombia,Ecuador,0,1,FIFA World Cup qualification,Barranquilla,Colombia,False,1,-1,Ecuador
5053,5505,5887,1965,Chile,Argentina,1,1,Copa Carlos Dittborn,Santiago,Chile,False,2,0,Draw
5054,5506,5888,1965,Pakistan,Turkey,1,3,Friendly,Teheran,Iran,True,4,-2,Turkey
5055,5507,5889,1965,Iran,Pakistan,4,1,Friendly,Teheran,Iran,False,5,3,Iran
5056,5508,5890,1965,Ecuador,Colombia,2,0,FIFA World Cup qualification,Guayaquil,Ecuador,False,2,2,Ecuador
5057,5509,5891,1965,Iran,Turkey,0,0,Friendly,Teheran,Iran,False,0,0,Draw
5058,5510,5892,1965,Paraguay,Bolivia,2,0,FIFA World Cup qualification,Asunción,Paraguay,False,2,2,Paraguay
5059,5511,5893,1965,Suriname,French Guiana,7,0,Friendly,Paramaribo,Suriname,False,7,7,Suriname
5060,5512,5894,1965,Suriname,French Guiana,5,0,Friendly,Paramaribo,Suriname,False,5,5,Suriname
5061,5513,5895,1965,Jordan,Iraq,0,0,Friendly,Amman,Jordan,False,0,0,Draw
5062,5514,5896,1965,Argentina,Paraguay,3,0,FIFA World Cup qualification,Buenos Aires,Argentina,False,3,3,Argentina
5063,5515,5897,1965,Chile,Colombia,7,2,FIFA World Cup qualification,Santiago,Chile,False,9,5,Chile
5064,5517,5901,1965,Guinea,Indonesia,3,1,Friendly,P'yongyang,North Korea,True,4,2,Guinea
5065,5518,5903,1965,Jamaica,Trinidad and Tobago,4,0,Friendly,Kingston,Jamaica,False,4,4,Jamaica
5066,5519,5904,1965,Cambodia,Indonesia,0,0,Friendly,P'yongyang,North Korea,True,0,0,Draw
5067,5522,5907,1965,Colombia,Chile,2,0,FIFA World Cup qualification,Barranquilla,Colombia,False,2,2,Colombia
5068,5523,5909,1965,Finland,Norway,4,0,Nordic Championship,Helsinki,Finland,False,4,4,Finland
5069,5524,5911,1965,Paraguay,Argentina,0,0,FIFA World Cup qualification,Asunción,Paraguay,False,0,0,Draw
5070,5526,5917,1965,Liberia,DR Congo,2,1,African Cup of Nations qualification,Monrovia,Liberia,False,3,1,Liberia
5071,5527,5918,1965,Burma,Hong Kong,4,2,Merdeka Tournament,Kuala Lumpur,Malaysia,True,6,2,Burma
5072,5528,5919,1965,Ecuador,Chile,2,2,FIFA World Cup qualification,Guayaquil,Ecuador,False,4,0,Draw
5073,5529,5920,1965,Argentina,Bolivia,4,1,FIFA World Cup qualification,Buenos Aires,Argentina,False,5,3,Argentina
5074,5532,5923,1965,Hong Kong,India,2,2,Merdeka Tournament,Ipoh,Malaysia,True,4,0,Draw
5075,5534,5926,1965,Malaysia,India,0,3,Merdeka Tournament,Ipoh,Malaysia,False,3,-3,India
5076,5535,5927,1965,Bolivia,Paraguay,2,1,FIFA World Cup qualification,La Paz,Bolivia,False,3,1,Bolivia
5077,5536,5928,1965,Burma,Thailand,1,1,Merdeka Tournament,Kuala Lumpur,Malaysia,True,2,0,Draw
5078,5537,5929,1965,Chile,Ecuador,3,1,FIFA World Cup qualification,Santiago,Chile,False,4,2,Chile
5079,5538,5930,1965,Sudan,Uganda,4,1,African Cup of Nations qualification,Khartoum,Sudan,False,5,3,Sudan
5080,5539,5931,1965,Sweden,Finland,2,2,Nordic Championship,Luleå,Sweden,False,4,0,Draw
5081,5544,5936,1965,Burma,India,1,1,Merdeka Tournament,Ipoh,Malaysia,True,2,0,Draw
5082,5545,5937,1965,Hong Kong,Thailand,1,1,Merdeka Tournament,Ipoh,Malaysia,True,2,0,Draw
5083,5546,5938,1965,Gabon,Nigeria,2,2,Friendly,Libreville,Gabon,False,4,0,Draw
5084,5547,5940,1965,Bolivia,Argentina,1,2,FIFA World Cup qualification,La Paz,Bolivia,False,3,-1,Argentina
5085,5548,5941,1965,Gabon,Nigeria,1,4,Friendly,Libreville,Gabon,False,5,-3,Nigeria
5086,5549,5942,1965,Singapore,India,1,2,Friendly,Kallang,Singapore,False,3,-1,India
5087,5552,5945,1965,DR Congo,Ivory Coast,4,2,African Cup of Nations qualification,Brazzaville,Congo,True,6,2,DR Congo
5088,5553,5946,1965,Hungary,Austria,3,0,FIFA World Cup qualification,Budapest,Hungary,False,3,3,Hungary
5089,5554,5947,1965,Brazil,Uruguay,3,0,Friendly,Belo Horizonte,Brazil,False,3,3,Brazil
5090,5556,5949,1965,Zambia,Kenya,3,3,Friendly,Ndola,Zambia,False,6,0,Draw
5091,5558,5951,1965,Zambia,Kenya,2,3,Friendly,Kitwe,Zambia,False,5,-1,Kenya
5092,5559,5952,1965,Norway,France,0,1,FIFA World Cup qualification,Oslo,Norway,False,1,-1,France
5093,5560,5953,1965,Uganda,Zambia,2,2,Friendly,Kampala,Uganda,False,4,0,Draw
5094,5562,5956,1965,Zambia,Kenya,3,2,Friendly,Lusaka,Zambia,False,5,1,Zambia
5095,5563,5957,1965,DR Congo,Liberia,3,2,African Cup of Nations qualification,Brazzaville,Congo,True,5,1,DR Congo
5096,5565,5959,1965,Bulgaria,Belgium,3,0,FIFA World Cup qualification,Sofia,Bulgaria,False,3,3,Bulgaria
5097,5566,5960,1965,Kenya,Tanzania,0,2,Friendly,Kampala,Uganda,True,2,-2,Tanzania
5098,5567,5961,1965,Norway,Denmark,2,2,Nordic Championship,Oslo,Norway,False,4,0,Draw
5099,5568,5962,1965,Sweden,Germany,1,2,FIFA World Cup qualification,Solna,Sweden,False,3,-1,Germany
5100,5569,5963,1965,Uganda,Kenya,2,2,Friendly,Kampala,Uganda,False,4,0,Draw
5101,5570,5964,1965,Finland,Poland,2,0,FIFA World Cup qualification,Helsinki,Finland,False,2,2,Finland
5102,5573,5967,1965,Northern Ireland,Scotland,3,2,British Championship,Belfast,Northern Ireland,False,5,1,Northern Ireland
5103,5574,5968,1965,Uganda,Tanzania,1,1,Friendly,Kampala,Uganda,False,2,0,Draw
5104,5575,5969,1965,Wales,England,0,0,British Championship,Cardiff,Wales,False,0,0,Draw
5105,5576,5970,1965,Greece,Russia,1,4,FIFA World Cup qualification,Piraeus,Greece,False,5,-3,Russia
5106,5578,5972,1965,Germany,Austria,4,1,Friendly,Stuttgart,Germany,False,5,3,Germany
5107,5581,5975,1965,Chile,Ecuador,2,1,FIFA World Cup qualification,Lima,Peru,True,3,1,Chile
5108,5582,5976,1965,Scotland,Poland,1,2,FIFA World Cup qualification,Glasgow,Scotland,False,3,-1,Poland
5109,5583,5977,1965,Ghana,Congo,5,0,Friendly,Accra,Ghana,False,5,5,Ghana
5110,5584,5978,1965,Congo,Ghana,2,1,Friendly,Brazzaville,Congo,False,3,1,Congo
5111,5585,5979,1965,Denmark,Russia,1,3,FIFA World Cup qualification,Copenhagen,Denmark,False,4,-2,Russia
5112,5586,5980,1965,Netherlands,Switzerland,0,0,FIFA World Cup qualification,Amsterdam,Netherlands,False,0,0,Draw
5113,5587,5981,1965,England,Austria,2,3,Friendly,London,England,False,5,-1,Austria
5114,5588,5982,1965,Congo,Ghana,1,2,Friendly,Brazzaville,Congo,False,3,-1,Ghana
5115,5589,5983,1965,Kenya,Tanzania,4,2,Friendly,Nairobi,Kenya,False,6,2,Kenya
5116,5590,5984,1965,Turkey,Romania,2,1,FIFA World Cup qualification,Ankara,Turkey,False,3,1,Turkey
5117,5591,5985,1965,Poland,Finland,7,0,FIFA World Cup qualification,Szczecin,Poland,False,7,7,Poland
5118,5592,5986,1965,Belgium,Bulgaria,5,0,FIFA World Cup qualification,Brussels,Belgium,False,5,5,Belgium
5119,5593,5987,1965,Denmark,Greece,1,1,FIFA World Cup qualification,Copenhagen,Denmark,False,2,0,Draw
5120,5594,5988,1965,Spain,Republic of Ireland,4,1,FIFA World Cup qualification,Seville,Spain,False,5,3,Spain
5121,5595,5989,1965,Wales,Russia,2,1,FIFA World Cup qualification,Cardiff,Wales,False,3,1,Wales
5122,5596,5990,1965,Nigeria,Ghana,0,4,Friendly,Lagos,Nigeria,False,4,-4,Ghana
5123,5597,5991,1965,Algeria,Morocco,0,0,Friendly,Algiers,Algeria,False,0,0,Draw
5124,5599,5994,1965,Sweden,Norway,0,0,Nordic Championship,Solna,Sweden,False,0,0,Draw
5125,5600,5995,1965,Italy,Poland,6,1,FIFA World Cup qualification,Rome,Italy,False,7,5,Italy
5126,5601,5996,1965,France,Luxembourg,4,1,FIFA World Cup qualification,Marseille,France,False,5,3,France
5127,5602,5997,1965,Cyprus,Sweden,0,5,FIFA World Cup qualification,Famagusta,Cyprus,False,5,-5,Sweden
5128,5603,5998,1965,Ghana,Nigeria,3,0,Friendly,Accra,Ghana,False,3,3,Ghana
5129,5604,6000,1965,Scotland,Italy,1,0,FIFA World Cup qualification,Glasgow,Scotland,False,1,1,Scotland
5130,5605,6001,1965,England,Northern Ireland,2,1,British Championship,London,England,False,3,1,England
5131,5606,6002,1965,Republic of Ireland,Spain,0,1,FIFA World Cup qualification,Paris,France,True,1,-1,Spain
5132,5607,6003,1965,Israel,Belgium,0,5,FIFA World Cup qualification,Ramat-Gan,Israel,False,5,-5,Belgium
5133,5608,6004,1965,DR Congo,Ghana,2,5,African Cup of Nations,Sousse,Tunisia,True,7,-3,Ghana
5134,5609,6005,1965,Tunisia,Ethiopia,4,0,African Cup of Nations,Tunis,Tunisia,False,4,4,Tunisia
5135,5610,6007,1965,DR Congo,Ivory Coast,0,3,African Cup of Nations,Sfax,Tunisia,True,3,-3,Ivory Coast
5136,5611,6008,1965,Cyprus,Germany,0,6,FIFA World Cup qualification,Nicosia,Cyprus,False,6,-6,Germany
5137,5612,6009,1965,Switzerland,Netherlands,2,1,FIFA World Cup qualification,Berne,Switzerland,False,3,1,Switzerland
5138,5613,6010,1965,Tunisia,Senegal,0,0,African Cup of Nations,Tunis,Tunisia,False,0,0,Draw
5139,5614,6012,1965,Ethiopia,Senegal,1,5,African Cup of Nations,Tunis,Tunisia,True,6,-4,Senegal
5140,5615,6013,1965,Ghana,Ivory Coast,4,1,African Cup of Nations,Bizerte,Tunisia,True,5,3,Ghana
5141,5616,6014,1965,Brazil,Russia,2,2,Friendly,Rio de Janeiro,Brazil,False,4,0,Draw
5142,5617,6015,1965,Brazil,Hungary,5,3,Friendly,São Paulo,Brazil,False,8,2,Brazil
5143,5618,6017,1965,Dominica,Grenada,2,0,Windward Islands Tournament,Kingstown,Saint Vincent and the Grenadines,True,2,2,Dominica
5144,5619,6018,1965,Israel,Bulgaria,1,2,FIFA World Cup qualification,Ramat-Gan,Israel,False,3,-1,Bulgaria
5145,5620,6019,1965,Ivory Coast,Senegal,1,0,African Cup of Nations,Tunis,Tunisia,True,1,1,Ivory Coast
5146,5621,6021,1965,Romania,Portugal,2,0,FIFA World Cup qualification,Bucharest,Romania,False,2,2,Romania
5147,5622,6022,1965,Tunisia,Ghana,2,3,African Cup of Nations,Tunis,Tunisia,False,5,-1,Ghana
5148,5623,6023,1965,Saint Vincent and the Grenadines,Saint Lucia,1,2,Windward Islands Tournament,Kingstown,Saint Vincent and the Grenadines,False,3,-1,Saint Lucia
5149,5624,6024,1965,Congo,Ivory Coast,0,1,Friendly,Brazzaville,Congo,False,1,-1,Ivory Coast
5150,5625,6025,1965,Dominica,Saint Lucia,1,0,Windward Islands Tournament,Kingstown,Saint Vincent and the Grenadines,True,1,1,Dominica
5151,5626,6026,1965,Albania,Northern Ireland,1,1,FIFA World Cup qualification,Tirana,Albania,False,2,0,Draw
5152,5628,6028,1965,Scotland,Wales,4,1,British Championship,Glasgow,Scotland,False,5,3,Scotland
5153,5629,6029,1965,Ivory Coast,Mali,1,3,Friendly,Brazzaville,Congo,True,4,-2,Mali
5154,5630,6030,1965,Cambodia,Australia,0,0,Friendly,Phnom Penh,Cambodia,False,0,0,Draw
5155,5631,6031,1965,Saint Vincent and the Grenadines,Dominica,3,1,Windward Islands Tournament,Kingstown,Saint Vincent and the Grenadines,False,4,2,Saint Vincent and the Grenadines
5156,5632,6032,1965,Hong Kong,Australia,1,0,Friendly,So Kon Po,Hong Kong,False,1,1,Hong Kong
5157,5633,6033,1965,Argentina,Russia,1,1,Friendly,Buenos Aires,Argentina,False,2,0,Draw
5158,5634,6034,1965,Wales,Denmark,4,2,FIFA World Cup qualification,Wrexham,Wales,False,6,2,Wales
5159,5636,6036,1965,Uruguay,Russia,1,3,Friendly,Montevideo,Uruguay,False,4,-2,Russia
5160,5637,6037,1965,Hong Kong,Singapore,0,0,Friendly,So Kon Po,Hong Kong,False,0,0,Draw
5161,5638,6038,1965,Hong Kong,Singapore,1,2,Friendly,So Kon Po,Hong Kong,False,3,-1,Singapore
5162,5639,6039,1965,Italy,Scotland,3,0,FIFA World Cup qualification,Naples,Italy,False,3,3,Italy
5163,5640,6040,1965,Malaysia,Australia,0,1,Friendly,Ipoh,Malaysia,False,1,-1,Australia
5164,5641,6041,1965,Malaysia,Australia,0,3,Friendly,Ipoh,Malaysia,False,3,-3,Australia
5165,5642,6042,1965,Spain,England,0,2,Friendly,Madrid,Spain,False,2,-2,England
5166,5643,6043,1965,Kenya,Ghana,2,13,Friendly,Nairobi,Kenya,False,15,-11,Ghana
5167,5644,6044,1965,Nigeria,Benin,0,1,Friendly,Lagos,Nigeria,False,1,-1,Benin
5168,5645,6045,1965,Kenya,Ghana,3,3,Friendly,Nairobi,Kenya,False,6,0,Draw
5169,5646,6046,1965,Bermuda,Jamaica,0,3,Friendly,Hamilton,Bermuda,False,3,-3,Jamaica
5170,5647,6047,1965,Belgium,Bulgaria,1,2,FIFA World Cup qualification,Florence,Italy,True,3,-1,Bulgaria
5171,5648,6048,1966,England,Poland,1,1,Friendly,Liverpool,England,False,2,0,Draw
5172,5649,6049,1966,Panama,Nicaragua,3,1,Friendly,Panama City,Panama,False,4,2,Panama
5173,5650,6050,1966,Malta,Libya,1,0,Friendly,Gżira,Malta,False,1,1,Malta
5174,5651,6051,1966,Chile,Russia,0,2,Friendly,Santiago,Chile,False,2,-2,Russia
5175,5652,6052,1966,England,Germany,1,0,Friendly,London,England,False,1,1,England
5176,5653,6053,1966,Egypt,Bulgaria,2,2,Friendly,Cairo,Egypt,False,4,0,Draw
5177,5654,6054,1966,Benin,Nigeria,1,2,Friendly,Cotonou,Dahomey,False,3,-1,Nigeria
5178,5655,6055,1966,Niger,DR Congo,2,1,Friendly,Niamey,Niger,False,3,1,Niger
5179,5656,6056,1966,Panama,Guatemala,0,1,Friendly,Panama City,Panama,False,1,-1,Guatemala
5180,5657,6057,1966,Uganda,Kenya,2,3,Friendly,Kampala,Uganda,False,5,-1,Kenya
5181,5658,6058,1966,Guinea,Senegal,5,0,Friendly,Conakry,Guinea,False,5,5,Guinea
5182,5659,6059,1966,Morocco,Algeria,1,0,Friendly,Casablanca,Morocco,False,1,1,Morocco
5183,5660,6060,1966,Togo,Nigeria,2,2,Friendly,Lomé,Togo,False,4,0,Draw
5184,5661,6061,1966,Libya,Morocco,4,0,Friendly,Tripoli,Libya,False,4,4,Libya
5185,5662,6062,1966,Libya,Iraq,0,2,Friendly,Tripoli,Libya,False,2,-2,Iraq
5186,5663,6063,1966,Iran,Turkey,0,0,Friendly,Teheran,Iran,False,0,0,Draw
5187,5664,6064,1966,Iraq,Morocco,0,1,Friendly,Tripoli,Libya,True,1,-1,Morocco
5188,5665,6065,1966,France,Italy,0,0,Friendly,Paris,France,False,0,0,Draw
5189,5666,6066,1966,Iraq,Morocco,1,2,Friendly,Tripoli,Libya,True,3,-1,Morocco
5190,5667,6067,1966,Netherlands,Germany,2,4,Friendly,Rotterdam,Netherlands,False,6,-2,Germany
5191,5668,6068,1966,Panama,El Salvador,1,0,Friendly,Panama City,Panama,False,1,1,Panama
5192,5669,6069,1966,Libya,Malta,0,1,Friendly,Tripoli,Libya,False,1,-1,Malta
5193,5670,6070,1966,Wales,Northern Ireland,1,4,British Championship,Cardiff,Wales,False,5,-3,Northern Ireland
5194,5671,6071,1966,Bahrain,Kuwait,4,4,UAFA Cup,Baghdad,Iraq,True,8,0,Draw
5195,5672,6072,1966,Iraq,Lebanon,0,0,UAFA Cup,Baghdad,Iraq,False,0,0,Draw
5196,5673,6073,1966,Montenegro,Russia,0,1,Friendly,Titograd,Yugoslavia,False,1,-1,Russia
5197,5674,6074,1966,Libya,Palestine,0,0,UAFA Cup,Baghdad,Iraq,True,0,0,Draw
5198,5675,6075,1966,Scotland,England,3,4,British Championship,Glasgow,Scotland,False,7,-1,England
5199,5676,6076,1966,Syria,Yemen,4,1,UAFA Cup,Baghdad,Iraq,True,5,3,Syria
5200,5677,6077,1966,Bahrain,Lebanon,1,6,UAFA Cup,Baghdad,Iraq,True,7,-5,Lebanon
5201,5678,6078,1966,Iraq,Jordan,2,1,UAFA Cup,Baghdad,Iraq,False,3,1,Iraq
5202,5679,6079,1966,Kenya,Uganda,3,3,Friendly,Nairobi,Kenya,False,6,0,Draw
5203,5680,6080,1966,Libya,Syria,0,0,UAFA Cup,Baghdad,Iraq,True,0,0,Draw
5204,5681,6081,1966,Palestine,Yemen,7,0,UAFA Cup,Baghdad,Iraq,True,7,7,Palestine
5205,5682,6082,1966,Iraq,Kuwait,3,1,UAFA Cup,Baghdad,Iraq,False,4,2,Iraq
5206,5683,6083,1966,Jordan,Lebanon,1,2,UAFA Cup,Baghdad,Iraq,True,3,-1,Lebanon
5207,5684,6084,1966,Israel,Finland,7,1,Friendly,Jaffa,Israel,False,8,6,Israel
5208,5685,6085,1966,Libya,Yemen,14,0,UAFA Cup,Baghdad,Iraq,True,14,14,Libya
5209,5686,6086,1966,Palestine,Syria,1,3,UAFA Cup,Baghdad,Iraq,True,4,-2,Syria
5210,5687,6087,1966,Iraq,Bahrain,10,1,UAFA Cup,Baghdad,Iraq,False,11,9,Iraq
5211,5688,6088,1966,Jordan,Kuwait,2,2,UAFA Cup,Baghdad,Iraq,True,4,0,Draw
5212,5689,6089,1966,Iraq,Libya,3,1,UAFA Cup,Baghdad,Iraq,False,4,2,Iraq
5213,5690,6090,1966,Lebanon,Syria,0,1,UAFA Cup,Baghdad,Iraq,True,1,-1,Syria
5214,5691,6091,1966,Bahrain,Jordan,1,2,UAFA Cup,Baghdad,Iraq,True,3,-1,Jordan
5215,5692,6092,1966,Kuwait,Lebanon,1,2,UAFA Cup,Baghdad,Iraq,True,3,-1,Lebanon
5216,5693,6093,1966,Nigeria,Togo,1,1,Friendly,Lagos,Nigeria,False,2,0,Draw
5217,5694,6094,1966,Benin,Ghana,2,5,Friendly,Cotonou,Dahomey,False,7,-3,Ghana
5218,5695,6095,1966,Iraq,Syria,2,1,UAFA Cup,Baghdad,Iraq,False,3,1,Iraq
5219,5696,6096,1966,Libya,Lebanon,6,1,UAFA Cup,Baghdad,Iraq,True,7,5,Libya
5220,5697,6097,1966,Chile,Brazil,0,1,Copa Bernardo O'Higgins,Santiago,Chile,False,1,-1,Brazil
5221,5698,6098,1966,Netherlands,Belgium,3,1,Friendly,Rotterdam,Netherlands,False,4,2,Netherlands
5222,5699,6099,1966,Chile,Brazil,2,1,Copa Bernardo O'Higgins,Viña del Mar,Chile,False,3,1,Chile
5223,5700,6100,1966,France,Belgium,0,3,Friendly,Paris,France,False,3,-3,Belgium
5224,5701,6101,1966,Switzerland,Russia,2,2,Friendly,Basel,Switzerland,False,4,0,Draw
5225,5702,6102,1966,Austria,Russia,0,1,Friendly,Vienna,Austria,False,1,-1,Russia
5226,5703,6103,1966,Mexico,Paraguay,7,0,Friendly,Mexico City,Mexico,False,7,7,Mexico
5227,5704,6104,1966,Togo,Benin,1,0,Friendly,Lomé,Togo,False,1,1,Togo
5228,5705,6106,1966,Poland,Hungary,1,1,Friendly,Chorzów,Poland,False,2,0,Draw
5229,5707,6108,1966,Republic of Ireland,Germany,0,4,Friendly,Dublin,Republic of Ireland,False,4,-4,Germany
5230,5708,6109,1966,Northern Ireland,Germany,0,2,Friendly,Belfast,Northern Ireland,False,2,-2,Germany
5231,5709,6110,1966,Finland,Israel,0,3,Friendly,Helsinki,Finland,False,3,-3,Israel
5232,5710,6112,1966,Mexico,Chile,1,0,Friendly,Mexico City,Mexico,False,1,1,Mexico
5233,5711,6113,1966,Scotland,Netherlands,0,3,Friendly,Glasgow,Scotland,False,3,-3,Netherlands
5234,5712,6114,1966,Brazil,Wales,3,1,Friendly,Rio de Janeiro,Brazil,False,4,2,Brazil
5235,5713,6115,1966,Brazil,Chile,1,1,Friendly,São Paulo,Brazil,False,2,0,Draw
5236,5714,6116,1966,Paraguay,Uruguay,2,2,Copa Artigas,Asunción,Paraguay,False,4,0,Draw
5237,5715,6117,1966,Brazil,Wales,1,0,Friendly,Belo Horizonte,Brazil,False,1,1,Brazil
5238,5716,6119,1966,Poland,Sweden,1,1,Friendly,Wrocław,Poland,False,2,0,Draw
5239,5717,6120,1966,Uruguay,Paraguay,3,1,Copa Artigas,Montevideo,Uruguay,False,4,2,Uruguay
5240,5718,6121,1966,Brazil,Chile,1,0,Friendly,Rio de Janeiro,Brazil,False,1,1,Brazil
5241,5719,6122,1966,Austria,Republic of Ireland,1,0,Friendly,Vienna,Austria,False,1,1,Austria
5242,5720,6123,1966,Belgium,Russia,0,1,Friendly,Brussels,Belgium,False,1,-1,Russia
5243,5721,6124,1966,Chile,Wales,2,0,Friendly,Santiago,Chile,False,2,2,Chile
5244,5722,6125,1966,Belgium,Republic of Ireland,2,3,Friendly,Liège,Belgium,False,5,-1,Republic of Ireland
5245,5723,6126,1966,Lithuania,Libya,6,0,Friendly,Vilnius,Lithuania,False,6,6,Lithuania
5246,5724,6127,1966,Benin,Togo,2,2,Friendly,Cotonou,Dahomey,False,4,0,Draw
5247,5725,6128,1966,Chile,Mexico,0,1,Friendly,Santiago,Chile,False,1,-1,Mexico
5248,5726,6129,1966,Denmark,Turkey,0,0,Friendly,Copenhagen,Denmark,False,0,0,Draw
5249,5727,6130,1966,Germany,Romania,1,0,Friendly,Ludwigshafen,Germany,False,1,1,Germany
5250,5728,6132,1966,Brazil,Peru,4,0,Friendly,São Paulo,Brazil,False,4,4,Brazil
5251,5729,6133,1966,Finland,Sweden,1,0,Nordic Championship,Helsinki,Finland,False,1,1,Finland
5252,5730,6134,1966,Brazil,Poland,4,1,Friendly,Belo Horizonte,Brazil,False,5,3,Brazil
5253,5731,6135,1966,Hungary,Switzerland,3,1,Friendly,Budapest,Hungary,False,4,2,Hungary
5254,5732,6136,1966,Russia,France,3,3,Friendly,Moscow,Soviet Union,False,6,0,Draw
5255,5733,6137,1966,Brazil,Poland,2,1,Friendly,Rio de Janeiro,Brazil,False,3,1,Brazil
5256,5734,6138,1966,Brazil,Peru,3,1,Friendly,Rio de Janeiro,Brazil,False,4,2,Brazil
5257,5735,6139,1966,Curaçao,Jamaica,0,0,Friendly,Port-au-Prince,Haiti,True,0,0,Draw
5258,5736,6140,1966,Trinidad and Tobago,Suriname,3,2,Friendly,Port-au-Prince,Haiti,True,5,1,Trinidad and Tobago
5259,5737,6141,1966,Argentina,Poland,1,1,Friendly,Buenos Aires,Argentina,False,2,0,Draw
5260,5738,6142,1966,Haiti,Guadeloupe,3,0,Friendly,Port-au-Prince,Haiti,False,3,3,Haiti
5261,5740,6144,1966,Portugal,Norway,4,0,Friendly,Oeiras,Portugal,False,4,4,Portugal
5262,5741,6145,1966,Trinidad and Tobago,Curaçao,1,0,Friendly,Port-au-Prince,Haiti,True,1,1,Trinidad and Tobago
5263,5742,6146,1966,Haiti,Suriname,1,4,Friendly,Port-au-Prince,Haiti,False,5,-3,Suriname
5264,5743,6147,1966,Jamaica,Guadeloupe,0,0,Friendly,Port-au-Prince,Haiti,True,0,0,Draw
5265,5744,6148,1966,Italy,Bulgaria,6,1,Friendly,Bologna,Italy,False,7,5,Italy
5266,5746,6150,1966,Guadeloupe,Suriname,0,4,Friendly,Port-au-Prince,Haiti,True,4,-4,Suriname
5267,5747,6151,1966,Israel,Uruguay,1,2,Friendly,Ramat-Gan,Israel,False,3,-1,Uruguay
5268,5748,6152,1966,Trinidad and Tobago,Jamaica,4,1,Friendly,Port-au-Prince,Haiti,True,5,3,Trinidad and Tobago
5269,5749,6153,1966,Haiti,Curaçao,3,0,Friendly,Port-au-Prince,Haiti,False,3,3,Haiti
5270,5750,6154,1966,Jamaica,Suriname,3,5,Friendly,Port-au-Prince,Haiti,True,8,-2,Suriname
5271,5751,6155,1966,Guadeloupe,Curaçao,0,4,Friendly,Port-au-Prince,Haiti,True,4,-4,Curaçao
5272,5752,6156,1966,Haiti,Trinidad and Tobago,1,0,Friendly,Port-au-Prince,Haiti,False,1,1,Haiti
5273,5753,6157,1966,Italy,Austria,1,0,Friendly,Milan,Italy,False,1,1,Italy
5274,5754,6158,1966,Scotland,Portugal,0,1,Friendly,Glasgow,Scotland,False,1,-1,Portugal
5275,5755,6159,1966,Romania,Uruguay,1,0,Friendly,Bucharest,Romania,False,1,1,Romania
5276,5756,6160,1966,Switzerland,Mexico,1,1,Friendly,Lausanne,Switzerland,False,2,0,Draw
5277,5757,6161,1966,Curaçao,Suriname,1,1,Friendly,Port-au-Prince,Haiti,True,2,0,Draw
5278,5758,6162,1966,Trinidad and Tobago,Guadeloupe,1,2,Friendly,Port-au-Prince,Haiti,True,3,-1,Guadeloupe
5279,5759,6163,1966,Denmark,Portugal,1,3,Friendly,Esbjerg,Denmark,False,4,-2,Portugal
5280,5760,6164,1966,Haiti,Jamaica,3,0,Friendly,Port-au-Prince,Haiti,False,3,3,Haiti
5281,5761,6165,1966,Italy,Argentina,3,0,Friendly,Turin,Italy,False,3,3,Italy
5282,5762,6166,1966,Northern Ireland,Mexico,4,1,Friendly,Belfast,Northern Ireland,False,5,3,Northern Ireland
5283,5764,6168,1966,Spain,Uruguay,1,1,Friendly,La Coruña,Spain,False,2,0,Draw
5284,5765,6169,1966,Scotland,Brazil,1,1,Friendly,Glasgow,Scotland,False,2,0,Draw
5285,5766,6170,1966,Denmark,Norway,0,1,Nordic Championship,Copenhagen,Denmark,False,1,-1,Norway
5286,5767,6171,1966,Finland,England,0,3,Friendly,Helsinki,Finland,False,3,-3,England
5287,5768,6172,1966,Portugal,Uruguay,3,0,Friendly,Oeiras,Portugal,False,3,3,Portugal
5288,5770,6175,1966,Italy,Mexico,5,0,Friendly,Florence,Italy,False,5,5,Italy
5289,5771,6176,1966,Norway,England,1,6,Friendly,Oslo,Norway,False,7,-5,England
5290,5772,6177,1966,DR Congo,Ghana,0,3,Friendly,Brazzaville,Congo,True,3,-3,Ghana
5291,5773,6178,1966,Sweden,Brazil,2,3,Friendly,Gothenburg,Sweden,False,5,-1,Brazil
5292,5774,6179,1966,Zambia,Malawi,4,1,Friendly,Ndola,Zambia,False,5,3,Zambia
5293,5775,6181,1966,Denmark,England,0,2,Friendly,Copenhagen,Denmark,False,2,-2,England
5294,5776,6182,1966,Portugal,Romania,1,0,Friendly,Porto,Portugal,False,1,1,Portugal
5295,5777,6183,1966,Malawi,Zambia,0,3,Friendly,Blantyre,Malawi,False,3,-3,Zambia
5296,5778,6184,1966,Madagascar,Zambia,0,3,Friendly,Blantyre,Malawi,True,3,-3,Zambia
5297,5779,6185,1966,Poland,England,0,1,Friendly,Chorzów,Poland,False,1,-1,England
5298,5780,6186,1966,Malawi,Zambia,0,6,Friendly,Blantyre,Malawi,False,6,-6,Zambia
5299,5781,6187,1966,Ethiopia,Uganda,5,0,Friendly,Addis Abeba,Ethiopia,False,5,5,Ethiopia
5300,5782,6188,1966,Malawi,Zambia,1,5,Friendly,Blantyre,Malawi,False,6,-4,Zambia
5301,5783,6189,1966,Malawi,Madagascar,1,6,Friendly,Lilongwe,Malawi,False,7,-5,Madagascar
5302,5784,6190,1966,Ethiopia,Sudan,1,1,Friendly,Addis Abeba,Ethiopia,False,2,0,Draw
5303,5785,6191,1966,England,Uruguay,0,0,FIFA World Cup,London,England,False,0,0,Draw
5304,5786,6192,1966,Brazil,Bulgaria,2,0,FIFA World Cup,Liverpool,England,True,2,2,Brazil
5305,5787,6193,1966,Germany,Switzerland,5,0,FIFA World Cup,Sheffield,England,True,5,5,Germany
5306,5788,6195,1966,Argentina,Spain,2,1,FIFA World Cup,Birmingham,England,True,3,1,Argentina
5307,5789,6196,1966,Chile,Italy,0,2,FIFA World Cup,Sunderland,England,True,2,-2,Italy
5308,5790,6197,1966,France,Mexico,1,1,FIFA World Cup,London,England,True,2,0,Draw
5309,5791,6198,1966,Hungary,Portugal,1,3,FIFA World Cup,Manchester,England,True,4,-2,Portugal
5310,5792,6199,1966,Brazil,Hungary,1,3,FIFA World Cup,Liverpool,England,True,4,-2,Hungary
5311,5794,6201,1966,France,Uruguay,1,2,FIFA World Cup,London,England,True,3,-1,Uruguay
5312,5795,6202,1966,Spain,Switzerland,2,1,FIFA World Cup,Sheffield,England,True,3,1,Spain
5313,5796,6203,1966,Argentina,Germany,0,0,FIFA World Cup,Birmingham,England,True,0,0,Draw
5314,5797,6204,1966,Bulgaria,Portugal,0,3,FIFA World Cup,Manchester,England,True,3,-3,Portugal
5315,5798,6205,1966,England,Mexico,2,0,FIFA World Cup,London,England,False,2,2,England
5316,5799,6206,1966,Italy,Russia,0,1,FIFA World Cup,Sunderland,England,True,1,-1,Russia
5317,5800,6207,1966,Sudan,Uganda,2,1,Friendly,Addis Abeba,Ethiopia,True,3,1,Sudan
5318,5801,6208,1966,Argentina,Switzerland,2,0,FIFA World Cup,Sheffield,England,True,2,2,Argentina
5319,5802,6209,1966,Brazil,Portugal,1,3,FIFA World Cup,Liverpool,England,True,4,-2,Portugal
5320,5804,6211,1966,Mexico,Uruguay,0,0,FIFA World Cup,London,England,True,0,0,Draw
5321,5805,6212,1966,Bulgaria,Hungary,1,3,FIFA World Cup,Manchester,England,True,4,-2,Hungary
5322,5806,6213,1966,Chile,Russia,1,2,FIFA World Cup,Sunderland,England,True,3,-1,Russia
5323,5807,6214,1966,England,France,2,0,FIFA World Cup,London,England,False,2,2,England
5324,5808,6215,1966,Germany,Spain,2,1,FIFA World Cup,Birmingham,England,True,3,1,Germany
5325,5809,6217,1966,England,Argentina,1,0,FIFA World Cup,London,England,False,1,1,England
5326,5810,6218,1966,Germany,Uruguay,4,0,FIFA World Cup,Sheffield,England,True,4,4,Germany
5327,5811,6219,1966,Hungary,Russia,1,2,FIFA World Cup,Sunderland,England,True,3,-1,Russia
5328,5812,6221,1966,Germany,Russia,2,1,FIFA World Cup,Liverpool,England,True,3,1,Germany
5329,5813,6222,1966,England,Portugal,2,1,FIFA World Cup,London,England,False,3,1,England
5330,5814,6223,1966,Portugal,Russia,2,1,FIFA World Cup,London,England,True,3,1,Portugal
5331,5815,6224,1966,England,Germany,4,2,FIFA World Cup,London,England,False,6,2,England
5332,5816,6225,1966,Cameroon,Congo,2,3,Friendly,Yaoundé,Cameroon,False,5,-1,Congo
5333,5817,6226,1966,DR Congo,Central African Republic,5,0,Friendly,Kinshasa,DR Congo,False,5,5,DR Congo
5334,5818,6227,1966,Burma,Singapore,2,2,Merdeka Tournament,Kuala Lumpur,Malaysia,True,4,0,Draw
5335,5820,6229,1966,Hong Kong,India,0,2,Merdeka Tournament,Kuala Lumpur,Malaysia,True,2,-2,India
5336,5821,6230,1966,Norway,Finland,1,1,Nordic Championship,Stavanger,Norway,False,2,0,Draw
5337,5822,6231,1966,Togo,Ivory Coast,1,2,Friendly,Lomé,Togo,False,3,-1,Ivory Coast
5338,5823,6232,1966,Burma,Thailand,3,0,Merdeka Tournament,Kuala Lumpur,Malaysia,True,3,3,Burma
5339,5824,6233,1966,Togo,Ghana,1,1,Friendly,Lomé,Togo,False,2,0,Draw
5340,5827,6236,1966,Ghana,Togo,6,2,Friendly,Accra,Ghana,False,8,4,Ghana
5341,5828,6238,1966,Malaysia,Burma,0,0,Merdeka Tournament,Kuala Lumpur,Malaysia,False,0,0,Draw
5342,5829,6239,1966,India,Singapore,0,1,Merdeka Tournament,Kuala Lumpur,Malaysia,True,1,-1,Singapore
5343,5831,6241,1966,Hong Kong,Thailand,2,2,Merdeka Tournament,Ipoh,Malaysia,True,4,0,Draw
5344,5832,6242,1966,Burma,Hong Kong,2,0,Merdeka Tournament,Kuala Lumpur,Malaysia,True,2,2,Burma
5345,5836,6247,1966,Guinea,Cameroon,2,2,Friendly,Conakry,Guinea,False,4,0,Draw
5346,5839,6250,1966,Guinea,Mali,5,0,Friendly,Conakry,Guinea,False,5,5,Guinea
5347,5841,6253,1966,Zambia,Kenya,0,1,Friendly,Ndola,Zambia,False,1,-1,Kenya
5348,5842,6254,1966,Netherlands,Hungary,2,2,UEFA Euro qualification,Rotterdam,Netherlands,False,4,0,Draw
5349,5843,6255,1966,Zambia,Kenya,2,1,Friendly,Lusaka,Zambia,False,3,1,Zambia
5350,5844,6257,1966,Zambia,Kenya,5,4,Friendly,Ndola,Zambia,False,9,1,Zambia
5351,5845,6258,1966,Austria,Netherlands,2,1,Friendly,Vienna,Austria,False,3,1,Austria
5352,5846,6259,1966,Finland,Denmark,2,1,Nordic Championship,Helsinki,Finland,False,3,1,Finland
5353,5847,6260,1966,Norway,Sweden,2,4,Nordic Championship,Oslo,Norway,False,6,-2,Sweden
5354,5848,6263,1966,Hungary,Denmark,6,0,UEFA Euro qualification,Budapest,Hungary,False,6,6,Hungary
5355,5849,6265,1966,Tanzania,Uganda,0,3,Friendly,Zanzibar,Zanzibar,True,3,-3,Uganda
5356,5850,6266,1966,Kenya,Uganda,0,0,Friendly,Zanzibar,Tanzania,True,0,0,Draw
5357,5851,6267,1966,Hungary,France,4,2,Friendly,Budapest,Hungary,False,6,2,Hungary
5358,5852,6269,1966,Tanzania,Kenya,2,3,Friendly,Zanzibar,Tanzania,False,5,-1,Kenya
5359,5853,6271,1966,Finland,Austria,0,0,UEFA Euro qualification,Helsinki,Finland,False,0,0,Draw
5360,5854,6272,1966,Poland,Luxembourg,4,0,UEFA Euro qualification,Szczecin,Poland,False,4,4,Poland
5361,5855,6273,1966,Sweden,Austria,4,1,Friendly,Solna,Sweden,False,5,3,Sweden
5362,5857,6275,1966,Turkey,Germany,0,2,Friendly,Ankara,Turkey,False,2,-2,Germany
5363,5858,6276,1966,French Guiana,Suriname,3,3,Friendly,Cayenne,French Guiana,False,6,0,Draw
5364,5859,6277,1966,French Guiana,Suriname,0,3,Friendly,Cayenne,French Guiana,False,3,-3,Suriname
5365,5860,6278,1966,Greece,Finland,2,1,UEFA Euro qualification,Salonica,Greece,False,3,1,Greece
5366,5861,6279,1966,Russia,Turkey,0,2,Friendly,Moscow,Soviet Union,False,2,-2,Turkey
5367,5862,6281,1966,Belgium,Switzerland,1,0,Friendly,Bruges,Belgium,False,1,1,Belgium
5368,5863,6282,1966,France,Poland,2,1,UEFA Euro qualification,Paris,France,False,3,1,France
5369,5864,6283,1966,Northern Ireland,England,0,2,UEFA Euro qualification,Belfast,Northern Ireland,False,2,-2,England
5370,5865,6284,1966,Wales,Scotland,1,1,UEFA Euro qualification,Cardiff,Wales,False,2,0,Draw
5371,5866,6285,1966,Republic of Ireland,Spain,0,0,UEFA Euro qualification,Dublin,Republic of Ireland,False,0,0,Draw
5372,5868,6287,1966,Denmark,Israel,3,1,Friendly,Copenhagen,Denmark,False,4,2,Denmark
5373,5869,6288,1966,Hungary,Austria,3,1,Friendly,Budapest,Hungary,False,4,2,Hungary
5374,5870,6289,1966,Cameroon,Togo,2,0,Friendly,Yaoundé,Cameroon,False,2,2,Cameroon
5375,5871,6290,1966,Italy,Russia,1,0,Friendly,Milan,Italy,False,1,1,Italy
5376,5872,6291,1966,Ivory Coast,Ghana,1,1,Friendly,Abidjan,Ivory Coast,False,2,0,Draw
5377,5874,6294,1966,Romania,Switzerland,4,2,UEFA Euro qualification,Bucharest,Romania,False,6,2,Romania
5378,5875,6295,1966,Malaysia,Thailand,1,1,Vietnam Independence Cup,Saigon,Vietnam Republic,True,2,0,Draw
5379,5876,6296,1966,Dominica,Saint Vincent and the Grenadines,0,1,Windward Islands Tournament,St. George's,Grenada,True,1,-1,Saint Vincent and the Grenadines
5380,5877,6297,1966,Nigeria,DR Congo,3,2,Friendly,Lagos,Nigeria,False,5,1,Nigeria
5381,5879,6300,1966,Grenada,Saint Lucia,7,1,Windward Islands Tournament,St. George's,Grenada,False,8,6,Grenada
5382,5881,6302,1966,Sweden,Denmark,2,1,Nordic Championship,Solna,Sweden,False,3,1,Sweden
5383,5882,6303,1966,Grenada,Dominica,3,3,Windward Islands Tournament,St. George's,Grenada,False,6,0,Draw
5384,5883,6304,1966,Saint Lucia,Saint Vincent and the Grenadines,1,2,Windward Islands Tournament,St. George's,Grenada,True,3,-1,Saint Vincent and the Grenadines
5385,5884,6305,1966,Dominica,Saint Lucia,5,3,Windward Islands Tournament,St. George's,Grenada,True,8,2,Dominica
5386,5885,6306,1966,Belgium,France,2,1,UEFA Euro qualification,Brussels,Belgium,False,3,1,Belgium
5387,5886,6307,1966,Grenada,Saint Vincent and the Grenadines,1,3,Windward Islands Tournament,St. George's,Grenada,False,4,-2,Saint Vincent and the Grenadines
5388,5887,6308,1966,Sierra Leone,Liberia,1,1,Friendly,Freetown,Sierra Leone,False,2,0,Draw
5389,5888,6309,1966,Bulgaria,Norway,4,2,UEFA Euro qualification,Sofia,Bulgaria,False,6,2,Bulgaria
5390,5889,6310,1966,Portugal,Sweden,1,2,UEFA Euro qualification,Oeiras,Portugal,False,3,-1,Sweden
5391,5890,6311,1966,England,Wales,5,1,UEFA Euro qualification,London,England,False,6,4,England
5392,5891,6312,1966,Republic of Ireland,Turkey,2,1,UEFA Euro qualification,Dublin,Republic of Ireland,False,3,1,Republic of Ireland
5393,5892,6313,1966,Scotland,Northern Ireland,2,1,UEFA Euro qualification,Glasgow,Scotland,False,3,1,Scotland
5394,5893,6314,1966,Romania,Poland,4,3,Friendly,Ploieşti,Romania,False,7,1,Romania
5395,5894,6315,1966,Germany,Norway,3,0,Friendly,Cologne,Germany,False,3,3,Germany
5396,5895,6316,1966,Liberia,Sierra Leone,2,0,Friendly,Monrovia,Liberia,False,2,2,Liberia
5397,5896,6317,1966,Mali,Guinea,1,0,Friendly,Bamako,Mali,False,1,1,Mali
5398,5897,6318,1966,Algeria,Morocco,2,2,Friendly,Algiers,Algeria,False,4,0,Draw
5399,5898,6319,1966,DR Congo,Nigeria,1,0,Friendly,Kinshasa,DR Congo,False,1,1,DR Congo
5400,5899,6320,1966,Palestine,Yemen,5,3,GaNEFo,Phnom Penh,Cambodia,True,8,2,Palestine
5401,5901,6323,1966,Italy,Romania,3,1,UEFA Euro qualification,Naples,Italy,False,4,2,Italy
5402,5902,6324,1966,Luxembourg,France,0,3,UEFA Euro qualification,Luxembourg,Luxembourg,False,3,-3,France
5403,5905,6328,1966,Cambodia,Yemen,8,0,GaNEFo,Phnom Penh,Cambodia,False,8,8,Cambodia
5404,5908,6331,1966,Chile,Colombia,5,2,Copa América,Santiago,Chile,False,7,3,Chile
5405,5909,6334,1966,Netherlands,Denmark,2,0,UEFA Euro qualification,Rotterdam,Netherlands,False,2,2,Netherlands
5406,5910,6335,1966,Uganda,Kenya,1,2,Friendly,Kampala,Uganda,False,3,-1,Kenya
5407,5911,6336,1966,DR Congo,Gabon,4,3,Friendly,Bangui,Central African Republic,True,7,1,DR Congo
5408,5912,6337,1966,Central African Republic,DR Congo,1,4,Friendly,Bangui,Central African Republic,False,5,-3,DR Congo
5409,5913,6339,1966,Cyprus,Romania,1,5,UEFA Euro qualification,Nicosia,Cyprus,False,6,-4,Romania
5410,5914,6340,1966,Israel,Poland,0,0,Friendly,Jaffa,Israel,False,0,0,Draw
5411,5915,6343,1966,Israel,Romania,1,2,Friendly,Jaffa,Israel,False,3,-1,Romania
5412,5916,6344,1966,Spain,Republic of Ireland,2,0,UEFA Euro qualification,Valencia,Spain,False,2,2,Spain
5413,5917,6345,1966,Libya,Egypt,2,2,African Cup of Nations qualification,Tripoli,Libya,False,4,0,Draw
5414,5919,6347,1966,Kenya,Sudan,0,1,Friendly,Nairobi,Kenya,False,1,-1,Sudan
5415,5920,6348,1966,Colombia,Chile,0,0,Copa América,Bogotá,Colombia,False,0,0,Draw
5416,5921,6350,1966,Kenya,Sudan,3,2,Friendly,Nairobi,Kenya,False,5,1,Kenya
5417,5922,6351,1966,New Caledonia,Vanuatu,5,0,South Pacific Games,Nouméa,New Caledonia,False,5,5,New Caledonia
5418,5923,6352,1966,New Caledonia,Solomon Islands,8,0,South Pacific Games,Nouméa,New Caledonia,False,8,8,New Caledonia
5419,5925,6354,1966,Solomon Islands,Vanuatu,4,4,South Pacific Games,Nouméa,New Caledonia,True,8,0,Draw
5420,5926,6355,1966,New Caledonia,Papua New Guinea,4,0,South Pacific Games,Nouméa,New Caledonia,False,4,4,New Caledonia
5421,5928,6358,1966,Papua New Guinea,Vanuatu,2,5,South Pacific Games,Nouméa,New Caledonia,True,7,-3,Vanuatu
5422,5929,6359,1966,Ecuador,Paraguay,2,2,Copa América,Guayaquil,Ecuador,False,4,0,Draw
5423,5930,6360,1966,Paraguay,Ecuador,3,1,Copa América,Asunción,Paraguay,False,4,2,Paraguay
5424,5931,6361,1967,Gabon,DR Congo,1,0,Friendly,Libreville,Gabon,False,1,1,Gabon
5425,5932,6362,1967,Uruguay,Romania,1,1,Friendly,Montevideo,Uruguay,False,2,0,Draw
5426,5933,6363,1967,Mexico,Switzerland,3,0,Friendly,Mexico City,Mexico,False,3,3,Mexico
5427,5934,6364,1967,Mexico,Switzerland,0,2,Friendly,Guadalajara,Mexico,False,2,-2,Switzerland
5428,5935,6365,1967,Jamaica,Curaçao,1,1,CONCACAF Championship qualification,Kingston,Jamaica,False,2,0,Draw
5429,5936,6366,1967,Cuba,Haiti,1,1,CONCACAF Championship qualification,Kingston,Jamaica,True,2,0,Draw
5430,5937,6367,1967,Curaçao,Trinidad and Tobago,1,2,CONCACAF Championship qualification,Kingston,Jamaica,True,3,-1,Trinidad and Tobago
5431,5938,6368,1967,Uruguay,Bolivia,4,0,Copa América,Montevideo,Uruguay,False,4,4,Uruguay
5432,5939,6369,1967,Jamaica,Cuba,2,1,CONCACAF Championship qualification,Kingston,Jamaica,False,3,1,Jamaica
5433,5940,6370,1967,Curaçao,Cuba,2,2,CONCACAF Championship qualification,Kingston,Jamaica,True,4,0,Draw
5434,5942,6372,1967,Argentina,Paraguay,4,1,Copa América,Montevideo,Uruguay,True,5,3,Argentina
5435,5943,6373,1967,Chile,Venezuela,2,0,Copa América,Montevideo,Uruguay,True,2,2,Chile
5436,5944,6374,1967,Guatemala,Honduras,3,1,Friendly,Guatemala,Guatemala,False,4,2,Guatemala
5437,5945,6375,1967,Jamaica,Trinidad and Tobago,1,1,CONCACAF Championship qualification,Kingston,Jamaica,False,2,0,Draw
5438,5946,6376,1967,Curaçao,Haiti,0,1,CONCACAF Championship qualification,Kingston,Jamaica,True,1,-1,Haiti
5439,5947,6377,1967,Cuba,Trinidad and Tobago,1,2,CONCACAF Championship qualification,Kingston,Jamaica,True,3,-1,Trinidad and Tobago
5440,5949,6379,1967,Jamaica,Haiti,0,1,CONCACAF Championship qualification,Kingston,Jamaica,False,1,-1,Haiti
5441,5950,6380,1967,Martinique,Guadeloupe,2,1,Friendly,Fort-de-France,Martinique,False,3,1,Martinique
5442,5951,6381,1967,Uruguay,Venezuela,4,0,Copa América,Montevideo,Uruguay,False,4,4,Uruguay
5443,5952,6382,1967,Bolivia,Argentina,0,1,Copa América,Montevideo,Uruguay,True,1,-1,Argentina
5444,5953,6383,1967,Chile,Paraguay,4,2,Copa América,Montevideo,Uruguay,True,6,2,Chile
5445,5954,6384,1967,DR Congo,Congo,4,1,Friendly,Kinshasa,DR Congo,False,5,3,DR Congo
5446,5955,6385,1967,Honduras,Guatemala,1,1,Friendly,Tegucigalpa,Honduras,False,2,0,Draw
5447,5956,6386,1967,Tunisia,Turkey,0,0,Friendly,Tunis,Tunisia,False,0,0,Draw
5448,5957,6387,1967,Martinique,French Guiana,2,1,Friendly,Fort-de-France,Martinique,False,3,1,Martinique
5449,5959,6389,1967,Argentina,Venezuela,5,1,Copa América,Montevideo,Uruguay,True,6,4,Argentina
5450,5960,6390,1967,Paraguay,Bolivia,1,0,Copa América,Montevideo,Uruguay,True,1,1,Paraguay
5451,5961,6391,1967,Uruguay,Chile,2,2,Copa América,Montevideo,Uruguay,False,4,0,Draw
5452,5962,6392,1967,Argentina,Chile,2,0,Copa América,Montevideo,Uruguay,True,2,2,Argentina
5453,5963,6393,1967,Bolivia,Venezuela,0,3,Copa América,Montevideo,Uruguay,True,3,-3,Venezuela
5454,5964,6394,1967,Nigeria,Ghana,2,2,Friendly,Lagos,Nigeria,False,4,0,Draw
5455,5965,6395,1967,Burkina Faso,Niger,3,2,Friendly,Ouagadougou,Upper Volta,False,5,1,Burkina Faso
5456,5967,6397,1967,Uruguay,Paraguay,2,0,Copa América,Montevideo,Uruguay,False,2,2,Uruguay
5457,5968,6398,1967,Niger,Congo,1,3,Friendly,Niamey,Niger,False,4,-2,Congo
5458,5969,6399,1967,Bolivia,Chile,0,0,Copa América,Montevideo,Uruguay,True,0,0,Draw
5459,5970,6400,1967,Turkey,Spain,0,0,UEFA Euro qualification,Istanbul,Turkey,False,0,0,Draw
5460,5971,6401,1967,Venezuela,Paraguay,3,5,Copa América,Montevideo,Uruguay,True,8,-2,Paraguay
5461,5972,6402,1967,Uruguay,Argentina,1,0,Copa América,Montevideo,Uruguay,False,1,1,Uruguay
5462,5973,6403,1967,Mali,Congo,1,0,Friendly,Bamako,Mali,False,1,1,Mali
5463,5974,6404,1967,Tunisia,Cameroon,4,0,African Cup of Nations qualification,Tunis,Tunisia,False,4,4,Tunisia
5464,5975,6405,1967,Burkina Faso,Algeria,1,2,African Cup of Nations qualification,Ouagadougou,Upper Volta,False,3,-1,Algeria
5465,5976,6406,1967,Ghana,Nigeria,2,0,Friendly,Accra,Ghana,False,2,2,Ghana
5466,5978,6408,1967,Guatemala,Panama,3,1,CONCACAF Championship qualification,Guatemala,Guatemala,False,4,2,Guatemala
5467,5979,6409,1967,Greece,Libya,4,0,Friendly,Athens,Greece,False,4,4,Greece
5468,5980,6410,1967,Guatemala,Nicaragua,3,1,CONCACAF Championship qualification,Guatemala,Guatemala,False,4,2,Guatemala
5469,5981,6411,1967,Nicaragua,Panama,3,1,CONCACAF Championship qualification,Guatemala,Guatemala,True,4,2,Nicaragua
5470,5982,6412,1967,Togo,DR Congo,2,4,Friendly,Lomé,Togo,False,6,-2,DR Congo
5471,5983,6413,1967,Ethiopia,Kenya,2,0,Friendly,Khartoum,Sudan,True,2,2,Ethiopia
5472,5984,6414,1967,Ghana,Ivory Coast,2,2,Friendly,Accra,Ghana,False,4,0,Draw
5473,5985,6415,1967,Tunisia,Congo,1,1,African Cup of Nations qualification,Tunis,Tunisia,False,2,0,Draw
5474,5986,6416,1967,Sudan,Tanzania,1,0,Friendly,Khartoum,Sudan,False,1,1,Sudan
5475,5987,6417,1967,Germany,Morocco,5,1,Friendly,Karlsruhe,Germany,False,6,4,Germany
5476,5988,6418,1967,Turkey,Republic of Ireland,2,1,UEFA Euro qualification,Ankara,Turkey,False,3,1,Turkey
5477,5989,6419,1967,Kenya,Tanzania,2,0,Friendly,Khartoum,Sudan,True,2,2,Kenya
5478,5990,6420,1967,Sudan,Ethiopia,1,1,Friendly,Khartoum,Sudan,False,2,0,Draw
5479,5991,6421,1967,Uganda,DR Congo,0,5,Friendly,Kampala,Uganda,False,5,-5,DR Congo
5480,5992,6422,1967,Cameroon,Congo,1,1,African Cup of Nations qualification,Yaoundé,Cameroon,False,2,0,Draw
5481,5993,6423,1967,Sudan,Ethiopia,5,3,Friendly,Khartoum,Sudan,False,8,2,Sudan
5482,5994,6424,1967,Ethiopia,Sudan,2,1,Friendly,Addis Abeba,Ethiopia,False,3,1,Ethiopia
5483,5996,6426,1967,Benin,Congo,1,1,Friendly,Cotonou,Dahomey,False,2,0,Draw
5484,5997,6427,1967,Ivory Coast,Liberia,1,1,Friendly,Abidjan,Ivory Coast,False,2,0,Draw
5485,5998,6428,1967,Mexico,Nicaragua,4,0,CONCACAF Championship,Tegucigalpa,Honduras,True,4,4,Mexico
5486,5999,6429,1967,Libya,Sudan,1,1,Friendly,Tripoli,Libya,False,2,0,Draw
5487,6000,6430,1967,Greece,Romania,1,2,Friendly,Athens,Greece,False,3,-1,Romania
5488,6001,6431,1967,Haiti,Trinidad and Tobago,2,3,CONCACAF Championship,Tegucigalpa,Honduras,True,5,-1,Trinidad and Tobago
5489,6002,6432,1967,Guatemala,Mexico,1,0,CONCACAF Championship,Tegucigalpa,Honduras,True,1,1,Guatemala
5490,6003,6433,1967,Iraq,Sudan,2,2,Friendly,Tripoli,Libya,True,4,0,Draw
5491,6004,6434,1967,Libya,Iraq,0,1,Friendly,Tripoli,Libya,False,1,-1,Iraq
5492,6005,6435,1967,Mexico,Trinidad and Tobago,4,0,CONCACAF Championship,Tegucigalpa,Honduras,True,4,4,Mexico
5493,6006,6436,1967,Nigeria,Ivory Coast,0,0,African Cup of Nations qualification,Lagos,Nigeria,False,0,0,Draw
5494,6007,6437,1967,Haiti,Mexico,0,1,CONCACAF Championship,Tegucigalpa,Honduras,True,1,-1,Mexico
5495,6008,6438,1967,Nicaragua,Trinidad and Tobago,1,3,CONCACAF Championship,Tegucigalpa,Honduras,True,4,-2,Trinidad and Tobago
5496,6009,6439,1967,DR Congo,Sudan,3,2,African Cup of Nations qualification,Kinshasa,DR Congo,False,5,1,DR Congo
5497,6010,6440,1967,Congo,Ghana,3,1,Friendly,Brazzaville,Congo,False,4,2,Congo
5498,6011,6441,1967,Honduras,Mexico,0,1,CONCACAF Championship,Tegucigalpa,Honduras,False,1,-1,Mexico
5499,6012,6442,1967,Luxembourg,Belgium,0,5,UEFA Euro qualification,Luxembourg,Luxembourg,False,5,-5,Belgium
5500,6013,6443,1967,Algeria,Hungary,0,1,Friendly,Algiers,Algeria,False,1,-1,Hungary
5501,6014,6444,1967,Cyprus,Italy,0,2,UEFA Euro qualification,Nicosia,Cyprus,False,2,-2,Italy
5502,6015,6445,1967,France,Romania,1,2,Friendly,Paris,France,False,3,-1,Romania
5503,6016,6446,1967,Germany,Bulgaria,1,0,Friendly,Hanover,Germany,False,1,1,Germany
5504,6019,6449,1967,Italy,Portugal,1,1,Friendly,Rome,Italy,False,2,0,Draw
5505,6020,6450,1967,Gabon,Ivory Coast,0,3,Friendly,Libreville,Gabon,False,3,-3,Ivory Coast
5506,6021,6452,1967,Sudan,DR Congo,1,0,African Cup of Nations qualification,Khartoum,Sudan,False,1,1,Sudan
5507,6022,6455,1967,Germany,Albania,6,0,UEFA Euro qualification,Dortmund,Germany,False,6,6,Germany
5508,6023,6456,1967,Algeria,Burkina Faso,3,1,African Cup of Nations qualification,Algiers,Algeria,False,4,2,Algeria
5509,6024,6457,1967,Northern Ireland,Wales,0,0,UEFA Euro qualification,Belfast,Northern Ireland,False,0,0,Draw
5510,6025,6458,1967,England,Scotland,2,3,UEFA Euro qualification,London,England,False,5,-1,Scotland
5511,6026,6459,1967,Belgium,Netherlands,1,0,Friendly,Antwerp,Belgium,False,1,1,Belgium
5512,6027,6460,1967,Luxembourg,Poland,0,0,UEFA Euro qualification,Luxembourg,Luxembourg,False,0,0,Draw
5513,6028,6461,1967,Congo,DR Congo,3,1,Friendly,Brazzaville,Congo,False,4,2,Congo
5514,6030,6463,1967,Romania,Cyprus,7,0,UEFA Euro qualification,Bucharest,Romania,False,7,7,Romania
5515,6031,6464,1967,Ivory Coast,Togo,3,0,African Cup of Nations qualification,Abidjan,Ivory Coast,False,3,3,Ivory Coast
5516,6033,6467,1967,Ivory Coast,Nigeria,2,0,African Cup of Nations qualification,Abidjan,Ivory Coast,False,2,2,Ivory Coast
5517,6034,6468,1967,Finland,Greece,1,1,UEFA Euro qualification,Helsinki,Finland,False,2,0,Draw
5518,6035,6469,1967,Hungary,Netherlands,2,1,UEFA Euro qualification,Budapest,Hungary,False,3,1,Hungary
5519,6036,6470,1967,Scotland,Russia,0,2,Friendly,Glasgow,Scotland,False,2,-2,Russia
5520,6038,6472,1967,Suriname,French Guiana,6,1,Friendly,Paramaribo,Suriname,False,7,5,Suriname
5521,6039,6473,1967,Suriname,French Guiana,3,0,Friendly,Paramaribo,Suriname,False,3,3,Suriname
5522,6040,6474,1967,Israel,Scotland,1,2,Friendly,Ramat-Gan,Israel,False,3,-1,Scotland
5523,6041,6475,1967,Congo,Tanzania,6,1,Friendly,Brazzaville,Congo,False,7,5,Congo
5524,6044,6478,1967,Poland,Belgium,3,1,UEFA Euro qualification,Chorzów,Poland,False,4,2,Poland
5525,6045,6479,1967,Denmark,Hungary,0,2,UEFA Euro qualification,Copenhagen,Denmark,False,2,-2,Hungary
5526,6046,6480,1967,England,Spain,2,0,Friendly,London,England,False,2,2,England
5527,6047,6481,1967,Ghana,DR Congo,2,0,Friendly,Accra,Ghana,False,2,2,Ghana
5528,6048,6482,1967,Switzerland,Romania,7,1,UEFA Euro qualification,Zürich,Switzerland,False,8,6,Switzerland
5529,6049,6483,1967,Austria,England,0,1,Friendly,Vienna,Austria,False,1,-1,England
5530,6050,6484,1967,Russia,Mexico,2,0,Friendly,Leningrad,Soviet Union,False,2,2,Russia
5531,6051,6485,1967,Spain,Turkey,2,0,UEFA Euro qualification,Bilbao,Spain,False,2,2,Spain
5532,6052,6486,1967,Finland,Norway,0,2,Nordic Championship,Helsinki,Finland,False,2,-2,Norway
5533,6053,6487,1967,Russia,Mexico,0,1,Friendly,Volgograd,Soviet Union,False,1,-1,Mexico
5534,6054,6488,1967,Sweden,Portugal,1,1,UEFA Euro qualification,Solna,Sweden,False,2,0,Draw
5535,6055,6489,1967,France,Russia,2,4,Friendly,Paris,France,False,6,-2,Russia
5536,6056,6490,1967,Belarus,Mexico,2,1,Friendly,Minsk,Soviet Union,False,3,1,Belarus
5537,6058,6492,1967,Norway,Portugal,1,2,UEFA Euro qualification,Oslo,Norway,False,3,-1,Portugal
5538,6059,6493,1967,Russia,Austria,4,3,UEFA Euro qualification,Moscow,Soviet Union,False,7,1,Russia
5539,6060,6494,1967,Sweden,Bulgaria,0,2,UEFA Euro qualification,Solna,Sweden,False,2,-2,Bulgaria
5540,6061,6496,1967,Uganda,Zambia,1,3,Friendly,Kampala,Uganda,False,4,-2,Zambia
5541,6062,6497,1967,Denmark,Sweden,1,1,Nordic Championship,Copenhagen,Denmark,False,2,0,Draw
5542,6063,6498,1967,Romania,Italy,0,1,UEFA Euro qualification,Bucharest,Romania,False,1,-1,Italy
5543,6064,6499,1967,Uruguay,Brazil,0,0,Copa Rio Branco,Montevideo,Uruguay,False,0,0,Draw
5544,6065,6500,1967,Uruguay,Brazil,2,2,Copa Rio Branco,Montevideo,Uruguay,False,4,0,Draw
5545,6066,6501,1967,Norway,Bulgaria,0,0,UEFA Euro qualification,Oslo,Norway,False,0,0,Draw
5546,6067,6502,1967,Uruguay,Brazil,1,1,Copa Rio Branco,Montevideo,Uruguay,False,2,0,Draw
5547,6068,6503,1967,Tanzania,Zambia,2,2,Friendly,Dar es Salaam,Tanzania,False,4,0,Draw
5548,6069,6504,1967,Benin,Ghana,2,1,Friendly,Cotonou,Dahomey,False,3,1,Benin
5549,6070,6505,1967,Tanzania,Zambia,2,1,Friendly,Dar es Salaam,Tanzania,False,3,1,Tanzania
5550,6071,6506,1967,Russia,Greece,4,0,UEFA Euro qualification,Tbilisi,Soviet Union,False,4,4,Russia
5551,6072,6507,1967,Peru,Uruguay,0,1,Friendly,Lima,Peru,False,1,-1,Uruguay
5552,6073,6509,1967,Guyana,Suriname,2,2,Friendly,Georgetown,Guyana,False,4,0,Draw
5553,6074,6510,1967,Peru,Uruguay,1,2,Friendly,Lima,Peru,False,3,-1,Uruguay
5554,6075,6511,1967,Guyana,Suriname,0,1,Friendly,Georgetown,Guyana,False,1,-1,Suriname
5555,6077,6513,1967,Mauritania,Tanzania,1,1,Friendly,Nouakchott,Mauritania,False,2,0,Draw
5556,6078,6514,1967,Niger,Burkina Faso,2,3,Friendly,Niamey,Niger,False,5,-1,Burkina Faso
5557,6079,6515,1967,DR Congo,Ethiopia,1,0,Friendly,Kinshasa,DR Congo,False,1,1,DR Congo
5558,6080,6516,1967,Guyana,Suriname,0,2,Friendly,Georgetown,Guyana,False,2,-2,Suriname
5559,6081,6517,1967,Tanzania,Mauritius,1,0,African Cup of Nations qualification,Dar es Salaam,Tanzania,False,1,1,Tanzania
5560,6082,6518,1967,Japan,Philippines,2,0,AFC Asian Cup qualification,Taipei,Chinese Taipei,True,2,2,Japan
5561,6083,6519,1967,Japan,Indonesia,2,1,AFC Asian Cup qualification,Taipei,Chinese Taipei,True,3,1,Japan
5562,6084,6521,1967,Indonesia,Philippines,6,0,AFC Asian Cup qualification,Taipei,Chinese Taipei,True,6,6,Indonesia
5563,6085,6522,1967,DR Congo,Mali,2,2,Friendly,Kinshasa,DR Congo,False,4,0,Draw
5564,6086,6523,1967,Hong Kong,Thailand,1,0,Merdeka Tournament,Kuala Lumpur,Malaysia,True,1,1,Hong Kong
5565,6088,6525,1967,Sweden,Finland,2,0,Nordic Championship,Solna,Sweden,False,2,2,Sweden
5566,6092,6529,1967,India,Thailand,1,1,Merdeka Tournament,Kuala Lumpur,Malaysia,True,2,0,Draw
5567,6094,6531,1967,DR Congo,Sudan,2,1,African Cup of Nations qualification,Kampala,Uganda,True,3,1,DR Congo
5568,6096,6533,1967,Indonesia,Singapore,4,1,Merdeka Tournament,Ipoh,Malaysia,True,5,3,Indonesia
5569,6097,6534,1967,Burma,Singapore,3,0,Merdeka Tournament,Ipoh,Malaysia,True,3,3,Burma
5570,6098,6535,1967,Chile,Argentina,1,0,Friendly,Santiago,Chile,False,1,1,Chile
5571,6102,6539,1967,Hong Kong,India,0,4,Merdeka Tournament,Kuala Lumpur,Malaysia,True,4,-4,India
5572,6103,6540,1967,Mauritius,Tanzania,1,1,African Cup of Nations qualification,Curepipe,Mauritius,False,2,0,Draw
5573,6104,6541,1967,Togo,Ivory Coast,0,2,African Cup of Nations qualification,Lomé,Togo,False,2,-2,Ivory Coast
5574,6106,6545,1967,Burma,Indonesia,5,0,Merdeka Tournament,Kuala Lumpur,Malaysia,True,5,5,Burma
5575,6107,6546,1967,Kenya,DR Congo,5,4,Friendly,Nairobi,Kenya,False,9,1,Kenya
5576,6108,6547,1967,Malaysia,India,0,0,Merdeka Tournament,Kuala Lumpur,Malaysia,False,0,0,Draw
5577,6112,6551,1967,Kenya,DR Congo,1,1,Friendly,Nairobi,Kenya,False,2,0,Draw
5578,6115,6555,1967,Mexico,Argentina,2,1,Friendly,Mexico City,Mexico,False,3,1,Mexico
5579,6116,6556,1967,Denmark,Iceland,14,2,Friendly,Copenhagen,Denmark,False,16,12,Denmark
5580,6117,6557,1967,Hong Kong,Indonesia,2,1,Merdeka Tournament,Kuala Lumpur,Malaysia,True,3,1,Hong Kong
5581,6123,6563,1967,India,Indonesia,0,3,Merdeka Tournament,Kuala Lumpur,Malaysia,True,3,-3,Indonesia
5582,6125,6565,1967,Russia,Finland,2,0,UEFA Euro qualification,Moscow,Soviet Union,False,2,2,Russia
5583,6126,6566,1967,DR Congo,Ghana,0,2,Friendly,Kinshasa,DR Congo,False,2,-2,Ghana
5584,6127,6567,1967,Norway,Sweden,3,1,UEFA Euro qualification,Oslo,Norway,False,4,2,Norway
5585,6128,6568,1967,Austria,Hungary,1,3,Friendly,Vienna,Austria,False,4,-2,Hungary
5586,6129,6569,1967,Finland,Russia,2,5,UEFA Euro qualification,Turku,Finland,False,7,-3,Russia
5587,6131,6571,1967,DR Congo,Tanzania,1,0,African Cup of Nations qualification,Kinshasa,DR Congo,False,1,1,DR Congo
5588,6132,6572,1967,Poland,France,1,4,UEFA Euro qualification,Warsaw,Poland,False,5,-3,France
5589,6133,6573,1967,Chile,Brazil,0,1,Friendly,Santiago,Chile,False,1,-1,Brazil
5590,6134,6574,1967,Austria,Finland,2,1,UEFA Euro qualification,Vienna,Austria,False,3,1,Austria
5591,6135,6575,1967,Norway,Denmark,0,5,Nordic Championship,Oslo,Norway,False,5,-5,Denmark
5592,6136,6576,1967,Germany,France,5,1,Friendly,Berlin,Germany,False,6,4,Germany
5593,6138,6578,1967,Mali,Burkina Faso,4,0,African Cup of Nations qualification,Bamako,Mali,False,4,4,Mali
5594,6139,6579,1967,Ghana,Nigeria,1,1,Friendly,Accra,Ghana,False,2,0,Draw
5595,6140,6580,1967,Kenya,Uganda,3,1,Friendly,Nairobi,Kenya,False,4,2,Kenya
5596,6141,6582,1967,Ghana,Burkina Faso,5,2,Friendly,Accra,Ghana,False,7,3,Ghana
5597,6142,6583,1967,Russia,Switzerland,2,2,Friendly,Moscow,Soviet Union,False,4,0,Draw
5598,6143,6584,1967,Tanzania,Uganda,1,2,Friendly,Nairobi,Kenya,True,3,-1,Uganda
5599,6144,6585,1967,Denmark,Netherlands,3,2,UEFA Euro qualification,Copenhagen,Denmark,False,5,1,Denmark
5600,6145,6586,1967,Greece,Austria,4,1,UEFA Euro qualification,Piraeus,Greece,False,5,3,Greece
5601,6147,6588,1967,Trinidad and Tobago,Martinique,2,2,Friendly,Port of Spain,Trinidad and Tobago,False,4,0,Draw
5602,6150,6591,1967,Singapore,Hong Kong,4,0,Friendly,Kallang,Singapore,False,4,4,Singapore
5603,6151,6592,1967,Belgium,Poland,2,4,UEFA Euro qualification,Brussels,Belgium,False,6,-2,Poland
5604,6152,6593,1967,Bulgaria,Russia,1,2,Friendly,Sofia,Bulgaria,False,3,-1,Russia
5605,6153,6594,1967,Kenya,Tanzania,5,3,Friendly,Nairobi,Kenya,False,8,2,Kenya
5606,6154,6595,1967,El Salvador,Haiti,2,0,Friendly,San Salvador,El Salvador,False,2,2,El Salvador
5607,6156,6598,1967,Paraguay,Argentina,1,1,Friendly,Asunción,Paraguay,False,2,0,Draw
5608,6157,6599,1967,Tanzania,DR Congo,0,1,African Cup of Nations qualification,Dar es Salaam,Tanzania,False,1,-1,DR Congo
5609,6158,6600,1967,Sierra Leone,Nigeria,1,1,Friendly,Freetown,Sierra Leone,False,2,0,Draw
5610,6159,6601,1967,Austria,Russia,1,0,UEFA Euro qualification,Vienna,Austria,False,1,1,Austria
5611,6160,6602,1967,Liberia,DR Congo,1,4,Friendly,Monrovia,Liberia,False,5,-3,DR Congo
5612,6161,6603,1967,Ghana,Nigeria,2,1,Friendly,Accra,Ghana,False,3,1,Ghana
5613,6162,6604,1967,Northern Ireland,Scotland,1,0,UEFA Euro qualification,Belfast,Northern Ireland,False,1,1,Northern Ireland
5614,6163,6605,1967,Wales,England,0,3,UEFA Euro qualification,Cardiff,Wales,False,3,-3,England
5615,6164,6606,1967,Denmark,Finland,3,0,Nordic Championship,Copenhagen,Denmark,False,3,3,Denmark
5616,6165,6607,1967,Guatemala,El Salvador,1,0,Friendly,Guatemala,Guatemala,False,1,1,Guatemala
5617,6167,6609,1967,Trinidad and Tobago,Martinique,3,2,Friendly,Port of Spain,Trinidad and Tobago,False,5,1,Trinidad and Tobago
5618,6168,6610,1967,France,Belgium,1,1,UEFA Euro qualification,Nantes,France,False,2,0,Draw
5619,6169,6611,1967,El Salvador,Costa Rica,3,1,Friendly,San Salvador,El Salvador,False,4,2,El Salvador
5620,6170,6613,1967,Poland,Romania,0,0,Friendly,Cracow,Poland,False,0,0,Draw
5621,6171,6614,1967,Uganda,Ethiopia,2,3,Friendly,Kampala,Uganda,False,5,-1,Ethiopia
5622,6172,6615,1967,Greece,Russia,0,1,UEFA Euro qualification,Piraeus,Greece,False,1,-1,Russia
5623,6173,6616,1967,Italy,Cyprus,5,0,UEFA Euro qualification,Cosenza,Italy,False,5,5,Italy
5624,6175,6618,1967,Malaysia,Thailand,3,2,Vietnam Independence Cup,Saigon,Vietnam Republic,True,5,1,Malaysia
5625,6176,6620,1967,Australia,New Zealand,5,3,Vietnam Independence Cup,Saigon,Vietnam Republic,True,8,2,Australia
5626,6177,6621,1967,Austria,Greece,1,1,UEFA Euro qualification,Vienna,Austria,False,2,0,Draw
5627,6178,6622,1967,El Salvador,Guatemala,1,3,Friendly,San Salvador,El Salvador,False,4,-2,Guatemala
5628,6180,6624,1967,Puerto Rico,Martinique,3,6,Friendly,San Juan,Puerto Rico,False,9,-3,Martinique
5629,6181,6625,1967,Sweden,Norway,5,2,UEFA Euro qualification,Solna,Sweden,False,7,3,Sweden
5630,6182,6628,1967,Chile,Argentina,3,1,Friendly,Santiago,Chile,False,4,2,Chile
5631,6183,6629,1967,Hong Kong,Malaysia,0,2,Vietnam Independence Cup,Saigon,Vietnam Republic,True,2,-2,Malaysia
5632,6184,6630,1967,New Caledonia,New Zealand,4,0,Friendly,Nouméa,New Caledonia,False,4,4,New Caledonia
5633,6185,6631,1967,New Zealand,Singapore,3,1,Vietnam Independence Cup,Saigon,Vietnam Republic,True,4,2,New Zealand
5634,6186,6632,1967,Puerto Rico,Guadeloupe,2,4,Friendly,San Juan,Puerto Rico,False,6,-2,Guadeloupe
5635,6187,6633,1967,Switzerland,Cyprus,5,0,UEFA Euro qualification,Lugano,Switzerland,False,5,5,Switzerland
5636,6188,6634,1967,Hong Kong,Thailand,1,5,Vietnam Independence Cup,Saigon,Vietnam Republic,True,6,-4,Thailand
5637,6189,6636,1967,Australia,Singapore,5,1,Vietnam Independence Cup,Saigon,Vietnam Republic,True,6,4,Australia
5638,6190,6637,1967,Guadeloupe,Martinique,0,1,Friendly,San Juan,Puerto Rico,True,1,-1,Martinique
5639,6191,6639,1967,Australia,Malaysia,1,0,Vietnam Independence Cup,Saigon,Vietnam Republic,True,1,1,Australia
5640,6192,6640,1967,Bulgaria,Sweden,3,0,UEFA Euro qualification,Sofia,Bulgaria,False,3,3,Bulgaria
5641,6193,6641,1967,Burma,India,2,0,AFC Asian Cup qualification,Rangoon,Burma,False,2,2,Burma
5642,6194,6642,1967,Portugal,Norway,2,1,UEFA Euro qualification,Porto,Portugal,False,3,1,Portugal
5643,6195,6645,1967,Zimbabwe,Malawi,1,0,Friendly,Salisbury,Rhodesia,False,1,1,Zimbabwe
5644,6197,6648,1967,Burkina Faso,Mali,0,1,African Cup of Nations qualification,Ouagadougou,Upper Volta,False,1,-1,Mali
5645,6198,6649,1967,India,Pakistan,1,1,AFC Asian Cup qualification,Rangoon,Burma,True,2,0,Draw
5646,6200,6651,1967,Burma,Cambodia,1,0,AFC Asian Cup qualification,Rangoon,Burma,False,1,1,Burma
5647,6201,6652,1967,Malaysia,New Zealand,2,8,Friendly,Kuala Lumpur,Malaysia,False,10,-6,New Zealand
5648,6202,6653,1967,Switzerland,Italy,2,2,UEFA Euro qualification,Berne,Switzerland,False,4,0,Draw
5649,6203,6654,1967,Burma,Pakistan,2,0,AFC Asian Cup qualification,Rangoon,Burma,False,2,2,Burma
5650,6204,6655,1967,Belgium,Luxembourg,3,0,UEFA Euro qualification,Bruges,Belgium,False,3,3,Belgium
5651,6205,6657,1967,England,Northern Ireland,2,0,UEFA Euro qualification,London,England,False,2,2,England
5652,6206,6658,1967,Romania,Germany,1,0,Friendly,Bucharest,Romania,False,1,1,Romania
5653,6207,6659,1967,Scotland,Wales,3,2,UEFA Euro qualification,Glasgow,Scotland,False,5,1,Scotland
5654,6208,6660,1967,Senegal,Guinea,2,1,African Cup of Nations qualification,Dakar,Senegal,False,3,1,Senegal
5655,6209,6661,1967,Benin,DR Congo,2,5,Friendly,Cotonou,Dahomey,False,7,-3,DR Congo
5656,6210,6662,1967,Zimbabwe,Mauritius,1,2,Friendly,Salisbury,Rhodesia,False,3,-1,Mauritius
5657,6211,6663,1967,Bulgaria,Portugal,1,0,UEFA Euro qualification,Sofia,Bulgaria,False,1,1,Bulgaria
5658,6212,6664,1967,Burkina Faso,Ivory Coast,3,2,Friendly,Ouagadougou,Upper Volta,False,5,1,Burkina Faso
5659,6213,6665,1967,Grenada,Saint Vincent and the Grenadines,1,1,Windward Islands Tournament,Roseau,Dominica,True,2,0,Draw
5660,6214,6666,1967,Iran,Turkey,0,1,Friendly,Dhaka,Pakistan,True,1,-1,Turkey
5661,6215,6667,1967,Trinidad and Tobago,Jamaica,1,0,Friendly,San Fernando,Trinidad and Tobago,False,1,1,Trinidad and Tobago
5662,6216,6668,1967,Zimbabwe,Mauritius,2,3,Friendly,Salisbury,Rhodesia,False,5,-1,Mauritius
5663,6217,6669,1967,Dominica,Saint Lucia,2,4,Windward Islands Tournament,Roseau,Dominica,False,6,-2,Saint Lucia
5664,6218,6670,1967,Pakistan,Turkey,4,7,Friendly,Dhaka,Pakistan,False,11,-3,Turkey
5665,6219,6671,1967,Netherlands,Russia,3,1,Friendly,Rotterdam,Netherlands,False,4,2,Netherlands
5666,6220,6672,1967,Saint Lucia,Saint Vincent and the Grenadines,4,3,Windward Islands Tournament,Roseau,Dominica,True,7,1,Saint Lucia
5667,6221,6673,1967,Dominica,Grenada,2,4,Windward Islands Tournament,Roseau,Dominica,False,6,-2,Grenada
5668,6222,6674,1967,Grenada,Saint Lucia,2,1,Windward Islands Tournament,Roseau,Dominica,True,3,1,Grenada
5669,6223,6675,1967,Sierra Leone,Guinea,2,1,Friendly,Freetown,Sierra Leone,False,3,1,Sierra Leone
5670,6224,6676,1967,Trinidad and Tobago,Jamaica,1,0,Friendly,Port of Spain,Trinidad and Tobago,False,1,1,Trinidad and Tobago
5671,6225,6677,1967,Dominica,Saint Vincent and the Grenadines,1,2,Windward Islands Tournament,Roseau,Dominica,False,3,-1,Saint Vincent and the Grenadines
5672,6226,6678,1967,Mali,Congo,1,1,Friendly,Bamako,Mali,False,2,0,Draw
5673,6227,6679,1967,England,Russia,2,2,Friendly,London,England,False,4,0,Draw
5674,6228,6680,1967,Mauritius,Ethiopia,0,2,Friendly,Port Louis,Mauritius,False,2,-2,Ethiopia
5675,6229,6681,1967,Mexico,Hungary,2,1,Friendly,Mexico City,Mexico,False,3,1,Mexico
5676,6230,6682,1967,Mexico,Hungary,0,2,Friendly,Mexico City,Mexico,False,2,-2,Hungary
5677,6231,6683,1967,Saudi Arabia,Tunisia,4,0,Friendly,Riyadh,Saudi Arabia,False,4,4,Saudi Arabia
5678,6232,6684,1967,Chile,Hungary,4,5,Friendly,Santiago,Chile,False,9,-1,Hungary
5679,6233,6685,1967,Chile,Russia,1,4,Friendly,Santiago,Chile,False,5,-3,Russia
5680,6234,6686,1967,Albania,Germany,0,0,UEFA Euro qualification,Tirana,Albania,False,0,0,Draw
5681,6235,6687,1967,Kenya,Zambia,1,5,Friendly,Nairobi,Kenya,False,6,-4,Zambia
5682,6236,6688,1967,Portugal,Bulgaria,0,0,UEFA Euro qualification,Oeiras,Portugal,False,0,0,Draw
5683,6237,6689,1967,France,Luxembourg,3,1,UEFA Euro qualification,Paris,France,False,4,2,France
5684,6238,6690,1967,Italy,Switzerland,4,0,UEFA Euro qualification,Cagliari,Italy,False,4,4,Italy
5685,6239,6691,1967,Nigeria,Ghana,2,2,Friendly,Lagos,Nigeria,False,4,0,Draw
5686,6240,6692,1967,DR Congo,Romania,1,1,Friendly,Kinshasa,DR Congo,False,2,0,Draw
5687,6241,6693,1967,Ethiopia,Kenya,2,0,Friendly,Addis Abeba,Ethiopia,False,2,2,Ethiopia
5688,6242,6694,1968,Israel,Belgium,0,2,Friendly,Jaffa,Israel,False,2,-2,Belgium
5689,6243,6695,1968,Algeria,Ivory Coast,0,3,African Cup of Nations,Addis Abeba,Ethiopia,True,3,-3,Ivory Coast
5690,6244,6696,1968,Congo,DR Congo,0,3,African Cup of Nations,Asmara,Ethiopia,True,3,-3,DR Congo
5691,6245,6697,1968,Ethiopia,Uganda,2,1,African Cup of Nations,Addis Abeba,Ethiopia,False,3,1,Ethiopia
5692,6246,6698,1968,Ghana,Senegal,2,2,African Cup of Nations,Asmara,Ethiopia,True,4,0,Draw
5693,6247,6699,1968,Algeria,Uganda,4,0,African Cup of Nations,Addis Abeba,Ethiopia,True,4,4,Algeria
5694,6248,6700,1968,Congo,Senegal,1,2,African Cup of Nations,Asmara,Ethiopia,True,3,-1,Senegal
5695,6249,6701,1968,DR Congo,Ghana,1,2,African Cup of Nations,Asmara,Ethiopia,True,3,-1,Ghana
5696,6250,6702,1968,Ethiopia,Ivory Coast,1,0,African Cup of Nations,Addis Abeba,Ethiopia,False,1,1,Ethiopia
5697,6251,6703,1968,Congo,Ghana,1,3,African Cup of Nations,Asmara,Ethiopia,True,4,-2,Ghana
5698,6252,6704,1968,DR Congo,Senegal,2,1,African Cup of Nations,Asmara,Ethiopia,True,3,1,DR Congo
5699,6253,6705,1968,Ethiopia,Algeria,3,1,African Cup of Nations,Addis Abeba,Ethiopia,False,4,2,Ethiopia
5700,6254,6706,1968,Ivory Coast,Uganda,2,1,African Cup of Nations,Addis Abeba,Ethiopia,True,3,1,Ivory Coast
5701,6255,6707,1968,Ethiopia,DR Congo,2,3,African Cup of Nations,Addis Abeba,Ethiopia,False,5,-1,DR Congo
5702,6256,6708,1968,Ghana,Ivory Coast,4,3,African Cup of Nations,Asmara,Ethiopia,True,7,1,Ghana
5703,6257,6709,1968,DR Congo,Ghana,1,0,African Cup of Nations,Addis Abeba,Ethiopia,True,1,1,DR Congo
5704,6258,6710,1968,Ethiopia,Ivory Coast,0,1,African Cup of Nations,Addis Abeba,Ethiopia,False,1,-1,Ivory Coast
5705,6259,6711,1968,Nigeria,Sierra Leone,4,1,Friendly,Lagos,Nigeria,False,5,3,Nigeria
5706,6260,6712,1968,Israel,Switzerland,2,1,Friendly,Jaffa,Israel,False,3,1,Israel
5707,6261,6713,1968,Cyprus,Switzerland,2,1,UEFA Euro qualification,Nicosia,Cyprus,False,3,1,Cyprus
5708,6262,6714,1968,Israel,Sweden,0,3,Friendly,Jaffa,Israel,False,3,-3,Sweden
5709,6263,6715,1968,Scotland,England,1,1,UEFA Euro qualification,Glasgow,Scotland,False,2,0,Draw
5710,6264,6716,1968,Burkina Faso,Guinea,2,0,Friendly,Ouagadougou,Upper Volta,False,2,2,Burkina Faso
5711,6265,6717,1968,Spain,Sweden,3,1,Friendly,Seville,Spain,False,4,2,Spain
5712,6266,6718,1968,Wales,Northern Ireland,2,0,UEFA Euro qualification,Wrexham,Wales,False,2,2,Wales
5713,6267,6719,1968,Mexico,Russia,0,0,Friendly,Mexico City,Mexico,False,0,0,Draw
5714,6268,6720,1968,Belgium,Germany,1,3,Friendly,Brussels,Belgium,False,4,-2,Germany
5715,6269,6721,1968,Guinea,DR Congo,1,0,Friendly,Conakry,Guinea,False,1,1,Guinea
5716,6270,6722,1968,Mexico,Russia,1,1,Friendly,León,Mexico,False,2,0,Draw
5717,6271,6723,1968,Mexico,Russia,0,0,Friendly,Mexico City,Mexico,False,0,0,Draw
5718,6272,6724,1968,Turkey,Tunisia,0,0,Friendly,Izmir,Turkey,False,0,0,Draw
5719,6273,6725,1968,Morocco,Algeria,0,0,Friendly,Casablanca,Morocco,False,0,0,Draw
5720,6274,6726,1968,Mexico,Japan,4,0,Friendly,Mexico City,Mexico,False,4,4,Mexico
5721,6275,6727,1968,Australia,Japan,2,2,Friendly,Sydney,Australia,False,4,0,Draw
5722,6276,6728,1968,Australia,Japan,3,1,Friendly,Melbourne,Australia,False,4,2,Australia
5723,6277,6729,1968,Guinea,Burkina Faso,3,1,Friendly,Conakry,Guinea,False,4,2,Guinea
5724,6278,6730,1968,Guinea,Burkina Faso,1,3,Friendly,Conakry,Guinea,False,4,-2,Burkina Faso
5725,6279,6731,1968,England,Spain,1,0,UEFA Euro qualification,London,England,False,1,1,England
5726,6280,6732,1968,Australia,Japan,1,3,Friendly,Adelaide,Australia,False,4,-2,Japan
5727,6281,6733,1968,Barbados,Suriname,0,2,Friendly,Bridgetown,Barbados,False,2,-2,Suriname
5728,6282,6734,1968,Bulgaria,Italy,3,2,UEFA Euro qualification,Sofia,Bulgaria,False,5,1,Bulgaria
5729,6284,6736,1968,Netherlands,Belgium,1,2,Friendly,Amsterdam,Netherlands,False,3,-1,Belgium
5730,6285,6737,1968,Togo,Guinea,1,1,Friendly,Lomé,Togo,False,2,0,Draw
5731,6286,6738,1968,Barbados,Suriname,0,0,Friendly,Bridgetown,Barbados,False,0,0,Draw
5732,6287,6739,1968,Benin,Guinea,2,5,Friendly,Cotonou,Dahomey,False,7,-3,Guinea
5733,6288,6740,1968,Martinique,Suriname,1,3,Friendly,Fort-de-France,Martinique,False,4,-2,Suriname
5734,6289,6741,1968,Martinique,Suriname,3,2,Friendly,Fort-de-France,Martinique,False,5,1,Martinique
5735,6290,6742,1968,Switzerland,Germany,0,0,Friendly,Basel,Switzerland,False,0,0,Draw
5736,6291,6743,1968,Italy,Bulgaria,2,0,UEFA Euro qualification,Naples,Italy,False,2,2,Italy
5737,6292,6744,1968,Poland,Turkey,8,0,Friendly,Chorzów,Poland,False,8,8,Poland
5738,6293,6745,1968,Russia,Belgium,1,0,Friendly,Moscow,Soviet Union,False,1,1,Russia
5739,6294,6748,1968,Austria,Romania,1,1,Friendly,Linz,Austria,False,2,0,Draw
5740,6295,6749,1968,Poland,Netherlands,0,0,Friendly,Warsaw,Poland,False,0,0,Draw
5741,6296,6750,1968,Eswatini,Malawi,2,0,Friendly,Mbabane,Eswatini,False,2,2,Eswatini
5742,6297,6751,1968,Sweden,Spain,1,1,Friendly,Malmö,Sweden,False,2,0,Draw
5743,6298,6752,1968,Hungary,Russia,2,0,UEFA Euro qualification,Budapest,Hungary,False,2,2,Hungary
5744,6299,6753,1968,El Salvador,Guatemala,3,0,Friendly,San Salvador,El Salvador,False,3,3,El Salvador
5745,6300,6754,1968,Kenya,Nigeria,1,2,Friendly,Nairobi,Kenya,False,3,-1,Nigeria
5746,6301,6755,1968,Spain,England,1,2,UEFA Euro qualification,Madrid,Spain,False,3,-1,England
5747,6302,6756,1968,Wales,Germany,1,1,Friendly,Cardiff,Wales,False,2,0,Draw
5748,6303,6757,1968,Iran,Hong Kong,2,0,AFC Asian Cup,Teheran,Iran,False,2,2,Iran
5749,6305,6759,1968,Russia,Hungary,3,0,UEFA Euro qualification,Moscow,Soviet Union,False,3,3,Russia
5750,6306,6760,1968,Hong Kong,Israel,1,6,AFC Asian Cup,Teheran,Iran,True,7,-5,Israel
5751,6308,6762,1968,Burma,Israel,1,0,AFC Asian Cup,Teheran,Iran,True,1,1,Burma
5752,6310,6764,1968,Republic of Ireland,Poland,2,2,Friendly,Dublin,Republic of Ireland,False,4,0,Draw
5753,6311,6765,1968,Paraguay,Argentina,2,0,Friendly,Asunción,Paraguay,False,2,2,Paraguay
5754,6312,6766,1968,Iran,Burma,3,1,AFC Asian Cup,Teheran,Iran,False,4,2,Iran
5755,6314,6768,1968,Burma,Hong Kong,2,0,AFC Asian Cup,Teheran,Iran,True,2,2,Burma
5756,6315,6769,1968,Austria,Cyprus,7,1,FIFA World Cup qualification,Vienna,Austria,False,8,6,Austria
5757,6316,6770,1968,Ghana,Ivory Coast,2,1,Friendly,Accra,Ghana,False,3,1,Ghana
5758,6317,6771,1968,Iran,Israel,2,1,AFC Asian Cup,Teheran,Iran,False,3,1,Iran
5759,6318,6772,1968,Mexico,Uruguay,3,3,Friendly,Mexico City,Mexico,False,6,0,Draw
5760,6319,6773,1968,England,Sweden,3,1,Friendly,London,England,False,4,2,England
5761,6320,6774,1968,Mexico,Uruguay,2,2,Friendly,Mexico City,Mexico,False,4,0,Draw
5762,6321,6775,1968,Netherlands,Scotland,0,0,Friendly,Amsterdam,Netherlands,False,0,0,Draw
5763,6322,6776,1968,Germany,England,1,0,Friendly,Hanover,Germany,False,1,1,Germany
5764,6323,6777,1968,Paraguay,Uruguay,0,0,Copa Artigas,Asunción,Paraguay,False,0,0,Draw
5765,6324,6778,1968,Finland,Denmark,1,3,Nordic Championship,Helsinki,Finland,False,4,-2,Denmark
5766,6325,6779,1968,Argentina,Uruguay,2,0,Copa Lipton,Buenos Aires,Argentina,False,2,2,Argentina
5767,6327,6781,1968,Italy,Russia,0,0,UEFA Euro,Naples,Italy,False,0,0,Draw
5768,6328,6782,1968,Romania,Netherlands,0,0,Friendly,Bucharest,Romania,False,0,0,Draw
5769,6329,6783,1968,England,Russia,2,0,UEFA Euro,Rome,Italy,True,2,2,England
5770,6331,6785,1968,Brazil,Uruguay,2,0,Copa Rio Branco,São Paulo,Brazil,False,2,2,Brazil
5771,6332,6786,1968,Norway,Poland,1,6,Friendly,Oslo,Norway,False,7,-5,Poland
5772,6334,6788,1968,Brazil,Uruguay,4,0,Copa Rio Branco,Rio de Janeiro,Brazil,False,4,4,Brazil
5773,6335,6789,1968,Germany,Brazil,2,1,Friendly,Stuttgart,Germany,False,3,1,Germany
5774,6336,6790,1968,Russia,Austria,3,1,Friendly,Leningrad,Soviet Union,False,4,2,Russia
5775,6337,6791,1968,Finland,Belgium,1,2,FIFA World Cup qualification,Helsinki,Finland,False,3,-1,Belgium
5776,6338,6792,1968,Poland,Brazil,3,6,Friendly,Warsaw,Poland,False,9,-3,Brazil
5777,6339,6793,1968,Uruguay,Argentina,2,1,Copa Newton,Montevideo,Uruguay,False,3,1,Uruguay
5778,6340,6795,1968,Denmark,Norway,5,1,Nordic Championship,Copenhagen,Denmark,False,6,4,Denmark
5779,6341,6797,1968,Sweden,Denmark,2,1,Nordic Championship,Solna,Sweden,False,3,1,Sweden
5780,6342,6798,1968,Zambia,Uganda,2,1,Friendly,Lusaka,Zambia,False,3,1,Zambia
5781,6343,6799,1968,Portugal,Brazil,0,2,Friendly,Lourenço Marques,Mozambique,True,2,-2,Brazil
5782,6344,6800,1968,Zambia,Uganda,1,1,Friendly,Mufulira,Zambia,False,2,0,Draw
5783,6345,6801,1968,Zambia,Uganda,2,1,Friendly,Ndola,Zambia,False,3,1,Zambia
5784,6346,6802,1968,Zambia,Uganda,2,2,Friendly,Kitwe,Zambia,False,4,0,Draw
5785,6347,6803,1968,Malawi,Kenya,2,2,Friendly,Blantyre,Malawi,False,4,0,Draw
5786,6348,6804,1968,Mexico,Brazil,0,2,Friendly,Mexico City,Mexico,False,2,-2,Brazil
5787,6349,6805,1968,Mexico,Brazil,2,1,Friendly,Mexico City,Mexico,False,3,1,Mexico
5788,6350,6806,1968,Malawi,Botswana,8,1,Friendly,Blantyre,Malawi,False,9,7,Malawi
5789,6351,6807,1968,Peru,Brazil,3,4,Friendly,Lima,Peru,False,7,-1,Brazil
5790,6352,6808,1968,Honduras,El Salvador,0,0,Friendly,Tegucigalpa,Honduras,False,0,0,Draw
5791,6353,6809,1968,Peru,Brazil,0,4,Friendly,Lima,Peru,False,4,-4,Brazil
5792,6354,6810,1968,Iceland,Norway,0,4,Friendly,Reykjavík,Iceland,False,4,-4,Norway
5793,6355,6811,1968,Eswatini,Malawi,2,0,Friendly,Mbabane,Eswatini,False,2,2,Eswatini
5794,6356,6812,1968,Paraguay,Brazil,0,4,Copa Oswaldo Cruz,Asunción,Paraguay,False,4,-4,Brazil
5795,6357,6813,1968,Paraguay,Brazil,1,0,Copa Oswaldo Cruz,Asunción,Paraguay,False,1,1,Paraguay
5796,6358,6814,1968,El Salvador,Honduras,2,1,Friendly,San Salvador,El Salvador,False,3,1,El Salvador
5797,6359,6815,1968,Sweden,Russia,2,2,Friendly,Gothenburg,Sweden,False,4,0,Draw
5798,6360,6816,1968,Brazil,Argentina,4,1,Friendly,Rio de Janeiro,Brazil,False,5,3,Brazil
5799,6362,6819,1968,Brazil,Argentina,3,2,Friendly,Belo Horizonte,Brazil,False,5,1,Brazil
5800,6363,6820,1968,Hong Kong,Thailand,0,0,Merdeka Tournament,Kuala Lumpur,Malaysia,True,0,0,Draw
5801,6365,6822,1968,Burma,Hong Kong,3,0,Merdeka Tournament,Kuala Lumpur,Malaysia,True,3,3,Burma
5802,6368,6826,1968,Burma,Thailand,0,0,Merdeka Tournament,Ipoh,Malaysia,True,0,0,Draw
5803,6370,6829,1968,El Salvador,Guatemala,1,0,Friendly,San Salvador,El Salvador,False,1,1,El Salvador
5804,6371,6830,1968,Hong Kong,India,1,1,Merdeka Tournament,Ipoh,Malaysia,True,2,0,Draw
5805,6372,6831,1968,Indonesia,Singapore,4,0,Merdeka Tournament,Kuala Lumpur,Malaysia,True,4,4,Indonesia
5806,6374,6833,1968,Burma,India,1,3,Merdeka Tournament,Kuala Lumpur,Malaysia,True,4,-2,India
5807,6377,6836,1968,Malaysia,Burma,1,1,Merdeka Tournament,Kuala Lumpur,Malaysia,False,2,0,Draw
5808,6378,6837,1968,Norway,Finland,4,1,Nordic Championship,Oslo,Norway,False,5,3,Norway
5809,6379,6838,1968,Peru,Chile,1,2,Copa del Pacífico,Lima,Peru,False,3,-1,Chile
5810,6381,6840,1968,India,Thailand,0,1,Merdeka Tournament,Kuala Lumpur,Malaysia,True,1,-1,Thailand
5811,6383,6842,1968,Burma,Indonesia,2,1,Merdeka Tournament,Kuala Lumpur,Malaysia,True,3,1,Burma
5812,6384,6844,1968,Peru,Chile,0,0,Copa del Pacífico,Lima,Peru,False,0,0,Draw
5813,6388,6848,1968,Malaysia,Burma,3,0,Merdeka Tournament,Kuala Lumpur,Malaysia,False,3,3,Malaysia
5814,6391,6851,1968,India,Indonesia,1,3,Friendly,Kallang,Singapore,True,4,-2,Indonesia
5815,6392,6852,1968,Peru,Argentina,2,2,Friendly,Lima,Peru,False,4,0,Draw
5816,6394,6854,1968,Singapore,Indonesia,1,0,Friendly,Kallang,Singapore,False,1,1,Singapore
5817,6395,6855,1968,Peru,Argentina,1,1,Friendly,Lima,Peru,False,2,0,Draw
5818,6396,6856,1968,Suriname,French Guiana,2,1,Friendly,Paramaribo,Suriname,False,3,1,Suriname
5819,6397,6857,1968,Netherlands,Luxembourg,2,0,FIFA World Cup qualification,Rotterdam,Netherlands,False,2,2,Netherlands
5820,6398,6858,1968,Israel,Northern Ireland,2,3,Friendly,Jaffa,Israel,False,5,-1,Northern Ireland
5821,6399,6859,1968,El Salvador,Costa Rica,1,1,Friendly,San Salvador,El Salvador,False,2,0,Draw
5822,6400,6860,1968,Finland,Sweden,0,3,Nordic Championship,Helsinki,Finland,False,3,-3,Sweden
5823,6401,6861,1968,Norway,Sweden,1,1,Nordic Championship,Oslo,Norway,False,2,0,Draw
5824,6402,6862,1968,United States,Israel,3,3,Friendly,New York,United States,False,6,0,Draw
5825,6403,6863,1968,New Zealand,Fiji,5,0,Friendly,Auckland,New Zealand,False,5,5,New Zealand
5826,6404,6864,1968,New Caledonia,Fiji,2,1,Friendly,Nouméa,New Caledonia,False,3,1,New Caledonia
5827,6405,6865,1968,Ghana,Benin,3,0,Friendly,Accra,Ghana,False,3,3,Ghana
5828,6406,6866,1968,Switzerland,Austria,1,0,Friendly,Berne,Switzerland,False,1,1,Switzerland
5829,6408,6868,1968,France,Germany,1,1,Friendly,Marseille,France,False,2,0,Draw
5830,6409,6869,1968,United States,Israel,0,4,Friendly,Philadelphia,United States,False,4,-4,Israel
5831,6410,6871,1968,Tanzania,Uganda,0,2,Friendly,Dar es Salaam,Tanzania,False,2,-2,Uganda
5832,6412,6873,1968,Mexico,Ethiopia,3,0,Friendly,León,Mexico,False,3,3,Mexico
5833,6413,6874,1968,Tanzania,Kenya,3,3,Friendly,Dar es Salaam,Tanzania,False,6,0,Draw
5834,6415,6876,1968,Curaçao,Costa Rica,1,1,Friendly,Willemstad,Netherlands Antilles,False,2,0,Draw
5835,6416,6877,1968,Kenya,Uganda,1,1,Friendly,Dar es Salaam,Tanzania,True,2,0,Draw
5836,6418,6879,1968,Canada,Bermuda,4,0,FIFA World Cup qualification,Toronto,Canada,False,4,4,Canada
5837,6419,6880,1968,Suriname,Martinique,7,0,Friendly,Paramaribo,Suriname,False,7,7,Suriname
5838,6420,6881,1968,New Zealand,New Caledonia,1,3,Friendly,Auckland,New Zealand,False,4,-2,New Caledonia
5839,6421,6882,1968,Suriname,Martinique,0,0,Friendly,Paramaribo,Suriname,False,0,0,Draw
5840,6422,6883,1968,Belgium,Finland,6,1,FIFA World Cup qualification,Waregem,Belgium,False,7,5,Belgium
5841,6423,6884,1968,Sweden,Norway,5,0,FIFA World Cup qualification,Solna,Sweden,False,5,5,Sweden
5842,6424,6885,1968,Turkey,Bulgaria,0,2,Friendly,Istanbul,Turkey,False,2,-2,Bulgaria
5843,6425,6886,1968,Uganda,Zambia,2,3,Friendly,Kampala,Uganda,False,5,-1,Zambia
5844,6426,6887,1968,Switzerland,Greece,1,0,FIFA World Cup qualification,Basel,Switzerland,False,1,1,Switzerland
5845,6427,6888,1968,Uganda,Zambia,1,1,Friendly,Mbale,Uganda,False,2,0,Draw
5846,6428,6889,1968,Austria,Germany,0,2,FIFA World Cup qualification,Vienna,Austria,False,2,-2,Germany
5847,6429,6890,1968,Kenya,Zambia,2,1,Friendly,Nairobi,Kenya,False,3,1,Kenya
5848,6430,6891,1968,Ethiopia,Thailand,6,0,Friendly,León,Mexico,True,6,6,Ethiopia
5849,6432,6893,1968,Colombia,Mexico,0,1,Friendly,Bogotá,Colombia,False,1,-1,Mexico
5850,6433,6894,1968,Denmark,Scotland,0,1,Friendly,Copenhagen,Denmark,False,1,-1,Scotland
5851,6434,6895,1968,France,Spain,1,3,Friendly,Lyon,France,False,4,-2,Spain
5852,6435,6896,1968,Bermuda,Canada,0,0,FIFA World Cup qualification,Hamilton,Bermuda,False,0,0,Draw
5853,6436,6898,1968,Haiti,United States,3,6,Friendly,Port-au-Prince,Haiti,False,9,-3,United States
5854,6437,6899,1968,Peru,Mexico,3,3,Friendly,Lima,Peru,False,6,0,Draw
5855,6439,6901,1968,Haiti,United States,5,2,Friendly,Port-au-Prince,Haiti,False,7,3,Haiti
5856,6440,6902,1968,Zambia,Tanzania,7,1,Friendly,Kitwe,Zambia,False,8,6,Zambia
5857,6441,6903,1968,Chile,Mexico,3,1,Friendly,Santiago,Chile,False,4,2,Chile
5858,6442,6904,1968,Haiti,United States,1,0,Friendly,Port-au-Prince,Haiti,False,1,1,Haiti
5859,6443,6905,1968,Northern Ireland,Turkey,4,1,FIFA World Cup qualification,Belfast,Northern Ireland,False,5,3,Northern Ireland
5860,6444,6906,1968,Wales,Italy,0,1,FIFA World Cup qualification,Cardiff,Wales,False,1,-1,Italy
5861,6445,6907,1968,Zambia,Tanzania,2,1,Friendly,Lusaka,Zambia,False,3,1,Zambia
5862,6446,6908,1968,Uruguay,Mexico,0,2,Friendly,Montevideo,Uruguay,False,2,-2,Mexico
5863,6447,6909,1968,Bulgaria,Netherlands,2,0,FIFA World Cup qualification,Sofia,Bulgaria,False,2,2,Bulgaria
5864,6448,6910,1968,Portugal,Romania,3,0,FIFA World Cup qualification,Oeiras,Portugal,False,3,3,Portugal
5865,6449,6912,1968,Zambia,Sudan,4,2,FIFA World Cup qualification,Ndola,Zambia,False,6,2,Zambia
5866,6450,6913,1968,Nigeria,Thailand,7,2,Friendly,León,Mexico,True,9,5,Nigeria
5867,6451,6914,1968,Poland,Republic of Ireland,1,0,Friendly,Chorzów,Poland,False,1,1,Poland
5868,6452,6915,1968,Brazil,Mexico,1,2,Friendly,Rio de Janeiro,Brazil,False,3,-1,Mexico
5869,6453,6916,1968,Brazil,Mexico,2,1,Friendly,Belo Horizonte,Brazil,False,3,1,Brazil
5870,6454,6917,1968,Morocco,Senegal,1,0,FIFA World Cup qualification,Casablanca,Morocco,False,1,1,Morocco
5871,6455,6918,1968,United States,Bermuda,6,2,FIFA World Cup qualification,Kansas City,United States,False,8,4,United States
5872,6456,6919,1968,France,Norway,0,1,FIFA World Cup qualification,Strasbourg,France,False,1,-1,Norway
5873,6457,6920,1968,Romania,England,0,0,Friendly,Bucharest,Romania,False,0,0,Draw
5874,6458,6921,1968,Scotland,Austria,2,1,FIFA World Cup qualification,Glasgow,Scotland,False,3,1,Scotland
5875,6459,6922,1968,Sudan,Zambia,4,2,FIFA World Cup qualification,Khartoum,Sudan,False,6,2,Sudan
5876,6460,6923,1968,Republic of Ireland,Austria,2,2,Friendly,Dublin,Republic of Ireland,False,4,0,Draw
5877,6461,6924,1968,Bermuda,United States,0,2,FIFA World Cup qualification,Hamilton,Bermuda,False,2,-2,United States
5878,6462,6925,1968,Guadeloupe,Martinique,3,1,Friendly,Basse-Terre,Guadeloupe,False,4,2,Guadeloupe
5879,6463,6926,1968,Costa Rica,El Salvador,3,0,Friendly,San José,Costa Rica,False,3,3,Costa Rica
5880,6464,6927,1968,Guadeloupe,Puerto Rico,2,0,Friendly,Basse-Terre,Guadeloupe,False,2,2,Guadeloupe
5881,6465,6928,1968,Martinique,Puerto Rico,7,0,Friendly,Basse-Terre,Guadeloupe,True,7,7,Martinique
5882,6466,6929,1968,Sierra Leone,Gambia,2,1,Friendly,Freetown,Sierra Leone,False,3,1,Sierra Leone
5883,6467,6930,1968,Algeria,Tunisia,1,2,FIFA World Cup qualification,Algiers,Algeria,False,3,-1,Tunisia
5884,6468,6931,1968,Guatemala,Trinidad and Tobago,4,0,FIFA World Cup qualification,Guatemala,Guatemala,False,4,4,Guatemala
5885,6469,6932,1968,Zambia,Mauritius,2,2,African Cup of Nations qualification,Lusaka,Zambia,False,4,0,Draw
5886,6470,6933,1968,Saint Lucia,Dominica,4,0,Windward Islands Tournament,Castries,Saint Lucia,False,4,4,Saint Lucia
5887,6471,6934,1968,Burma,Laos,3,0,King's Cup,Bangkok,Thailand,True,3,3,Burma
5888,6472,6935,1968,Denmark,Luxembourg,5,1,Friendly,Copenhagen,Denmark,False,6,4,Denmark
5889,6473,6936,1968,Dominica,Grenada,2,6,Windward Islands Tournament,Castries,Saint Lucia,True,8,-4,Grenada
5890,6474,6937,1968,Guatemala,Trinidad and Tobago,0,0,FIFA World Cup qualification,Guatemala,Guatemala,False,0,0,Draw
5891,6475,6938,1968,Thailand,Singapore,3,0,King's Cup,Bangkok,Thailand,False,3,3,Thailand
5892,6476,6939,1968,Indonesia,Malaysia,1,0,King's Cup,Bangkok,Thailand,True,1,1,Indonesia
5893,6477,6940,1968,Burma,Singapore,2,0,King's Cup,Bangkok,Thailand,True,2,2,Burma
5894,6478,6941,1968,Thailand,Laos,1,0,King's Cup,Bangkok,Thailand,False,1,1,Thailand
5895,6479,6942,1968,Cyprus,Germany,0,1,FIFA World Cup qualification,Nicosia,Cyprus,False,1,-1,Germany
5896,6480,6943,1968,Dominica,Saint Vincent and the Grenadines,1,1,Windward Islands Tournament,Castries,Saint Lucia,True,2,0,Draw
5897,6481,6944,1968,Haiti,Trinidad and Tobago,4,0,FIFA World Cup qualification,Port-au-Prince,Haiti,False,4,4,Haiti
5898,6482,6945,1968,Romania,Switzerland,2,0,FIFA World Cup qualification,Bucharest,Romania,False,2,2,Romania
5899,6483,6946,1968,Burma,Indonesia,1,3,King's Cup,Bangkok,Thailand,True,4,-2,Indonesia
5900,6484,6947,1968,DR Congo,Tunisia,1,0,Friendly,Kinshasa,DR Congo,False,1,1,DR Congo
5901,6485,6948,1968,Laos,Malaysia,0,5,King's Cup,Bangkok,Thailand,True,5,-5,Malaysia
5902,6486,6949,1968,Suriname,Curaçao,6,0,FIFA World Cup qualification,Paramaribo,Suriname,False,6,6,Suriname
5903,6487,6950,1968,Haiti,Trinidad and Tobago,2,4,FIFA World Cup qualification,Port-au-Prince,Haiti,False,6,-2,Trinidad and Tobago
5904,6488,6951,1968,Indonesia,Singapore,7,0,King's Cup,Bangkok,Thailand,True,7,7,Indonesia
5905,6489,6952,1968,Argentina,Chile,4,0,Copa Carlos Dittborn,Rosario,Argentina,False,4,4,Argentina
5906,6490,6953,1968,Costa Rica,Jamaica,3,0,FIFA World Cup qualification,San José,Costa Rica,False,3,3,Costa Rica
5907,6491,6954,1968,Indonesia,Malaysia,6,1,King's Cup,Bangkok,Thailand,True,7,5,Indonesia
5908,6492,6955,1968,Thailand,Burma,1,2,King's Cup,Bangkok,Thailand,False,3,-1,Burma
5909,6493,6956,1968,Cameroon,Tunisia,4,2,Friendly,Douala,Cameroon,False,6,2,Cameroon
5910,6494,6957,1968,Costa Rica,Jamaica,3,1,FIFA World Cup qualification,San José,Costa Rica,False,4,2,Costa Rica
5911,6495,6958,1968,El Salvador,Suriname,6,0,FIFA World Cup qualification,San Salvador,El Salvador,False,6,6,El Salvador
5912,6496,6959,1968,Ghana,Senegal,2,0,Friendly,Accra,Ghana,False,2,2,Ghana
5913,6497,6960,1968,Thailand,Malaysia,6,0,King's Cup,Bangkok,Thailand,False,6,6,Thailand
5914,6498,6961,1968,Burma,Indonesia,0,1,King's Cup,Bangkok,Thailand,True,1,-1,Indonesia
5915,6499,6962,1968,Chile,Argentina,2,1,Copa Carlos Dittborn,Santiago,Chile,False,3,1,Chile
5916,6500,6963,1968,Republic of Ireland,Denmark,1,1,Friendly,Dublin,Republic of Ireland,False,2,0,Draw
5917,6501,6964,1968,Curaçao,Suriname,2,0,FIFA World Cup qualification,Oranjestad,Netherlands Antilles,True,2,2,Curaçao
5918,6502,6965,1968,Honduras,Jamaica,3,1,FIFA World Cup qualification,Tegucigalpa,Honduras,False,4,2,Honduras
5919,6503,6966,1968,Nigeria,Cameroon,1,1,FIFA World Cup qualification,Lagos,Nigeria,False,2,0,Draw
5920,6504,6967,1968,Haiti,Guatemala,2,0,FIFA World Cup qualification,Port-au-Prince,Haiti,False,2,2,Haiti
5921,6505,6968,1968,Honduras,Jamaica,2,0,FIFA World Cup qualification,Tegucigalpa,Honduras,False,2,2,Honduras
5922,6506,6969,1968,Mauritius,Zambia,2,3,African Cup of Nations qualification,Curepipe,Mauritius,False,5,-1,Zambia
5923,6508,6971,1968,Cyprus,Scotland,0,5,FIFA World Cup qualification,Nicosia,Cyprus,False,5,-5,Scotland
5924,6509,6972,1968,England,Bulgaria,1,1,Friendly,London,England,False,2,0,Draw
5925,6510,6973,1968,Greece,Portugal,4,2,FIFA World Cup qualification,Piraeus,Greece,False,6,2,Greece
5926,6511,6974,1968,Spain,Belgium,1,1,FIFA World Cup qualification,Madrid,Spain,False,2,0,Draw
5927,6512,6975,1968,Turkey,Northern Ireland,0,3,FIFA World Cup qualification,Istanbul,Turkey,False,3,-3,Northern Ireland
5928,6513,6976,1968,El Salvador,Curaçao,1,0,FIFA World Cup qualification,San Salvador,El Salvador,False,1,1,El Salvador
5929,6514,6977,1968,Kenya,Sudan,1,1,Friendly,Nairobi,Kenya,False,2,0,Draw
5930,6515,6978,1968,Brazil,Germany,2,2,Friendly,Rio de Janeiro,Brazil,False,4,0,Draw
5931,6516,6979,1968,Sierra Leone,Guinea,1,1,Friendly,Freetown,Sierra Leone,False,2,0,Draw
5932,6517,6980,1968,El Salvador,Curaçao,2,1,FIFA World Cup qualification,San Salvador,El Salvador,False,3,1,El Salvador
5933,6519,6982,1968,Argentina,Poland,1,0,Friendly,Mar del Plata,Argentina,False,1,1,Argentina
5934,6521,6984,1968,Chile,Germany,2,1,Friendly,Santiago,Chile,False,3,1,Chile
5935,6524,6987,1968,Cameroon,Nigeria,2,3,FIFA World Cup qualification,Douala,Cameroon,False,5,-1,Nigeria
5936,6525,6988,1968,Honduras,Costa Rica,1,0,FIFA World Cup qualification,Tegucigalpa,Honduras,False,1,1,Honduras
5937,6526,6989,1968,Mexico,Germany,0,0,Friendly,Mexico City,Mexico,False,0,0,Draw
5938,6527,6990,1968,Suriname,El Salvador,4,1,FIFA World Cup qualification,Paramaribo,Suriname,False,5,3,Suriname
5939,6528,6991,1968,Costa Rica,Honduras,1,1,FIFA World Cup qualification,San José,Costa Rica,False,2,0,Draw
5940,6529,6992,1968,Tunisia,Algeria,0,0,FIFA World Cup qualification,Tunis,Tunisia,False,0,0,Draw
5941,6530,6993,1969,Mexico,Italy,2,3,Friendly,Mexico City,Mexico,False,5,-1,Italy
5942,6531,6994,1969,Ethiopia,Somalia,7,0,Friendly,Addis Abeba,Ethiopia,False,7,7,Ethiopia
5943,6532,6995,1969,Mexico,Italy,1,1,Friendly,Mexico City,Mexico,False,2,0,Draw
5944,6533,6996,1969,Senegal,Morocco,2,1,FIFA World Cup qualification,Dakar,Senegal,False,3,1,Senegal
5945,6534,6997,1969,Kenya,Tanzania,2,1,Friendly,Addis Abeba,Ethiopia,True,3,1,Kenya
5946,6535,6998,1969,Somalia,Uganda,1,7,Friendly,Addis Abeba,Ethiopia,True,8,-6,Uganda
5947,6536,6999,1969,Kenya,Sudan,0,1,Friendly,Addis Abeba,Ethiopia,True,1,-1,Sudan
5948,6537,7000,1969,Sudan,Tanzania,3,0,Friendly,Addis Abeba,Ethiopia,True,3,3,Sudan
5949,6538,7001,1969,Ethiopia,Uganda,4,0,Friendly,Addis Abeba,Ethiopia,False,4,4,Ethiopia
5950,6539,7002,1969,Bermuda,Denmark,1,5,Friendly,Hamilton,Bermuda,False,6,-4,Denmark
5951,6540,7003,1969,Ethiopia,Sudan,0,1,Friendly,Addis Abeba,Ethiopia,False,1,-1,Sudan
5952,6541,7004,1969,England,Romania,1,1,Friendly,London,England,False,2,0,Draw
5953,6542,7005,1969,Suriname,Denmark,2,1,Friendly,Paramaribo,Suriname,False,3,1,Suriname
5954,6543,7006,1969,Saudi Arabia,Turkey,1,2,Friendly,Riyadh,Saudi Arabia,False,3,-1,Turkey
5955,6544,7007,1969,Benin,Niger,1,1,Friendly,Cotonou,Dahomey,False,2,0,Draw
5956,6545,7008,1969,Congo,Senegal,1,0,Friendly,Brazzaville,Congo,False,1,1,Congo
5957,6546,7009,1969,Mexico,Denmark,3,0,Friendly,Mexico City,Mexico,False,3,3,Mexico
5958,6547,7010,1969,Senegal,Cameroon,3,2,Friendly,Dakar,Senegal,False,5,1,Senegal
5959,6548,7011,1969,DR Congo,Senegal,4,0,Friendly,Kinshasa,DR Congo,False,4,4,DR Congo
5960,6549,7012,1969,Libya,Ethiopia,2,0,FIFA World Cup qualification,Tripoli,Libya,False,2,2,Libya
5961,6550,7013,1969,DR Congo,Cameroon,2,1,Friendly,Kinshasa,DR Congo,False,3,1,DR Congo
5962,6551,7014,1969,Malawi,Zimbabwe,2,2,Friendly,Zomba,Malawi,False,4,0,Draw
5963,6552,7015,1969,Guinea,Sierra Leone,1,1,Friendly,Conakry,Guinea,False,2,0,Draw
5964,6553,7016,1969,Uganda,Cameroon,2,1,African Cup of Nations qualification,Kampala,Uganda,False,3,1,Uganda
5965,6554,7017,1969,Mexico,Colombia,1,0,Friendly,León,Mexico,False,1,1,Mexico
5966,6555,7018,1969,Haiti,Jamaica,1,2,Friendly,Port-au-Prince,Haiti,False,3,-1,Jamaica
5967,6556,7019,1969,Haiti,Jamaica,3,0,Friendly,Port-au-Prince,Haiti,False,3,3,Haiti
5968,6557,7020,1969,Zimbabwe,Malawi,4,0,Friendly,Salisbury,Rhodesia,False,4,4,Zimbabwe
5969,6558,7021,1969,Ethiopia,Libya,5,1,FIFA World Cup qualification,Addis Abeba,Ethiopia,False,6,4,Ethiopia
5970,6559,7022,1969,Morocco,Hungary,1,4,Friendly,Casablanca,Morocco,False,5,-3,Hungary
5971,6560,7023,1969,Zimbabwe,Malawi,1,1,Friendly,Salisbury,Rhodesia,False,2,0,Draw
5972,6561,7024,1969,France,Hungary,2,2,Friendly,Lyon,France,False,4,0,Draw
5973,6562,7025,1969,Morocco,Senegal,2,0,FIFA World Cup qualification,Las Palmas,Spain,True,2,2,Morocco
5974,6563,7026,1969,Kenya,Tanzania,0,1,African Cup of Nations qualification,Nairobi,Kenya,False,1,-1,Tanzania
5975,6564,7027,1969,Colombia,Russia,1,3,Friendly,Bogotá,Colombia,False,4,-2,Russia
5976,6565,7028,1969,Belgium,Spain,2,1,FIFA World Cup qualification,Liège,Belgium,False,3,1,Belgium
5977,6566,7029,1969,Guatemala,Haiti,1,1,FIFA World Cup qualification,Guatemala,Guatemala,False,2,0,Draw
5978,6567,7031,1969,Tanzania,Kenya,1,1,African Cup of Nations qualification,Dar es Salaam,Tanzania,False,2,0,Draw
5979,6568,7032,1969,Iran,Iraq,2,1,Friendly,Teheran,Iran,False,3,1,Iran
5980,6569,7033,1969,Algeria,Morocco,2,0,African Cup of Nations qualification,Algiers,Algeria,False,2,2,Algeria
5981,6570,7034,1969,Iraq,Pakistan,1,2,Friendly,Teheran,Iran,True,3,-1,Pakistan
5982,6571,7035,1969,England,France,5,0,Friendly,London,England,False,5,5,England
5983,6572,7036,1969,Iran,Pakistan,9,1,Friendly,Teheran,Iran,False,10,8,Iran
5984,6573,7037,1969,Israel,Greece,3,3,Friendly,Jaffa,Israel,False,6,0,Draw
5985,6574,7038,1969,Argentina,Paraguay,1,1,Friendly,Rosario,Argentina,False,2,0,Draw
5986,6575,7039,1969,Greece,Cyprus,1,0,Friendly,Athens,Greece,False,1,1,Greece
5987,6576,7040,1969,Germany,Wales,1,1,Friendly,Frankfurt am Main,Germany,False,2,0,Draw
5988,6577,7041,1969,Netherlands,Luxembourg,4,0,FIFA World Cup qualification,Rotterdam,Netherlands,False,4,4,Netherlands
5989,6578,7042,1969,Spain,Switzerland,1,0,Friendly,Valencia,Spain,False,1,1,Spain
5990,6579,7044,1969,Portugal,Mexico,0,0,Friendly,Oeiras,Portugal,False,0,0,Draw
5991,6580,7045,1969,Brazil,Peru,2,1,Friendly,Porto Alegre,Brazil,False,3,1,Brazil
5992,6581,7046,1969,Brazil,Peru,3,2,Friendly,Rio de Janeiro,Brazil,False,5,1,Brazil
5993,6582,7047,1969,Paraguay,Argentina,0,0,Friendly,Asunción,Paraguay,False,0,0,Draw
5994,6583,7048,1969,Luxembourg,Mexico,2,1,Friendly,Luxembourg,Luxembourg,False,3,1,Luxembourg
5995,6584,7049,1969,Belgium,Mexico,2,0,Friendly,Brussels,Belgium,False,2,2,Belgium
5996,6585,7051,1969,Greece,Romania,2,2,FIFA World Cup qualification,Piraeus,Greece,False,4,0,Draw
5997,6587,7053,1969,Portugal,Switzerland,0,2,FIFA World Cup qualification,Lisbon,Portugal,False,2,-2,Switzerland
5998,6588,7054,1969,Scotland,Germany,1,1,FIFA World Cup qualification,Glasgow,Scotland,False,2,0,Draw
5999,6589,7055,1969,Cyprus,Austria,1,2,FIFA World Cup qualification,Nicosia,Cyprus,False,3,-1,Austria
6000,6590,7056,1969,Haiti,United States,2,0,FIFA World Cup qualification,Port-au-Prince,Haiti,False,2,2,Haiti
6001,6591,7057,1969,Poland,Luxembourg,8,1,FIFA World Cup qualification,Cracow,Poland,False,9,7,Poland
6002,6592,7058,1969,Bulgaria,Luxembourg,2,1,FIFA World Cup qualification,Sofia,Bulgaria,False,3,1,Bulgaria
6003,6593,7059,1969,Israel,Austria,1,1,Friendly,Ramat-Gan,Israel,False,2,0,Draw
6004,6594,7060,1969,Spain,Mexico,0,0,Friendly,Seville,Spain,False,0,0,Draw
6005,6595,7061,1969,French Guiana,Suriname,1,2,Friendly,Cayenne,French Guiana,False,3,-1,Suriname
6006,6596,7062,1969,Malta,Austria,1,3,Friendly,Gżira,Malta,False,4,-2,Austria
6007,6597,7063,1969,Tunisia,Morocco,0,0,FIFA World Cup qualification,Tunis,Tunisia,False,0,0,Draw
6008,6598,7064,1969,France,Romania,1,0,Friendly,Paris,France,False,1,1,France
6009,6600,7066,1969,Turkey,Poland,1,3,Friendly,Ankara,Turkey,False,4,-2,Poland
6010,6601,7067,1969,Sweden,Mexico,1,0,Friendly,Malmö,Sweden,False,1,1,Sweden
6011,6602,7068,1969,Northern Ireland,England,1,3,British Championship,Belfast,Northern Ireland,False,4,-2,England
6012,6603,7069,1969,Wales,Scotland,3,5,British Championship,Wrexham,Wales,False,8,-2,Scotland
6013,6604,7070,1969,Ethiopia,Sudan,1,1,FIFA World Cup qualification,Addis Abeba,Ethiopia,False,2,0,Draw
6014,6606,7072,1969,Portugal,Greece,2,2,FIFA World Cup qualification,Porto,Portugal,False,4,0,Draw
6015,6607,7073,1969,Denmark,Mexico,3,1,Friendly,Copenhagen,Denmark,False,4,2,Denmark
6016,6608,7074,1969,Scotland,Northern Ireland,1,1,British Championship,Glasgow,Scotland,False,2,0,Draw
6017,6609,7075,1969,Togo,Guinea,1,1,African Cup of Nations qualification,Lomé,Togo,False,2,0,Draw
6018,6610,7076,1969,England,Wales,2,1,British Championship,London,England,False,3,1,England
6019,6611,7077,1969,Netherlands,Poland,1,0,FIFA World Cup qualification,Rotterdam,Netherlands,False,1,1,Netherlands
6020,6612,7078,1969,Colombia,Peru,1,3,Friendly,Bogotá,Colombia,False,4,-2,Peru
6021,6613,7079,1969,Norway,Mexico,0,2,Friendly,Oslo,Norway,False,2,-2,Mexico
6022,6614,7080,1969,England,Scotland,4,1,British Championship,London,England,False,5,3,England
6023,6615,7081,1969,Germany,Austria,1,0,FIFA World Cup qualification,Nuremberg,Germany,False,1,1,Germany
6024,6616,7082,1969,Nigeria,Ghana,2,1,FIFA World Cup qualification,Ibadan,Nigeria,False,3,1,Nigeria
6025,6617,7083,1969,Northern Ireland,Wales,0,0,British Championship,Belfast,Northern Ireland,False,0,0,Draw
6026,6618,7084,1969,Sudan,Ethiopia,3,1,FIFA World Cup qualification,Khartoum,Sudan,False,4,2,Sudan
6027,6619,7085,1969,United States,Haiti,0,1,FIFA World Cup qualification,San Diego,United States,False,1,-1,Haiti
6028,6620,7086,1969,El Salvador,Peru,1,4,Friendly,San Salvador,El Salvador,False,5,-3,Peru
6029,6621,7087,1969,Switzerland,Romania,0,1,FIFA World Cup qualification,Lausanne,Switzerland,False,1,-1,Romania
6030,6622,7088,1969,Scotland,Cyprus,8,0,FIFA World Cup qualification,Glasgow,Scotland,False,8,8,Scotland
6031,6623,7089,1969,Ghana,Nigeria,1,1,FIFA World Cup qualification,Accra,Ghana,False,2,0,Draw
6032,6624,7090,1969,Morocco,Tunisia,0,0,FIFA World Cup qualification,Casablanca,Morocco,False,0,0,Draw
6033,6625,7091,1969,Mexico,Peru,0,1,Friendly,Mexico City,Mexico,False,1,-1,Peru
6034,6626,7092,1969,Germany,Cyprus,12,0,FIFA World Cup qualification,Essen,Germany,False,12,12,Germany
6035,6627,7093,1969,Guinea,Gambia,6,2,Friendly,Conakry,Guinea,False,8,4,Guinea
6036,6628,7094,1969,Mexico,Peru,3,0,Friendly,León,Mexico,False,3,3,Mexico
6037,6629,7095,1969,Sweden,Finland,4,0,Nordic Championship,Växjö,Sweden,False,4,4,Sweden
6038,6630,7096,1969,Italy,Bulgaria,0,0,Friendly,Turin,Italy,False,0,0,Draw
6039,6632,7098,1969,Denmark,Republic of Ireland,2,0,FIFA World Cup qualification,Copenhagen,Denmark,False,2,2,Denmark
6040,6633,7099,1969,Chile,Argentina,1,1,Friendly,Santiago,Chile,False,2,0,Draw
6041,6634,7100,1969,Mexico,England,0,0,Friendly,Mexico City,Mexico,False,0,0,Draw
6042,6635,7101,1969,Sweden,Norway,4,2,Nordic Championship,Gothenburg,Sweden,False,6,2,Sweden
6043,6636,7102,1969,Mexico,England,0,4,Friendly,Guadalajara,Mexico,False,4,-4,England
6044,6638,7104,1969,Honduras,El Salvador,1,0,FIFA World Cup qualification,Tegucigalpa,Honduras,False,1,1,Honduras
6045,6639,7105,1969,Republic of Ireland,Hungary,1,2,FIFA World Cup qualification,Dublin,Republic of Ireland,False,3,-1,Hungary
6046,6640,7106,1969,Paraguay,Chile,0,1,Friendly,Asunción,Paraguay,False,1,-1,Chile
6047,6641,7107,1969,Uruguay,England,1,2,Friendly,Montevideo,Uruguay,False,3,-1,England
6048,6642,7108,1969,Argentina,Chile,2,1,Friendly,La Plata,Argentina,False,3,1,Argentina
6049,6643,7109,1969,Brazil,England,2,1,Friendly,Rio de Janeiro,Brazil,False,3,1,Brazil
6050,6644,7110,1969,Tunisia,Morocco,2,2,FIFA World Cup qualification,Marseille,France,True,4,0,Draw
6051,6645,7111,1969,Bulgaria,Poland,4,1,FIFA World Cup qualification,Sofia,Bulgaria,False,5,3,Bulgaria
6052,6646,7112,1969,Colombia,Chile,3,3,Friendly,Bogotá,Colombia,False,6,0,Draw
6053,6647,7113,1969,Denmark,Hungary,3,2,FIFA World Cup qualification,Copenhagen,Denmark,False,5,1,Denmark
6054,6648,7114,1969,El Salvador,Honduras,3,0,FIFA World Cup qualification,San Salvador,El Salvador,False,3,3,El Salvador
6055,6649,7115,1969,Peru,Colombia,1,1,Friendly,Lima,Peru,False,2,0,Draw
6056,6650,7116,1969,Norway,Sweden,2,5,FIFA World Cup qualification,Oslo,Norway,False,7,-3,Sweden
6057,6651,7117,1969,Ecuador,Colombia,4,1,Friendly,Guayaquil,Ecuador,False,5,3,Ecuador
6058,6652,7119,1969,Iceland,Bermuda,2,1,Friendly,Reykjavík,Iceland,False,3,1,Iceland
6059,6653,7120,1969,Denmark,Sweden,0,1,Nordic Championship,Copenhagen,Denmark,False,1,-1,Sweden
6060,6654,7121,1969,Finland,Spain,2,0,FIFA World Cup qualification,Helsinki,Finland,False,2,2,Finland
6061,6655,7123,1969,Honduras,El Salvador,2,3,FIFA World Cup qualification,Mexico City,Mexico,True,5,-1,El Salvador
6062,6656,7124,1969,Peru,Uruguay,1,0,Friendly,Lima,Peru,False,1,1,Peru
6063,6657,7125,1969,Denmark,Bermuda,6,0,Friendly,Aalborg,Denmark,False,6,6,Denmark
6064,6658,7126,1969,Madagascar,Malawi,3,0,Friendly,Antananarivo,Madagascar,False,3,3,Madagascar
6065,6659,7127,1969,Colombia,Uruguay,0,1,Friendly,Cali,Colombia,False,1,-1,Uruguay
6066,6660,7128,1969,Norway,Bermuda,3,0,Friendly,Stavanger,Norway,False,3,3,Norway
6067,6661,7129,1969,Chile,Paraguay,0,0,Friendly,Santiago,Chile,False,0,0,Draw
6068,6662,7130,1969,Ecuador,Uruguay,0,2,FIFA World Cup qualification,Guayaquil,Ecuador,False,2,-2,Uruguay
6069,6663,7131,1969,Malawi,Eswatini,3,0,Friendly,Blantyre,Malawi,False,3,3,Malawi
6070,6664,7133,1969,Peru,Paraguay,2,1,Friendly,Lima,Peru,False,3,1,Peru
6071,6665,7134,1969,Chile,Uruguay,0,0,FIFA World Cup qualification,Santiago,Chile,False,0,0,Draw
6072,6666,7135,1969,Peru,Paraguay,2,1,Friendly,Lima,Peru,False,3,1,Peru
6073,6667,7136,1969,Uruguay,Ecuador,1,0,FIFA World Cup qualification,Montevideo,Uruguay,False,1,1,Uruguay
6074,6668,7137,1969,Congo,Tunisia,4,1,Friendly,Brazzaville,Congo,False,5,3,Congo
6075,6669,7138,1969,Norway,Iceland,2,1,Friendly,Trondheim,Norway,False,3,1,Norway
6076,6670,7139,1969,Australia,Greece,2,2,Friendly,Brisbane,Australia,False,4,0,Draw
6077,6671,7140,1969,Finland,Iceland,3,1,Friendly,Helsinki,Finland,False,4,2,Finland
6078,6672,7142,1969,New Caledonia,New Zealand,0,0,Friendly,Nouméa,New Caledonia,False,0,0,Draw
6079,6673,7143,1969,Bolivia,Argentina,3,1,FIFA World Cup qualification,La Paz,Bolivia,False,4,2,Bolivia
6080,6674,7144,1969,Chile,Ecuador,4,1,FIFA World Cup qualification,Santiago,Chile,False,5,3,Chile
6081,6675,7145,1969,Colombia,Venezuela,3,0,FIFA World Cup qualification,Bogotá,Colombia,False,3,3,Colombia
6082,6676,7146,1969,New Caledonia,New Zealand,2,0,Friendly,Nouméa,New Caledonia,False,2,2,New Caledonia
6083,6677,7147,1969,New Caledonia,New Zealand,3,2,Friendly,Nouméa,New Caledonia,False,5,1,New Caledonia
6084,6678,7148,1969,Venezuela,Colombia,1,1,FIFA World Cup qualification,Caracas,Venezuela,False,2,0,Draw
6085,6679,7149,1969,Ecuador,Chile,1,1,FIFA World Cup qualification,Guayaquil,Ecuador,False,2,0,Draw
6086,6680,7150,1969,Peru,Argentina,1,0,FIFA World Cup qualification,Lima,Peru,False,1,1,Peru
6087,6681,7151,1969,Colombia,Brazil,0,2,FIFA World Cup qualification,Bogotá,Colombia,False,2,-2,Brazil
6088,6682,7152,1969,Russia,Sweden,0,1,Friendly,Moscow,Soviet Union,False,1,-1,Sweden
6089,6683,7153,1969,Venezuela,Paraguay,0,2,FIFA World Cup qualification,Caracas,Venezuela,False,2,-2,Paraguay
6090,6684,7154,1969,Bolivia,Peru,2,1,FIFA World Cup qualification,La Paz,Bolivia,False,3,1,Bolivia
6091,6685,7155,1969,Colombia,Paraguay,0,1,FIFA World Cup qualification,Bogotá,Colombia,False,1,-1,Paraguay
6092,6686,7156,1969,Uruguay,Chile,2,0,FIFA World Cup qualification,Montevideo,Uruguay,False,2,2,Uruguay
6093,6687,7157,1969,Venezuela,Brazil,0,5,FIFA World Cup qualification,Caracas,Venezuela,False,5,-5,Brazil
6094,6688,7158,1969,Fiji,Solomon Islands,5,1,South Pacific Games,Port Moresby,Papua New Guinea,True,6,4,Fiji
6095,6689,7160,1969,Papua New Guinea,New Caledonia,1,4,South Pacific Games,Port Moresby,Papua New Guinea,False,5,-3,New Caledonia
6096,6690,7161,1969,Congo,Ivory Coast,1,1,Friendly,Brazzaville,Congo,False,2,0,Draw
6097,6691,7162,1969,New Caledonia,Solomon Islands,1,1,South Pacific Games,Port Moresby,Papua New Guinea,True,2,0,Draw
6098,6693,7164,1969,Fiji,Vanuatu,5,2,South Pacific Games,Port Moresby,Papua New Guinea,True,7,3,Fiji
6099,6695,7166,1969,Papua New Guinea,Solomon Islands,4,0,South Pacific Games,Port Moresby,Papua New Guinea,False,4,4,Papua New Guinea
6100,6696,7167,1969,New Caledonia,Vanuatu,2,0,South Pacific Games,Port Moresby,Papua New Guinea,True,2,2,New Caledonia
6101,6697,7168,1969,Ghana,Niger,6,0,African Cup of Nations qualification,Accra,Ghana,False,6,6,Ghana
6102,6698,7169,1969,Paraguay,Brazil,0,3,FIFA World Cup qualification,Asunción,Paraguay,False,3,-3,Brazil
6103,6699,7170,1969,Peru,Bolivia,3,0,FIFA World Cup qualification,Lima,Peru,False,3,3,Peru
6104,6700,7171,1969,Fiji,New Caledonia,0,11,South Pacific Games,Port Moresby,Papua New Guinea,True,11,-11,New Caledonia
6105,6702,7173,1969,Papua New Guinea,Vanuatu,2,1,South Pacific Games,Port Moresby,Papua New Guinea,False,3,1,Papua New Guinea
6106,6703,7174,1969,Vanuatu,Solomon Islands,7,2,South Pacific Games,Port Moresby,Papua New Guinea,True,9,5,Vanuatu
6107,6704,7175,1969,Papua New Guinea,Fiji,1,1,South Pacific Games,Port Moresby,Papua New Guinea,False,2,0,Draw
6108,6705,7176,1969,Brazil,Colombia,6,2,FIFA World Cup qualification,Rio de Janeiro,Brazil,False,8,4,Brazil
6109,6706,7177,1969,Paraguay,Venezuela,1,0,FIFA World Cup qualification,Asunción,Paraguay,False,1,1,Paraguay
6110,6708,7179,1969,Papua New Guinea,Fiji,2,1,South Pacific Games,Port Moresby,Papua New Guinea,False,3,1,Papua New Guinea
6111,6709,7180,1969,Argentina,Bolivia,1,0,FIFA World Cup qualification,Buenos Aires,Argentina,False,1,1,Argentina
6112,6710,7181,1969,Benin,Gabon,1,0,Friendly,Cotonou,Dahomey,False,1,1,Benin
6113,6711,7182,1969,Brazil,Venezuela,6,0,FIFA World Cup qualification,Rio de Janeiro,Brazil,False,6,6,Brazil
6114,6712,7183,1969,Finland,Norway,2,2,Nordic Championship,Helsinki,Finland,False,4,0,Draw
6115,6713,7184,1969,Paraguay,Colombia,2,1,FIFA World Cup qualification,Asunción,Paraguay,False,3,1,Paraguay
6116,6714,7185,1969,Sweden,Israel,3,1,Friendly,Solna,Sweden,False,4,2,Sweden
6117,6715,7186,1969,Poland,Norway,6,1,Friendly,Łódź,Poland,False,7,5,Poland
6118,6716,7187,1969,Zambia,Malawi,4,0,Friendly,Lusaka,Zambia,False,4,4,Zambia
6119,6717,7188,1969,Argentina,Peru,2,2,FIFA World Cup qualification,Buenos Aires,Argentina,False,4,0,Draw
6120,6718,7189,1969,Brazil,Paraguay,1,0,FIFA World Cup qualification,Rio de Janeiro,Brazil,False,1,1,Brazil
6121,6719,7190,1969,Zambia,Malawi,5,0,Friendly,Ndola,Zambia,False,5,5,Zambia
6122,6720,7191,1969,Zambia,Malawi,7,0,Friendly,Kitwe,Zambia,False,7,7,Zambia
6123,6721,7193,1969,Poland,Netherlands,2,1,FIFA World Cup qualification,Chorzów,Poland,False,3,1,Poland
6124,6722,7194,1969,Denmark,Finland,5,2,Nordic Championship,Copenhagen,Denmark,False,7,3,Denmark
6125,6723,7195,1969,Northern Ireland,Russia,0,0,FIFA World Cup qualification,Belfast,Northern Ireland,False,0,0,Draw
6126,6724,7196,1969,Norway,France,1,3,FIFA World Cup qualification,Oslo,Norway,False,4,-2,France
6127,6725,7197,1969,Turkey,Pakistan,4,2,Friendly,Ankara,Turkey,False,6,2,Turkey
6128,6726,7198,1969,Iran,Pakistan,4,2,Friendly,Ankara,Turkey,True,6,2,Iran
6129,6727,7199,1969,Nigeria,Sudan,2,2,FIFA World Cup qualification,Ibadan,Nigeria,False,4,0,Draw
6130,6728,7201,1969,El Salvador,Costa Rica,2,1,Friendly,San Salvador,El Salvador,False,3,1,El Salvador
6131,6729,7202,1969,Singapore,New Zealand,0,2,Friendly,Kallang,Singapore,False,2,-2,New Zealand
6132,6730,7203,1969,Turkey,Iran,4,0,Friendly,Ankara,Turkey,False,4,4,Turkey
6133,6731,7204,1969,Egypt,Algeria,1,0,African Cup of Nations qualification,Cairo,Egypt,False,1,1,Egypt
6134,6732,7205,1969,Austria,Germany,1,1,Friendly,Vienna,Austria,False,2,0,Draw
6135,6733,7206,1969,Haiti,El Salvador,1,2,FIFA World Cup qualification,Port-au-Prince,Haiti,False,3,-1,El Salvador
6136,6734,7207,1969,Republic of Ireland,Scotland,1,1,Friendly,Dublin,Republic of Ireland,False,2,0,Draw
6137,6735,7208,1969,Morocco,Nigeria,2,1,FIFA World Cup qualification,Casablanca,Morocco,False,3,1,Morocco
6138,6736,7209,1969,Niger,Ghana,1,9,African Cup of Nations qualification,Niamey,Niger,False,10,-8,Ghana
6139,6737,7210,1969,Norway,Denmark,2,0,Nordic Championship,Oslo,Norway,False,2,2,Norway
6140,6738,7211,1969,Bulgaria,Germany,0,1,Friendly,Sofia,Bulgaria,False,1,-1,Germany
6141,6739,7212,1969,Sweden,Hungary,2,0,Friendly,Solna,Sweden,False,2,2,Sweden
6142,6740,7213,1969,Turkey,Switzerland,3,0,Friendly,Istanbul,Turkey,False,3,3,Turkey
6143,6741,7215,1969,Uganda,Tanzania,3,0,Friendly,Kampala,Uganda,False,3,3,Uganda
6144,6742,7216,1969,Algeria,Egypt,1,1,African Cup of Nations qualification,Algiers,Algeria,False,2,0,Draw
6145,6743,7217,1969,El Salvador,Haiti,0,3,FIFA World Cup qualification,San Salvador,El Salvador,False,3,-3,Haiti
6146,6744,7218,1969,Israel,New Zealand,4,0,FIFA World Cup qualification,Ramat-Gan,Israel,False,4,4,Israel
6147,6747,7221,1969,Israel,New Zealand,2,0,FIFA World Cup qualification,Ramat-Gan,Israel,False,2,2,Israel
6148,6748,7222,1969,Kenya,Tanzania,0,3,Friendly,Kampala,Uganda,True,3,-3,Tanzania
6149,6749,7223,1969,Sudan,Nigeria,3,3,FIFA World Cup qualification,Khartoum,Sudan,False,6,0,Draw
6150,6751,7225,1969,Uganda,Kenya,1,0,Friendly,Kampala,Uganda,False,1,1,Uganda
6151,6752,7226,1969,Suriname,French Guiana,1,1,Friendly,Paramaribo,Suriname,False,2,0,Draw
6152,6753,7228,1969,Haiti,El Salvador,0,1,FIFA World Cup qualification,Kingston,Jamaica,True,1,-1,El Salvador
6153,6754,7229,1969,Uganda,Ethiopia,4,0,Friendly,Kampala,Uganda,False,4,4,Uganda
6154,6755,7230,1969,Japan,Australia,1,3,FIFA World Cup qualification,Seoul,South Korea,True,4,-2,Australia
6155,6756,7231,1969,Sudan,Morocco,0,0,FIFA World Cup qualification,Khartoum,Sudan,False,0,0,Draw
6156,6757,7233,1969,Luxembourg,Poland,1,5,FIFA World Cup qualification,Luxembourg,Luxembourg,False,6,-4,Poland
6157,6758,7234,1969,Mali,Ivory Coast,0,0,African Cup of Nations qualification,Bamako,Mali,False,0,0,Draw
6158,6759,7235,1969,Romania,Portugal,1,0,FIFA World Cup qualification,Bucharest,Romania,False,1,1,Romania
6159,6760,7236,1969,Dominica,Suriname,1,3,Friendly,Roseau,Dominica,False,4,-2,Suriname
6160,6761,7238,1969,Greece,Switzerland,4,1,FIFA World Cup qualification,Salonica,Greece,False,5,3,Greece
6161,6762,7239,1969,Republic of Ireland,Denmark,1,1,FIFA World Cup qualification,Dublin,Republic of Ireland,False,2,0,Draw
6162,6763,7240,1969,Russia,Turkey,3,0,FIFA World Cup qualification,Kyïv,Soviet Union,True,3,3,Russia
6163,6764,7241,1969,Spain,Finland,6,0,FIFA World Cup qualification,La Línea de la Concepción,Spain,False,6,6,Spain
6164,6765,7242,1969,Sweden,France,2,0,FIFA World Cup qualification,Solna,Sweden,False,2,2,Sweden
6165,6766,7243,1969,Tunisia,Palestine,1,1,Friendly,Tunis,Tunisia,False,2,0,Draw
6166,6767,7244,1969,Australia,Japan,1,1,FIFA World Cup qualification,Seoul,South Korea,True,2,0,Draw
6167,6768,7245,1969,Dominica,Suriname,1,9,Friendly,Roseau,Dominica,False,10,-8,Suriname
6168,6769,7249,1969,Germany,Scotland,3,2,FIFA World Cup qualification,Hamburg,Germany,False,5,1,Germany
6169,6770,7250,1969,Hungary,Denmark,3,0,FIFA World Cup qualification,Budapest,Hungary,False,3,3,Hungary
6170,6771,7251,1969,Netherlands,Bulgaria,1,1,FIFA World Cup qualification,Rotterdam,Netherlands,False,2,0,Draw
6171,6772,7252,1969,Russia,Northern Ireland,2,0,FIFA World Cup qualification,Moscow,Soviet Union,True,2,2,Russia
6172,6774,7254,1969,Algeria,Palestine,2,0,Friendly,Algiers,Algeria,False,2,2,Algeria
6173,6775,7255,1969,French Guiana,Martinique,0,0,Friendly,Cayenne,French Guiana,False,0,0,Draw
6174,6776,7256,1969,Ivory Coast,Mali,4,0,African Cup of Nations qualification,Abidjan,Ivory Coast,False,4,4,Ivory Coast
6175,6777,7257,1969,Morocco,Sudan,3,0,FIFA World Cup qualification,Casablanca,Morocco,False,3,3,Morocco
6176,6778,7258,1969,Algeria,Morocco,1,0,Friendly,Algiers,Algeria,False,1,1,Algeria
6177,6779,7259,1969,Malaysia,Thailand,1,0,Merdeka Tournament,Kuala Lumpur,Malaysia,False,1,1,Malaysia
6178,6780,7260,1969,Burma,Singapore,3,1,Merdeka Tournament,Kuala Lumpur,Malaysia,True,4,2,Burma
6179,6782,7262,1969,France,Sweden,3,0,FIFA World Cup qualification,Paris,France,False,3,3,France
6180,6783,7263,1969,Indonesia,Thailand,4,0,Merdeka Tournament,Ipoh,Malaysia,True,4,4,Indonesia
6181,6784,7264,1969,Burma,India,6,0,Merdeka Tournament,Kuala Lumpur,Malaysia,True,6,6,Burma
6182,6785,7265,1969,Egypt,Sudan,3,1,Friendly,Cairo,Egypt,False,4,2,Egypt
6183,6787,7267,1969,Switzerland,Portugal,1,1,FIFA World Cup qualification,Berne,Switzerland,False,2,0,Draw
6184,6789,7269,1969,India,Singapore,3,0,Merdeka Tournament,Ipoh,Malaysia,True,3,3,India
6185,6790,7270,1969,Italy,Wales,4,1,FIFA World Cup qualification,Rome,Italy,False,5,3,Italy
6186,6791,7271,1969,Austria,Scotland,2,0,FIFA World Cup qualification,Vienna,Austria,False,2,2,Austria
6187,6792,7272,1969,Hungary,Republic of Ireland,4,0,FIFA World Cup qualification,Budapest,Hungary,False,4,4,Hungary
6188,6793,7273,1969,Jamaica,Panama,2,1,CONCACAF Championship qualification,Kingston,Jamaica,False,3,1,Jamaica
6189,6794,7274,1969,Mexico,Belgium,1,0,Friendly,Mexico City,Mexico,False,1,1,Mexico
6190,6795,7275,1969,Netherlands,England,0,1,Friendly,Amsterdam,Netherlands,False,1,-1,England
6191,6796,7276,1969,Indonesia,Singapore,9,2,Merdeka Tournament,Kuala Lumpur,Malaysia,True,11,7,Indonesia
6192,6797,7277,1969,India,Thailand,0,1,Merdeka Tournament,Kuala Lumpur,Malaysia,True,1,-1,Thailand
6193,6798,7278,1969,Malaysia,Burma,3,1,Merdeka Tournament,Kuala Lumpur,Malaysia,False,4,2,Malaysia
6194,6800,7280,1969,Nigeria,Morocco,2,0,FIFA World Cup qualification,Ibadan,Nigeria,False,2,2,Nigeria
6195,6801,7281,1969,Burma,Singapore,9,0,Merdeka Tournament,Kuala Lumpur,Malaysia,True,9,9,Burma
6196,6802,7282,1969,Ivory Coast,Morocco,1,0,Friendly,Abidjan,Ivory Coast,False,1,1,Ivory Coast
6197,6803,7283,1969,Malaysia,Indonesia,2,3,Merdeka Tournament,Kuala Lumpur,Malaysia,False,5,-1,Indonesia
6198,6804,7284,1969,Poland,Bulgaria,3,0,FIFA World Cup qualification,Warsaw,Poland,False,3,3,Poland
6199,6805,7285,1969,Saint Vincent and the Grenadines,Dominica,1,0,Windward Islands Tournament,Kingstown,Saint Vincent and the Grenadines,False,1,1,Saint Vincent and the Grenadines
6200,6806,7286,1969,Bermuda,Iceland,3,2,Friendly,Hamilton,Bermuda,False,5,1,Bermuda
6201,6807,7287,1969,French Guiana,Suriname,3,2,Friendly,Cayenne,French Guiana,False,5,1,French Guiana
6202,6808,7288,1969,Grenada,Saint Lucia,6,0,Windward Islands Tournament,Kingstown,Saint Vincent and the Grenadines,True,6,6,Grenada
6203,6809,7289,1969,Mexico,Norway,4,0,Friendly,Mexico City,Mexico,False,4,4,Mexico
6204,6810,7290,1969,Singapore,India,7,3,Friendly,Kallang,Singapore,False,10,4,Singapore
6205,6811,7291,1969,Congo,Guinea,1,1,Friendly,Brazzaville,Congo,False,2,0,Draw
6206,6812,7292,1969,Saint Vincent and the Grenadines,Saint Lucia,2,1,Windward Islands Tournament,Kingstown,Saint Vincent and the Grenadines,False,3,1,Saint Vincent and the Grenadines
6207,6813,7293,1969,Dominica,Grenada,0,1,Windward Islands Tournament,Kingstown,Saint Vincent and the Grenadines,True,1,-1,Grenada
6208,6814,7294,1969,Guatemala,Norway,1,3,Friendly,Guatemala,Guatemala,False,4,-2,Norway
6209,6815,7295,1969,Dominica,Saint Lucia,1,3,Windward Islands Tournament,Kingstown,Saint Vincent and the Grenadines,True,4,-2,Saint Lucia
6210,6816,7296,1969,Saint Vincent and the Grenadines,Grenada,0,0,Windward Islands Tournament,Kingstown,Saint Vincent and the Grenadines,False,0,0,Draw
6211,6817,7297,1969,Romania,Greece,1,1,FIFA World Cup qualification,Bucharest,Romania,False,2,0,Draw
6212,6818,7298,1969,Turkey,Russia,1,3,FIFA World Cup qualification,Istanbul,Turkey,False,4,-2,Russia
6213,6819,7299,1969,Iraq,Poland,1,1,Friendly,Baghdad,Iraq,False,2,0,Draw
6214,6820,7301,1969,Thailand,Malaysia,2,2,King's Cup,Bangkok,Thailand,False,4,0,Draw
6215,6821,7304,1969,Thailand,Laos,3,4,King's Cup,Bangkok,Thailand,False,7,-1,Laos
6216,6822,7305,1969,DR Congo,Zambia,10,1,Friendly,Kinshasa,DR Congo,False,11,9,DR Congo
6217,6826,7309,1969,Laos,Malaysia,1,1,King's Cup,Bangkok,Thailand,True,2,0,Draw
6218,6828,7311,1969,Zimbabwe,Australia,1,1,FIFA World Cup qualification,Maputo,Mozambique,True,2,0,Draw
6219,6831,7314,1969,Indonesia,Laos,3,0,King's Cup,Bangkok,Thailand,True,3,3,Indonesia
6220,6832,7316,1969,Australia,Zimbabwe,0,0,FIFA World Cup qualification,Maputo,Mozambique,True,0,0,Draw
6221,6833,7317,1969,Costa Rica,Curaçao,2,1,CONCACAF Championship,San José,Costa Rica,False,3,1,Costa Rica
6222,6834,7318,1969,Jamaica,Mexico,0,2,CONCACAF Championship,San José,Costa Rica,True,2,-2,Mexico
6223,6837,7321,1969,Guatemala,Curaçao,6,1,CONCACAF Championship,San José,Costa Rica,True,7,5,Guatemala
6224,6838,7322,1969,Jamaica,Trinidad and Tobago,2,3,CONCACAF Championship,San José,Costa Rica,True,5,-1,Trinidad and Tobago
6225,6839,7323,1969,Malawi,Zimbabwe,2,2,Friendly,Blantyre,Malawi,False,4,0,Draw
6226,6840,7324,1969,Curaçao,Trinidad and Tobago,3,1,CONCACAF Championship,San José,Costa Rica,True,4,2,Curaçao
6227,6841,7326,1969,Costa Rica,Trinidad and Tobago,5,0,CONCACAF Championship,San José,Costa Rica,False,5,5,Costa Rica
6228,6842,7327,1969,Israel,Australia,1,0,FIFA World Cup qualification,Ramat-Gan,Israel,False,1,1,Israel
6229,6843,7328,1969,Mexico,Curaçao,2,2,CONCACAF Championship,San José,Costa Rica,True,4,0,Draw
6230,6845,7330,1969,Jamaica,Curaçao,1,2,CONCACAF Championship,San José,Costa Rica,True,3,-1,Curaçao
6231,6846,7331,1969,Costa Rica,Guatemala,1,1,CONCACAF Championship,San José,Costa Rica,False,2,0,Draw
6232,6847,7332,1969,Luxembourg,Bulgaria,1,3,FIFA World Cup qualification,Luxembourg,Luxembourg,False,4,-2,Bulgaria
6233,6849,7334,1969,England,Portugal,1,0,Friendly,London,England,False,1,1,England
6234,6850,7335,1969,Australia,Israel,1,1,FIFA World Cup qualification,Sydney,Australia,False,2,0,Draw
6235,6851,7336,1969,DR Congo,Nigeria,5,0,Friendly,Kinshasa,DR Congo,False,5,5,DR Congo
6236,6853,7338,1969,Morocco,Bulgaria,3,0,Friendly,Casablanca,Morocco,False,3,3,Morocco
6237,6854,7339,1970,Malta,Luxembourg,1,1,Friendly,Gżira,Malta,False,2,0,Draw
6238,6855,7340,1970,England,Netherlands,0,0,Friendly,London,England,False,0,0,Draw
6239,6856,7341,1970,Israel,Netherlands,0,1,Friendly,Jaffa,Israel,False,1,-1,Netherlands
6240,6858,7343,1970,Cameroon,Ivory Coast,3,2,African Cup of Nations,Khartoum,Sudan,True,5,1,Cameroon
6241,6859,7344,1970,Sudan,Ethiopia,3,0,African Cup of Nations,Khartoum,Sudan,False,3,3,Sudan
6242,6860,7345,1970,DR Congo,Ghana,0,2,African Cup of Nations,Wad Madani,Sudan,True,2,-2,Ghana
6243,6861,7346,1970,Egypt,Guinea,4,1,African Cup of Nations,Wad Madani,Sudan,True,5,3,Egypt
6244,6863,7348,1970,Cameroon,Ethiopia,3,2,African Cup of Nations,Khartoum,Sudan,True,5,1,Cameroon
6245,6864,7349,1970,Sudan,Ivory Coast,0,1,African Cup of Nations,Khartoum,Sudan,False,1,-1,Ivory Coast
6246,6865,7350,1970,DR Congo,Guinea,2,2,African Cup of Nations,Wad Madani,Sudan,True,4,0,Draw
6247,6866,7351,1970,Egypt,Ghana,1,1,African Cup of Nations,Wad Madani,Sudan,True,2,0,Draw
6248,6867,7352,1970,Peru,Romania,1,1,Friendly,Lima,Peru,False,2,0,Draw
6249,6868,7353,1970,Ethiopia,Ivory Coast,1,6,African Cup of Nations,Khartoum,Sudan,True,7,-5,Ivory Coast
6250,6869,7354,1970,Sudan,Cameroon,2,1,African Cup of Nations,Khartoum,Sudan,False,3,1,Sudan
6251,6870,7355,1970,DR Congo,Egypt,0,1,African Cup of Nations,Wad Madani,Sudan,True,1,-1,Egypt
6252,6871,7356,1970,Ghana,Guinea,1,1,African Cup of Nations,Wad Madani,Sudan,True,2,0,Draw
6253,6872,7357,1970,Spain,Germany,2,0,Friendly,Seville,Spain,False,2,2,Spain
6254,6873,7358,1970,Ghana,Ivory Coast,2,1,African Cup of Nations,Khartoum,Sudan,True,3,1,Ghana
6255,6874,7359,1970,Peru,Russia,0,0,Friendly,Lima,Peru,False,0,0,Draw
6256,6875,7360,1970,Sudan,Egypt,2,1,African Cup of Nations,Khartoum,Sudan,False,3,1,Sudan
6257,6876,7361,1970,Mexico,Bulgaria,1,1,Friendly,Mexico City,Mexico,False,2,0,Draw
6258,6877,7362,1970,Egypt,Ivory Coast,3,1,African Cup of Nations,Khartoum,Sudan,True,4,2,Egypt
6259,6878,7363,1970,Sudan,Ghana,1,0,African Cup of Nations,Khartoum,Sudan,False,1,1,Sudan
6260,6879,7364,1970,Mexico,Bulgaria,2,0,Friendly,León,Mexico,False,2,2,Mexico
6261,6880,7365,1970,Peru,Russia,0,2,Friendly,Lima,Peru,False,2,-2,Russia
6262,6881,7366,1970,Peru,Bulgaria,1,3,Friendly,Lima,Peru,False,4,-2,Bulgaria
6263,6882,7367,1970,Spain,Italy,2,2,Friendly,Madrid,Spain,False,4,0,Draw
6264,6883,7368,1970,El Salvador,Russia,0,2,Friendly,San Salvador,El Salvador,False,2,-2,Russia
6265,6884,7369,1970,Mexico,Sweden,0,0,Friendly,Mexico City,Mexico,False,0,0,Draw
6266,6885,7370,1970,Peru,Bulgaria,5,3,Friendly,Lima,Peru,False,8,2,Peru
6267,6886,7371,1970,Belgium,England,1,3,Friendly,Brussels,Belgium,False,4,-2,England
6268,6887,7372,1970,Costa Rica,El Salvador,2,0,Friendly,San José,Costa Rica,False,2,2,Costa Rica
6269,6888,7373,1970,Mexico,Russia,0,0,Friendly,Mexico City,Mexico,False,0,0,Draw
6270,6889,7374,1970,Mexico,Sweden,0,1,Friendly,Puebla,Mexico,False,1,-1,Sweden
6271,6890,7375,1970,Brazil,Argentina,0,2,Friendly,Porto Alegre,Brazil,False,2,-2,Argentina
6272,6891,7376,1970,Peru,Mexico,0,1,Friendly,Lima,Peru,False,1,-1,Mexico
6273,6892,7377,1970,Brazil,Argentina,2,1,Friendly,Rio de Janeiro,Brazil,False,3,1,Brazil
6274,6893,7378,1970,Peru,Mexico,1,0,Friendly,Lima,Peru,False,1,1,Peru
6275,6894,7379,1970,Mexico,Peru,3,1,Friendly,Mexico City,Mexico,False,4,2,Mexico
6276,6895,7380,1970,Mexico,Peru,3,3,Friendly,León,Mexico,False,6,0,Draw
6277,6896,7381,1970,Brazil,Chile,5,0,Friendly,São Paulo,Brazil,False,5,5,Brazil
6278,6897,7382,1970,Burkina Faso,Niger,3,3,Friendly,Ouagadougou,Upper Volta,False,6,0,Draw
6279,6898,7383,1970,Ethiopia,Israel,1,5,Friendly,Addis Abeba,Ethiopia,False,6,-4,Israel
6280,6899,7384,1970,Guinea,Ivory Coast,4,2,Friendly,Conakry,Guinea,False,6,2,Guinea
6281,6900,7385,1970,Brazil,Chile,2,1,Friendly,Rio de Janeiro,Brazil,False,3,1,Brazil
6282,6901,7386,1970,Guinea,Mali,2,1,Friendly,Conakry,Guinea,False,3,1,Guinea
6283,6902,7387,1970,Bahrain,Qatar,2,1,Gulf Cup,Isa Town,Bahrain,False,3,1,Bahrain
6284,6903,7388,1970,Saudi Arabia,Kuwait,1,3,Gulf Cup,Isa Town,Bahrain,True,4,-2,Kuwait
6285,6904,7389,1970,Bahrain,Saudi Arabia,0,0,Gulf Cup,Isa Town,Bahrain,False,0,0,Draw
6286,6905,7390,1970,Kuwait,Qatar,4,2,Gulf Cup,Isa Town,Bahrain,True,6,2,Kuwait
6287,6906,7391,1970,Uruguay,Peru,2,0,Friendly,Montevideo,Uruguay,False,2,2,Uruguay
6288,6907,7392,1970,Saudi Arabia,Qatar,1,1,Gulf Cup,Isa Town,Bahrain,True,2,0,Draw
6289,6908,7393,1970,Bahrain,Kuwait,1,3,Gulf Cup,Isa Town,Bahrain,False,4,-2,Kuwait
6290,6909,7394,1970,Argentina,Uruguay,2,1,Friendly,Buenos Aires,Argentina,False,3,1,Argentina
6291,6910,7395,1970,France,Bulgaria,1,1,Friendly,Rouen,France,False,2,0,Draw
6292,6911,7396,1970,Germany,Romania,1,1,Friendly,Stuttgart,Germany,False,2,0,Draw
6293,6913,7399,1970,Brazil,Paraguay,0,0,Friendly,Rio de Janeiro,Brazil,False,0,0,Draw
6294,6914,7401,1970,Haiti,Bermuda,1,1,Friendly,Port-au-Prince,Haiti,False,2,0,Draw
6295,6915,7402,1970,Ghana,Ivory Coast,3,0,Friendly,Accra,Ghana,False,3,3,Ghana
6296,6916,7403,1970,Uruguay,Argentina,2,1,Friendly,Montevideo,Uruguay,False,3,1,Uruguay
6297,6917,7404,1970,Northern Ireland,Scotland,0,1,British Championship,Belfast,Northern Ireland,False,1,-1,Scotland
6298,6918,7405,1970,Wales,England,1,1,British Championship,Cardiff,Wales,False,2,0,Draw
6299,6919,7406,1970,Ghana,Ivory Coast,1,1,Friendly,Accra,Ghana,False,2,0,Draw
6300,6920,7407,1970,England,Northern Ireland,3,1,British Championship,London,England,False,4,2,England
6301,6921,7408,1970,Peru,El Salvador,3,0,Friendly,Lima,Peru,False,3,3,Peru
6302,6922,7409,1970,Scotland,Wales,0,0,British Championship,Glasgow,Scotland,False,0,0,Draw
6303,6923,7410,1970,Switzerland,Spain,0,1,Friendly,Lausanne,Switzerland,False,1,-1,Spain
6304,6924,7411,1970,Scotland,England,0,0,British Championship,Glasgow,Scotland,False,0,0,Draw
6305,6925,7412,1970,Wales,Northern Ireland,1,0,British Championship,Swansea,Wales,False,1,1,Wales
6306,6926,7413,1970,France,Romania,2,0,Friendly,Reims,France,False,2,2,France
6307,6927,7414,1970,Brazil,Austria,1,0,Friendly,Rio de Janeiro,Brazil,False,1,1,Brazil
6308,6928,7415,1970,Mexico,Ecuador,4,2,Friendly,León,Mexico,False,6,2,Mexico
6309,6929,7416,1970,Hungary,Poland,2,0,Friendly,Budapest,Hungary,False,2,2,Hungary
6310,6930,7417,1970,Switzerland,France,2,1,Friendly,Basel,Switzerland,False,3,1,Switzerland
6311,6931,7418,1970,Bulgaria,Russia,3,3,Friendly,Sofia,Bulgaria,False,6,0,Draw
6312,6932,7419,1970,Bulgaria,Russia,0,0,Friendly,Sofia,Bulgaria,False,0,0,Draw
6313,6933,7420,1970,Poland,Republic of Ireland,2,1,Friendly,Poznań,Poland,False,3,1,Poland
6314,6935,7422,1970,Germany,Republic of Ireland,2,1,Friendly,Berlin,Germany,False,3,1,Germany
6315,6937,7424,1970,Portugal,Italy,1,2,Friendly,Oeiras,Portugal,False,3,-1,Italy
6316,6940,7427,1970,Guinea,Senegal,3,1,Friendly,Conakry,Guinea,False,4,2,Guinea
6317,6941,7428,1970,Hungary,Sweden,1,2,Friendly,Budapest,Hungary,False,3,-1,Sweden
6318,6943,7430,1970,Guinea,Senegal,4,0,Friendly,Conakry,Guinea,False,4,4,Guinea
6319,6944,7431,1970,Denmark,Poland,0,2,Friendly,Copenhagen,Denmark,False,2,-2,Poland
6320,6945,7432,1970,Colombia,England,0,4,Friendly,Bogotá,Colombia,False,4,-4,England
6321,6946,7433,1970,Ecuador,England,0,2,Friendly,Quito,Ecuador,False,2,-2,England
6322,6947,7434,1970,Mexico,Russia,0,0,FIFA World Cup,Mexico City,Mexico,False,0,0,Draw
6323,6948,7435,1970,Bulgaria,Peru,2,3,FIFA World Cup,León,Mexico,True,5,-1,Peru
6324,6949,7436,1970,England,Romania,1,0,FIFA World Cup,Guadalajara,Mexico,True,1,1,England
6325,6950,7437,1970,Israel,Uruguay,0,2,FIFA World Cup,Puebla,Mexico,True,2,-2,Uruguay
6326,6951,7438,1970,Belgium,El Salvador,3,0,FIFA World Cup,Mexico City,Mexico,True,3,3,Belgium
6327,6953,7440,1970,Finland,Denmark,1,1,Nordic Championship,Helsinki,Finland,False,2,0,Draw
6328,6954,7441,1970,Germany,Morocco,2,1,FIFA World Cup,León,Mexico,True,3,1,Germany
6329,6955,7442,1970,Italy,Sweden,1,0,FIFA World Cup,Toluca,Mexico,True,1,1,Italy
6330,6956,7443,1970,Belgium,Russia,1,4,FIFA World Cup,Mexico City,Mexico,True,5,-3,Russia
6331,6957,7445,1970,Italy,Uruguay,0,0,FIFA World Cup,Puebla,Mexico,True,0,0,Draw
6332,6958,7446,1970,Morocco,Peru,0,3,FIFA World Cup,León,Mexico,True,3,-3,Peru
6333,6959,7447,1970,Uganda,Tanzania,1,1,Friendly,Kampala,Uganda,False,2,0,Draw
6334,6960,7448,1970,Brazil,England,1,0,FIFA World Cup,Guadalajara,Mexico,True,1,1,Brazil
6335,6961,7449,1970,Bulgaria,Germany,2,5,FIFA World Cup,León,Mexico,True,7,-3,Germany
6336,6962,7450,1970,Israel,Sweden,1,1,FIFA World Cup,Toluca,Mexico,True,2,0,Draw
6337,6963,7451,1970,Mexico,El Salvador,4,0,FIFA World Cup,Mexico City,Mexico,False,4,4,Mexico
6338,6964,7452,1970,Brazil,Romania,3,2,FIFA World Cup,Guadalajara,Mexico,True,5,1,Brazil
6339,6965,7453,1970,El Salvador,Russia,0,2,FIFA World Cup,Mexico City,Mexico,True,2,-2,Russia
6340,6966,7454,1970,Germany,Peru,3,1,FIFA World Cup,León,Mexico,True,4,2,Germany
6341,6967,7455,1970,Sweden,Uruguay,1,0,FIFA World Cup,Puebla,Mexico,True,1,1,Sweden
6342,6968,7456,1970,Bulgaria,Morocco,1,1,FIFA World Cup,León,Mexico,True,2,0,Draw
6343,6969,7458,1970,Israel,Italy,0,0,FIFA World Cup,Toluca,Mexico,True,0,0,Draw
6344,6970,7459,1970,Mexico,Belgium,1,0,FIFA World Cup,Mexico City,Mexico,False,1,1,Mexico
6345,6971,7460,1970,Honduras,Panama,1,0,Friendly,El Progreso,Honduras,False,1,1,Honduras
6346,6972,7461,1970,Brazil,Peru,4,2,FIFA World Cup,Guadalajara,Mexico,True,6,2,Brazil
6347,6973,7462,1970,England,Germany,2,3,FIFA World Cup,León,Mexico,True,5,-1,Germany
6348,6974,7463,1970,Mexico,Italy,1,4,FIFA World Cup,Toluca,Mexico,False,5,-3,Italy
6349,6975,7464,1970,Russia,Uruguay,0,1,FIFA World Cup,Mexico City,Mexico,True,1,-1,Uruguay
6350,6976,7465,1970,Brazil,Uruguay,3,1,FIFA World Cup,Guadalajara,Mexico,True,4,2,Brazil
6351,6977,7466,1970,Germany,Italy,3,4,FIFA World Cup,Mexico City,Mexico,True,7,-1,Italy
6352,6978,7467,1970,Norway,Finland,2,0,Nordic Championship,Bergen,Norway,False,2,2,Norway
6353,6979,7468,1970,Germany,Uruguay,1,0,FIFA World Cup,Mexico City,Mexico,True,1,1,Germany
6354,6980,7469,1970,Malaysia,Singapore,5,0,Indonesia Tournament,Jakarta,Indonesia,True,5,5,Malaysia
6355,6981,7470,1970,Brazil,Italy,4,1,FIFA World Cup,Mexico City,Mexico,True,5,3,Brazil
6356,6982,7471,1970,Indonesia,Hong Kong,2,1,Indonesia Tournament,Jakarta,Indonesia,False,3,1,Indonesia
6357,6985,7476,1970,Sweden,Denmark,1,1,Nordic Championship,Gothenburg,Sweden,False,2,0,Draw
6358,6986,7477,1970,Hong Kong,Malaysia,1,1,Indonesia Tournament,Jakarta,Indonesia,True,2,0,Draw
6359,6988,7479,1970,Indonesia,Hong Kong,3,2,Indonesia Tournament,Jakarta,Indonesia,False,5,1,Indonesia
6360,6989,7481,1970,DR Congo,Sudan,3,0,Friendly,Kinshasa,DR Congo,False,3,3,DR Congo
6361,6990,7482,1970,Malawi,Mauritius,1,0,Friendly,Zomba,Malawi,False,1,1,Malawi
6362,6991,7483,1970,Iceland,Denmark,0,0,Friendly,Reykjavík,Iceland,False,0,0,Draw
6363,6992,7484,1970,Malawi,Mauritius,0,0,Friendly,Lilongwe,Malawi,False,0,0,Draw
6364,6993,7485,1970,Gabon,Cameroon,1,1,Friendly,Libreville,Gabon,False,2,0,Draw
6365,6994,7488,1970,Iceland,Norway,2,0,Friendly,Reykjavík,Iceland,False,2,2,Iceland
6366,6995,7489,1970,Poland,Iraq,2,0,Friendly,Szczecin,Poland,False,2,2,Poland
6367,6996,7491,1970,Ivory Coast,Guinea,3,2,Friendly,Abidjan,Ivory Coast,False,5,1,Ivory Coast
6368,6999,7494,1970,Hong Kong,Japan,2,1,Merdeka Tournament,Kuala Lumpur,Malaysia,True,3,1,Hong Kong
6369,7001,7497,1970,Cameroon,Gabon,0,3,Friendly,Douala,Cameroon,False,3,-3,Gabon
6370,7002,7498,1970,Indonesia,Singapore,3,1,Merdeka Tournament,Kuala Lumpur,Malaysia,True,4,2,Indonesia
6371,7003,7499,1970,Hong Kong,Thailand,2,0,Merdeka Tournament,Kuala Lumpur,Malaysia,True,2,2,Hong Kong
6372,7005,7501,1970,Burma,India,2,0,Merdeka Tournament,Kuala Lumpur,Malaysia,True,2,2,Burma
6373,7006,7503,1970,Hong Kong,Indonesia,1,3,Merdeka Tournament,George Town,Malaysia,True,4,-2,Indonesia
6374,7007,7504,1970,Japan,Thailand,0,0,Merdeka Tournament,Kuala Lumpur,Malaysia,True,0,0,Draw
6375,7010,7508,1970,Hong Kong,Singapore,3,2,Merdeka Tournament,Kuala Lumpur,Malaysia,True,5,1,Hong Kong
6376,7014,7512,1970,Indonesia,Japan,3,4,Merdeka Tournament,Kuala Lumpur,Malaysia,True,7,-1,Japan
6377,7015,7513,1970,Malawi,Lesotho,1,2,Friendly,Lilongwe,Malawi,False,3,-1,Lesotho
6378,7016,7514,1970,Singapore,Thailand,4,5,Merdeka Tournament,Kuala Lumpur,Malaysia,True,9,-1,Thailand
6379,7019,7517,1970,Malaysia,Burma,1,2,Merdeka Tournament,Kuala Lumpur,Malaysia,False,3,-1,Burma
6380,7020,7518,1970,Indonesia,Thailand,6,3,Merdeka Tournament,Kuala Lumpur,Malaysia,True,9,3,Indonesia
6381,7021,7519,1970,Japan,Singapore,4,0,Merdeka Tournament,Kuala Lumpur,Malaysia,True,4,4,Japan
6382,7022,7520,1970,Malawi,Lesotho,6,1,Friendly,Lilongwe,Malawi,False,7,5,Malawi
6383,7023,7521,1970,Burma,Hong Kong,5,0,Merdeka Tournament,Kuala Lumpur,Malaysia,True,5,5,Burma
6384,7027,7525,1970,Hong Kong,India,2,3,Merdeka Tournament,Kuala Lumpur,Malaysia,True,5,-1,India
6385,7030,7528,1970,Singapore,India,3,8,Friendly,Kallang,Singapore,False,11,-5,India
6386,7031,7529,1970,Finland,Sweden,1,2,Nordic Championship,Helsinki,Finland,False,3,-1,Sweden
6387,7032,7530,1970,Libya,Tunisia,2,2,Friendly,Benghazi,Libya,False,4,0,Draw
6388,7033,7531,1970,Poland,Denmark,5,0,Friendly,Warsaw,Poland,False,5,5,Poland
6389,7034,7532,1970,Libya,Tunisia,3,2,Friendly,Tripoli,Libya,False,5,1,Libya
6390,7036,7535,1970,Iran,Pakistan,7,0,Friendly,Teheran,Iran,False,7,7,Iran
6391,7037,7536,1970,Germany,Hungary,3,1,Friendly,Nuremberg,Germany,False,4,2,Germany
6392,7038,7537,1970,Pakistan,Turkey,1,3,Friendly,Teheran,Iran,True,4,-2,Turkey
6393,7040,7539,1970,Iran,Turkey,1,1,Friendly,Teheran,Iran,False,2,0,Draw
6394,7041,7541,1970,Denmark,Norway,0,1,Nordic Championship,Copenhagen,Denmark,False,1,-1,Norway
6395,7042,7542,1970,Republic of Ireland,Poland,0,2,Friendly,Dublin,Republic of Ireland,False,2,-2,Poland
6396,7043,7543,1970,Tunisia,Libya,2,0,Friendly,Tunis,Tunisia,False,2,2,Tunisia
6397,7044,7545,1970,Hungary,Austria,1,1,Friendly,Budapest,Hungary,False,2,0,Draw
6398,7045,7546,1970,Tanzania,Kenya,2,0,Friendly,Zanzibar,Tanzania,False,2,2,Tanzania
6399,7046,7547,1970,Kenya,Uganda,1,2,Friendly,Zanzibar,Tanzania,True,3,-1,Uganda
6400,7047,7548,1970,Brazil,Mexico,2,1,Friendly,Rio de Janeiro,Brazil,False,3,1,Brazil
6401,7048,7550,1970,Tanzania,Uganda,1,4,Friendly,Zanzibar,Tanzania,False,5,-3,Uganda
6402,7049,7552,1970,Chile,Brazil,1,5,Friendly,Santiago,Chile,False,6,-4,Brazil
6403,7050,7553,1970,Suriname,Trinidad and Tobago,3,2,Friendly,Paramaribo,Suriname,False,5,1,Suriname
6404,7051,7554,1970,Austria,France,1,0,Friendly,Vienna,Austria,False,1,1,Austria
6405,7052,7555,1970,Curaçao,Trinidad and Tobago,1,1,Friendly,Paramaribo,Suriname,True,2,0,Draw
6406,7053,7557,1970,Norway,Hungary,1,3,UEFA Euro qualification,Oslo,Norway,False,4,-2,Hungary
6407,7054,7558,1970,Guyana,Trinidad and Tobago,1,1,Friendly,Georgetown,Guyana,False,2,0,Draw
6408,7055,7559,1970,Suriname,Curaçao,5,1,Friendly,Paramaribo,Suriname,False,6,4,Suriname
6409,7056,7560,1970,Guyana,Trinidad and Tobago,1,1,Friendly,Georgetown,Guyana,False,2,0,Draw
6410,7057,7561,1970,Malta,Greece,1,1,UEFA Euro qualification,Gżira,Malta,False,2,0,Draw
6411,7059,7563,1970,Romania,Finland,3,0,UEFA Euro qualification,Bucharest,Romania,False,3,3,Romania
6412,7060,7564,1970,Sierra Leone,Senegal,1,0,Friendly,Freetown,Sierra Leone,False,1,1,Sierra Leone
6413,7061,7565,1970,Denmark,Portugal,0,1,UEFA Euro qualification,Copenhagen,Denmark,False,1,-1,Portugal
6414,7062,7566,1970,Republic of Ireland,Sweden,1,1,UEFA Euro qualification,Dublin,Republic of Ireland,False,2,0,Draw
6415,7064,7568,1970,Poland,Albania,3,0,UEFA Euro qualification,Chorzów,Poland,False,3,3,Poland
6416,7065,7569,1970,Germany,Turkey,1,1,UEFA Euro qualification,Cologne,Germany,False,2,0,Draw
6417,7066,7570,1970,Switzerland,Italy,1,1,Friendly,Berne,Switzerland,False,2,0,Draw
6418,7067,7571,1970,Ivory Coast,Senegal,0,1,Friendly,Abidjan,Ivory Coast,False,1,-1,Senegal
6419,7068,7572,1970,Paraguay,Argentina,1,1,Friendly,Asunción,Paraguay,False,2,0,Draw
6420,7069,7573,1970,New Caledonia,Australia,1,3,Friendly,Nouméa,New Caledonia,False,4,-2,Australia
6421,7070,7575,1970,New Caledonia,Australia,0,1,Friendly,Nouméa,New Caledonia,False,1,-1,Australia
6422,7071,7576,1970,Togo,Senegal,3,0,Friendly,Lomé,Togo,False,3,3,Togo
6423,7073,7578,1970,Spain,Greece,2,1,Friendly,Zaragoza,Spain,False,3,1,Spain
6424,7074,7579,1970,Sweden,Republic of Ireland,1,0,UEFA Euro qualification,Solna,Sweden,False,1,1,Sweden
6425,7075,7580,1970,Indonesia,Thailand,1,2,Vietnam Independence Cup,Saigon,Vietnam Republic,True,3,-1,Thailand
6426,7076,7582,1970,Macau,Australia,0,9,Friendly,Macau,Macau,False,9,-9,Australia
6427,7077,7583,1970,Austria,Italy,1,2,UEFA Euro qualification,Vienna,Austria,False,3,-1,Italy
6428,7078,7584,1970,Malaysia,Thailand,1,4,Vietnam Independence Cup,Saigon,Vietnam Republic,True,5,-3,Thailand
6429,7079,7586,1970,Benin,Congo,3,2,Friendly,Cotonou,Dahomey,False,5,1,Benin
6430,7080,7587,1970,Indonesia,Malaysia,1,3,Vietnam Independence Cup,Saigon,Vietnam Republic,True,4,-2,Malaysia
6431,7081,7588,1970,Sierra Leone,Guinea,1,2,Friendly,Freetown,Sierra Leone,False,3,-1,Guinea
6432,7082,7590,1970,Zambia,Tanzania,5,1,African Cup of Nations qualification,Lusaka,Zambia,False,6,4,Zambia
6433,7083,7591,1970,Iran,Australia,1,2,Friendly,Teheran,Iran,False,3,-1,Australia
6434,7084,7592,1970,Gabon,Ivory Coast,1,2,African Cup of Nations qualification,Libreville,Gabon,False,3,-1,Ivory Coast
6435,7085,7593,1970,Hong Kong,Singapore,0,1,King's Cup,Bangkok,Thailand,True,1,-1,Singapore
6436,7086,7594,1970,Nigeria,Congo,0,0,African Cup of Nations qualification,Ibadan,Nigeria,False,0,0,Draw
6437,7087,7595,1970,Thailand,Laos,1,0,King's Cup,Bangkok,Thailand,False,1,1,Thailand
6438,7088,7596,1970,Togo,Benin,2,1,African Cup of Nations qualification,Lomé,Togo,False,3,1,Togo
6439,7089,7597,1970,Uganda,DR Congo,1,4,African Cup of Nations qualification,Kampala,Uganda,False,5,-3,DR Congo
6440,7090,7598,1970,Cambodia,Malaysia,1,1,King's Cup,Bangkok,Thailand,True,2,0,Draw
6441,7092,7600,1970,Thailand,Singapore,3,1,King's Cup,Bangkok,Thailand,False,4,2,Thailand
6442,7093,7601,1970,France,Norway,3,1,UEFA Euro qualification,Lyon,France,False,4,2,France
6443,7095,7604,1970,Scotland,Denmark,1,0,UEFA Euro qualification,Glasgow,Scotland,False,1,1,Scotland
6444,7096,7605,1970,Spain,Northern Ireland,3,0,UEFA Euro qualification,Seville,Spain,False,3,3,Spain
6445,7097,7606,1970,Suriname,French Guiana,3,2,Friendly,Paramaribo,Suriname,False,5,1,Suriname
6446,7098,7607,1970,Wales,Romania,0,0,UEFA Euro qualification,Cardiff,Wales,False,0,0,Draw
6447,7099,7609,1970,Thailand,Hong Kong,2,1,King's Cup,Bangkok,Thailand,False,3,1,Thailand
6448,7101,7611,1970,Indonesia,Malaysia,3,0,King's Cup,Bangkok,Thailand,True,3,3,Indonesia
6449,7102,7612,1970,Laos,Singapore,3,0,King's Cup,Bangkok,Thailand,True,3,3,Laos
6450,7104,7614,1970,Belgium,France,1,2,Friendly,Brussels,Belgium,False,3,-1,France
6451,7105,7615,1970,Bulgaria,Norway,1,1,UEFA Euro qualification,Sofia,Bulgaria,False,2,0,Draw
6452,7106,7616,1970,Cyprus,Russia,1,3,UEFA Euro qualification,Nicosia,Cyprus,False,4,-2,Russia
6453,7107,7617,1970,Guinea,Senegal,1,0,Friendly,Conakry,Guinea,False,1,1,Guinea
6454,7108,7618,1970,Indonesia,Cambodia,4,1,King's Cup,Bangkok,Thailand,True,5,3,Indonesia
6455,7110,7620,1970,Madagascar,Mauritius,2,1,African Cup of Nations qualification,Antananarivo,Madagascar,False,3,1,Madagascar
6456,7112,7622,1970,Switzerland,Hungary,0,1,Friendly,Basel,Switzerland,False,1,-1,Hungary
6457,7113,7623,1970,Hong Kong,Laos,4,2,King's Cup,Bangkok,Thailand,True,6,2,Hong Kong
6458,7114,7626,1970,Thailand,Indonesia,2,1,King's Cup,Bangkok,Thailand,False,3,1,Thailand
6459,7115,7628,1970,Indonesia,Malaysia,1,3,King's Cup,Bangkok,Thailand,True,4,-2,Malaysia
6460,7117,7630,1970,Dominica,Saint Lucia,1,1,Windward Islands Tournament,St. George's,Grenada,True,2,0,Draw
6461,7118,7631,1970,Benin,Togo,0,0,African Cup of Nations qualification,Porto Novo,Dahomey,False,0,0,Draw
6462,7119,7632,1970,Congo,Nigeria,2,1,African Cup of Nations qualification,Brazzaville,Congo,False,3,1,Congo
6463,7120,7633,1970,Greece,Germany,1,3,Friendly,Piraeus,Greece,False,4,-2,Germany
6464,7121,7634,1970,Grenada,Saint Vincent and the Grenadines,5,3,Windward Islands Tournament,St. George's,Grenada,False,8,2,Grenada
6465,7122,7635,1970,Ivory Coast,Gabon,1,0,African Cup of Nations qualification,Abidjan,Ivory Coast,False,1,1,Ivory Coast
6466,7123,7636,1970,DR Congo,Uganda,1,0,African Cup of Nations qualification,Kinshasa,DR Congo,False,1,1,DR Congo
6467,7124,7637,1970,Dominica,Saint Vincent and the Grenadines,0,1,Windward Islands Tournament,St. George's,Grenada,True,1,-1,Saint Vincent and the Grenadines
6468,7125,7638,1970,Belgium,Denmark,2,0,UEFA Euro qualification,Bruges,Belgium,False,2,2,Belgium
6469,7127,7640,1970,Grenada,Saint Lucia,6,1,Windward Islands Tournament,St. George's,Grenada,False,7,5,Grenada
6470,7128,7641,1970,Grenada,Dominica,2,1,Windward Islands Tournament,St. George's,Grenada,False,3,1,Grenada
6471,7129,7642,1970,Mauritius,Madagascar,4,1,African Cup of Nations qualification,Port Louis,Mauritius,False,5,3,Mauritius
6472,7130,7643,1970,Netherlands,Romania,2,0,Friendly,Amsterdam,Netherlands,False,2,2,Netherlands
6473,7131,7644,1970,Italy,Republic of Ireland,3,0,UEFA Euro qualification,Florence,Italy,False,3,3,Italy
6474,7132,7645,1970,Greece,Cyprus,1,1,Friendly,Piraeus,Greece,False,2,0,Draw
6475,7133,7646,1970,Algeria,Morocco,3,1,African Cup of Nations qualification,Algiers,Algeria,False,4,2,Algeria
6476,7134,7647,1970,Niger,Mali,0,1,African Cup of Nations qualification,Niamey,Niger,False,1,-1,Mali
6477,7135,7648,1970,Turkey,Albania,2,1,UEFA Euro qualification,Istanbul,Turkey,False,3,1,Turkey
6478,7136,7649,1970,Greece,Switzerland,0,1,UEFA Euro qualification,Piraeus,Greece,False,1,-1,Switzerland
6479,7137,7650,1970,Senegal,Malawi,4,1,Friendly,Dakar,Senegal,False,5,3,Senegal
6480,7138,7651,1970,Malta,Switzerland,1,2,UEFA Euro qualification,Gżira,Malta,False,3,-1,Switzerland
6481,7139,7652,1970,Libya,Egypt,0,1,African Cup of Nations qualification,Tripoli,Libya,False,1,-1,Egypt
6482,7140,7653,1970,Mali,Niger,3,1,African Cup of Nations qualification,Bamako,Mali,False,4,2,Mali
6483,7141,7654,1970,Morocco,Algeria,3,0,African Cup of Nations qualification,Casablanca,Morocco,False,3,3,Morocco
6484,7142,7655,1971,Egypt,Libya,2,1,African Cup of Nations qualification,Cairo,Egypt,False,3,1,Egypt
6485,7143,7656,1971,Argentina,France,3,4,Friendly,Buenos Aires,Argentina,False,7,-1,France
6486,7144,7657,1971,Ghana,DR Congo,1,1,Friendly,Accra,Ghana,False,2,0,Draw
6487,7145,7658,1971,Argentina,France,2,0,Friendly,Mar del Plata,Argentina,False,2,2,Argentina
6488,7146,7659,1971,Kuwait,Iraq,0,2,Friendly,Kuwait City,Kuwait,False,2,-2,Iraq
6489,7147,7660,1971,Ghana,Sierra Leone,1,2,Friendly,Accra,Ghana,False,3,-1,Sierra Leone
6490,7149,7662,1971,Belgium,Scotland,3,0,UEFA Euro qualification,Liège,Belgium,False,3,3,Belgium
6491,7150,7663,1971,Cyprus,Northern Ireland,0,3,UEFA Euro qualification,Nicosia,Cyprus,False,3,-3,Northern Ireland
6492,7151,7664,1971,Malta,England,0,1,UEFA Euro qualification,Gżira,Malta,False,1,-1,England
6493,7152,7665,1971,Ghana,Sierra Leone,1,2,Friendly,Accra,Ghana,False,3,-1,Sierra Leone
6494,7155,7668,1971,Nigeria,Sierra Leone,1,0,Friendly,Lagos,Nigeria,False,1,1,Nigeria
6495,7156,7669,1971,Albania,Germany,0,1,UEFA Euro qualification,Tirana,Albania,False,1,-1,Germany
6496,7157,7670,1971,Belgium,Portugal,3,0,UEFA Euro qualification,Brussels,Belgium,False,3,3,Belgium
6497,7158,7671,1971,Mexico,Russia,0,0,Friendly,Guadalajara,Mexico,False,0,0,Draw
6498,7159,7672,1971,Italy,Spain,1,2,Friendly,Cagliari,Italy,False,3,-1,Spain
6499,7160,7673,1971,Mexico,Russia,0,0,Friendly,Mexico City,Mexico,False,0,0,Draw
6500,7161,7675,1971,Netherlands,Luxembourg,6,0,UEFA Euro qualification,Rotterdam,Netherlands,False,6,6,Netherlands
6501,7162,7676,1971,El Salvador,Russia,0,1,Friendly,San Salvador,El Salvador,False,1,-1,Russia
6502,7163,7677,1971,Madagascar,Liberia,2,1,Friendly,Antananarivo,Madagascar,False,3,1,Madagascar
6503,7164,7678,1971,Cameroon,Senegal,1,1,Friendly,Yaoundé,Cameroon,False,2,0,Draw
6504,7165,7679,1971,Cameroon,Senegal,1,2,Friendly,Yaoundé,Cameroon,False,3,-1,Senegal
6505,7166,7680,1971,Lesotho,Madagascar,1,2,Friendly,Maseru,Lesotho,False,3,-1,Madagascar
6506,7167,7681,1971,Senegal,Cameroon,3,0,Friendly,Dakar,Senegal,False,3,3,Senegal
6507,7168,7682,1971,Cameroon,Congo,7,1,Friendly,Yaoundé,Cameroon,False,8,6,Cameroon
6508,7169,7683,1971,Spain,France,2,2,Friendly,Valencia,Spain,False,4,0,Draw
6509,7170,7684,1971,Malawi,Zambia,5,4,Friendly,Zomba,Malawi,False,9,1,Malawi
6510,7171,7685,1971,Malawi,Zambia,1,3,Friendly,Blantyre,Malawi,False,4,-2,Zambia
6511,7172,7686,1971,Malawi,Zambia,0,3,Friendly,Blantyre,Malawi,False,3,-3,Zambia
6512,7173,7687,1971,Togo,Liberia,0,2,Friendly,Lomé,Togo,False,2,-2,Liberia
6513,7174,7688,1971,Madagascar,Mauritius,3,0,Friendly,Antananarivo,Madagascar,False,3,3,Madagascar
6514,7175,7689,1971,Austria,Hungary,0,2,Friendly,Vienna,Austria,False,2,-2,Hungary
6515,7176,7691,1971,Greece,Bulgaria,0,1,Friendly,Piraeus,Greece,False,1,-1,Bulgaria
6516,7177,7692,1971,Haiti,Bahamas,8,0,Friendly,Port-au-Prince,Haiti,False,8,8,Haiti
6517,7178,7693,1971,England,Greece,3,0,UEFA Euro qualification,London,England,False,3,3,England
6518,7179,7694,1971,Northern Ireland,Cyprus,5,0,UEFA Euro qualification,Belfast,Northern Ireland,False,5,5,Northern Ireland
6519,7180,7695,1971,Portugal,Scotland,2,0,UEFA Euro qualification,Lisbon,Portugal,False,2,2,Portugal
6520,7181,7696,1971,Switzerland,Malta,5,0,UEFA Euro qualification,Lucerne,Switzerland,False,5,5,Switzerland
6521,7183,7700,1971,Hungary,France,1,1,UEFA Euro qualification,Budapest,Hungary,False,2,0,Draw
6522,7184,7701,1971,Sierra Leone,Gambia,3,1,Friendly,Freetown,Sierra Leone,False,4,2,Sierra Leone
6523,7185,7702,1971,Turkey,Germany,0,3,UEFA Euro qualification,Istanbul,Turkey,False,3,-3,Germany
6524,7186,7703,1971,Tanzania,DR Congo,0,1,Friendly,Dar es Salaam,Tanzania,False,1,-1,DR Congo
6525,7187,7704,1971,Bulgaria,Russia,1,1,Friendly,Sofia,Bulgaria,False,2,0,Draw
6526,7188,7705,1971,Guinea,Gambia,4,2,Friendly,Conakry,Guinea,False,6,2,Guinea
6527,7190,7707,1971,Ivory Coast,Ghana,2,6,Friendly,Abidjan,Ivory Coast,False,8,-4,Ghana
6528,7192,7710,1971,Cambodia,Malaysia,1,3,Korea Cup,Seoul,South Korea,True,4,-2,Malaysia
6529,7193,7711,1971,Cambodia,Thailand,3,4,Korea Cup,Seoul,South Korea,True,7,-1,Thailand
6530,7194,7712,1971,Switzerland,Poland,2,4,Friendly,Lausanne,Switzerland,False,6,-2,Poland
6531,7196,7715,1971,Burma,Indonesia,3,1,Korea Cup,Seoul,South Korea,True,4,2,Burma
6532,7197,7716,1971,Malaysia,Thailand,4,1,Korea Cup,Seoul,South Korea,True,5,3,Malaysia
6533,7198,7717,1971,Cyprus,Spain,0,2,UEFA Euro qualification,Nicosia,Cyprus,False,2,-2,Spain
6534,7199,7720,1971,Republic of Ireland,Italy,1,2,UEFA Euro qualification,Dublin,Republic of Ireland,False,3,-1,Italy
6535,7200,7721,1971,Burma,Malaysia,6,1,Korea Cup,Seoul,South Korea,True,7,5,Burma
6536,7201,7723,1971,Albania,Poland,1,1,UEFA Euro qualification,Tirana,Albania,False,2,0,Draw
6537,7202,7724,1971,England,Malta,5,0,UEFA Euro qualification,London,England,False,5,5,England
6538,7203,7725,1971,Portugal,Denmark,5,0,UEFA Euro qualification,Porto,Portugal,False,5,5,Portugal
6539,7204,7726,1971,Switzerland,Greece,1,0,UEFA Euro qualification,Berne,Switzerland,False,1,1,Switzerland
6540,7205,7727,1971,Indonesia,Malaysia,4,2,Korea Cup,Seoul,South Korea,True,6,2,Indonesia
6541,7206,7730,1971,Malaysia,Thailand,0,3,Friendly,Taipei,Chinese Taipei,True,3,-3,Thailand
6542,7207,7731,1971,Northern Ireland,England,0,1,British Championship,Belfast,Northern Ireland,False,1,-1,England
6543,7208,7732,1971,Wales,Scotland,0,0,British Championship,Cardiff,Wales,False,0,0,Draw
6544,7209,7734,1971,Scotland,Northern Ireland,0,1,British Championship,Glasgow,Scotland,False,1,-1,Northern Ireland
6545,7210,7735,1971,Bulgaria,Hungary,3,0,UEFA Euro qualification,Sofia,Bulgaria,False,3,3,Bulgaria
6546,7211,7736,1971,England,Wales,0,0,British Championship,London,England,False,0,0,Draw
6547,7212,7737,1971,Luxembourg,Belgium,0,4,Friendly,Luxembourg,Luxembourg,False,4,-4,Belgium
6548,7213,7738,1971,Sweden,Finland,4,1,Nordic Championship,Borås,Sweden,False,5,3,Sweden
6549,7214,7740,1971,Thailand,Cambodia,1,1,AFC Asian Cup qualification,Bangkok,Thailand,False,2,0,Draw
6550,7215,7741,1971,England,Scotland,3,1,British Championship,London,England,False,4,2,England
6551,7216,7742,1971,Indonesia,Hong Kong,2,1,AFC Asian Cup qualification,Bangkok,Thailand,True,3,1,Indonesia
6552,7217,7743,1971,Malaysia,Brunei,8,0,AFC Asian Cup qualification,Bangkok,Thailand,True,8,8,Malaysia
6553,7218,7744,1971,Northern Ireland,Wales,1,0,British Championship,Belfast,Northern Ireland,False,1,1,Northern Ireland
6554,7219,7745,1971,Cambodia,Hong Kong,2,1,AFC Asian Cup qualification,Bangkok,Thailand,True,3,1,Cambodia
6555,7220,7746,1971,Thailand,Brunei,10,0,AFC Asian Cup qualification,Bangkok,Thailand,False,10,10,Thailand
6556,7221,7747,1971,Uganda,Malawi,3,3,Friendly,Kampala,Uganda,False,6,0,Draw
6557,7222,7748,1971,Denmark,Belgium,1,2,UEFA Euro qualification,Copenhagen,Denmark,False,3,-1,Belgium
6558,7223,7749,1971,Finland,Wales,0,1,UEFA Euro qualification,Helsinki,Finland,False,1,-1,Wales
6559,7224,7750,1971,Malaysia,Cambodia,2,1,AFC Asian Cup qualification,Bangkok,Thailand,True,3,1,Malaysia
6560,7225,7751,1971,Norway,Iceland,3,1,Friendly,Bergen,Norway,False,4,2,Norway
6561,7226,7752,1971,Sweden,Austria,1,0,UEFA Euro qualification,Solna,Sweden,False,1,1,Sweden
6562,7227,7753,1971,Thailand,Indonesia,0,1,AFC Asian Cup qualification,Bangkok,Thailand,False,1,-1,Indonesia
6563,7228,7754,1971,Indonesia,Brunei,9,0,AFC Asian Cup qualification,Bangkok,Thailand,True,9,9,Indonesia
6564,7229,7755,1971,Malaysia,Hong Kong,2,1,AFC Asian Cup qualification,Bangkok,Thailand,True,3,1,Malaysia
6565,7230,7756,1971,Cambodia,Indonesia,2,0,AFC Asian Cup qualification,Bangkok,Thailand,True,2,2,Cambodia
6566,7231,7757,1971,Republic of Ireland,Austria,1,4,UEFA Euro qualification,Dublin,Republic of Ireland,False,5,-3,Austria
6567,7232,7758,1971,Russia,Spain,2,1,UEFA Euro qualification,Moscow,Soviet Union,False,3,1,Russia
6568,7233,7759,1971,Thailand,Malaysia,1,0,AFC Asian Cup qualification,Bangkok,Thailand,False,1,1,Thailand
6569,7234,7760,1971,Malaysia,Indonesia,3,0,AFC Asian Cup qualification,Bangkok,Thailand,True,3,3,Malaysia
6570,7235,7761,1971,Thailand,Cambodia,4,2,AFC Asian Cup qualification,Bangkok,Thailand,False,6,2,Thailand
6571,7236,7762,1971,Zambia,Ethiopia,5,1,Friendly,Lusaka,Zambia,False,6,4,Zambia
6572,7237,7763,1971,Indonesia,Singapore,3,0,Indonesia Tournament,Jakarta,Indonesia,False,3,3,Indonesia
6573,7239,7766,1971,India,Thailand,0,1,Indonesia Tournament,Jakarta,Indonesia,True,1,-1,Thailand
6574,7240,7767,1971,Zambia,DR Congo,2,1,African Cup of Nations qualification,Ndola,Zambia,False,3,1,Zambia
6575,7241,7768,1971,Indonesia,Burma,1,1,Indonesia Tournament,Jakarta,Indonesia,False,2,0,Draw
6576,7242,7769,1971,Russia,Cyprus,6,1,UEFA Euro qualification,Moscow,Soviet Union,False,7,5,Russia
6577,7243,7770,1971,Cambodia,Malaysia,1,1,Indonesia Tournament,Jakarta,Indonesia,True,2,0,Draw
6578,7245,7772,1971,Burma,Singapore,6,0,Indonesia Tournament,Jakarta,Indonesia,True,6,6,Burma
6579,7246,7773,1971,Denmark,Scotland,1,0,UEFA Euro qualification,Copenhagen,Denmark,False,1,1,Denmark
6580,7248,7775,1971,Norway,Bulgaria,1,4,UEFA Euro qualification,Oslo,Norway,False,5,-3,Bulgaria
6581,7249,7776,1971,Sweden,Italy,0,0,UEFA Euro qualification,Solna,Sweden,False,0,0,Draw
6582,7250,7777,1971,Burma,Malaysia,5,1,Indonesia Tournament,Jakarta,Indonesia,True,6,4,Burma
6583,7251,7778,1971,Indonesia,Thailand,0,0,Indonesia Tournament,Jakarta,Indonesia,False,0,0,Draw
6584,7253,7780,1971,Cambodia,Thailand,3,0,Indonesia Tournament,Jakarta,Indonesia,True,3,3,Cambodia
6585,7254,7781,1971,Germany,Albania,2,0,UEFA Euro qualification,Karlsruhe,Germany,False,2,2,Germany
6586,7255,7782,1971,Indonesia,Cambodia,1,0,Indonesia Tournament,Jakarta,Indonesia,False,1,1,Indonesia
6587,7256,7784,1971,Burma,Cambodia,8,0,Indonesia Tournament,Jakarta,Indonesia,True,8,8,Burma
6588,7257,7785,1971,Indonesia,Malaysia,2,1,Indonesia Tournament,Jakarta,Indonesia,False,3,1,Indonesia
6589,7258,7786,1971,Russia,Scotland,1,0,Friendly,Moscow,Soviet Union,False,1,1,Russia
6590,7259,7787,1971,Cambodia,Malaysia,1,2,Indonesia Tournament,Jakarta,Indonesia,True,3,-1,Malaysia
6591,7261,7789,1971,Indonesia,Burma,0,1,Indonesia Tournament,Jakarta,Indonesia,False,1,-1,Burma
6592,7262,7790,1971,Greece,Malta,2,0,UEFA Euro qualification,Piraeus,Greece,False,2,2,Greece
6593,7263,7791,1971,DR Congo,Zambia,3,0,African Cup of Nations qualification,Kinshasa,DR Congo,False,3,3,DR Congo
6594,7264,7792,1971,Denmark,Sweden,1,3,Nordic Championship,Copenhagen,Denmark,False,4,-2,Sweden
6595,7265,7793,1971,Norway,Germany,1,7,Friendly,Oslo,Norway,False,8,-6,Germany
6596,7266,7794,1971,Kenya,Sudan,3,3,Friendly,Nairobi,Kenya,False,6,0,Draw
6597,7267,7795,1971,Hong Kong,Thailand,6,0,Friendly,Victoria,Hong Kong,False,6,6,Hong Kong
6598,7268,7796,1971,Madagascar,Mauritius,1,1,Friendly,Antananarivo,Madagascar,False,2,0,Draw
6599,7269,7797,1971,Sweden,Germany,1,0,Friendly,Gothenburg,Sweden,False,1,1,Sweden
6600,7270,7798,1971,Denmark,Germany,1,3,Friendly,Copenhagen,Denmark,False,4,-2,Germany
6601,7271,7799,1971,Ivory Coast,Congo,3,2,African Cup of Nations qualification,Abidjan,Ivory Coast,False,5,1,Ivory Coast
6602,7272,7800,1971,Kenya,Mauritius,2,1,African Cup of Nations qualification,Nairobi,Kenya,False,3,1,Kenya
6603,7273,7801,1971,Paraguay,Argentina,1,1,Copa Chevallier Boutell,Asunción,Paraguay,False,2,0,Draw
6604,7274,7802,1971,Zambia,Cyprus,3,0,Friendly,Lusaka,Zambia,False,3,3,Zambia
6605,7275,7803,1971,Malawi,Uganda,3,1,Friendly,Blantyre,Malawi,False,4,2,Malawi
6606,7276,7804,1971,Mexico,Greece,1,1,Friendly,Mexico City,Mexico,False,2,0,Draw
6607,7277,7805,1971,Zambia,Cyprus,3,0,Friendly,Kitwe,Zambia,False,3,3,Zambia
6608,7278,7806,1971,Argentina,Paraguay,1,0,Copa Chevallier Boutell,Rosario,Argentina,False,1,1,Argentina
6609,7279,7807,1971,Libya,Syria,2,1,Friendly,Benghazi,Libya,False,3,1,Libya
6610,7280,7808,1971,Malawi,Uganda,0,1,Friendly,Blantyre,Malawi,False,1,-1,Uganda
6611,7281,7809,1971,Brazil,Austria,1,1,Friendly,São Paulo,Brazil,False,2,0,Draw
6612,7282,7810,1971,Egypt,Syria,1,0,Friendly,Benghazi,Libya,True,1,1,Egypt
6613,7283,7811,1971,Sudan,Palestine,1,1,Friendly,Tripoli,Libya,True,2,0,Draw
6614,7284,7812,1971,Zambia,Cyprus,3,0,Friendly,Ndola,Zambia,False,3,3,Zambia
6615,7285,7813,1971,Libya,Egypt,0,2,Friendly,Benghazi,Libya,False,2,-2,Egypt
6616,7286,7814,1971,Argentina,Uruguay,1,0,Friendly,Buenos Aires,Argentina,False,1,1,Argentina
6617,7288,7816,1971,Chile,Paraguay,3,2,Friendly,Santiago,Chile,False,5,1,Chile
6618,7289,7817,1971,Martinique,Guadeloupe,2,1,Friendly,Fort-de-France,Martinique,False,3,1,Martinique
6619,7290,7818,1971,Tanzania,Guinea,3,2,Friendly,Dar es Salaam,Tanzania,False,5,1,Tanzania
6620,7291,7819,1971,Libya,Sudan,4,6,Friendly,Benghazi,Libya,False,10,-2,Sudan
6621,7293,7821,1971,Congo,Ivory Coast,2,0,African Cup of Nations qualification,Brazzaville,Congo,False,2,2,Congo
6622,7294,7822,1971,Libya,Egypt,2,0,Friendly,Tripoli,Libya,False,2,2,Libya
6623,7295,7823,1971,Mauritius,Kenya,0,0,African Cup of Nations qualification,Port Louis,Mauritius,False,0,0,Draw
6624,7296,7824,1971,New Caledonia,New Zealand,4,2,Friendly,Nouméa,New Caledonia,False,6,2,New Caledonia
6625,7297,7825,1971,Uruguay,Argentina,1,1,Friendly,Montevideo,Uruguay,False,2,0,Draw
6626,7298,7826,1971,Zambia,Guinea,4,2,Friendly,Lusaka,Zambia,False,6,2,Zambia
6627,7299,7827,1971,New Caledonia,New Zealand,2,1,Friendly,Nouméa,New Caledonia,False,3,1,New Caledonia
6628,7300,7828,1971,Chile,Argentina,2,2,Copa Carlos Dittborn,Santiago,Chile,False,4,0,Draw
6629,7301,7829,1971,Guadeloupe,Martinique,1,1,Friendly,Basse-Terre,Guadeloupe,False,2,0,Draw
6630,7302,7830,1971,Zambia,Guinea,1,5,Friendly,Mufulira,Zambia,False,6,-4,Guinea
6631,7303,7831,1971,Brazil,Paraguay,1,0,Friendly,Rio de Janeiro,Brazil,False,1,1,Brazil
6632,7304,7832,1971,Senegal,Sierra Leone,2,1,Friendly,Dakar,Senegal,False,3,1,Senegal
6633,7305,7833,1971,Zambia,Guinea,2,1,Friendly,Ndola,Zambia,False,3,1,Zambia
6634,7306,7834,1971,Peru,Paraguay,0,0,Friendly,Lima,Peru,False,0,0,Draw
6635,7307,7835,1971,Argentina,Brazil,1,1,Copa Roca,Buenos Aires,Argentina,False,2,0,Draw
6636,7308,7836,1971,Denmark,Japan,3,2,Friendly,Copenhagen,Denmark,False,5,1,Denmark
6637,7309,7837,1971,Argentina,Brazil,2,2,Copa Roca,Buenos Aires,Argentina,False,4,0,Draw
6638,7310,7838,1971,Argentina,Chile,1,0,Copa Carlos Dittborn,Buenos Aires,Argentina,False,1,1,Argentina
6639,7312,7840,1971,Hong Kong,Singapore,1,2,Merdeka Tournament,Kuala Lumpur,Malaysia,True,3,-1,Singapore
6640,7313,7841,1971,India,Philippines,5,1,Merdeka Tournament,Kuala Lumpur,Malaysia,True,6,4,India
6641,7314,7842,1971,Burma,Singapore,0,1,Merdeka Tournament,Kuala Lumpur,Malaysia,True,1,-1,Singapore
6642,7315,7843,1971,India,Indonesia,1,3,Merdeka Tournament,Kuala Lumpur,Malaysia,True,4,-2,Indonesia
6643,7316,7844,1971,Paraguay,Chile,2,0,Friendly,Asunción,Paraguay,False,2,2,Paraguay
6644,7317,7845,1971,Sweden,Norway,3,0,Nordic Championship,Malmö,Sweden,False,3,3,Sweden
6645,7318,7846,1971,Burma,Indonesia,2,2,Merdeka Tournament,Kuala Lumpur,Malaysia,True,4,0,Draw
6646,7319,7847,1971,Hong Kong,Philippines,2,1,Merdeka Tournament,Kuala Lumpur,Malaysia,True,3,1,Hong Kong
6647,7320,7848,1971,India,Singapore,2,2,Merdeka Tournament,Kuala Lumpur,Malaysia,True,4,0,Draw
6648,7322,7850,1971,Burma,Hong Kong,4,0,Merdeka Tournament,Kuala Lumpur,Malaysia,True,4,4,Burma
6649,7323,7851,1971,Indonesia,Philippines,3,1,Merdeka Tournament,Kuala Lumpur,Malaysia,True,4,2,Indonesia
6650,7324,7852,1971,Peru,Chile,1,0,Copa del Pacífico,Lima,Peru,False,1,1,Peru
6651,7325,7853,1971,Burma,Philippines,2,0,Merdeka Tournament,Kuala Lumpur,Malaysia,True,2,2,Burma
6652,7326,7854,1971,Hong Kong,India,2,1,Merdeka Tournament,Kuala Lumpur,Malaysia,True,3,1,Hong Kong
6653,7327,7855,1971,Iceland,Japan,0,2,Friendly,Reykjavík,Iceland,False,2,-2,Japan
6654,7328,7856,1971,Indonesia,Singapore,4,0,Merdeka Tournament,Ipoh,Malaysia,True,4,4,Indonesia
6655,7329,7857,1971,Bolivia,Chile,3,4,Friendly,La Paz,Bolivia,False,7,-1,Chile
6656,7330,7858,1971,Burma,India,9,1,Merdeka Tournament,Kuala Lumpur,Malaysia,True,10,8,Burma
6657,7331,7859,1971,Hong Kong,Indonesia,0,3,Merdeka Tournament,Ipoh,Malaysia,True,3,-3,Indonesia
6658,7332,7860,1971,Paraguay,Peru,2,0,Friendly,Asunción,Paraguay,False,2,2,Paraguay
6659,7333,7861,1971,Philippines,Singapore,4,4,Merdeka Tournament,Kuala Lumpur,Malaysia,True,8,0,Draw
6660,7334,7862,1971,Philippines,Thailand,3,1,Merdeka Tournament,Kuala Lumpur,Malaysia,True,4,2,Philippines
6661,7335,7863,1971,Chile,Peru,1,0,Copa del Pacífico,Santiago,Chile,False,1,1,Chile
6662,7336,7864,1971,Guinea,Senegal,1,0,African Cup of Nations qualification,Conakry,Guinea,False,1,1,Guinea
6663,7339,7867,1971,Burma,Indonesia,1,0,Merdeka Tournament,Kuala Lumpur,Malaysia,True,1,1,Burma
6664,7341,7869,1971,Saint Lucia,Saint Vincent and the Grenadines,1,5,Friendly,Castries,Saint Lucia,False,6,-4,Saint Vincent and the Grenadines
6665,7342,7870,1971,India,Indonesia,2,1,Friendly,Kallang,Singapore,True,3,1,India
6666,7343,7871,1971,Singapore,Malaysia,2,2,Friendly,Kallang,Singapore,False,4,0,Draw
6667,7344,7872,1971,Philippines,Thailand,0,1,Friendly,Kallang,Singapore,True,1,-1,Thailand
6668,7345,7873,1971,Finland,Norway,1,1,Nordic Championship,Helsinki,Finland,False,2,0,Draw
6669,7346,7874,1971,India,Malaysia,6,0,Friendly,Kallang,Singapore,True,6,6,India
6670,7348,7876,1971,Singapore,Indonesia,3,2,Friendly,Kallang,Singapore,False,5,1,Singapore
6671,7351,7880,1971,Senegal,Guinea,0,0,African Cup of Nations qualification,Dakar,Senegal,False,0,0,Draw
6672,7352,7881,1971,Austria,Sweden,1,0,UEFA Euro qualification,Vienna,Austria,False,1,1,Austria
6673,7353,7882,1971,Honduras,Guatemala,1,0,CONCACAF Championship qualification,Tegucigalpa,Honduras,False,1,1,Honduras
6674,7354,7883,1971,Denmark,Finland,0,0,Nordic Championship,Copenhagen,Denmark,False,0,0,Draw
6675,7355,7884,1971,Germany,Mexico,5,0,Friendly,Hanover,Germany,False,5,5,Germany
6676,7356,7885,1971,Norway,France,1,3,UEFA Euro qualification,Oslo,Norway,False,4,-2,France
6677,7357,7886,1971,Fiji,New Caledonia,1,5,South Pacific Games,Papeete,French Polynesia,True,6,-4,New Caledonia
6678,7358,7889,1971,Cook Islands,Papua New Guinea,1,16,South Pacific Games,Papeete,French Polynesia,True,17,-15,Papua New Guinea
6679,7359,7890,1971,Fiji,Vanuatu,4,6,South Pacific Games,Papeete,French Polynesia,True,10,-2,Vanuatu
6680,7360,7892,1971,New Caledonia,Vanuatu,0,0,South Pacific Games,Papeete,French Polynesia,True,0,0,Draw
6681,7361,7894,1971,Guatemala,Honduras,1,1,CONCACAF Championship qualification,Guatemala,Guatemala,False,2,0,Draw
6682,7362,7895,1971,Cook Islands,Fiji,1,15,South Pacific Games,Papeete,French Polynesia,True,16,-14,Fiji
6683,7363,7896,1971,El Salvador,Nicaragua,1,0,CONCACAF Championship qualification,San Salvador,El Salvador,False,1,1,El Salvador
6684,7364,7897,1971,New Caledonia,Papua New Guinea,4,0,South Pacific Games,Papeete,French Polynesia,True,4,4,New Caledonia
6685,7365,7900,1971,Russia,India,5,0,Friendly,Moscow,Soviet Union,False,5,5,Russia
6686,7366,7902,1971,New Caledonia,Vanuatu,7,1,South Pacific Games,Papeete,French Polynesia,True,8,6,New Caledonia
6687,7367,7903,1971,Finland,Romania,0,4,UEFA Euro qualification,Helsinki,Finland,False,4,-4,Romania
6688,7368,7904,1971,Poland,Turkey,5,1,UEFA Euro qualification,Cracow,Poland,False,6,4,Poland
6689,7369,7905,1971,Russia,Northern Ireland,1,0,UEFA Euro qualification,Moscow,Soviet Union,False,1,1,Russia
6690,7370,7908,1971,Hungary,Bulgaria,2,0,UEFA Euro qualification,Budapest,Hungary,False,2,2,Hungary
6691,7371,7909,1971,Italy,Mexico,2,0,Friendly,Genoa,Italy,False,2,2,Italy
6692,7372,7910,1971,Kenya,Tanzania,1,1,Friendly,Nairobi,Kenya,False,2,0,Draw
6693,7373,7911,1971,Norway,Denmark,1,4,Nordic Championship,Oslo,Norway,False,5,-3,Denmark
6694,7374,7912,1971,Switzerland,Turkey,4,0,Friendly,Zürich,Switzerland,False,4,4,Switzerland
6695,7376,7914,1971,Uganda,Tanzania,0,0,Friendly,Nairobi,Kenya,True,0,0,Draw
6696,7377,7915,1971,Greece,Mexico,0,1,Friendly,Salonica,Greece,False,1,-1,Mexico
6697,7379,7917,1971,Jamaica,Cuba,0,1,CONCACAF Championship qualification,Kingston,Jamaica,False,1,-1,Cuba
6698,7381,7919,1971,Kenya,Uganda,2,0,Friendly,Nairobi,Kenya,False,2,2,Kenya
6699,7382,7920,1971,Cuba,Jamaica,0,0,CONCACAF Championship qualification,Havana,Cuba,False,0,0,Draw
6700,7383,7921,1971,Lesotho,Malawi,0,0,Friendly,Maseru,Lesotho,False,0,0,Draw
6701,7384,7922,1971,France,Hungary,0,2,UEFA Euro qualification,Colombes,France,False,2,-2,Hungary
6702,7385,7923,1971,Italy,Sweden,3,0,UEFA Euro qualification,Milan,Italy,False,3,3,Italy
6703,7386,7924,1971,Austria,Republic of Ireland,6,0,UEFA Euro qualification,Linz,Austria,False,6,6,Austria
6704,7387,7925,1971,Lesotho,Malawi,0,2,Friendly,Maseru,Lesotho,False,2,-2,Malawi
6705,7389,7927,1971,Poland,Germany,1,3,UEFA Euro qualification,Warsaw,Poland,False,4,-2,Germany
6706,7390,7928,1971,Northern Ireland,Russia,1,1,UEFA Euro qualification,Belfast,Northern Ireland,False,2,0,Draw
6707,7391,7929,1971,Scotland,Portugal,2,1,UEFA Euro qualification,Glasgow,Scotland,False,3,1,Scotland
6708,7392,7930,1971,Switzerland,England,2,3,UEFA Euro qualification,Basel,Switzerland,False,5,-1,England
6709,7393,7931,1971,Wales,Finland,3,0,UEFA Euro qualification,Swansea,Wales,False,3,3,Wales
6710,7394,7933,1971,Zambia,Kenya,0,2,Friendly,Ndola,Zambia,False,2,-2,Kenya
6711,7395,7934,1971,Zambia,Kenya,3,1,Friendly,Kitwe,Zambia,False,4,2,Zambia
6712,7396,7935,1971,Zambia,Kenya,0,1,Friendly,Lusaka,Zambia,False,1,-1,Kenya
6713,7397,7937,1971,Hungary,Norway,4,0,UEFA Euro qualification,Budapest,Hungary,False,4,4,Hungary
6714,7398,7938,1971,Spain,Russia,0,0,UEFA Euro qualification,Seville,Spain,False,0,0,Draw
6715,7399,7939,1971,Uruguay,Chile,3,0,Copa Juan Pinto Durán,Montevideo,Uruguay,False,3,3,Uruguay
6716,7400,7941,1971,Singapore,Thailand,0,1,Vietnam Independence Cup,Saigon,Vietnam Republic,True,1,-1,Thailand
6717,7401,7943,1971,Malaysia,Singapore,1,1,Vietnam Independence Cup,Saigon,Vietnam Republic,True,2,0,Draw
6718,7402,7945,1971,Martinique,Haiti,2,2,Friendly,Fort-de-France,Martinique,False,4,0,Draw
6719,7403,7946,1971,Singapore,Thailand,3,1,Vietnam Independence Cup,Saigon,Vietnam Republic,True,4,2,Singapore
6720,7404,7948,1971,Chile,Uruguay,5,0,Copa Juan Pinto Durán,Santiago,Chile,False,5,5,Chile
6721,7405,7949,1971,Belgium,Luxembourg,1,0,Friendly,Verviers,Belgium,False,1,1,Belgium
6722,7406,7950,1971,Thailand,Singapore,2,0,King's Cup,Bangkok,Thailand,False,2,2,Thailand
6723,7408,7953,1971,England,Switzerland,1,1,UEFA Euro qualification,London,England,False,2,0,Draw
6724,7409,7954,1971,France,Bulgaria,2,1,UEFA Euro qualification,Nantes,France,False,3,1,France
6725,7410,7955,1971,Indonesia,Malaysia,2,0,King's Cup,Bangkok,Thailand,True,2,2,Indonesia
6726,7411,7956,1971,Scotland,Belgium,1,0,UEFA Euro qualification,Aberdeen,Scotland,False,1,1,Scotland
6727,7412,7957,1971,Australia,Israel,2,2,Friendly,Brisbane,Australia,False,4,0,Draw
6728,7415,7960,1971,Albania,Turkey,3,0,UEFA Euro qualification,Tirana,Albania,False,3,3,Albania
6729,7416,7961,1971,Australia,Israel,1,0,Friendly,Sydney,Australia,False,1,1,Australia
6730,7417,7962,1971,Guinea,Tanzania,3,2,Friendly,Conakry,Guinea,False,5,1,Guinea
6731,7418,7964,1971,Malta,Hungary,0,2,FIFA World Cup qualification,Gżira,Malta,False,2,-2,Hungary
6732,7420,7966,1971,Thailand,Indonesia,1,0,King's Cup,Bangkok,Thailand,False,1,1,Thailand
6733,7422,7968,1971,Bulgaria,Greece,2,2,Friendly,Sofia,Bulgaria,False,4,0,Draw
6734,7423,7969,1971,Germany,Poland,0,0,UEFA Euro qualification,Hamburg,Germany,False,0,0,Draw
6735,7424,7970,1971,Netherlands,Luxembourg,8,0,UEFA Euro qualification,Eindhoven,Netherlands,False,8,8,Netherlands
6736,7425,7971,1971,Iraq,Kuwait,3,1,Friendly,Baghdad,Iraq,False,4,2,Iraq
6737,7426,7972,1971,Italy,Austria,2,2,UEFA Euro qualification,Rome,Italy,False,4,0,Draw
6738,7427,7973,1971,Australia,Israel,1,3,Friendly,Melbourne,Australia,False,4,-2,Israel
6739,7428,7974,1971,Haiti,Mexico,0,0,CONCACAF Championship,San Fernando,Trinidad and Tobago,True,0,0,Draw
6740,7429,7975,1971,Portugal,Belgium,1,1,UEFA Euro qualification,Lisbon,Portugal,False,2,0,Draw
6741,7430,7976,1971,Cuba,Honduras,3,1,CONCACAF Championship,Port of Spain,Trinidad and Tobago,True,4,2,Cuba
6742,7431,7977,1971,Costa Rica,Haiti,0,0,CONCACAF Championship,Port of Spain,Trinidad and Tobago,True,0,0,Draw
6743,7432,7978,1971,Libya,Algeria,0,0,Friendly,Tripoli,Libya,False,0,0,Draw
6744,7433,7979,1971,Romania,Wales,2,0,UEFA Euro qualification,Bucharest,Romania,False,2,2,Romania
6745,7434,7980,1971,Spain,Cyprus,7,0,UEFA Euro qualification,Granada,Spain,False,7,7,Spain
6746,7435,7981,1971,Trinidad and Tobago,Mexico,0,2,CONCACAF Championship,Port of Spain,Trinidad and Tobago,False,2,-2,Mexico
6747,7436,7982,1971,Grenada,Saint Lucia,5,2,Windward Islands Tournament,Roseau,Dominica,True,7,3,Grenada
6748,7437,7983,1971,Nigeria,Burkina Faso,4,0,Friendly,Lagos,Nigeria,False,4,4,Nigeria
6749,7438,7984,1971,Cuba,Mexico,0,1,CONCACAF Championship,San Fernando,Trinidad and Tobago,True,1,-1,Mexico
6750,7439,7985,1971,Dominica,Saint Vincent and the Grenadines,3,0,Windward Islands Tournament,Roseau,Dominica,False,3,3,Dominica
6751,7440,7986,1971,Trinidad and Tobago,Haiti,1,6,CONCACAF Championship,Arima,Trinidad and Tobago,False,7,-5,Haiti
6752,7441,7987,1971,Barbados,Curaçao,1,3,Friendly,Bridgetown,Barbados,False,4,-2,Curaçao
6753,7442,7988,1971,Grenada,Saint Vincent and the Grenadines,1,1,Windward Islands Tournament,Roseau,Dominica,True,2,0,Draw
6754,7443,7989,1971,Togo,Burkina Faso,1,0,Friendly,Lomé,Togo,False,1,1,Togo
6755,7444,7990,1971,Dominica,Saint Lucia,2,2,Windward Islands Tournament,Roseau,Dominica,False,4,0,Draw
6756,7445,7991,1971,Greece,England,0,2,UEFA Euro qualification,Piraeus,Greece,False,2,-2,England
6757,7446,7992,1971,Guinea,Nigeria,3,0,Friendly,Conakry,Guinea,False,3,3,Guinea
6758,7447,7993,1971,Haiti,Honduras,3,1,CONCACAF Championship,Port of Spain,Trinidad and Tobago,True,4,2,Haiti
6759,7448,7994,1971,Netherlands,Scotland,2,1,Friendly,Amsterdam,Netherlands,False,3,1,Netherlands
6760,7449,7995,1971,Costa Rica,Mexico,0,1,CONCACAF Championship,Port of Spain,Trinidad and Tobago,True,1,-1,Mexico
6761,7450,7996,1971,Bulgaria,France,2,1,UEFA Euro qualification,Sofia,Bulgaria,False,3,1,Bulgaria
6762,7451,7997,1971,Cuba,Haiti,0,0,CONCACAF Championship,San Fernando,Trinidad and Tobago,True,0,0,Draw
6763,7452,7998,1971,Dominica,Grenada,3,0,Windward Islands Tournament,Roseau,Dominica,False,3,3,Dominica
6764,7453,7999,1971,Honduras,Mexico,1,2,CONCACAF Championship,Port of Spain,Trinidad and Tobago,True,3,-1,Mexico
6765,7454,8000,1971,Sierra Leone,Nigeria,0,1,Friendly,Freetown,Sierra Leone,False,1,-1,Nigeria
6766,7455,8001,1971,Kenya,Zambia,1,0,Friendly,Kisumu,Kenya,False,1,1,Kenya
6767,7456,8002,1971,Tanzania,Burundi,4,1,Friendly,Dar es Salaam,Tanzania,False,5,3,Tanzania
6768,7457,8003,1971,Turkey,Poland,1,0,UEFA Euro qualification,Izmir,Turkey,False,1,1,Turkey
6769,7458,8004,1971,Kenya,Zambia,3,2,Friendly,Nakuru,Kenya,False,5,1,Kenya
6770,7459,8005,1971,Malta,Algeria,1,1,Friendly,Gżira,Malta,False,2,0,Draw
6771,7461,8007,1971,Kuwait,Iraq,1,1,AFC Asian Cup qualification,Kuwait City,Kuwait,False,2,0,Draw
6772,7462,8008,1971,Bahrain,Lebanon,3,0,AFC Asian Cup qualification,Kuwait City,Kuwait,True,3,3,Bahrain
6773,7463,8009,1971,Syria,Jordan,0,0,AFC Asian Cup qualification,Kuwait City,Kuwait,True,0,0,Draw
6774,7464,8010,1971,Burkina Faso,Togo,1,2,Friendly,Ouagadougou,Upper Volta,False,3,-1,Togo
6775,7465,8011,1971,Kenya,Zambia,0,2,Friendly,Nairobi,Kenya,False,2,-2,Zambia
6776,7467,8013,1971,Iraq,Sri Lanka,5,0,AFC Asian Cup qualification,Kuwait City,Kuwait,True,5,5,Iraq
6777,7468,8014,1971,Jordan,Bahrain,3,2,AFC Asian Cup qualification,Kuwait City,Kuwait,True,5,1,Jordan
6778,7469,8015,1971,Kuwait,Lebanon,1,0,AFC Asian Cup qualification,Kuwait City,Kuwait,False,1,1,Kuwait
6779,7470,8016,1971,Iraq,Bahrain,1,0,AFC Asian Cup qualification,Kuwait City,Kuwait,True,1,1,Iraq
6780,7471,8017,1971,Jordan,Sri Lanka,2,1,AFC Asian Cup qualification,Kuwait City,Kuwait,True,3,1,Jordan
6781,7472,8018,1971,Kuwait,Syria,2,2,AFC Asian Cup qualification,Kuwait City,Kuwait,False,4,0,Draw
6782,7473,8019,1971,Iraq,Jordan,2,0,AFC Asian Cup qualification,Kuwait City,Kuwait,True,2,2,Iraq
6783,7474,8020,1971,Lebanon,Syria,3,2,AFC Asian Cup qualification,Kuwait City,Kuwait,True,5,1,Lebanon
6784,7475,8021,1971,Niger,Libya,0,1,Friendly,Niamey,Niger,False,1,-1,Libya
6785,7476,8022,1971,Senegal,Mali,4,1,Friendly,Dakar,Senegal,False,5,3,Senegal
6786,7477,8023,1971,Bahrain,Sri Lanka,3,0,AFC Asian Cup qualification,Kuwait City,Kuwait,True,3,3,Bahrain
6787,7478,8024,1971,Kuwait,Jordan,2,0,AFC Asian Cup qualification,Kuwait City,Kuwait,False,2,2,Kuwait
6788,7479,8025,1971,Iraq,Lebanon,4,1,AFC Asian Cup qualification,Kuwait City,Kuwait,True,5,3,Iraq
6789,7480,8026,1971,Kuwait,Iraq,0,1,AFC Asian Cup qualification,Kuwait City,Kuwait,False,1,-1,Iraq
6790,7481,8027,1971,Lebanon,Jordan,2,0,AFC Asian Cup qualification,Kuwait City,Kuwait,True,2,2,Lebanon
6791,7482,8028,1972,Algeria,Palestine,2,0,Friendly,Baghdad,Iraq,True,2,2,Algeria
6792,7483,8029,1972,Iraq,Egypt,0,0,Friendly,Baghdad,Iraq,False,0,0,Draw
6793,7484,8030,1972,Kuwait,Libya,3,2,Friendly,Baghdad,Iraq,True,5,1,Kuwait
6794,7487,8033,1972,Algeria,Qatar,3,0,Friendly,Baghdad,Iraq,True,3,3,Algeria
6795,7488,8034,1972,Palestine,Syria,1,3,Friendly,Baghdad,Iraq,True,4,-2,Syria
6796,7489,8035,1972,Egypt,Kuwait,2,0,Friendly,Baghdad,Iraq,True,2,2,Egypt
6797,7490,8036,1972,Iraq,Libya,3,0,Friendly,Baghdad,Iraq,False,3,3,Iraq
6798,7492,8038,1972,Syria,Qatar,3,2,Friendly,Baghdad,Iraq,True,5,1,Syria
6799,7493,8039,1972,Egypt,Libya,1,1,Friendly,Baghdad,Iraq,True,2,0,Draw
6800,7494,8040,1972,Iraq,Kuwait,3,1,Friendly,Baghdad,Iraq,False,4,2,Iraq
6801,7495,8041,1972,Algeria,Syria,0,1,Friendly,Baghdad,Iraq,True,1,-1,Syria
6802,7497,8043,1972,Burkina Faso,Nigeria,3,3,Friendly,Ouagadougou,Upper Volta,False,6,0,Draw
6803,7498,8044,1972,Senegal,Congo,0,2,Friendly,Dakar,Senegal,False,2,-2,Congo
6804,7500,8046,1972,Palestine,Qatar,7,2,Friendly,Baghdad,Iraq,True,9,5,Palestine
6805,7501,8047,1972,Guinea,Congo,0,1,Friendly,Conakry,Guinea,False,1,-1,Congo
6806,7502,8048,1972,Iraq,Algeria,3,1,Friendly,Baghdad,Iraq,False,4,2,Iraq
6807,7503,8049,1972,Spain,Hungary,1,0,Friendly,Madrid,Spain,False,1,1,Spain
6808,7504,8050,1972,Algeria,Syria,3,1,Friendly,Baghdad,Iraq,True,4,2,Algeria
6809,7506,8052,1972,Togo,Benin,4,0,Friendly,Lomé,Togo,False,4,4,Togo
6810,7507,8053,1972,Mexico,Chile,2,0,Friendly,Guadalajara,Mexico,False,2,2,Mexico
6811,7508,8054,1972,Nigeria,Guinea,1,1,Friendly,Lagos,Nigeria,False,2,0,Draw
6812,7509,8055,1972,Congo,Benin,2,2,Friendly,Brazzaville,Congo,False,4,0,Draw
6813,7510,8056,1972,Congo,Guinea,2,2,Friendly,Brazzaville,Congo,False,4,0,Draw
6814,7511,8057,1972,Haiti,Chile,1,0,Friendly,Port-au-Prince,Haiti,False,1,1,Haiti
6815,7512,8058,1972,Cameroon,Nigeria,1,2,Friendly,Douala,Cameroon,False,3,-1,Nigeria
6816,7513,8059,1972,Guadeloupe,Haiti,4,4,Friendly,Basse-Terre,Guadeloupe,False,8,0,Draw
6817,7514,8060,1972,Martinique,Haiti,2,2,Friendly,Fort-de-France,Martinique,False,4,0,Draw
6818,7515,8061,1972,Greece,Netherlands,0,5,Friendly,Piraeus,Greece,False,5,-5,Netherlands
6819,7516,8062,1972,Northern Ireland,Spain,1,1,UEFA Euro qualification,Kingston upon Hull,England,True,2,0,Draw
6820,7517,8063,1972,Senegal,Morocco,1,3,Friendly,Dakar,Senegal,False,4,-2,Morocco
6821,7518,8064,1972,Nigeria,Morocco,3,0,Friendly,Lagos,Nigeria,False,3,3,Nigeria
6822,7519,8065,1972,Tunisia,Austria,3,3,Friendly,Tunis,Tunisia,False,6,0,Draw
6823,7520,8066,1972,Cameroon,Kenya,2,1,African Cup of Nations,Yaoundé,Cameroon,False,3,1,Cameroon
6824,7521,8067,1972,Israel,Norway,2,1,Friendly,Jaffa,Israel,False,3,1,Israel
6825,7522,8068,1972,Mali,Togo,3,3,African Cup of Nations,Yaoundé,Cameroon,True,6,0,Draw
6826,7523,8069,1972,Congo,Morocco,1,1,African Cup of Nations,Douala,Cameroon,True,2,0,Draw
6827,7524,8070,1972,Sudan,DR Congo,1,1,African Cup of Nations,Douala,Cameroon,True,2,0,Draw
6828,7525,8071,1972,Cameroon,Togo,2,0,African Cup of Nations,Yaoundé,Cameroon,False,2,2,Cameroon
6829,7526,8072,1972,Kenya,Mali,1,1,African Cup of Nations,Yaoundé,Cameroon,True,2,0,Draw
6830,7527,8073,1972,Congo,DR Congo,0,2,African Cup of Nations,Douala,Cameroon,True,2,-2,DR Congo
6831,7528,8074,1972,Morocco,Sudan,1,1,African Cup of Nations,Douala,Cameroon,True,2,0,Draw
6832,7529,8075,1972,Cameroon,Mali,1,1,African Cup of Nations,Yaoundé,Cameroon,False,2,0,Draw
6833,7530,8076,1972,Kenya,Togo,1,1,African Cup of Nations,Yaoundé,Cameroon,True,2,0,Draw
6834,7531,8077,1972,Congo,Sudan,4,2,African Cup of Nations,Douala,Cameroon,True,6,2,Congo
6835,7532,8078,1972,Morocco,DR Congo,1,1,African Cup of Nations,Douala,Cameroon,True,2,0,Draw
6836,7533,8079,1972,Algeria,Guinea,1,0,FIFA World Cup qualification,Algiers,Algeria,False,1,1,Algeria
6837,7534,8080,1972,Cameroon,Congo,0,1,African Cup of Nations,Yaoundé,Cameroon,False,1,-1,Congo
6838,7535,8081,1972,Mali,DR Congo,4,3,African Cup of Nations,Douala,Cameroon,True,7,1,Mali
6839,7536,8082,1972,Cameroon,DR Congo,5,2,African Cup of Nations,Yaoundé,Cameroon,False,7,3,Cameroon
6840,7537,8083,1972,Greece,Italy,2,1,Friendly,Piraeus,Greece,False,3,1,Greece
6841,7538,8084,1972,Congo,Mali,3,2,African Cup of Nations,Yaoundé,Cameroon,True,5,1,Congo
6842,7539,8085,1972,Guinea,Algeria,5,1,FIFA World Cup qualification,Conakry,Guinea,False,6,4,Guinea
6843,7540,8086,1972,Algeria,Malta,1,0,Friendly,Algiers,Algeria,False,1,1,Algeria
6844,7541,8087,1972,Saudi Arabia,Kuwait,2,2,Gulf Cup,Riyadh,Saudi Arabia,False,4,0,Draw
6845,7542,8088,1972,Qatar,United Arab Emirates,0,1,Gulf Cup,Riyadh,Saudi Arabia,True,1,-1,United Arab Emirates
6846,7543,8089,1972,Bahrain,Kuwait,0,2,Gulf Cup,Riyadh,Saudi Arabia,True,2,-2,Kuwait
6847,7544,8090,1972,Saudi Arabia,United Arab Emirates,4,0,Gulf Cup,Riyadh,Saudi Arabia,False,4,4,Saudi Arabia
6848,7545,8091,1972,Bahrain,Qatar,6,2,Gulf Cup,Riyadh,Saudi Arabia,True,8,4,Bahrain
6849,7546,8092,1972,Kuwait,United Arab Emirates,7,0,Gulf Cup,Riyadh,Saudi Arabia,True,7,7,Kuwait
6850,7547,8093,1972,Saudi Arabia,Qatar,4,0,Gulf Cup,Riyadh,Saudi Arabia,False,4,4,Saudi Arabia
6851,7548,8094,1972,Bahrain,United Arab Emirates,2,0,Gulf Cup,Riyadh,Saudi Arabia,True,2,2,Bahrain
6852,7549,8095,1972,Kuwait,Qatar,5,0,Gulf Cup,Riyadh,Saudi Arabia,True,5,5,Kuwait
6853,7550,8096,1972,Saudi Arabia,Bahrain,2,1,Gulf Cup,Riyadh,Saudi Arabia,False,3,1,Saudi Arabia
6854,7551,8097,1972,Bulgaria,Russia,1,1,Friendly,Sofia,Bulgaria,False,2,0,Draw
6855,7552,8098,1972,Colombia,Peru,1,1,Friendly,Bogotá,Colombia,False,2,0,Draw
6856,7553,8099,1972,Hungary,Germany,0,2,Friendly,Budapest,Hungary,False,2,-2,Germany
6857,7554,8100,1972,Portugal,Cyprus,4,0,FIFA World Cup qualification,Lisbon,Portugal,False,4,4,Portugal
6858,7555,8101,1972,Jamaica,Cuba,2,0,Friendly,Kingston,Jamaica,False,2,2,Jamaica
6859,7556,8102,1972,Mexico,Peru,2,1,Friendly,Mexico City,Mexico,False,3,1,Mexico
6860,7558,8105,1972,Romania,France,2,0,Friendly,Bucharest,Romania,False,2,2,Romania
6861,7559,8106,1972,Greece,Spain,0,0,Friendly,Salonica,Greece,False,0,0,Draw
6862,7560,8107,1972,Haiti,Puerto Rico,7,0,FIFA World Cup qualification,Port-au-Prince,Haiti,False,7,7,Haiti
6863,7561,8108,1972,Ghana,Ivory Coast,1,2,Friendly,Accra,Ghana,False,3,-1,Ivory Coast
6864,7562,8109,1972,Russia,Peru,2,0,Friendly,Kyïv,Soviet Union,False,2,2,Russia
6865,7563,8110,1972,Puerto Rico,Haiti,0,5,FIFA World Cup qualification,San Juan,Puerto Rico,False,5,-5,Haiti
6866,7564,8111,1972,Romania,Peru,2,2,Friendly,Bucharest,Romania,False,4,0,Draw
6867,7565,8112,1972,Brazil,Paraguay,3,2,Friendly,Porto Alegre,Brazil,False,5,1,Brazil
6868,7566,8114,1972,Scotland,Peru,2,0,Friendly,Glasgow,Scotland,False,2,2,Scotland
6869,7567,8115,1972,Switzerland,Sweden,1,1,Friendly,Geneva,Switzerland,False,2,0,Draw
6870,7568,8116,1972,England,Germany,1,3,UEFA Euro qualification,London,England,False,4,-2,Germany
6871,7569,8117,1972,Hungary,Romania,1,1,UEFA Euro qualification,Budapest,Hungary,False,2,0,Draw
6872,7570,8118,1972,Italy,Belgium,0,0,UEFA Euro qualification,Milan,Italy,False,0,0,Draw
6873,7571,8119,1972,Madagascar,Tanzania,0,1,Friendly,Antananarivo,Madagascar,False,1,-1,Tanzania
6874,7572,8120,1972,Austria,Malta,4,0,FIFA World Cup qualification,Vienna,Austria,False,4,4,Austria
6875,7573,8121,1972,Lesotho,Zambia,0,0,FIFA World Cup qualification,Maseru,Lesotho,False,0,0,Draw
6876,7574,8123,1972,Netherlands,Peru,3,0,Friendly,Rotterdam,Netherlands,False,3,3,Netherlands
6877,7575,8124,1972,Hungary,Malta,3,0,FIFA World Cup qualification,Budapest,Hungary,False,3,3,Hungary
6878,7576,8125,1972,Ethiopia,Greece,0,1,Friendly,Addis Abeba,Ethiopia,False,1,-1,Greece
6879,7577,8126,1972,Iran,Cambodia,2,0,AFC Asian Cup,Bangkok,Thailand,True,2,2,Iran
6880,7578,8128,1972,Thailand,Kuwait,0,2,AFC Asian Cup,Bangkok,Thailand,False,2,-2,Kuwait
6881,7579,8129,1972,Iran,Iraq,3,0,AFC Asian Cup,Bangkok,Thailand,True,3,3,Iran
6882,7581,8131,1972,Cyprus,Portugal,0,1,FIFA World Cup qualification,Nicosia,Cyprus,False,1,-1,Portugal
6883,7582,8132,1972,Poland,Switzerland,0,0,Friendly,Poznań,Poland,False,0,0,Draw
6884,7583,8133,1972,Thailand,Iraq,1,1,AFC Asian Cup,Bangkok,Thailand,False,2,0,Draw
6885,7584,8135,1972,Belgium,Italy,2,1,UEFA Euro qualification,Brussels,Belgium,False,3,1,Belgium
6886,7585,8136,1972,Germany,England,0,0,UEFA Euro qualification,Berlin,Germany,False,0,0,Draw
6887,7587,8138,1972,Thailand,Iran,2,3,AFC Asian Cup,Bangkok,Thailand,False,5,-1,Iran
6888,7588,8139,1972,Cambodia,Kuwait,4,0,AFC Asian Cup,Bangkok,Thailand,True,4,4,Cambodia
6889,7589,8140,1972,Romania,Hungary,2,2,UEFA Euro qualification,Bucharest,Romania,False,4,0,Draw
6890,7591,8142,1972,Iran,Cambodia,2,1,AFC Asian Cup,Bangkok,Thailand,True,3,1,Iran
6891,7592,8143,1972,Hungary,Romania,2,1,UEFA Euro qualification,Belgrade,Yugoslavia,True,3,1,Hungary
6892,7593,8144,1972,Kenya,Madagascar,1,3,Friendly,Nairobi,Kenya,False,4,-2,Madagascar
6893,7595,8146,1972,Belgium,Iceland,4,0,FIFA World Cup qualification,Liège,Belgium,False,4,4,Belgium
6894,7597,8148,1972,Thailand,Cambodia,2,2,AFC Asian Cup,Bangkok,Thailand,False,4,0,Draw
6895,7598,8149,1972,Scotland,Northern Ireland,2,0,British Championship,Glasgow,Scotland,False,2,2,Scotland
6896,7599,8150,1972,Wales,England,0,3,British Championship,Cardiff,Wales,False,3,-3,England
6897,7600,8151,1972,Belgium,Iceland,4,0,FIFA World Cup qualification,Bruges,Belgium,False,4,4,Belgium
6898,7601,8152,1972,Mauritius,Uganda,1,2,Friendly,Port Louis,Mauritius,False,3,-1,Uganda
6899,7602,8153,1972,England,Northern Ireland,0,1,British Championship,London,England,False,1,-1,Northern Ireland
6900,7603,8154,1972,Spain,Uruguay,2,0,Friendly,Madrid,Spain,False,2,2,Spain
6901,7604,8155,1972,Scotland,Wales,1,0,British Championship,Glasgow,Scotland,False,1,1,Scotland
6902,7605,8156,1972,Argentina,Paraguay,0,0,Friendly,Salta,Argentina,False,0,0,Draw
6903,7606,8157,1972,Sweden,Hungary,0,0,FIFA World Cup qualification,Solna,Sweden,False,0,0,Draw
6904,7607,8158,1972,Germany,Russia,4,1,Friendly,Munich,Germany,False,5,3,Germany
6905,7608,8160,1972,Scotland,England,0,1,British Championship,Glasgow,Scotland,False,1,-1,England
6906,7609,8161,1972,Wales,Northern Ireland,0,0,British Championship,Wrexham,Wales,False,0,0,Draw
6907,7610,8162,1972,Finland,Norway,0,0,Nordic Championship,Turku,Finland,False,0,0,Draw
6908,7611,8163,1972,Mauritius,Uganda,1,3,Friendly,Curepipe,Mauritius,False,4,-2,Uganda
6909,7612,8164,1972,Chile,Argentina,3,4,Copa Carlos Dittborn,Santiago,Chile,False,7,-1,Argentina
6910,7613,8166,1972,Liberia,Guinea,0,2,Friendly,Monrovia,Liberia,False,2,-2,Guinea
6911,7614,8167,1972,Sierra Leone,Ghana,3,1,Friendly,Freetown,Sierra Leone,False,4,2,Sierra Leone
6912,7615,8168,1972,Puerto Rico,Panama,0,0,Friendly,San Juan,Puerto Rico,False,0,0,Draw
6913,7616,8169,1972,Zambia,Lesotho,6,1,FIFA World Cup qualification,Ndola,Zambia,False,7,5,Zambia
6914,7617,8170,1972,Indonesia,Burma,1,0,Indonesia Tournament,Jakarta,Indonesia,False,1,1,Indonesia
6915,7618,8171,1972,Tunisia,Algeria,3,1,Friendly,Tunis,Tunisia,False,4,2,Tunisia
6916,7619,8172,1972,Cambodia,Singapore,3,0,Indonesia Tournament,Jakarta,Indonesia,True,3,3,Cambodia
6917,7620,8173,1972,Togo,DR Congo,0,0,FIFA World Cup qualification,Lomé,Togo,False,0,0,Draw
6918,7621,8174,1972,Denmark,Finland,3,0,Nordic Championship,Copenhagen,Denmark,False,3,3,Denmark
6919,7622,8175,1972,Russia,Bulgaria,1,0,Friendly,Moscow,Soviet Union,False,1,1,Russia
6920,7623,8176,1972,Cambodia,Thailand,2,0,Indonesia Tournament,Jakarta,Indonesia,True,2,2,Cambodia
6921,7624,8177,1972,Philippines,Singapore,2,0,Indonesia Tournament,Jakarta,Indonesia,True,2,2,Philippines
6922,7625,8178,1972,Burma,Sri Lanka,4,2,Indonesia Tournament,Jakarta,Indonesia,True,6,2,Burma
6923,7626,8179,1972,Laos,Malaysia,1,2,Indonesia Tournament,Jakarta,Indonesia,True,3,-1,Malaysia
6924,7627,8180,1972,Austria,Sweden,2,0,FIFA World Cup qualification,Vienna,Austria,False,2,2,Austria
6925,7628,8181,1972,Kenya,Uganda,2,0,Friendly,Nairobi,Kenya,False,2,2,Kenya
6926,7629,8182,1972,Bolivia,Peru,0,3,Brazil Independence Cup,Curitiba,Brazil,True,3,-3,Peru
6927,7630,8183,1972,Burma,Laos,6,1,Indonesia Tournament,Jakarta,Indonesia,True,7,5,Burma
6928,7631,8184,1972,Ecuador,Portugal,0,3,Brazil Independence Cup,Natal,Brazil,True,3,-3,Portugal
6929,7632,8185,1972,Iran,Republic of Ireland,1,2,Brazil Independence Cup,Recife,Brazil,True,3,-1,Republic of Ireland
6930,7633,8186,1972,Paraguay,Venezuela,4,1,Brazil Independence Cup,Campo Grande,Brazil,True,5,3,Paraguay
6931,7634,8187,1972,Philippines,Thailand,1,0,Indonesia Tournament,Jakarta,Indonesia,True,1,1,Philippines
6932,7635,8188,1972,Laos,Sri Lanka,1,3,Indonesia Tournament,Jakarta,Indonesia,True,4,-2,Sri Lanka
6933,7636,8189,1972,Belgium,Germany,1,2,UEFA Euro,Antwerp,Belgium,False,3,-1,Germany
6934,7637,8190,1972,Chile,Ecuador,2,1,Brazil Independence Cup,Natal,Brazil,True,3,1,Chile
6935,7638,8191,1972,Hungary,Russia,0,1,UEFA Euro,Brussels,Belgium,True,1,-1,Russia
6936,7639,8192,1972,Iran,Portugal,0,3,Brazil Independence Cup,Recife,Brazil,True,3,-3,Portugal
6937,7640,8193,1972,Norway,Uruguay,0,1,Friendly,Oslo,Norway,False,1,-1,Uruguay
6938,7641,8194,1972,Paraguay,Peru,1,0,Brazil Independence Cup,Campo Grande,Brazil,True,1,1,Paraguay
6939,7643,8196,1972,Burma,Malaysia,2,2,Indonesia Tournament,Jakarta,Indonesia,True,4,0,Draw
6940,7644,8197,1972,Benin,Congo,5,3,Friendly,Cotonou,Dahomey,False,8,2,Benin
6941,7645,8198,1972,Belgium,Hungary,2,1,UEFA Euro,Liège,Belgium,False,3,1,Belgium
6942,7646,8199,1972,Romania,Italy,3,3,Friendly,Bucharest,Romania,False,6,0,Draw
6943,7647,8200,1972,Benin,Ghana,0,5,FIFA World Cup qualification,Cotonou,Dahomey,True,5,-5,Ghana
6944,7649,8202,1972,Chile,Portugal,1,4,Brazil Independence Cup,Recife,Brazil,True,5,-3,Portugal
6945,7650,8203,1972,Colombia,France,2,3,Brazil Independence Cup,Salvador,Brazil,True,5,-1,France
6946,7651,8204,1972,Ecuador,Republic of Ireland,2,3,Brazil Independence Cup,Natal,Brazil,True,5,-1,Republic of Ireland
6947,7652,8205,1972,Germany,Russia,3,0,UEFA Euro,Brussels,Belgium,True,3,3,Germany
6948,7653,8206,1972,Peru,Venezuela,1,0,Brazil Independence Cup,Manaus,Brazil,True,1,1,Peru
6949,7654,8207,1972,Burma,Cambodia,0,3,Indonesia Tournament,Jakarta,Indonesia,True,3,-3,Cambodia
6950,7655,8208,1972,DR Congo,Togo,4,0,FIFA World Cup qualification,Kinshasa,Zaïre,False,4,4,DR Congo
6951,7656,8209,1972,Bolivia,Venezuela,2,2,Brazil Independence Cup,Manaus,Brazil,True,4,0,Draw
6952,7657,8210,1972,Bulgaria,Italy,1,1,Friendly,Sofia,Bulgaria,False,2,0,Draw
6953,7658,8211,1972,Chile,Republic of Ireland,2,1,Brazil Independence Cup,Recife,Brazil,True,3,1,Chile
6954,7659,8212,1972,Ecuador,Iran,1,1,Brazil Independence Cup,Recife,Brazil,True,2,0,Draw
6955,7660,8213,1972,Finland,Albania,1,0,FIFA World Cup qualification,Helsinki,Finland,False,1,1,Finland
6956,7661,8214,1972,Argentina,Colombia,4,1,Brazil Independence Cup,Salvador,Brazil,True,5,3,Argentina
6957,7663,8216,1972,Singapore,Sri Lanka,3,1,Friendly,Kallang,Singapore,False,4,2,Singapore
6958,7664,8217,1972,Argentina,France,0,0,Brazil Independence Cup,Salvador,Brazil,True,0,0,Draw
6959,7665,8218,1972,Bolivia,Paraguay,1,6,Brazil Independence Cup,Manaus,Brazil,True,7,-5,Paraguay
6960,7666,8219,1972,Chile,Iran,2,1,Brazil Independence Cup,Recife,Brazil,True,3,1,Chile
6961,7667,8220,1972,Republic of Ireland,Portugal,1,2,Brazil Independence Cup,Recife,Brazil,True,3,-1,Portugal
6962,7670,8223,1972,Argentina,Portugal,1,3,Brazil Independence Cup,Rio de Janeiro,Brazil,True,4,-2,Portugal
6963,7672,8225,1972,Sweden,Denmark,2,0,Nordic Championship,Malmö,Sweden,False,2,2,Sweden
6964,7673,8226,1972,Uruguay,Russia,0,1,Brazil Independence Cup,São Paulo,Brazil,True,1,-1,Russia
6965,7674,8227,1972,Argentina,Russia,1,0,Brazil Independence Cup,Belo Horizonte,Brazil,True,1,1,Argentina
6966,7676,8229,1972,DR Congo,Guinea,6,0,Friendly,Kinshasa,Zaïre,False,6,6,DR Congo
6967,7677,8231,1972,Ghana,Benin,5,1,FIFA World Cup qualification,Kumasi,Ghana,False,6,4,Ghana
6968,7678,8232,1972,Portugal,Uruguay,1,1,Brazil Independence Cup,Rio de Janeiro,Brazil,True,2,0,Draw
6969,7679,8233,1972,Iceland,Denmark,2,5,Friendly,Reykjavík,Iceland,False,7,-3,Denmark
6970,7680,8234,1972,Tanzania,Sudan,3,0,Friendly,Dar es Salaam,Tanzania,False,3,3,Tanzania
6971,7681,8235,1972,Brazil,Scotland,1,0,Brazil Independence Cup,Rio de Janeiro,Brazil,False,1,1,Brazil
6972,7682,8236,1972,Argentina,Uruguay,1,0,Brazil Independence Cup,Porto Alegre,Brazil,True,1,1,Argentina
6973,7683,8238,1972,Malawi,Lesotho,1,0,Friendly,Blantyre,Malawi,False,1,1,Malawi
6974,7684,8239,1972,Portugal,Russia,1,0,Brazil Independence Cup,Belo Horizonte,Brazil,True,1,1,Portugal
6975,7685,8240,1972,Tanzania,Nigeria,0,0,Friendly,Dar es Salaam,Tanzania,False,0,0,Draw
6976,7686,8241,1972,Malawi,Lesotho,4,0,Friendly,Blantyre,Malawi,False,4,4,Malawi
6977,7688,8243,1972,Brazil,Portugal,1,0,Brazil Independence Cup,Rio de Janeiro,Brazil,False,1,1,Brazil
6978,7689,8244,1972,Uganda,Sudan,4,0,Friendly,Kampala,Uganda,False,4,4,Uganda
6979,7690,8246,1972,Iceland,Faroe Islands,3,0,Friendly,Reykjavík,Iceland,False,3,3,Iceland
6980,7691,8247,1972,Indonesia,Singapore,0,0,Merdeka Tournament,Kuala Lumpur,Malaysia,True,0,0,Draw
6981,7693,8249,1972,Singapore,Thailand,0,2,Merdeka Tournament,Kuala Lumpur,Malaysia,True,2,-2,Thailand
6982,7694,8250,1972,Cambodia,Philippines,2,2,Merdeka Tournament,Kuala Lumpur,Malaysia,True,4,0,Draw
6983,7695,8251,1972,Finland,Russia,1,1,Friendly,Vaasa,Finland,False,2,0,Draw
6984,7696,8252,1972,Japan,Sri Lanka,5,0,Merdeka Tournament,Ipoh,Malaysia,True,5,5,Japan
6985,7697,8253,1972,Kenya,Sudan,2,0,FIFA World Cup qualification,Nairobi,Kenya,False,2,2,Kenya
6986,7698,8254,1972,Hong Kong,Singapore,4,1,Merdeka Tournament,Kuala Lumpur,Malaysia,True,5,3,Hong Kong
6987,7699,8256,1972,Japan,Philippines,5,1,Merdeka Tournament,Kuala Lumpur,Malaysia,True,6,4,Japan
6988,7700,8257,1972,Indonesia,Thailand,3,2,Merdeka Tournament,Kuala Lumpur,Malaysia,True,5,1,Indonesia
6989,7701,8259,1972,Philippines,Sri Lanka,4,1,Merdeka Tournament,Kuala Lumpur,Malaysia,True,5,3,Philippines
6990,7702,8260,1972,Hong Kong,Indonesia,1,0,Merdeka Tournament,Kuala Lumpur,Malaysia,True,1,1,Hong Kong
6991,7703,8261,1972,Cambodia,Sri Lanka,6,1,Merdeka Tournament,Kuala Lumpur,Malaysia,True,7,5,Cambodia
6992,7704,8262,1972,Hong Kong,Thailand,2,2,Merdeka Tournament,Ipoh,Malaysia,True,4,0,Draw
6993,7706,8264,1972,Sudan,Kenya,1,0,FIFA World Cup qualification,Khartoum,Sudan,False,1,1,Sudan
6994,7707,8265,1972,Singapore,Sri Lanka,6,1,Merdeka Tournament,Kuala Lumpur,Malaysia,True,7,5,Singapore
6995,7709,8267,1972,Uganda,Tanzania,1,1,Friendly,Kampala,Uganda,False,2,0,Draw
6996,7711,8269,1972,Philippines,Thailand,0,4,Merdeka Tournament,Kuala Lumpur,Malaysia,True,4,-4,Thailand
6997,7712,8270,1972,Indonesia,Philippines,3,0,Friendly,Kallang,Singapore,True,3,3,Indonesia
6998,7713,8271,1972,Singapore,Sri Lanka,6,1,Friendly,Kallang,Singapore,False,7,5,Singapore
6999,7714,8272,1972,Norway,Iceland,4,1,FIFA World Cup qualification,Stavanger,Norway,False,5,3,Norway
7000,7715,8273,1972,Hong Kong,Sri Lanka,2,1,Friendly,Kallang,Singapore,True,3,1,Hong Kong
7001,7716,8274,1972,Japan,Philippines,4,1,Friendly,Kallang,Singapore,True,5,3,Japan
7002,7717,8275,1972,Nigeria,Congo,2,1,FIFA World Cup qualification,Ibadan,Nigeria,False,3,1,Nigeria
7003,7718,8276,1972,Costa Rica,Mexico,1,0,Friendly,San José,Costa Rica,False,1,1,Costa Rica
7004,7719,8277,1972,Indonesia,Japan,1,0,Friendly,Kallang,Singapore,True,1,1,Indonesia
7005,7720,8278,1972,Singapore,Hong Kong,0,2,Friendly,Kallang,Singapore,False,2,-2,Hong Kong
7006,7721,8279,1972,Sweden,Russia,4,4,Friendly,Solna,Sweden,False,8,0,Draw
7007,7722,8280,1972,Cambodia,Indonesia,0,5,Friendly,Kallang,Singapore,True,5,-5,Indonesia
7008,7723,8281,1972,Peru,Mexico,3,2,Friendly,Lima,Peru,False,5,1,Peru
7009,7724,8282,1972,Hong Kong,Cambodia,2,1,Friendly,Kallang,Singapore,True,3,1,Hong Kong
7010,7725,8283,1972,Congo,Nigeria,1,1,FIFA World Cup qualification,Brazzaville,Congo,False,2,0,Draw
7011,7726,8284,1972,Chile,Mexico,0,2,Friendly,Santiago,Chile,False,2,-2,Mexico
7012,7727,8285,1972,Canada,United States,3,2,FIFA World Cup qualification,St. John's,Canada,False,5,1,Canada
7013,7728,8286,1972,Canada,Mexico,0,1,FIFA World Cup qualification,Toronto,Canada,False,1,-1,Mexico
7014,7729,8287,1972,United States,Canada,2,2,FIFA World Cup qualification,Baltimore,United States,False,4,0,Draw
7015,7730,8289,1972,Greece,France,1,3,Friendly,Piraeus,Greece,False,4,-2,France
7016,7731,8290,1972,Guatemala,Canada,2,2,Friendly,Guatemala,Guatemala,False,4,0,Draw
7017,7732,8291,1972,Mexico,United States,3,1,FIFA World Cup qualification,Mexico City,Mexico,False,4,2,Mexico
7018,7733,8292,1972,Romania,Austria,1,1,Friendly,Craiova,Romania,False,2,0,Draw
7019,7735,8294,1972,Mexico,Canada,2,1,FIFA World Cup qualification,Mexico City,Mexico,False,3,1,Mexico
7020,7736,8295,1972,United States,Mexico,1,2,FIFA World Cup qualification,Los Angeles,United States,False,3,-1,Mexico
7021,7739,8298,1972,New Zealand,New Caledonia,4,1,Friendly,Wellington,New Zealand,False,5,3,New Zealand
7022,7740,8299,1972,Norway,Sweden,1,3,Nordic Championship,Oslo,Norway,False,4,-2,Sweden
7023,7741,8300,1972,Cambodia,Malaysia,0,1,Korea Cup,Seoul,South Korea,True,1,-1,Malaysia
7024,7742,8301,1972,Finland,Romania,1,1,FIFA World Cup qualification,Helsinki,Finland,False,2,0,Draw
7025,7744,8304,1972,Burma,Philippines,4,0,Korea Cup,Seoul,South Korea,True,4,4,Burma
7026,7745,8306,1972,Malaysia,Thailand,1,1,Korea Cup,Seoul,South Korea,True,2,0,Draw
7027,7746,8307,1972,Burma,Indonesia,1,1,Korea Cup,Seoul,South Korea,True,2,0,Draw
7028,7747,8308,1972,Philippines,Singapore,0,5,Korea Cup,Seoul,South Korea,True,5,-5,Singapore
7029,7748,8309,1972,Cambodia,Thailand,0,0,Korea Cup,Seoul,South Korea,True,0,0,Draw
7030,7749,8311,1972,Burma,Singapore,1,0,Korea Cup,Seoul,South Korea,True,1,1,Burma
7031,7750,8312,1972,Cambodia,Philippines,1,0,Korea Cup,Seoul,South Korea,True,1,1,Cambodia
7032,7751,8314,1972,Indonesia,Malaysia,3,1,Korea Cup,Seoul,South Korea,True,4,2,Indonesia
7033,7752,8315,1972,Singapore,Thailand,1,4,Korea Cup,Seoul,South Korea,True,5,-3,Thailand
7034,7753,8316,1972,Burma,Indonesia,3,1,Korea Cup,Seoul,South Korea,True,4,2,Burma
7035,7754,8318,1972,Martinique,Trinidad and Tobago,1,2,Friendly,Fort-de-France,Martinique,False,3,-1,Trinidad and Tobago
7036,7755,8319,1972,New Zealand,New Caledonia,2,1,Friendly,Auckland,New Zealand,False,3,1,New Zealand
7037,7756,8320,1972,Costa Rica,El Salvador,2,0,Friendly,San José,Costa Rica,False,2,2,Costa Rica
7038,7757,8321,1972,Martinique,Trinidad and Tobago,1,2,Friendly,Fort-de-France,Martinique,False,3,-1,Trinidad and Tobago
7039,7758,8322,1972,Algeria,Turkey,1,0,Friendly,Algiers,Algeria,False,1,1,Algeria
7040,7759,8323,1972,Denmark,Switzerland,1,1,Friendly,Copenhagen,Denmark,False,2,0,Draw
7041,7760,8324,1972,Lesotho,Zambia,1,1,Friendly,Maseru,Lesotho,False,2,0,Draw
7042,7761,8325,1972,Norway,Belgium,0,2,FIFA World Cup qualification,Oslo,Norway,False,2,-2,Belgium
7043,7762,8326,1972,Hong Kong,Singapore,2,3,Friendly,So Kon Po,Hong Kong,False,5,-1,Singapore
7044,7763,8328,1972,Indonesia,Australia,1,4,Friendly,Jakarta,Indonesia,False,5,-3,Australia
7045,7764,8329,1972,Luxembourg,Italy,0,4,FIFA World Cup qualification,Luxembourg,Luxembourg,False,4,-4,Italy
7046,7765,8330,1972,El Salvador,Costa Rica,0,1,Friendly,San Salvador,El Salvador,False,1,-1,Costa Rica
7047,7766,8331,1972,Lesotho,Zambia,1,1,Friendly,Maseru,Lesotho,False,2,0,Draw
7048,7767,8332,1972,Australia,New Zealand,3,1,Friendly,Jakarta,Indonesia,True,4,2,Australia
7049,7769,8334,1972,Indonesia,New Zealand,1,1,Friendly,Jakarta,Indonesia,False,2,0,Draw
7050,7770,8335,1972,Spain,Argentina,1,0,Friendly,Madrid,Spain,False,1,1,Spain
7051,7771,8336,1972,Saint Kitts and Nevis,Trinidad and Tobago,0,3,Friendly,Basseterre,Saint Kitts and Nevis,False,3,-3,Trinidad and Tobago
7052,7772,8337,1972,Mexico,Costa Rica,3,1,Friendly,Mexico City,Mexico,False,4,2,Mexico
7053,7773,8339,1972,France,Russia,1,0,FIFA World Cup qualification,Paris,France,False,1,1,France
7054,7774,8340,1972,New Caledonia,New Zealand,3,1,Friendly,Nouméa,New Caledonia,False,4,2,New Caledonia
7055,7775,8341,1972,Austria,Hungary,2,2,FIFA World Cup qualification,Vienna,Austria,False,4,0,Draw
7056,7776,8342,1972,Guatemala,Costa Rica,0,0,Friendly,Guatemala,Guatemala,False,0,0,Draw
7057,7777,8343,1972,Malawi,Kenya,0,1,Friendly,Lilongwe,Malawi,False,1,-1,Kenya
7058,7779,8345,1972,Sierra Leone,Ivory Coast,0,1,FIFA World Cup qualification,Freetown,Sierra Leone,False,1,-1,Ivory Coast
7059,7780,8346,1972,Sweden,Malta,7,0,FIFA World Cup qualification,Gothenburg,Sweden,False,7,7,Sweden
7060,7781,8348,1972,Bulgaria,Northern Ireland,3,0,FIFA World Cup qualification,Sofia,Bulgaria,False,3,3,Bulgaria
7061,7782,8349,1972,Denmark,Scotland,1,4,FIFA World Cup qualification,Copenhagen,Denmark,False,5,-3,Scotland
7062,7783,8350,1972,Republic of Ireland,Russia,1,2,FIFA World Cup qualification,Dublin,Republic of Ireland,False,3,-1,Russia
7063,7785,8352,1972,Switzerland,Italy,0,0,FIFA World Cup qualification,Berne,Switzerland,False,0,0,Draw
7064,7786,8354,1972,Luxembourg,Turkey,2,0,FIFA World Cup qualification,Luxembourg,Luxembourg,False,2,2,Luxembourg
7065,7787,8355,1972,Malawi,Kenya,2,1,Friendly,Blantyre,Malawi,False,3,1,Malawi
7066,7788,8357,1972,Peru,Argentina,0,2,Copa Ramón Castilla,Lima,Peru,False,2,-2,Argentina
7067,7789,8358,1972,Cambodia,Singapore,0,1,Vietnam Independence Cup,Saigon,Vietnam Republic,True,1,-1,Singapore
7068,7790,8360,1972,Cambodia,Malaysia,1,0,Vietnam Independence Cup,Saigon,Vietnam Republic,True,1,1,Cambodia
7069,7791,8361,1972,Ivory Coast,Sierra Leone,2,0,FIFA World Cup qualification,Abidjan,Ivory Coast,False,2,2,Ivory Coast
7070,7792,8362,1972,Philippines,Australia,0,6,Friendly,Manila,Philippines,False,6,-6,Australia
7071,7793,8363,1972,Romania,Albania,2,0,FIFA World Cup qualification,Bucharest,Romania,False,2,2,Romania
7072,7794,8366,1972,Malaysia,Singapore,1,3,Vietnam Independence Cup,Saigon,Vietnam Republic,True,4,-2,Singapore
7073,7795,8367,1972,Netherlands,Norway,9,0,FIFA World Cup qualification,Rotterdam,Netherlands,False,9,9,Netherlands
7074,7796,8369,1972,Nigeria,Tanzania,2,1,Friendly,Benin City,Nigeria,False,3,1,Nigeria
7075,7797,8370,1972,Trinidad and Tobago,Antigua and Barbuda,11,1,FIFA World Cup qualification,Port of Spain,Trinidad and Tobago,False,12,10,Trinidad and Tobago
7076,7798,8371,1972,Nigeria,Tanzania,3,2,Friendly,Lagos,Nigeria,False,5,1,Nigeria
7077,7799,8372,1972,Costa Rica,Guatemala,1,1,Friendly,San José,Costa Rica,False,2,0,Draw
7078,7800,8373,1972,Germany,Switzerland,5,1,Friendly,Düsseldorf,Germany,False,6,4,Germany
7079,7801,8374,1972,Republic of Ireland,France,2,1,FIFA World Cup qualification,Dublin,Republic of Ireland,False,3,1,Republic of Ireland
7080,7802,8375,1972,Scotland,Denmark,2,0,FIFA World Cup qualification,Glasgow,Scotland,False,2,2,Scotland
7081,7803,8376,1972,Wales,England,0,1,FIFA World Cup qualification,Cardiff,Wales,False,1,-1,England
7082,7804,8377,1972,Tunisia,Algeria,1,2,Friendly,Tunis,Tunisia,False,3,-1,Algeria
7083,7805,8379,1972,Sierra Leone,Tanzania,2,2,Friendly,Freetown,Sierra Leone,False,4,0,Draw
7084,7806,8380,1972,Thailand,Singapore,4,0,King's Cup,Bangkok,Thailand,False,4,4,Thailand
7085,7807,8382,1972,Antigua and Barbuda,Trinidad and Tobago,1,2,FIFA World Cup qualification,St. John's,Antigua and Barbuda,False,3,-1,Trinidad and Tobago
7086,7808,8383,1972,Belgium,Netherlands,0,0,FIFA World Cup qualification,Antwerp,Belgium,False,0,0,Draw
7087,7809,8384,1972,Cyprus,Bulgaria,0,4,FIFA World Cup qualification,Akdoğan,Cyprus,False,4,-4,Bulgaria
7088,7810,8385,1972,Morocco,Senegal,0,0,FIFA World Cup qualification,Rabat,Morocco,False,0,0,Draw
7089,7811,8386,1972,Indonesia,Singapore,1,2,King's Cup,Bangkok,Thailand,True,3,-1,Singapore
7090,7812,8387,1972,Thailand,Malaysia,0,2,King's Cup,Bangkok,Thailand,False,2,-2,Malaysia
7091,7814,8389,1972,Malaysia,Singapore,2,0,King's Cup,Bangkok,Thailand,True,2,2,Malaysia
7092,7815,8390,1972,Mali,Nigeria,2,1,Friendly,Bamako,Mali,False,3,1,Mali
7093,7817,8393,1972,Liberia,Nigeria,1,3,Friendly,Monrovia,Liberia,False,4,-2,Nigeria
7094,7818,8394,1972,Thailand,Indonesia,3,0,King's Cup,Bangkok,Thailand,False,3,3,Thailand
7095,7819,8395,1972,Dominica,Grenada,1,2,Windward Islands Tournament,Castries,Saint Lucia,True,3,-1,Grenada
7096,7820,8396,1972,Malta,Austria,0,2,FIFA World Cup qualification,Gżira,Malta,False,2,-2,Austria
7097,7821,8397,1972,Tanzania,Ethiopia,1,1,FIFA World Cup qualification,Dar es Salaam,Tanzania,False,2,0,Draw
7098,7822,8398,1972,Indonesia,Malaysia,0,2,King's Cup,Bangkok,Thailand,True,2,-2,Malaysia
7099,7823,8399,1972,Sierra Leone,Nigeria,0,1,Friendly,Freetown,Sierra Leone,False,1,-1,Nigeria
7100,7824,8400,1972,Saint Lucia,Saint Vincent and the Grenadines,2,1,Windward Islands Tournament,Castries,Saint Lucia,False,3,1,Saint Lucia
7101,7826,8402,1972,Dominica,Saint Vincent and the Grenadines,1,2,Windward Islands Tournament,Castries,Saint Lucia,True,3,-1,Saint Vincent and the Grenadines
7102,7827,8404,1972,Thailand,Malaysia,0,1,King's Cup,Bangkok,Thailand,False,1,-1,Malaysia
7103,7828,8405,1972,Trinidad and Tobago,Suriname,2,1,FIFA World Cup qualification,Port of Spain,Trinidad and Tobago,False,3,1,Trinidad and Tobago
7104,7830,8407,1972,Saint Lucia,Grenada,1,0,Windward Islands Tournament,Castries,Saint Lucia,False,1,1,Saint Lucia
7105,7831,8408,1972,Trinidad and Tobago,Suriname,1,1,FIFA World Cup qualification,San Fernando,Trinidad and Tobago,False,2,0,Draw
7106,7832,8409,1972,Grenada,Saint Vincent and the Grenadines,0,0,Windward Islands Tournament,Castries,Saint Lucia,True,0,0,Draw
7107,7833,8410,1972,Saint Lucia,Dominica,1,0,Windward Islands Tournament,Castries,Saint Lucia,False,1,1,Saint Lucia
7108,7834,8411,1972,Antigua and Barbuda,Suriname,0,6,FIFA World Cup qualification,St. John's,Antigua and Barbuda,False,6,-6,Suriname
7109,7835,8412,1972,Ethiopia,Tanzania,0,0,FIFA World Cup qualification,Addis Abeba,Ethiopia,False,0,0,Draw
7110,7836,8413,1972,Guatemala,El Salvador,1,0,FIFA World Cup qualification,Guatemala,Guatemala,False,1,1,Guatemala
7111,7837,8414,1972,Honduras,Costa Rica,2,1,FIFA World Cup qualification,Tegucigalpa,Honduras,False,3,1,Honduras
7112,7838,8415,1972,Senegal,Morocco,1,2,FIFA World Cup qualification,Dakar,Senegal,False,3,-1,Morocco
7113,7839,8416,1972,Nigeria,Mali,3,0,Friendly,Lagos,Nigeria,False,3,3,Nigeria
7114,7840,8417,1972,Antigua and Barbuda,Suriname,1,3,FIFA World Cup qualification,St. John's,Antigua and Barbuda,False,4,-2,Suriname
7115,7841,8418,1972,Egypt,Tunisia,2,1,FIFA World Cup qualification,Cairo,Egypt,False,3,1,Egypt
7116,7842,8419,1972,Costa Rica,Honduras,3,3,FIFA World Cup qualification,San José,Costa Rica,False,6,0,Draw
7117,7843,8420,1972,El Salvador,Guatemala,0,1,FIFA World Cup qualification,San Salvador,El Salvador,False,1,-1,Guatemala
7118,7844,8421,1972,Ethiopia,Tanzania,3,0,FIFA World Cup qualification,Addis Abeba,Ethiopia,False,3,3,Ethiopia
7119,7845,8422,1972,Mauritius,Kenya,1,3,FIFA World Cup qualification,Curepipe,Mauritius,False,4,-2,Kenya
7120,7846,8423,1972,Turkey,Luxembourg,3,0,FIFA World Cup qualification,Istanbul,Turkey,False,3,3,Turkey
7121,7847,8424,1972,Nigeria,Sierra Leone,4,0,Friendly,Lagos,Nigeria,False,4,4,Nigeria
7122,7848,8425,1972,Haiti,Curaçao,3,0,Friendly,Port-au-Prince,Haiti,False,3,3,Haiti
7123,7849,8426,1972,Panama,Puerto Rico,5,0,Friendly,Panama City,Panama,False,5,5,Panama
7124,7850,8427,1972,Panama,Puerto Rico,0,1,Friendly,Panama City,Panama,False,1,-1,Puerto Rico
7125,7851,8428,1972,Haiti,Curaçao,4,1,Friendly,Port-au-Prince,Haiti,False,5,3,Haiti
7126,7852,8429,1972,Kenya,Mauritius,2,2,FIFA World Cup qualification,Nairobi,Kenya,False,4,0,Draw
7127,7853,8430,1972,Tunisia,Egypt,2,0,FIFA World Cup qualification,Tunis,Tunisia,False,2,2,Tunisia
7128,7854,8431,1972,Nigeria,Benin,3,0,Friendly,Lagos,Nigeria,False,3,3,Nigeria
7129,7855,8432,1972,Bermuda,Jamaica,0,0,Friendly,Hamilton,Bermuda,False,0,0,Draw
7130,7856,8433,1972,Bermuda,Jamaica,0,3,Friendly,Hamilton,Bermuda,False,3,-3,Jamaica
7131,7857,8434,1972,Ghana,Togo,2,2,Friendly,Accra,Ghana,False,4,0,Draw
7132,7858,8435,1972,Liberia,Ghana,2,2,Friendly,Monrovia,Liberia,False,4,0,Draw
7133,7859,8436,1973,Gambia,Senegal,2,1,Friendly,Banjul,Gambia,False,3,1,Gambia
7134,7860,8437,1973,Italy,Turkey,0,0,FIFA World Cup qualification,Naples,Italy,False,0,0,Draw
7135,7861,8438,1973,Greece,Spain,2,3,FIFA World Cup qualification,Athens,Greece,False,5,-1,Spain
7136,7862,8439,1973,England,Wales,1,1,FIFA World Cup qualification,London,England,False,2,0,Draw
7137,7863,8440,1973,Uganda,Congo,3,1,Friendly,Kampala,Uganda,False,4,2,Uganda
7138,7864,8441,1973,Cyprus,Bulgaria,0,3,Friendly,Akdoğan,Cyprus,False,3,-3,Bulgaria
7139,7865,8442,1973,Guyana,Haiti,1,3,Friendly,Georgetown,Guyana,False,4,-2,Haiti
7140,7866,8443,1973,Greece,Bulgaria,2,2,Friendly,Athens,Greece,False,4,0,Draw
7141,7867,8444,1973,Guyana,Haiti,1,0,Friendly,Georgetown,Guyana,False,1,1,Guyana
7142,7868,8445,1973,Cameroon,DR Congo,0,1,FIFA World Cup qualification,Douala,Cameroon,False,1,-1,DR Congo
7143,7869,8446,1973,Haiti,Trinidad and Tobago,0,0,Friendly,Port-au-Prince,Haiti,False,0,0,Draw
7144,7870,8447,1973,Indonesia,Bulgaria,0,4,Friendly,Jakarta,Indonesia,False,4,-4,Bulgaria
7145,7872,8449,1973,Haiti,Trinidad and Tobago,4,2,Friendly,Port-au-Prince,Haiti,False,6,2,Haiti
7146,7873,8450,1973,Mexico,Argentina,2,0,Friendly,Mexico City,Mexico,False,2,2,Mexico
7147,7874,8451,1973,Barbados,Haiti,3,2,Friendly,Bridgetown,Barbados,False,5,1,Barbados
7148,7875,8452,1973,New Caledonia,Bulgaria,3,5,Friendly,Nouméa,New Caledonia,False,8,-2,Bulgaria
7149,7876,8453,1973,Nigeria,Ghana,2,3,FIFA World Cup qualification,Lagos,Nigeria,False,5,-1,Ghana
7150,7877,8454,1973,Guinea,Morocco,1,1,FIFA World Cup qualification,Conakry,Guinea,False,2,0,Draw
7151,7878,8455,1973,Tunisia,Ivory Coast,1,1,FIFA World Cup qualification,Tunis,Tunisia,False,2,0,Draw
7152,7879,8456,1973,Australia,Bulgaria,2,2,Friendly,Sydney,Australia,False,4,0,Draw
7153,7881,8458,1973,Cyprus,Northern Ireland,1,0,FIFA World Cup qualification,Akdoğan,Cyprus,False,1,1,Cyprus
7154,7882,8459,1973,Germany,Argentina,2,3,Friendly,Munich,Germany,False,5,-1,Argentina
7155,7883,8460,1973,Scotland,England,0,5,Friendly,Glasgow,Scotland,False,5,-5,England
7156,7884,8461,1973,Turkey,Algeria,4,0,Friendly,Izmir,Turkey,False,4,4,Turkey
7157,7886,8463,1973,Australia,Bulgaria,1,3,Friendly,Adelaide,Australia,False,4,-2,Bulgaria
7158,7887,8464,1973,Morocco,Senegal,3,1,Friendly,Casablanca,Morocco,False,4,2,Morocco
7159,7889,8466,1973,New Zealand,Fiji,5,1,Oceania Nations Cup,Auckland,New Zealand,False,6,4,New Zealand
7160,7890,8467,1973,Australia,Bulgaria,0,2,Friendly,Melbourne,Australia,False,2,-2,Bulgaria
7161,7892,8469,1973,New Caledonia,Vanuatu,4,1,Oceania Nations Cup,Auckland,New Zealand,True,5,3,New Caledonia
7162,7894,8471,1973,Fiji,New Caledonia,0,2,Oceania Nations Cup,Auckland,New Zealand,True,2,-2,New Caledonia
7163,7895,8472,1973,Israel,Argentina,1,1,Friendly,Jaffa,Israel,False,2,0,Draw
7164,7897,8474,1973,Fiji,Vanuatu,1,2,Oceania Nations Cup,Auckland,New Zealand,True,3,-1,Vanuatu
7165,7898,8475,1973,New Zealand,New Caledonia,2,1,Oceania Nations Cup,Auckland,New Zealand,False,3,1,New Zealand
7166,7899,8476,1973,Spain,Greece,3,1,FIFA World Cup qualification,Málaga,Spain,False,4,2,Spain
7167,7901,8478,1973,New Zealand,Vanuatu,3,1,Oceania Nations Cup,Auckland,New Zealand,False,4,2,New Zealand
7168,7902,8479,1973,New Caledonia,Vanuatu,2,1,Oceania Nations Cup,Auckland,New Zealand,True,3,1,New Caledonia
7169,7904,8481,1973,DR Congo,Cameroon,0,1,FIFA World Cup qualification,Kinshasa,Zaïre,False,1,-1,Cameroon
7170,7905,8482,1973,Ghana,Nigeria,0,0,FIFA World Cup qualification,Accra,Ghana,False,0,0,Draw
7171,7906,8483,1973,Ivory Coast,Tunisia,2,1,FIFA World Cup qualification,Abidjan,Ivory Coast,False,3,1,Ivory Coast
7172,7907,8484,1973,Morocco,Guinea,2,0,FIFA World Cup qualification,Tétouan,Morocco,False,2,2,Morocco
7173,7908,8485,1973,Turkey,Italy,0,1,FIFA World Cup qualification,Istanbul,Turkey,False,1,-1,Italy
7174,7909,8486,1973,DR Congo,Cameroon,2,0,FIFA World Cup qualification,Kinshasa,Zaïre,False,2,2,DR Congo
7175,7910,8487,1973,France,Portugal,1,2,Friendly,Paris,France,False,3,-1,Portugal
7176,7911,8488,1973,New Zealand,Australia,1,1,FIFA World Cup qualification,Auckland,New Zealand,False,2,0,Draw
7177,7912,8489,1973,Peru,Guatemala,5,1,Friendly,Lima,Peru,False,6,4,Peru
7178,7913,8490,1973,Sudan,Ethiopia,1,0,Friendly,Khartoum,Sudan,False,1,1,Sudan
7179,7914,8491,1973,Australia,Iraq,3,1,FIFA World Cup qualification,Sydney,Australia,False,4,2,Australia
7180,7915,8492,1973,Indonesia,New Zealand,1,1,FIFA World Cup qualification,Sydney,Australia,True,2,0,Draw
7181,7916,8493,1973,Australia,Indonesia,2,1,FIFA World Cup qualification,Sydney,Australia,False,3,1,Australia
7182,7917,8494,1973,Iraq,New Zealand,2,0,FIFA World Cup qualification,Sydney,Australia,True,2,2,Iraq
7183,7918,8495,1973,Australia,New Zealand,3,3,FIFA World Cup qualification,Sydney,Australia,False,6,0,Draw
7184,7919,8496,1973,Iraq,Indonesia,1,1,FIFA World Cup qualification,Sydney,Australia,True,2,0,Draw
7185,7920,8497,1973,Bermuda,United States,4,0,Friendly,Hamilton,Bermuda,False,4,4,Bermuda
7186,7921,8498,1973,Australia,Iraq,0,0,FIFA World Cup qualification,Melbourne,Australia,False,0,0,Draw
7187,7922,8499,1973,Indonesia,New Zealand,1,0,FIFA World Cup qualification,Melbourne,Australia,True,1,1,Indonesia
7188,7923,8500,1973,Poland,United States,4,0,Friendly,Łódź,Poland,False,4,4,Poland
7189,7924,8501,1973,Iraq,Indonesia,3,2,FIFA World Cup qualification,Sydney,Australia,True,5,1,Iraq
7190,7925,8502,1973,Australia,Indonesia,6,0,FIFA World Cup qualification,Sydney,Australia,False,6,6,Australia
7191,7926,8503,1973,Iraq,New Zealand,4,0,FIFA World Cup qualification,Sydney,Australia,True,4,4,Iraq
7192,7927,8504,1973,Peru,Bolivia,2,0,Friendly,Lima,Peru,False,2,2,Peru
7193,7928,8505,1973,Austria,Netherlands,1,0,Friendly,Vienna,Austria,False,1,1,Austria
7194,7929,8506,1973,Bulgaria,Russia,1,0,Friendly,Plovdiv,Bulgaria,False,1,1,Bulgaria
7195,7931,8508,1973,Northern Ireland,Portugal,1,1,FIFA World Cup qualification,Coventry,England,True,2,0,Draw
7196,7932,8509,1973,Peru,Paraguay,1,0,Friendly,Lima,Peru,False,1,1,Peru
7197,7933,8510,1973,Wales,Poland,2,0,FIFA World Cup qualification,Cardiff,Wales,False,2,2,Wales
7198,7934,8511,1973,Bolivia,Paraguay,1,1,Friendly,La Paz,Bolivia,False,2,0,Draw
7199,7935,8512,1973,Italy,Luxembourg,5,0,FIFA World Cup qualification,Genoa,Italy,False,5,5,Italy
7200,7936,8513,1973,Ethiopia,Zambia,0,0,FIFA World Cup qualification,Addis Abeba,Ethiopia,False,0,0,Draw
7201,7937,8514,1973,Central African Republic,Ivory Coast,4,2,African Cup of Nations qualification,Bangui,Central African Republic,False,6,2,Central African Republic
7202,7938,8516,1973,Luxembourg,Switzerland,0,1,FIFA World Cup qualification,Luxembourg,Luxembourg,False,1,-1,Switzerland
7203,7939,8517,1973,Paraguay,Peru,1,1,Friendly,Asunción,Paraguay,False,2,0,Draw
7204,7940,8518,1973,Kuwait,Qatar,9,0,Friendly,Kuwait City,Kuwait,False,9,9,Kuwait
7205,7941,8519,1973,Haiti,Chile,1,1,Friendly,Port-au-Prince,Haiti,False,2,0,Draw
7206,7942,8520,1973,Burkina Faso,DR Congo,0,5,African Cup of Nations qualification,Ouagadougou,Upper Volta,False,5,-5,DR Congo
7207,7943,8521,1973,Zambia,Ethiopia,4,2,FIFA World Cup qualification,Lusaka,Zambia,False,6,2,Zambia
7208,7944,8522,1973,Kuwait,Qatar,4,1,Friendly,Kuwait City,Kuwait,False,5,3,Kuwait
7209,7946,8524,1973,Russia,Romania,2,0,Friendly,Kyïv,Soviet Union,False,2,2,Russia
7210,7947,8525,1973,Turkey,Bulgaria,5,2,Balkan Cup,Izmir,Turkey,False,7,3,Turkey
7211,7948,8526,1973,Senegal,Ghana,1,0,African Cup of Nations qualification,Dakar,Senegal,False,1,1,Senegal
7212,7949,8527,1973,DR Congo,Burkina Faso,4,1,African Cup of Nations qualification,Kinshasa,Zaïre,False,5,3,DR Congo
7213,7950,8528,1973,Ivory Coast,Central African Republic,2,1,African Cup of Nations qualification,Abidjan,Ivory Coast,False,3,1,Ivory Coast
7214,7951,8529,1973,Peru,Panama,4,0,Friendly,Lima,Peru,False,4,4,Peru
7215,7952,8530,1973,Ecuador,Chile,1,1,Friendly,Guayaquil,Ecuador,False,2,0,Draw
7216,7953,8531,1973,Denmark,Sweden,1,2,Friendly,Copenhagen,Denmark,False,3,-1,Sweden
7217,7954,8532,1973,Kenya,Uganda,1,2,African Cup of Nations qualification,Nairobi,Kenya,False,3,-1,Uganda
7218,7955,8533,1973,Bolivia,Ecuador,3,3,Friendly,La Paz,Bolivia,False,6,0,Draw
7219,7956,8534,1973,Hungary,Austria,2,2,FIFA World Cup qualification,Budapest,Hungary,False,4,0,Draw
7220,7957,8535,1973,Peru,Chile,2,0,FIFA World Cup qualification,Lima,Peru,False,2,2,Peru
7221,7958,8536,1973,Bulgaria,Portugal,2,1,FIFA World Cup qualification,Sofia,Bulgaria,False,3,1,Bulgaria
7222,7960,8538,1973,Netherlands,Spain,3,2,Friendly,Amsterdam,Netherlands,False,5,1,Netherlands
7223,7962,8540,1973,Syria,Kuwait,2,1,FIFA World Cup qualification,Teheran,Iran,True,3,1,Syria
7224,7963,8541,1973,Albania,Romania,1,4,FIFA World Cup qualification,Tirana,Albania,False,5,-3,Romania
7225,7964,8542,1973,Ecuador,Bolivia,0,0,Friendly,Quito,Ecuador,False,0,0,Draw
7226,7965,8543,1973,Iran,Kuwait,2,1,FIFA World Cup qualification,Teheran,Iran,False,3,1,Iran
7227,7966,8545,1973,Iran,Syria,1,0,FIFA World Cup qualification,Teheran,Iran,False,1,1,Iran
7228,7967,8547,1973,Northern Ireland,Cyprus,3,0,FIFA World Cup qualification,London,England,True,3,3,Northern Ireland
7229,7969,8549,1973,Switzerland,Turkey,0,0,FIFA World Cup qualification,Basel,Switzerland,False,0,0,Draw
7230,7971,8551,1973,Syria,Kuwait,2,0,FIFA World Cup qualification,Teheran,Iran,True,2,2,Syria
7231,7972,8552,1973,England,Northern Ireland,2,1,British Championship,Liverpool,England,False,3,1,England
7232,7973,8553,1973,Germany,Bulgaria,3,0,Friendly,Hamburg,Germany,False,3,3,Germany
7233,7974,8554,1973,Haiti,Ecuador,1,2,Friendly,Port-au-Prince,Haiti,False,3,-1,Ecuador
7234,7975,8555,1973,Wales,Scotland,0,2,British Championship,Wrexham,Wales,False,2,-2,Scotland
7235,7976,8556,1973,Chile,Peru,2,0,FIFA World Cup qualification,Santiago,Chile,False,2,2,Chile
7236,7977,8557,1973,Iran,Kuwait,2,0,FIFA World Cup qualification,Teheran,Iran,False,2,2,Iran
7237,7979,8560,1973,Russia,Republic of Ireland,1,0,FIFA World Cup qualification,Moscow,Soviet Union,True,1,1,Russia
7238,7980,8561,1973,England,Wales,3,0,British Championship,London,England,False,3,3,England
7239,7981,8562,1973,Haiti,Ecuador,1,0,Friendly,Port-au-Prince,Haiti,False,1,1,Haiti
7240,7982,8563,1973,Iran,Syria,0,1,FIFA World Cup qualification,Teheran,Iran,False,1,-1,Syria
7241,7983,8566,1973,Israel,Japan,2,1,FIFA World Cup qualification,Seoul,South Korea,True,3,1,Israel
7242,7984,8567,1973,Poland,Republic of Ireland,2,0,Friendly,Wrocław,Poland,False,2,2,Poland
7243,7985,8568,1973,Scotland,Northern Ireland,1,2,British Championship,Glasgow,Scotland,False,3,-1,Northern Ireland
7244,7987,8570,1973,Argentina,Uruguay,1,1,Copa Lipton,Buenos Aires,Argentina,False,2,0,Draw
7245,7988,8571,1973,Hong Kong,Malaysia,1,0,FIFA World Cup qualification,Seoul,South Korea,True,1,1,Hong Kong
7246,7989,8572,1973,England,Scotland,1,0,British Championship,London,England,False,1,1,England
7247,7990,8573,1973,France,Republic of Ireland,1,1,FIFA World Cup qualification,Paris,France,False,2,0,Draw
7248,7991,8574,1973,Israel,Malaysia,3,0,FIFA World Cup qualification,Seoul,South Korea,True,3,3,Israel
7249,7992,8576,1973,Northern Ireland,Wales,1,0,British Championship,Liverpool,England,True,1,1,Northern Ireland
7250,7993,8577,1973,Ivory Coast,Morocco,1,1,FIFA World Cup qualification,Abidjan,Ivory Coast,False,2,0,Draw
7251,7994,8579,1973,Israel,Thailand,6,0,FIFA World Cup qualification,Seoul,South Korea,True,6,6,Israel
7252,7995,8581,1973,Japan,Hong Kong,0,1,FIFA World Cup qualification,Seoul,South Korea,True,1,-1,Hong Kong
7253,7996,8583,1973,Sweden,Austria,3,2,FIFA World Cup qualification,Gothenburg,Sweden,False,5,1,Sweden
7254,7997,8584,1973,Thailand,Malaysia,0,2,FIFA World Cup qualification,Seoul,South Korea,True,2,-2,Malaysia
7255,7998,8585,1973,Uruguay,Argentina,1,1,Copa Newton,Montevideo,Uruguay,False,2,0,Draw
7256,8000,8587,1973,Israel,Japan,1,0,FIFA World Cup qualification,Seoul,South Korea,True,1,1,Israel
7257,8001,8589,1973,Russia,France,2,0,FIFA World Cup qualification,Moscow,Soviet Union,True,2,2,Russia
7258,8002,8590,1973,Brazil,Bolivia,5,0,Friendly,Rio de Janeiro,Brazil,False,5,5,Brazil
7259,8003,8591,1973,Cameroon,DR Congo,2,1,African Cup of Nations qualification,Yaoundé,Cameroon,False,3,1,Cameroon
7260,8004,8593,1973,Haiti,Colombia,1,2,Friendly,Port-au-Prince,Haiti,False,3,-1,Colombia
7261,8006,8596,1973,Haiti,Colombia,2,1,Friendly,Port-au-Prince,Haiti,False,3,1,Haiti
7262,8007,8597,1973,Algeria,Brazil,0,2,Friendly,Algiers,Algeria,False,2,-2,Brazil
7263,8008,8598,1973,Morocco,Ivory Coast,4,1,FIFA World Cup qualification,Tétouan,Morocco,False,5,3,Morocco
7264,8009,8599,1973,Madagascar,Zambia,2,1,African Cup of Nations qualification,Antananarivo,Madagascar,False,3,1,Madagascar
7265,8011,8602,1973,Haiti,Uruguay,0,0,Friendly,Port-au-Prince,Haiti,False,0,0,Draw
7266,8012,8603,1973,Norway,Republic of Ireland,1,1,Friendly,Oslo,Norway,False,2,0,Draw
7267,8013,8604,1973,Poland,England,2,0,FIFA World Cup qualification,Chorzów,Poland,False,2,2,Poland
7268,8014,8605,1973,Tunisia,Brazil,1,4,Friendly,Tunis,Tunisia,False,5,-3,Brazil
7269,8015,8606,1973,Faroe Islands,Iceland,0,4,Friendly,Klaksvík,Faroe Islands,False,4,-4,Iceland
7270,8016,8607,1973,Italy,Brazil,2,0,Friendly,Rome,Italy,False,2,2,Italy
7271,8017,8609,1973,Russia,England,1,2,Friendly,Moscow,Soviet Union,False,3,-1,England
7272,8018,8610,1973,Burma,Malaysia,2,2,Indonesia Tournament,Jakarta,Indonesia,True,4,0,Draw
7273,8019,8611,1973,Austria,Brazil,1,1,Friendly,Vienna,Austria,False,2,0,Draw
7274,8020,8612,1973,Hungary,Sweden,3,3,FIFA World Cup qualification,Budapest,Hungary,False,6,0,Draw
7275,8021,8613,1973,DR Congo,Cameroon,2,0,African Cup of Nations qualification,Kinshasa,Zaïre,False,2,2,DR Congo
7276,8022,8614,1973,Indonesia,Malaysia,2,0,Indonesia Tournament,Jakarta,Indonesia,False,2,2,Indonesia
7277,8023,8615,1973,Italy,England,2,0,Friendly,Turin,Italy,False,2,2,Italy
7278,8024,8616,1973,Germany,Brazil,0,1,Friendly,Berlin,Germany,False,1,-1,Brazil
7279,8025,8618,1973,Indonesia,Burma,0,0,Indonesia Tournament,Jakarta,Indonesia,False,0,0,Draw
7280,8026,8619,1973,Colombia,Ecuador,1,1,FIFA World Cup qualification,Bogotá,Colombia,False,2,0,Draw
7281,8027,8620,1973,Denmark,Norway,1,0,Nordic Championship,Copenhagen,Denmark,False,1,1,Denmark
7282,8028,8621,1973,Russia,Brazil,0,1,Friendly,Moscow,Soviet Union,False,1,-1,Brazil
7283,8029,8622,1973,Switzerland,Scotland,1,0,Friendly,Berne,Switzerland,False,1,1,Switzerland
7284,8030,8624,1973,Colombia,Uruguay,0,0,FIFA World Cup qualification,Bogotá,Colombia,False,0,0,Draw
7285,8031,8625,1973,Sweden,Brazil,1,0,Friendly,Solna,Sweden,False,1,1,Sweden
7286,8032,8626,1973,Ecuador,Colombia,1,1,FIFA World Cup qualification,Guayaquil,Ecuador,False,2,0,Draw
7287,8033,8627,1973,Scotland,Brazil,0,1,Friendly,Glasgow,Scotland,False,1,-1,Brazil
7288,8034,8628,1973,Ecuador,Uruguay,1,2,FIFA World Cup qualification,Quito,Ecuador,False,3,-1,Uruguay
7289,8035,8629,1973,Peru,Colombia,3,1,Friendly,Lima,Peru,False,4,2,Peru
7290,8036,8630,1973,Republic of Ireland,Brazil,3,4,Friendly,Dublin,Republic of Ireland,False,7,-1,Brazil
7291,8037,8631,1973,Tanzania,Congo,2,1,Friendly,Dar es Salaam,Tanzania,False,3,1,Tanzania
7292,8038,8632,1973,Uruguay,Colombia,0,1,FIFA World Cup qualification,Montevideo,Uruguay,False,1,-1,Colombia
7293,8039,8633,1973,Malawi,Mauritius,4,1,Friendly,Lilongwe,Malawi,False,5,3,Malawi
7294,8040,8634,1973,Malawi,Mauritius,1,0,Friendly,Lilongwe,Malawi,False,1,1,Malawi
7295,8041,8635,1973,Sweden,Finland,1,1,Nordic Championship,Halmstad,Sweden,False,2,0,Draw
7296,8042,8636,1973,Uruguay,Ecuador,4,0,FIFA World Cup qualification,Montevideo,Uruguay,False,4,4,Uruguay
7297,8043,8637,1973,Sweden,Iceland,1,0,Friendly,Uddevalla,Sweden,False,1,1,Sweden
7298,8044,8638,1973,Argentina,Chile,5,4,Copa Carlos Dittborn,Buenos Aires,Argentina,False,9,1,Argentina
7299,8045,8639,1973,Bolivia,Peru,2,0,Friendly,La Paz,Bolivia,False,2,2,Bolivia
7300,8046,8640,1973,Ghana,Ivory Coast,0,3,African Cup of Nations qualification,Accra,Ghana,False,3,-3,Ivory Coast
7301,8047,8641,1973,Mauritius,Réunion,1,1,Friendly,Curepipe,Mauritius,False,2,0,Draw
7302,8048,8642,1973,Egypt,Tanzania,10,1,Friendly,Tunis,Tunisia,True,11,9,Egypt
7303,8050,8644,1973,Chile,Argentina,3,1,Copa Carlos Dittborn,Santiago,Chile,False,4,2,Chile
7304,8052,8646,1973,Israel,Uruguay,1,2,Friendly,Ramat-Gan,Israel,False,3,-1,Uruguay
7305,8053,8647,1973,Chile,Bolivia,3,0,Friendly,Santiago,Chile,False,3,3,Chile
7306,8055,8649,1973,Cambodia,Singapore,1,1,Merdeka Tournament,Kuala Lumpur,Malaysia,True,2,0,Draw
7307,8056,8650,1973,Malaysia,Kuwait,0,0,Merdeka Tournament,Kuala Lumpur,Malaysia,False,0,0,Draw
7308,8057,8651,1973,Argentina,Peru,3,1,Copa Ramón Castilla,Buenos Aires,Argentina,False,4,2,Argentina
7309,8058,8652,1973,Bangladesh,Thailand,2,2,Merdeka Tournament,Kuala Lumpur,Malaysia,True,4,0,Draw
7310,8060,8654,1973,Kuwait,Singapore,2,0,Merdeka Tournament,Ipoh,Malaysia,True,2,2,Kuwait
7311,8062,8656,1973,India,Thailand,2,0,Merdeka Tournament,Kuala Lumpur,Malaysia,True,2,2,India
7312,8063,8657,1973,Ivory Coast,Ghana,1,0,African Cup of Nations qualification,Abidjan,Ivory Coast,False,1,1,Ivory Coast
7313,8064,8658,1973,Burma,Singapore,1,0,Merdeka Tournament,Kuala Lumpur,Malaysia,True,1,1,Burma
7314,8065,8659,1973,Bangladesh,Kuwait,1,2,Merdeka Tournament,Kuala Lumpur,Malaysia,True,3,-1,Kuwait
7315,8066,8660,1973,Canada,Poland,1,3,Friendly,Toronto,Canada,False,4,-2,Poland
7316,8067,8661,1973,Bangladesh,Singapore,1,1,Merdeka Tournament,Ipoh,Malaysia,True,2,0,Draw
7317,8069,8664,1973,Iceland,Norway,0,4,FIFA World Cup qualification,Reykjavík,Iceland,False,4,-4,Norway
7318,8070,8665,1973,United States,Poland,0,1,Friendly,Chicago,United States,False,1,-1,Poland
7319,8071,8666,1973,Burma,Kuwait,2,0,Merdeka Tournament,Kuala Lumpur,Malaysia,True,2,2,Burma
7320,8072,8667,1973,Canada,United States,0,2,Friendly,Windsor,Canada,False,2,-2,United States
7321,8073,8668,1973,Chile,Peru,2,1,FIFA World Cup qualification,Montevideo,Uruguay,True,3,1,Chile
7322,8074,8669,1973,Ghana,DR Congo,1,0,FIFA World Cup qualification,Accra,Ghana,False,1,1,Ghana
7323,8075,8670,1973,Mexico,Poland,0,1,Friendly,Los Angeles,United States,True,1,-1,Poland
7324,8076,8671,1973,Russia,Sweden,0,0,Friendly,Moscow,Soviet Union,False,0,0,Draw
7325,8078,8673,1973,Cambodia,Thailand,1,4,Merdeka Tournament,Kuala Lumpur,Malaysia,True,5,-3,Thailand
7326,8079,8674,1973,Eswatini,Malawi,0,1,Friendly,Mbabane,Eswatini,False,1,-1,Malawi
7327,8080,8675,1973,Bangladesh,Burma,0,6,Merdeka Tournament,Kuala Lumpur,Malaysia,True,6,-6,Burma
7328,8082,8677,1973,Mexico,Poland,1,2,Friendly,Monterrey,Mexico,False,3,-1,Poland
7329,8084,8679,1973,Cambodia,Singapore,0,3,Merdeka Tournament,Kuala Lumpur,Malaysia,True,3,-3,Singapore
7330,8085,8680,1973,Malaysia,Burma,2,1,Merdeka Tournament,Kuala Lumpur,Malaysia,False,3,1,Malaysia
7331,8086,8681,1973,United States,Poland,0,4,Friendly,San Francisco,United States,False,4,-4,Poland
7332,8087,8682,1973,Libya,United Arab Emirates,2,2,Friendly,Benghazi,Libya,False,4,0,Draw
7333,8088,8683,1973,Bangladesh,Thailand,0,2,Merdeka Tournament,Kuala Lumpur,Malaysia,True,2,-2,Thailand
7334,8090,8685,1973,Malaysia,Kuwait,3,1,Merdeka Tournament,Kuala Lumpur,Malaysia,False,4,2,Malaysia
7335,8091,8686,1973,New Zealand,Iran,0,0,Friendly,Auckland,New Zealand,False,0,0,Draw
7336,8092,8687,1973,United States,Poland,1,0,Friendly,New Britain,United States,False,1,1,United States
7337,8093,8688,1973,Zambia,Kenya,2,0,FIFA World Cup qualification,Ndola,Zambia,False,2,2,Zambia
7338,8094,8689,1973,Algeria,United Arab Emirates,2,0,Friendly,Benghazi,Libya,True,2,2,Algeria
7339,8095,8690,1973,Iraq,Yemen,2,0,Friendly,Benghazi,Libya,True,2,2,Iraq
7340,8096,8691,1973,Singapore,Bangladesh,0,1,Friendly,Kallang,Singapore,False,1,-1,Bangladesh
7341,8097,8692,1973,Syria,Tunisia,1,4,Friendly,Tripoli,Libya,True,5,-3,Tunisia
7342,8098,8693,1973,Libya,Yemen,10,0,Friendly,Benghazi,Libya,False,10,10,Libya
7343,8099,8694,1973,Algeria,Iraq,0,0,Friendly,Benghazi,Libya,True,0,0,Draw
7344,8100,8695,1973,Congo,Uganda,3,2,Friendly,Brazzaville,Congo,False,5,1,Congo
7345,8101,8696,1973,Egypt,Tunisia,0,1,Friendly,Tripoli,Libya,True,1,-1,Tunisia
7346,8102,8697,1973,Singapore,India,4,5,Friendly,Kallang,Singapore,False,9,-1,India
7347,8104,8699,1973,Algeria,Yemen,15,1,Friendly,Benghazi,Libya,True,16,14,Algeria
7348,8105,8700,1973,Australia,Iran,3,0,FIFA World Cup qualification,Sydney,Australia,False,3,3,Australia
7349,8106,8701,1973,Egypt,Palestine,2,0,Friendly,Tripoli,Libya,True,2,2,Egypt
7350,8107,8702,1973,Libya,Iraq,0,0,Friendly,Benghazi,Libya,False,0,0,Draw
7351,8108,8703,1973,Bulgaria,Poland,0,2,Friendly,Varna,Bulgaria,False,2,-2,Poland
7352,8109,8704,1973,DR Congo,Ghana,4,1,FIFA World Cup qualification,Kinshasa,Zaïre,False,5,3,DR Congo
7353,8110,8705,1973,Kenya,Zambia,2,2,FIFA World Cup qualification,Nairobi,Kenya,False,4,0,Draw
7354,8112,8707,1973,Egypt,Syria,0,2,Friendly,Tripoli,Libya,True,2,-2,Syria
7355,8113,8708,1973,Iraq,United Arab Emirates,3,1,Friendly,Benghazi,Libya,True,4,2,Iraq
7356,8114,8709,1973,Libya,Algeria,0,2,Friendly,Benghazi,Libya,False,2,-2,Algeria
7357,8115,8710,1973,Palestine,Tunisia,2,6,Friendly,Tripoli,Libya,True,8,-4,Tunisia
7358,8116,8711,1973,Netherlands,Iceland,5,0,FIFA World Cup qualification,Amsterdam,Netherlands,False,5,5,Netherlands
7359,8117,8712,1973,Algeria,Syria,0,0,Friendly,Benghazi,Libya,True,0,0,Draw
7360,8118,8713,1973,Iraq,Tunisia,0,2,Friendly,Tripoli,Libya,True,2,-2,Tunisia
7361,8119,8714,1973,Iran,Australia,2,0,FIFA World Cup qualification,Teheran,Iran,False,2,2,Iran
7362,8120,8715,1973,Algeria,Iraq,0,0,Friendly,Tripoli,Libya,True,0,0,Draw
7363,8121,8716,1973,Syria,Tunisia,0,4,Friendly,Tripoli,Libya,True,4,-4,Tunisia
7364,8122,8717,1973,Finland,Sweden,1,2,Nordic Championship,Helsinki,Finland,False,3,-1,Sweden
7365,8123,8718,1973,Netherlands,Iceland,8,1,FIFA World Cup qualification,Deventer,Netherlands,False,9,7,Netherlands
7366,8124,8719,1973,Bolivia,Paraguay,1,2,FIFA World Cup qualification,La Paz,Bolivia,False,3,-1,Paraguay
7367,8125,8720,1973,Russia,Germany,0,1,Friendly,Moscow,Soviet Union,False,1,-1,Germany
7368,8126,8721,1973,France,Greece,3,1,Friendly,Paris,France,False,4,2,France
7369,8127,8722,1973,Argentina,Bolivia,4,0,FIFA World Cup qualification,Buenos Aires,Argentina,False,4,4,Argentina
7370,8128,8723,1973,United States,Bermuda,1,0,Friendly,Hartford,United States,False,1,1,United States
7371,8129,8724,1973,Norway,Netherlands,1,2,FIFA World Cup qualification,Oslo,Norway,False,3,-1,Netherlands
7372,8130,8725,1973,Paraguay,Argentina,1,1,FIFA World Cup qualification,Asunción,Paraguay,False,2,0,Draw
7373,8131,8726,1973,Mexico,Chile,1,2,Friendly,Mexico City,Mexico,False,3,-1,Chile
7374,8132,8727,1973,Burma,Thailand,2,2,Korea Cup,Seoul,South Korea,True,4,0,Draw
7375,8133,8729,1973,Uganda,Somalia,6,1,CECAFA Cup,Kampala,Uganda,False,7,5,Uganda
7376,8134,8730,1973,Bolivia,Argentina,0,1,FIFA World Cup qualification,La Paz,Bolivia,False,1,-1,Argentina
7377,8136,8732,1973,Norway,Denmark,0,1,Nordic Championship,Trondheim,Norway,False,1,-1,Denmark
7378,8137,8734,1973,Malaysia,Thailand,5,1,Korea Cup,Seoul,South Korea,True,6,4,Malaysia
7379,8138,8735,1973,Somalia,Zambia,1,6,CECAFA Cup,Kampala,Uganda,True,7,-5,Zambia
7380,8140,8737,1973,Burma,Malaysia,1,3,Korea Cup,Seoul,South Korea,True,4,-2,Malaysia
7381,8141,8738,1973,England,Austria,7,0,Friendly,London,England,False,7,7,England
7382,8142,8740,1973,Indonesia,Cambodia,2,3,Korea Cup,Seoul,South Korea,True,5,-1,Cambodia
7383,8143,8741,1973,Northern Ireland,Bulgaria,0,0,FIFA World Cup qualification,Sheffield,England,True,0,0,Draw
7384,8144,8742,1973,Poland,Wales,3,0,FIFA World Cup qualification,Chorzów,Poland,False,3,3,Poland
7385,8145,8743,1973,Russia,Chile,0,0,FIFA World Cup qualification,Moscow,Soviet Union,True,0,0,Draw
7386,8147,8745,1973,Switzerland,Luxembourg,1,0,FIFA World Cup qualification,Lucerne,Switzerland,False,1,1,Switzerland
7387,8148,8746,1973,Uganda,Zambia,1,1,CECAFA Cup,Kampala,Uganda,False,2,0,Draw
7388,8149,8748,1973,Kenya,Tanzania,1,2,CECAFA Cup,Kampala,Uganda,True,3,-1,Tanzania
7389,8150,8749,1973,Cambodia,Malaysia,2,0,Korea Cup,Seoul,South Korea,True,2,2,Cambodia
7390,8151,8751,1973,Malta,Canada,2,0,Friendly,Gżira,Malta,False,2,2,Malta
7391,8152,8752,1973,Uganda,Zambia,2,1,CECAFA Cup,Kampala,Uganda,False,3,1,Uganda
7392,8153,8753,1973,Italy,Sweden,2,0,Friendly,Milan,Italy,False,2,2,Italy
7393,8154,8754,1973,Uganda,Tanzania,2,1,CECAFA Cup,Kampala,Uganda,False,3,1,Uganda
7394,8155,8755,1973,Burma,Cambodia,0,0,Korea Cup,Seoul,South Korea,True,0,0,Draw
7395,8156,8757,1973,Malta,Canada,0,0,Friendly,Gżira,Malta,False,0,0,Draw
7396,8157,8758,1973,Paraguay,Bolivia,4,0,FIFA World Cup qualification,Asunción,Paraguay,False,4,4,Paraguay
7397,8158,8759,1973,Argentina,Paraguay,3,1,FIFA World Cup qualification,Buenos Aires,Argentina,False,4,2,Argentina
7398,8159,8760,1973,Luxembourg,Canada,0,2,Friendly,Luxembourg,Luxembourg,False,2,-2,Canada
7399,8160,8761,1973,Albania,Finland,1,0,FIFA World Cup qualification,Tirana,Albania,False,1,1,Albania
7400,8161,8762,1973,Germany,Austria,4,0,Friendly,Hanover,Germany,False,4,4,Germany
7401,8162,8763,1973,Netherlands,Poland,1,1,Friendly,Rotterdam,Netherlands,False,2,0,Draw
7402,8163,8764,1973,Trinidad and Tobago,Martinique,2,0,Friendly,Port of Spain,Trinidad and Tobago,False,2,2,Trinidad and Tobago
7403,8164,8765,1973,Denmark,Hungary,2,2,Friendly,Copenhagen,Denmark,False,4,0,Draw
7404,8165,8766,1973,Germany,France,2,1,Friendly,Gelsenkirchen,Germany,False,3,1,Germany
7405,8166,8767,1973,Portugal,Bulgaria,2,2,FIFA World Cup qualification,Lisbon,Portugal,False,4,0,Draw
7406,8167,8768,1973,Romania,Finland,9,0,FIFA World Cup qualification,Bucharest,Romania,False,9,9,Romania
7407,8168,8769,1973,Mexico,United States,2,0,Friendly,Mexico City,Mexico,False,2,2,Mexico
7408,8169,8771,1973,England,Poland,1,1,FIFA World Cup qualification,London,England,False,2,0,Draw
7409,8170,8773,1973,Turkey,Spain,0,0,Friendly,Istanbul,Turkey,False,0,0,Draw
7410,8171,8774,1973,Italy,Switzerland,2,0,FIFA World Cup qualification,Rome,Italy,False,2,2,Italy
7411,8172,8775,1973,Republic of Ireland,Poland,1,0,Friendly,Dublin,Republic of Ireland,False,1,1,Republic of Ireland
7412,8173,8777,1973,Zambia,Morocco,4,0,FIFA World Cup qualification,Lusaka,Zambia,False,4,4,Zambia
7413,8174,8778,1973,Curaçao,Suriname,1,1,Friendly,Willemstad,Netherlands Antilles,False,2,0,Draw
7414,8176,8780,1973,Curaçao,Suriname,2,2,Friendly,Willemstad,Netherlands Antilles,False,4,0,Draw
7415,8177,8781,1973,Algeria,Morocco,2,0,Friendly,Algiers,Algeria,False,2,2,Algeria
7416,8178,8782,1973,Belgium,Norway,2,0,FIFA World Cup qualification,Brussels,Belgium,False,2,2,Belgium
7417,8180,8785,1973,Haiti,United States,1,0,Friendly,Port-au-Prince,Haiti,False,1,1,Haiti
7418,8181,8786,1973,Malaysia,Singapore,2,1,Vietnam Independence Cup,Saigon,Vietnam Republic,True,3,1,Malaysia
7419,8182,8787,1973,Guyana,Jamaica,2,1,Friendly,Georgetown,Guyana,False,3,1,Guyana
7420,8183,8789,1973,Zambia,DR Congo,0,2,FIFA World Cup qualification,Lusaka,Zambia,False,2,-2,DR Congo
7421,8184,8790,1973,Haiti,United States,1,0,Friendly,Port-au-Prince,Haiti,False,1,1,Haiti
7422,8185,8791,1973,Barbados,Suriname,0,2,Friendly,Georgetown,Guyana,True,2,-2,Suriname
7423,8186,8792,1973,Guadeloupe,Martinique,0,2,Friendly,Basse-Terre,Guadeloupe,False,2,-2,Martinique
7424,8188,8794,1973,Dominica,Grenada,4,2,Windward Islands Tournament,Roseau,Dominica,False,6,2,Dominica
7425,8189,8795,1973,Guyana,Suriname,0,2,Friendly,Georgetown,Guyana,False,2,-2,Suriname
7426,8190,8796,1973,Haiti,Canada,5,1,Friendly,Port-au-Prince,Haiti,False,6,4,Haiti
7427,8191,8798,1973,Dominica,Saint Lucia,1,0,Windward Islands Tournament,Roseau,Dominica,False,1,1,Dominica
7428,8192,8799,1973,Malta,Sweden,1,2,FIFA World Cup qualification,Gżira,Malta,False,3,-1,Sweden
7429,8193,8800,1973,Saint Vincent and the Grenadines,Grenada,4,1,Windward Islands Tournament,Kingstown,Saint Vincent and the Grenadines,False,5,3,Saint Vincent and the Grenadines
7430,8194,8801,1973,Haiti,Canada,0,1,Friendly,Port-au-Prince,Haiti,False,1,-1,Canada
7431,8196,8803,1973,Israel,United States,3,1,Friendly,Jaffa,Israel,False,4,2,Israel
7432,8197,8804,1973,England,Italy,0,1,Friendly,London,England,False,1,-1,Italy
7433,8198,8805,1973,Portugal,Northern Ireland,1,1,FIFA World Cup qualification,Lisbon,Portugal,False,2,0,Draw
7434,8199,8806,1973,Scotland,Germany,1,1,Friendly,Glasgow,Scotland,False,2,0,Draw
7435,8200,8807,1973,Israel,United States,2,0,Friendly,Beersheba,Israel,False,2,2,Israel
7436,8201,8808,1973,Saint Lucia,Grenada,1,3,Windward Islands Tournament,Castries,Saint Lucia,False,4,-2,Grenada
7437,8202,8809,1973,Saint Lucia,Dominica,2,1,Windward Islands Tournament,Castries,Saint Lucia,False,3,1,Saint Lucia
7438,8203,8810,1973,Bulgaria,Cyprus,2,0,FIFA World Cup qualification,Sofia,Bulgaria,False,2,2,Bulgaria
7439,8204,8811,1973,DR Congo,Zambia,2,1,FIFA World Cup qualification,Kinshasa,Zaïre,False,3,1,DR Congo
7440,8205,8812,1973,Netherlands,Belgium,0,0,FIFA World Cup qualification,Amsterdam,Netherlands,False,0,0,Draw
7441,8206,8813,1973,Turkey,Switzerland,2,0,FIFA World Cup qualification,Izmir,Turkey,False,2,2,Turkey
7442,8207,8814,1973,Saint Vincent and the Grenadines,Dominica,2,2,Windward Islands Tournament,Kingstown,Saint Vincent and the Grenadines,False,4,0,Draw
7443,8208,8815,1973,France,Denmark,3,0,Friendly,Paris,France,False,3,3,France
7444,8209,8816,1973,Grenada,Dominica,1,1,Windward Islands Tournament,St. George's,Grenada,False,2,0,Draw
7445,8211,8818,1973,Saint Vincent and the Grenadines,Saint Lucia,2,0,Windward Islands Tournament,Kingstown,Saint Vincent and the Grenadines,False,2,2,Saint Vincent and the Grenadines
7446,8212,8819,1973,Germany,Spain,2,1,Friendly,Stuttgart,Germany,False,3,1,Germany
7447,8213,8820,1973,Morocco,Zambia,2,0,FIFA World Cup qualification,Tétouan,Morocco,False,2,2,Morocco
7448,8214,8821,1973,Austria,Sweden,1,2,FIFA World Cup qualification,Gelsenkirchen,Germany,True,3,-1,Sweden
7449,8215,8822,1973,Saint Lucia,Saint Vincent and the Grenadines,0,1,Windward Islands Tournament,Castries,Saint Lucia,False,1,-1,Saint Vincent and the Grenadines
7450,8216,8823,1973,Grenada,Saint Lucia,2,0,Windward Islands Tournament,St. George's,Grenada,False,2,2,Grenada
7451,8217,8824,1973,Honduras,Trinidad and Tobago,2,1,FIFA World Cup qualification,Port-au-Prince,Haiti,True,3,1,Honduras
7452,8218,8825,1973,Dominica,Saint Vincent and the Grenadines,0,0,Windward Islands Tournament,Roseau,Dominica,False,0,0,Draw
7453,8219,8826,1973,Guatemala,Mexico,0,0,FIFA World Cup qualification,Port-au-Prince,Haiti,True,0,0,Draw
7454,8220,8827,1973,Haiti,Curaçao,3,0,FIFA World Cup qualification,Port-au-Prince,Haiti,False,3,3,Haiti
7455,8221,8828,1973,Panama,Nicaragua,2,0,Friendly,Panama City,Panama,False,2,2,Panama
7456,8223,8830,1973,Honduras,Mexico,1,1,FIFA World Cup qualification,Port-au-Prince,Haiti,True,2,0,Draw
7457,8224,8831,1973,Haiti,Trinidad and Tobago,2,1,FIFA World Cup qualification,Port-au-Prince,Haiti,False,3,1,Haiti
7458,8225,8832,1973,Guatemala,Curaçao,2,2,FIFA World Cup qualification,Port-au-Prince,Haiti,True,4,0,Draw
7459,8226,8833,1973,Haiti,Honduras,1,0,FIFA World Cup qualification,Port-au-Prince,Haiti,False,1,1,Haiti
7460,8227,8834,1973,Kenya,Uganda,2,2,Friendly,Nairobi,Kenya,False,4,0,Draw
7461,8228,8835,1973,Mexico,Curaçao,8,0,FIFA World Cup qualification,Port-au-Prince,Haiti,True,8,8,Mexico
7462,8229,8836,1973,DR Congo,Morocco,3,0,FIFA World Cup qualification,Kinshasa,Zaïre,False,3,3,DR Congo
7463,8230,8837,1973,Guatemala,Trinidad and Tobago,0,1,FIFA World Cup qualification,Port-au-Prince,Haiti,True,1,-1,Trinidad and Tobago
7464,8231,8838,1973,Uganda,Zambia,2,0,Friendly,Nairobi,Kenya,True,2,2,Uganda
7465,8232,8839,1973,Honduras,Curaçao,2,2,FIFA World Cup qualification,Port-au-Prince,Haiti,True,4,0,Draw
7466,8233,8840,1973,Kenya,Zambia,3,1,Friendly,Nairobi,Kenya,False,4,2,Kenya
7467,8234,8841,1973,Haiti,Guatemala,2,1,FIFA World Cup qualification,Port-au-Prince,Haiti,False,3,1,Haiti
7468,8235,8842,1973,Mexico,Trinidad and Tobago,0,4,FIFA World Cup qualification,Port-au-Prince,Haiti,True,4,-4,Trinidad and Tobago
7469,8236,8843,1973,Guatemala,Honduras,1,1,FIFA World Cup qualification,Port-au-Prince,Haiti,True,2,0,Draw
7470,8237,8844,1973,Laos,Singapore,3,2,King's Cup,Bangkok,Thailand,True,5,1,Laos
7471,8238,8845,1973,Thailand,Burma,2,1,King's Cup,Bangkok,Thailand,False,3,1,Thailand
7472,8240,8847,1973,Burma,Singapore,6,1,King's Cup,Bangkok,Thailand,True,7,5,Burma
7473,8241,8848,1973,Curaçao,Trinidad and Tobago,0,4,FIFA World Cup qualification,Port-au-Prince,Haiti,True,4,-4,Trinidad and Tobago
7474,8242,8849,1973,Thailand,Laos,5,0,King's Cup,Bangkok,Thailand,False,5,5,Thailand
7475,8243,8850,1973,Haiti,Mexico,0,1,FIFA World Cup qualification,Port-au-Prince,Haiti,False,1,-1,Mexico
7476,8244,8852,1973,Burma,Laos,2,1,King's Cup,Bangkok,Thailand,True,3,1,Burma
7477,8246,8854,1973,Thailand,Singapore,3,0,King's Cup,Bangkok,Thailand,False,3,3,Thailand
7478,8247,8855,1973,Cambodia,Malaysia,2,3,King's Cup,Bangkok,Thailand,True,5,-1,Malaysia
7479,8248,8856,1973,Congo,Tunisia,0,1,Friendly,Brazzaville,Congo,False,1,-1,Tunisia
7480,8250,8858,1973,Thailand,Malaysia,0,1,King's Cup,Bangkok,Thailand,False,1,-1,Malaysia
7481,8251,8860,1973,Thailand,Burma,1,0,King's Cup,Bangkok,Thailand,False,1,1,Thailand
7482,8252,8861,1973,Guinea,Tunisia,0,0,Friendly,Conakry,Guinea,False,0,0,Draw
7483,8253,8862,1974,Uganda,Congo,0,2,Friendly,Kampala,Uganda,False,2,-2,Congo
7484,8254,8863,1974,Mali,Tunisia,1,0,Friendly,Bamako,Mali,False,1,1,Mali
7485,8255,8864,1974,Mauritius,Malawi,4,1,Friendly,Port Louis,Mauritius,False,5,3,Mauritius
7486,8256,8865,1974,Mauritius,Malawi,2,1,Friendly,Port Louis,Mauritius,False,3,1,Mauritius
7487,8257,8866,1974,Pakistan,Iran,1,2,Friendly,Karachi,Pakistan,False,3,-1,Iran
7488,8258,8867,1974,Pakistan,Turkey,2,2,Friendly,Karachi,Pakistan,False,4,0,Draw
7489,8259,8868,1974,Iran,Turkey,0,1,Friendly,Karachi,Pakistan,True,1,-1,Turkey
7490,8260,8869,1974,Mauritius,Malawi,2,2,Friendly,Port Louis,Mauritius,False,4,0,Draw
7491,8261,8870,1974,Panama,El Salvador,1,0,Friendly,Panama City,Panama,False,1,1,Panama
7492,8262,8871,1974,Cyprus,Bulgaria,1,4,Friendly,Morphou,Cyprus,False,5,-3,Bulgaria
7493,8263,8872,1974,Kuwait,Bulgaria,1,3,Friendly,Kuwait City,Kuwait,False,4,-2,Bulgaria
7494,8264,8873,1974,Kuwait,Bulgaria,1,2,Friendly,Kuwait City,Kuwait,False,3,-1,Bulgaria
7495,8265,8874,1974,Singapore,Japan,0,1,Friendly,Kallang,Singapore,False,1,-1,Japan
7496,8266,8876,1974,Ghana,Guinea,5,2,Friendly,Accra,Ghana,False,7,3,Ghana
7497,8267,8877,1974,Congo,Mali,2,2,Friendly,Brazzaville,Congo,False,4,0,Draw
7498,8268,8878,1974,Ghana,Guinea,3,1,Friendly,Accra,Ghana,False,4,2,Ghana
7499,8269,8881,1974,Hong Kong,Japan,0,0,Friendly,So Kon Po,Hong Kong,False,0,0,Draw
7500,8270,8883,1974,Iraq,Morocco,0,0,Friendly,Baghdad,Iraq,False,0,0,Draw
7501,8271,8884,1974,Spain,Germany,1,0,Friendly,Barcelona,Spain,False,1,1,Spain
7502,8272,8885,1974,Iraq,Morocco,0,0,Friendly,Baghdad,Iraq,False,0,0,Draw
7503,8273,8886,1974,Kuwait,Morocco,0,2,Friendly,Kuwait City,Kuwait,False,2,-2,Morocco
7504,8274,8887,1974,Italy,Germany,0,0,Friendly,Rome,Italy,False,0,0,Draw
7505,8276,8889,1974,Qatar,Morocco,0,1,Friendly,Doha,Qatar,False,1,-1,Morocco
7506,8278,8891,1974,Bahrain,Morocco,0,1,Friendly,Manama,Bahrain,False,1,-1,Morocco
7507,8279,8892,1974,Egypt,Uganda,2,1,African Cup of Nations,Cairo,Egypt,False,3,1,Egypt
7508,8280,8893,1974,Ivory Coast,Zambia,0,1,African Cup of Nations,al-Mahalla al-Kubra,Egypt,True,1,-1,Zambia
7509,8281,8894,1974,Congo,Mauritius,2,0,African Cup of Nations,Alexandria,Egypt,True,2,2,Congo
7510,8282,8895,1974,Guinea,DR Congo,1,2,African Cup of Nations,Damanhur,Egypt,True,3,-1,DR Congo
7511,8283,8896,1974,Egypt,Zambia,3,1,African Cup of Nations,Cairo,Egypt,False,4,2,Egypt
7512,8284,8897,1974,Ivory Coast,Uganda,2,2,African Cup of Nations,al-Mahalla al-Kubra,Egypt,True,4,0,Draw
7513,8285,8898,1974,Congo,DR Congo,2,1,African Cup of Nations,Alexandria,Egypt,True,3,1,Congo
7514,8286,8899,1974,Guinea,Mauritius,2,1,African Cup of Nations,Damanhur,Egypt,True,3,1,Guinea
7515,8287,8900,1974,Egypt,Ivory Coast,2,0,African Cup of Nations,Cairo,Egypt,False,2,2,Egypt
7516,8288,8901,1974,Saudi Arabia,Morocco,0,0,Friendly,Riyadh,Saudi Arabia,False,0,0,Draw
7517,8289,8902,1974,Togo,Denmark,0,2,Friendly,Lomé,Togo,False,2,-2,Denmark
7518,8290,8903,1974,Uganda,Zambia,0,1,African Cup of Nations,al-Mahalla al-Kubra,Egypt,True,1,-1,Zambia
7519,8291,8904,1974,Congo,Guinea,1,1,African Cup of Nations,Alexandria,Egypt,True,2,0,Draw
7520,8292,8905,1974,Mauritius,DR Congo,1,4,African Cup of Nations,Damanhur,Egypt,True,5,-3,DR Congo
7521,8293,8906,1974,Congo,Zambia,2,4,African Cup of Nations,Alexandria,Egypt,True,6,-2,Zambia
7522,8294,8907,1974,Egypt,DR Congo,2,3,African Cup of Nations,Cairo,Egypt,False,5,-1,DR Congo
7523,8295,8908,1974,Benin,Denmark,2,0,Friendly,Cotonou,Dahomey,False,2,2,Benin
7524,8296,8909,1974,Egypt,Congo,4,0,African Cup of Nations,Cairo,Egypt,False,4,4,Egypt
7525,8297,8910,1974,DR Congo,Zambia,2,2,African Cup of Nations,Cairo,Egypt,True,4,0,Draw
7526,8298,8912,1974,Réunion,Seychelles,2,0,Friendly,Saint-Pierre,Réunion,False,2,2,Réunion
7527,8299,8913,1974,DR Congo,Zambia,2,0,African Cup of Nations,Cairo,Egypt,True,2,2,DR Congo
7528,8300,8914,1974,Puerto Rico,Panama,0,1,Friendly,San Juan,Puerto Rico,False,1,-1,Panama
7529,8301,8915,1974,Kuwait,United Arab Emirates,2,0,Gulf Cup,Kuwait City,Kuwait,False,2,2,Kuwait
7530,8302,8916,1974,Bahrain,Oman,4,0,Gulf Cup,Kuwait City,Kuwait,True,4,4,Bahrain
7531,8303,8917,1974,Qatar,Saudi Arabia,0,2,Gulf Cup,Kuwait City,Kuwait,True,2,-2,Saudi Arabia
7532,8304,8918,1974,Bahrain,United Arab Emirates,0,4,Gulf Cup,Kuwait City,Kuwait,True,4,-4,United Arab Emirates
7533,8305,8919,1974,Kuwait,Oman,5,0,Gulf Cup,Kuwait City,Kuwait,False,5,5,Kuwait
7534,8306,8920,1974,Bahrain,Saudi Arabia,1,4,Gulf Cup,Kuwait City,Kuwait,True,5,-3,Saudi Arabia
7535,8307,8921,1974,Oman,Qatar,0,4,Gulf Cup,Kuwait City,Kuwait,True,4,-4,Qatar
7536,8308,8922,1974,France,Romania,1,0,Friendly,Paris,France,False,1,1,France
7537,8309,8923,1974,Haiti,Uruguay,0,1,Friendly,Port-au-Prince,Haiti,False,1,-1,Uruguay
7538,8310,8924,1974,Saudi Arabia,United Arab Emirates,2,0,Gulf Cup,Kuwait City,Kuwait,True,2,2,Saudi Arabia
7539,8311,8925,1974,Kuwait,Qatar,1,0,Gulf Cup,Kuwait City,Kuwait,False,1,1,Kuwait
7540,8312,8926,1974,Haiti,Uruguay,0,0,Friendly,Port-au-Prince,Haiti,False,0,0,Draw
7541,8313,8927,1974,Kuwait,United Arab Emirates,6,0,Gulf Cup,Kuwait City,Kuwait,False,6,6,Kuwait
7542,8314,8928,1974,Qatar,Saudi Arabia,1,3,Gulf Cup,Kuwait City,Kuwait,True,4,-2,Saudi Arabia
7543,8315,8930,1974,Germany,Scotland,2,1,Friendly,Frankfurt am Main,Germany,False,3,1,Germany
7544,8316,8931,1974,Netherlands,Austria,1,1,Friendly,Rotterdam,Netherlands,False,2,0,Draw
7545,8317,8932,1974,Jamaica,Uruguay,0,3,Friendly,Kingston,Jamaica,False,3,-3,Uruguay
7546,8318,8933,1974,Qatar,United Arab Emirates,1,1,Gulf Cup,Kuwait City,Kuwait,True,2,0,Draw
7547,8319,8934,1974,Kuwait,Saudi Arabia,4,0,Gulf Cup,Kuwait City,Kuwait,False,4,4,Kuwait
7548,8320,8935,1974,Brazil,Mexico,1,1,Friendly,Rio de Janeiro,Brazil,False,2,0,Draw
7549,8321,8936,1974,Hungary,Bulgaria,3,1,Friendly,Zalaegerszeg,Hungary,False,4,2,Hungary
7550,8322,8937,1974,Portugal,England,0,0,Friendly,Lisbon,Portugal,False,0,0,Draw
7551,8324,8939,1974,Morocco,Algeria,2,0,Friendly,Casablanca,Morocco,False,2,2,Morocco
7552,8325,8940,1974,Bermuda,Canada,0,0,Friendly,Hamilton,Bermuda,False,0,0,Draw
7553,8327,8942,1974,Haiti,Poland,2,1,Friendly,Port-au-Prince,Haiti,False,3,1,Haiti
7554,8328,8943,1974,Brazil,Bulgaria,1,0,Friendly,Rio de Janeiro,Brazil,False,1,1,Brazil
7555,8329,8944,1974,Haiti,Poland,1,3,Friendly,Port-au-Prince,Haiti,False,4,-2,Poland
7556,8330,8945,1974,Belgium,Poland,1,1,Friendly,Liège,Belgium,False,2,0,Draw
7557,8331,8946,1974,Brazil,Romania,2,0,Friendly,São Paulo,Brazil,False,2,2,Brazil
7558,8332,8947,1974,Germany,Hungary,5,0,Friendly,Dortmund,Germany,False,5,5,Germany
7559,8333,8949,1974,Indonesia,Uruguay,2,1,Friendly,Jakarta,Indonesia,False,3,1,Indonesia
7560,8334,8950,1974,Brazil,Haiti,4,0,Friendly,Brasília,Brazil,False,4,4,Brazil
7561,8335,8951,1974,Indonesia,Uruguay,2,3,Friendly,Jakarta,Indonesia,False,5,-1,Uruguay
7562,8336,8952,1974,Argentina,Romania,2,1,Friendly,Buenos Aires,Argentina,False,3,1,Argentina
7563,8337,8953,1974,Haiti,Chile,0,1,Friendly,Port-au-Prince,Haiti,False,1,-1,Chile
7564,8338,8954,1974,Haiti,Chile,0,0,Friendly,Port-au-Prince,Haiti,False,0,0,Draw
7565,8339,8956,1974,Brazil,Greece,0,0,Friendly,Rio de Janeiro,Brazil,False,0,0,Draw
7566,8340,8957,1974,Brazil,Austria,0,0,Friendly,São Paulo,Brazil,False,0,0,Draw
7567,8341,8958,1974,Germany,Sweden,2,0,Friendly,Hamburg,Germany,False,2,2,Germany
7568,8342,8959,1974,Switzerland,Belgium,0,1,Friendly,Geneva,Switzerland,False,1,-1,Belgium
7569,8343,8961,1974,Brazil,Republic of Ireland,2,1,Friendly,Rio de Janeiro,Brazil,False,3,1,Brazil
7570,8344,8963,1974,Bulgaria,Turkey,5,1,Balkan Cup,Sofia,Bulgaria,False,6,4,Bulgaria
7571,8345,8964,1974,Uruguay,Republic of Ireland,2,0,Friendly,Montevideo,Uruguay,False,2,2,Uruguay
7572,8346,8965,1974,Scotland,Northern Ireland,0,1,British Championship,Glasgow,Scotland,False,1,-1,Northern Ireland
7573,8347,8966,1974,Wales,England,0,2,British Championship,Cardiff,Wales,False,2,-2,England
7574,8348,8967,1974,Brazil,Paraguay,2,0,Friendly,Rio de Janeiro,Brazil,False,2,2,Brazil
7575,8349,8968,1974,Chile,Republic of Ireland,1,2,Friendly,Santiago,Chile,False,3,-1,Republic of Ireland
7576,8350,8970,1974,Scotland,Wales,2,0,British Championship,Glasgow,Scotland,False,2,2,Scotland
7577,8351,8971,1974,England,Northern Ireland,1,0,British Championship,London,England,False,1,1,England
7578,8352,8972,1974,Poland,Greece,2,0,Friendly,Warsaw,Poland,False,2,2,Poland
7579,8353,8973,1974,Burma,Thailand,2,1,Korea Cup,Seoul,South Korea,True,3,1,Burma
7580,8354,8974,1974,France,Argentina,0,1,Friendly,Paris,France,False,1,-1,Argentina
7581,8355,8976,1974,Scotland,England,2,0,British Championship,Glasgow,Scotland,False,2,2,Scotland
7582,8356,8977,1974,Wales,Northern Ireland,1,0,British Championship,Wrexham,Wales,False,1,1,Wales
7583,8357,8978,1974,Burma,Cambodia,6,0,Korea Cup,Seoul,South Korea,True,6,6,Burma
7584,8359,8980,1974,Indonesia,Australia,1,2,Friendly,Jakarta,Indonesia,False,3,-1,Australia
7585,8360,8981,1974,England,Argentina,2,2,Friendly,London,England,False,4,0,Draw
7586,8362,8984,1974,Netherlands,Argentina,4,1,Friendly,Amsterdam,Netherlands,False,5,3,Netherlands
7587,8363,8985,1974,Israel,Australia,2,1,Friendly,Jaffa,Israel,False,3,1,Israel
7588,8365,8988,1974,Romania,Greece,3,1,Balkan Cup,Bucharest,Romania,False,4,2,Romania
7589,8366,8989,1974,Belgium,Scotland,2,1,Friendly,Bruges,Belgium,False,3,1,Belgium
7590,8367,8990,1974,Bulgaria,England,0,1,Friendly,Sofia,Bulgaria,False,1,-1,England
7591,8368,8991,1974,Indonesia,Burma,2,4,Indonesia Tournament,Jakarta,Indonesia,False,6,-2,Burma
7592,8369,8992,1974,Tunisia,Iraq,2,1,Friendly,Tunis,Tunisia,False,3,1,Tunisia
7593,8370,8993,1974,Burma,Malaysia,3,0,Indonesia Tournament,Jakarta,Indonesia,True,3,3,Burma
7594,8371,8994,1974,Denmark,Sweden,0,2,Nordic Championship,Copenhagen,Denmark,False,2,-2,Sweden
7595,8372,8995,1974,Netherlands,Romania,0,0,Friendly,Rotterdam,Netherlands,False,0,0,Draw
7596,8373,8997,1974,Finland,Denmark,1,1,Nordic Championship,Oulu,Finland,False,2,0,Draw
7597,8374,8998,1974,Norway,Scotland,1,2,Friendly,Oslo,Norway,False,3,-1,Scotland
7598,8375,8999,1974,Indonesia,Malaysia,4,3,Indonesia Tournament,Jakarta,Indonesia,False,7,1,Indonesia
7599,8376,9000,1974,Libya,Iraq,1,0,Friendly,Tripoli,Libya,False,1,1,Libya
7600,8377,9001,1974,Austria,Italy,0,0,Friendly,Vienna,Austria,False,0,0,Draw
7601,8378,9003,1974,Sweden,Switzerland,0,0,Friendly,Malmö,Sweden,False,0,0,Draw
7602,8380,9005,1974,DR Congo,Scotland,0,2,FIFA World Cup,Dortmund,Germany,True,2,-2,Scotland
7603,8381,9007,1974,Germany,Chile,1,0,FIFA World Cup,Berlin,Germany,False,1,1,Germany
7604,8382,9008,1974,Italy,Haiti,3,1,FIFA World Cup,Munich,Germany,True,4,2,Italy
7605,8383,9009,1974,Poland,Argentina,3,2,FIFA World Cup,Stuttgart,Germany,True,5,1,Poland
7606,8384,9010,1974,Sweden,Bulgaria,0,0,FIFA World Cup,Düsseldorf,Germany,True,0,0,Draw
7607,8385,9011,1974,Uruguay,Netherlands,0,2,FIFA World Cup,Hanover,Germany,True,2,-2,Netherlands
7608,8387,9013,1974,Germany,Australia,3,0,FIFA World Cup,Hamburg,Germany,False,3,3,Germany
7609,8388,9014,1974,Scotland,Brazil,0,0,FIFA World Cup,Frankfurt am Main,Germany,True,0,0,Draw
7610,8389,9016,1974,Argentina,Italy,1,1,FIFA World Cup,Stuttgart,Germany,True,2,0,Draw
7611,8390,9017,1974,Bulgaria,Uruguay,1,1,FIFA World Cup,Hanover,Germany,True,2,0,Draw
7612,8391,9018,1974,Haiti,Poland,0,7,FIFA World Cup,Munich,Germany,True,7,-7,Poland
7613,8392,9019,1974,Netherlands,Sweden,0,0,FIFA World Cup,Dortmund,Germany,True,0,0,Draw
7614,8393,9020,1974,Australia,Chile,0,0,FIFA World Cup,Berlin,Germany,True,0,0,Draw
7615,8394,9021,1974,DR Congo,Brazil,0,3,FIFA World Cup,Gelsenkirchen,Germany,True,3,-3,Brazil
7616,8397,9024,1974,Argentina,Haiti,4,1,FIFA World Cup,Munich,Germany,True,5,3,Argentina
7617,8398,9025,1974,Bulgaria,Netherlands,1,4,FIFA World Cup,Dortmund,Germany,True,5,-3,Netherlands
7618,8399,9026,1974,Poland,Italy,2,1,FIFA World Cup,Stuttgart,Germany,True,3,1,Poland
7619,8400,9027,1974,Sweden,Uruguay,3,0,FIFA World Cup,Düsseldorf,Germany,True,3,3,Sweden
7620,8403,9030,1974,Mali,Congo,1,1,Friendly,Bamako,Mali,False,2,0,Draw
7621,8404,9031,1974,Netherlands,Argentina,4,0,FIFA World Cup,Gelsenkirchen,Germany,True,4,4,Netherlands
7622,8405,9032,1974,Sweden,Poland,0,1,FIFA World Cup,Stuttgart,Germany,True,1,-1,Poland
7623,8406,9033,1974,Argentina,Brazil,1,2,FIFA World Cup,Hanover,Germany,True,3,-1,Brazil
7624,8407,9035,1974,Germany,Sweden,4,2,FIFA World Cup,Düsseldorf,Germany,False,6,2,Germany
7625,8410,9038,1974,Faroe Islands,Iceland,2,3,Friendly,Tórshavn,Faroe Islands,False,5,-1,Iceland
7626,8411,9039,1974,Germany,Poland,1,0,FIFA World Cup,Frankfurt am Main,Germany,False,1,1,Germany
7627,8412,9040,1974,Netherlands,Brazil,2,0,FIFA World Cup,Dortmund,Germany,True,2,2,Netherlands
7628,8414,9043,1974,Brazil,Poland,0,1,FIFA World Cup,Munich,Germany,True,1,-1,Poland
7629,8415,9044,1974,Malawi,Ivory Coast,5,1,Friendly,Lilongwe,Malawi,False,6,4,Malawi
7630,8416,9045,1974,Germany,Netherlands,2,1,FIFA World Cup,Munich,Germany,False,3,1,Germany
7631,8417,9046,1974,Malawi,Tanzania,1,0,Friendly,Lilongwe,Malawi,False,1,1,Malawi
7632,8418,9047,1974,Malawi,Zambia,0,1,Friendly,Lilongwe,Malawi,False,1,-1,Zambia
7633,8419,9049,1974,Nigeria,Ivory Coast,2,0,Friendly,Lagos,Nigeria,False,2,2,Nigeria
7634,8420,9051,1974,Hong Kong,Indonesia,2,2,Merdeka Tournament,Ipoh,Malaysia,True,4,0,Draw
7635,8421,9052,1974,India,Thailand,4,2,Merdeka Tournament,Ipoh,Malaysia,True,6,2,India
7636,8422,9053,1974,Malaysia,India,4,1,Merdeka Tournament,Ipoh,Malaysia,False,5,3,Malaysia
7637,8423,9054,1974,Indonesia,Thailand,1,2,Merdeka Tournament,Ipoh,Malaysia,True,3,-1,Thailand
7638,8424,9055,1974,Indonesia,Singapore,5,0,Merdeka Tournament,Ipoh,Malaysia,True,5,5,Indonesia
7639,8425,9056,1974,Hong Kong,India,2,2,Merdeka Tournament,Ipoh,Malaysia,True,4,0,Draw
7640,8426,9057,1974,Singapore,Thailand,1,1,Merdeka Tournament,Ipoh,Malaysia,True,2,0,Draw
7641,8427,9058,1974,India,Indonesia,0,0,Merdeka Tournament,Ipoh,Malaysia,True,0,0,Draw
7642,8428,9059,1974,Malaysia,Thailand,3,2,Merdeka Tournament,Ipoh,Malaysia,False,5,1,Malaysia
7643,8429,9060,1974,Hong Kong,Thailand,1,0,Merdeka Tournament,Ipoh,Malaysia,True,1,1,Hong Kong
7644,8430,9061,1974,Singapore,Hong Kong,0,1,Friendly,Kallang,Singapore,False,1,-1,Hong Kong
7645,8431,9062,1974,Sweden,Norway,2,1,Nordic Championship,Gothenburg,Sweden,False,3,1,Sweden
7646,8432,9063,1974,Somalia,Burundi,0,2,African Cup of Nations qualification,Mogadishu,Somalia,False,2,-2,Burundi
7647,8433,9065,1974,Nigeria,Ghana,1,1,Friendly,Lagos,Nigeria,False,2,0,Draw
7648,8434,9066,1974,Iraq,Bahrain,4,0,Friendly,Baghdad,Iraq,False,4,4,Iraq
7649,8435,9067,1974,Norway,Finland,1,2,Nordic Championship,Oslo,Norway,False,3,-1,Finland
7650,8436,9068,1974,Nigeria,Ghana,0,1,Friendly,Lagos,Nigeria,False,1,-1,Ghana
7651,8437,9069,1974,Iceland,Finland,2,2,Friendly,Reykjavík,Iceland,False,4,0,Draw
7652,8438,9070,1974,Burundi,Somalia,0,1,African Cup of Nations qualification,Bujumbura,Burundi,False,1,-1,Somalia
7653,8439,9071,1974,Malta,Libya,0,1,Friendly,Gżira,Malta,False,1,-1,Libya
7654,8440,9072,1974,Haiti,Jamaica,0,1,Friendly,New York,United States,True,1,-1,Jamaica
7655,8441,9073,1974,Jamaica,Trinidad and Tobago,2,1,Friendly,New York,United States,True,3,1,Jamaica
7656,8442,9074,1974,Finland,Poland,1,2,UEFA Euro qualification,Helsinki,Finland,False,3,-1,Poland
7657,8443,9075,1974,Denmark,Indonesia,9,0,Friendly,Copenhagen,Denmark,False,9,9,Denmark
7658,8444,9076,1974,Austria,Wales,2,1,UEFA Euro qualification,Vienna,Austria,False,3,1,Austria
7659,8445,9077,1974,Libya,Malta,0,0,Friendly,Tripoli,Libya,False,0,0,Draw
7660,8446,9078,1974,Norway,Northern Ireland,2,1,UEFA Euro qualification,Oslo,Norway,False,3,1,Norway
7661,8448,9080,1974,Sweden,Netherlands,1,5,Friendly,Solna,Sweden,False,6,-4,Netherlands
7662,8449,9081,1974,Switzerland,Germany,1,2,Friendly,Basel,Switzerland,False,3,-1,Germany
7663,8450,9082,1974,Mexico,United States,3,1,Friendly,Monterrey,Mexico,False,4,2,Mexico
7664,8451,9083,1974,Libya,DR Congo,0,2,Friendly,Tripoli,Libya,False,2,-2,DR Congo
7665,8452,9084,1974,Poland,France,0,2,Friendly,Wrocław,Poland,False,2,-2,France
7666,8453,9085,1974,Iceland,Belgium,0,2,UEFA Euro qualification,Reykjavík,Iceland,False,2,-2,Belgium
7667,8454,9086,1974,United States,Mexico,0,1,Friendly,Dallas,United States,False,1,-1,Mexico
7668,8455,9087,1974,Libya,Somalia,3,2,Friendly,Tripoli,Libya,False,5,1,Libya
7669,8456,9088,1974,Ivory Coast,Ghana,1,1,Friendly,Abidjan,Ivory Coast,False,2,0,Draw
7670,8457,9089,1974,Libya,Somalia,3,2,Friendly,Tripoli,Libya,False,5,1,Libya
7671,8458,9090,1974,Bulgaria,Romania,0,0,Friendly,Sofia,Bulgaria,False,0,0,Draw
7672,8459,9092,1974,Denmark,Spain,1,2,UEFA Euro qualification,Copenhagen,Denmark,False,3,-1,Spain
7673,8460,9093,1974,Finland,Netherlands,1,3,UEFA Euro qualification,Helsinki,Finland,False,4,-2,Netherlands
7674,8461,9094,1974,Syria,Palestine,2,0,Friendly,Damascus,Syria,False,2,2,Syria
7675,8462,9095,1974,Algeria,Lebanon,4,1,Friendly,Damascus,Syria,True,5,3,Algeria
7676,8463,9096,1974,Austria,Hungary,1,0,Friendly,Vienna,Austria,False,1,1,Austria
7677,8465,9098,1974,Yemen,Sudan,0,6,Friendly,Damascus,Syria,True,6,-6,Sudan
7678,8466,9100,1974,Algeria,Jordan,6,0,Friendly,Damascus,Syria,True,6,6,Algeria
7679,8467,9101,1974,Libya,Yemen,9,1,Friendly,Damascus,Syria,True,10,8,Libya
7680,8468,9102,1974,Palestine,Sudan,1,3,Friendly,Damascus,Syria,True,4,-2,Sudan
7681,8469,9103,1974,Morocco,Tunisia,3,1,Friendly,Damascus,Syria,True,4,2,Morocco
7682,8470,9104,1974,Libya,Palestine,0,0,Friendly,Damascus,Syria,True,0,0,Draw
7683,8471,9105,1974,Algeria,Tunisia,0,1,Friendly,Damascus,Syria,True,1,-1,Tunisia
7684,8472,9106,1974,Libya,Sudan,1,3,Friendly,Damascus,Syria,True,4,-2,Sudan
7685,8473,9107,1974,Syria,Yemen,6,0,Friendly,Damascus,Syria,False,6,6,Syria
7686,8474,9108,1974,Palestine,Yemen,7,1,Friendly,Damascus,Syria,True,8,6,Palestine
7687,8475,9109,1974,Morocco,Sudan,2,0,Friendly,Damascus,Syria,True,2,2,Morocco
7688,8476,9110,1974,Denmark,Iceland,2,1,Friendly,Aalborg,Denmark,False,3,1,Denmark
7689,8477,9112,1974,Netherlands,Switzerland,1,0,Friendly,Rotterdam,Netherlands,False,1,1,Netherlands
7690,8478,9113,1974,Poland,Finland,3,0,UEFA Euro qualification,Poznań,Poland,False,3,3,Poland
7691,8479,9114,1974,Sudan,Tunisia,1,3,Friendly,Damascus,Syria,True,4,-2,Tunisia
7692,8480,9115,1974,Syria,Morocco,1,1,Friendly,Damascus,Syria,False,2,0,Draw
7693,8481,9116,1974,Argentina,Spain,1,1,Friendly,Buenos Aires,Argentina,False,2,0,Draw
7694,8482,9117,1974,Belgium,France,2,1,UEFA Euro qualification,Brussels,Belgium,False,3,1,Belgium
7695,8483,9119,1974,Bulgaria,Greece,3,3,UEFA Euro qualification,Sofia,Bulgaria,False,6,0,Draw
7696,8484,9121,1974,Denmark,Romania,0,0,UEFA Euro qualification,Copenhagen,Denmark,False,0,0,Draw
7697,8485,9122,1974,Luxembourg,Hungary,2,4,UEFA Euro qualification,Luxembourg,Luxembourg,False,6,-2,Hungary
7698,8487,9124,1974,Republic of Ireland,Russia,3,0,UEFA Euro qualification,Dublin,Republic of Ireland,False,3,3,Republic of Ireland
7699,8489,9126,1974,Sweden,Northern Ireland,0,2,UEFA Euro qualification,Solna,Sweden,False,2,-2,Northern Ireland
7700,8490,9127,1974,Wales,Hungary,2,0,UEFA Euro qualification,Cardiff,Wales,False,2,2,Wales
7701,8491,9130,1974,Algeria,Morocco,0,0,Friendly,Algiers,Algeria,False,0,0,Draw
7702,8492,9131,1974,Poland,Canada,2,0,Friendly,Warsaw,Poland,False,2,2,Poland
7703,8493,9133,1974,Laos,Malaysia,0,0,Vietnam Independence Cup,Saigon,Vietnam Republic,True,0,0,Draw
7704,8494,9135,1974,Cambodia,Thailand,2,2,Vietnam Independence Cup,Saigon,Vietnam Republic,True,4,0,Draw
7705,8495,9136,1974,Kenya,Zambia,2,3,CECAFA Cup,Zanzibar,Tanzania,True,5,-1,Zambia
7706,8498,9139,1974,Somalia,Uganda,1,1,CECAFA Cup,Zanzibar,Tanzania,True,2,0,Draw
7707,8500,9142,1974,Chile,Argentina,0,2,Copa Carlos Dittborn,Santiago,Chile,False,2,-2,Argentina
7708,8501,9143,1974,Tanzania,Uganda,1,1,CECAFA Cup,Zanzibar,Tanzania,False,2,0,Draw
7709,8502,9146,1974,Bulgaria,Hungary,0,0,Friendly,Varna,Bulgaria,False,0,0,Draw
7710,8503,9147,1974,Togo,Liberia,1,0,African Cup of Nations qualification,Lomé,Togo,False,1,1,Togo
7711,8504,9148,1974,Tunisia,Libya,1,0,African Cup of Nations qualification,Tunis,Tunisia,False,1,1,Tunisia
7712,8505,9150,1974,Switzerland,Portugal,3,0,Friendly,Berne,Switzerland,False,3,3,Switzerland
7713,8506,9151,1974,Turkey,Austria,0,1,Friendly,Istanbul,Turkey,False,1,-1,Austria
7714,8507,9152,1974,Greece,Cyprus,3,1,Friendly,Piraeus,Greece,False,4,2,Greece
7715,8509,9154,1974,Argentina,Chile,1,1,Copa Carlos Dittborn,Buenos Aires,Argentina,False,2,0,Draw
7716,8510,9155,1974,England,Portugal,0,0,UEFA Euro qualification,London,England,False,0,0,Draw
7717,8511,9156,1974,Greece,Germany,2,2,UEFA Euro qualification,Piraeus,Greece,False,4,0,Draw
7718,8512,9157,1974,Netherlands,Italy,3,1,UEFA Euro qualification,Rotterdam,Netherlands,False,4,2,Netherlands
7719,8513,9158,1974,Scotland,Spain,1,2,UEFA Euro qualification,Glasgow,Scotland,False,3,-1,Spain
7720,8514,9159,1974,Turkey,Republic of Ireland,1,1,UEFA Euro qualification,Izmir,Turkey,False,2,0,Draw
7721,8515,9160,1974,Wales,Luxembourg,5,0,UEFA Euro qualification,Swansea,Wales,False,5,5,Wales
7722,8516,9161,1974,Liberia,Togo,0,2,African Cup of Nations qualification,Monrovia,Liberia,False,2,-2,Togo
7723,8517,9162,1974,Libya,Tunisia,1,0,African Cup of Nations qualification,Tripoli,Libya,False,1,1,Libya
7724,8518,9163,1974,Suriname,Trinidad and Tobago,0,0,Friendly,Paramaribo,Suriname,False,0,0,Draw
7725,8519,9164,1974,Morocco,Gambia,3,0,African Cup of Nations qualification,Rabat,Morocco,False,3,3,Morocco
7726,8520,9165,1974,Suriname,Trinidad and Tobago,2,1,Friendly,Paramaribo,Suriname,False,3,1,Suriname
7727,8521,9166,1974,Grenada,Saint Vincent and the Grenadines,1,0,Windward Islands Tournament,Castries,Saint Lucia,True,1,1,Grenada
7728,8522,9167,1974,Turkey,Switzerland,2,1,UEFA Euro qualification,Izmir,Turkey,False,3,1,Turkey
7729,8523,9168,1974,Saint Lucia,Dominica,0,3,Windward Islands Tournament,Castries,Saint Lucia,False,3,-3,Dominica
7730,8524,9169,1974,Dominica,Grenada,0,0,Windward Islands Tournament,Castries,Saint Lucia,True,0,0,Draw
7731,8525,9170,1974,Hungary,Switzerland,1,0,Friendly,Szolnok,Hungary,False,1,1,Hungary
7732,8526,9171,1974,Israel,Romania,0,1,Friendly,Jaffa,Israel,False,1,-1,Romania
7733,8527,9172,1974,Saint Lucia,Saint Vincent and the Grenadines,1,2,Windward Islands Tournament,Castries,Saint Lucia,False,3,-1,Saint Vincent and the Grenadines
7734,8528,9173,1974,Dominica,Saint Vincent and the Grenadines,1,2,Windward Islands Tournament,Castries,Saint Lucia,True,3,-1,Saint Vincent and the Grenadines
7735,8529,9174,1974,Gambia,Morocco,0,3,African Cup of Nations qualification,Banjul,Gambia,False,3,-3,Morocco
7736,8530,9176,1974,Saint Lucia,Grenada,1,2,Windward Islands Tournament,Castries,Saint Lucia,False,3,-1,Grenada
7737,8531,9177,1974,Laos,Singapore,0,2,King's Cup,Bangkok,Thailand,True,2,-2,Singapore
7738,8532,9178,1974,Thailand,Malaysia,0,2,King's Cup,Bangkok,Thailand,False,2,-2,Malaysia
7739,8534,9180,1974,Kenya,Seychelles,2,3,Friendly,Nairobi,Kenya,False,5,-1,Seychelles
7740,8535,9181,1974,Malaysia,Singapore,0,0,King's Cup,Bangkok,Thailand,True,0,0,Draw
7741,8536,9182,1974,Thailand,Laos,6,1,King's Cup,Bangkok,Thailand,False,7,5,Thailand
7742,8538,9184,1974,Laos,Malaysia,2,2,King's Cup,Bangkok,Thailand,True,4,0,Draw
7743,8539,9185,1974,Thailand,Singapore,2,1,King's Cup,Bangkok,Thailand,False,3,1,Thailand
7744,8540,9186,1974,Ghana,Guinea,1,1,Friendly,Accra,Ghana,False,2,0,Draw
7745,8542,9189,1974,Thailand,Malaysia,4,1,King's Cup,Bangkok,Thailand,False,5,3,Thailand
7746,8543,9190,1974,Greece,Bulgaria,2,1,UEFA Euro qualification,Piraeus,Greece,False,3,1,Greece
7747,8544,9192,1974,Thailand,Cambodia,1,0,King's Cup,Bangkok,Thailand,False,1,1,Thailand
7748,8545,9193,1974,Cambodia,Malaysia,0,3,King's Cup,Bangkok,Thailand,True,3,-3,Malaysia
7749,8548,9196,1974,Chile,Paraguay,1,0,Friendly,Santiago,Chile,False,1,1,Chile
7750,8549,9197,1974,Malta,Germany,0,1,UEFA Euro qualification,Gżira,Malta,False,1,-1,Germany
7751,8550,9198,1974,Suriname,Trinidad and Tobago,2,3,Friendly,Paramaribo,Suriname,False,5,-1,Trinidad and Tobago
7752,8552,9200,1974,Bermuda,Suriname,2,1,Friendly,Hamilton,Bermuda,False,3,1,Bermuda
7753,8553,9201,1974,Bermuda,Suriname,1,3,Friendly,Hamilton,Bermuda,False,4,-2,Suriname
7754,8554,9202,1974,Cameroon,Guinea,1,1,Friendly,Yaoundé,Cameroon,False,2,0,Draw
7755,8555,9203,1974,Italy,Bulgaria,0,0,Friendly,Genoa,Italy,False,0,0,Draw
7756,8556,9204,1974,Kuwait,Tunisia,2,0,Friendly,Kuwait City,Kuwait,False,2,2,Kuwait
7757,8557,9205,1974,Malawi,Tanzania,1,1,Friendly,Lilongwe,Malawi,False,2,0,Draw
7758,8558,9206,1974,Malawi,Tanzania,3,3,Friendly,Lilongwe,Malawi,False,6,0,Draw
7759,8559,9207,1975,Cameroon,Guinea,1,0,Friendly,Yaoundé,Cameroon,False,1,1,Cameroon
7760,8560,9208,1975,Iraq,Tunisia,0,0,Friendly,Baghdad,Iraq,False,0,0,Draw
7761,8561,9209,1975,Bermuda,Suriname,2,5,Friendly,Hamilton,Bermuda,False,7,-3,Suriname
7762,8562,9210,1975,Cuba,Canada,4,0,Friendly,Havana,Cuba,False,4,4,Cuba
7763,8563,9211,1975,Iraq,Libya,3,1,Friendly,Baghdad,Iraq,False,4,2,Iraq
7764,8564,9212,1975,Kuwait,Libya,1,0,Friendly,Kuwait City,Kuwait,False,1,1,Kuwait
7765,8565,9213,1975,Mali,Guinea,0,2,Friendly,Bamako,Mali,False,2,-2,Guinea
7766,8566,9214,1975,Nigeria,Cameroon,1,0,Friendly,Lagos,Nigeria,False,1,1,Nigeria
7767,8567,9215,1975,Guinea,Cameroon,3,0,Friendly,Conakry,Guinea,False,3,3,Guinea
7768,8568,9216,1975,Malawi,Mauritius,1,0,Friendly,Zomba,Malawi,False,1,1,Malawi
7769,8569,9217,1975,Liberia,Cameroon,2,0,Friendly,Monrovia,Liberia,False,2,2,Liberia
7770,8570,9218,1975,Malawi,Mauritius,1,1,Friendly,Blantyre,Malawi,False,2,0,Draw
7771,8571,9219,1975,Jamaica,Haiti,1,0,Friendly,Kingston,Jamaica,False,1,1,Jamaica
7772,8572,9220,1975,Malawi,Mauritius,3,0,Friendly,Blantyre,Malawi,False,3,3,Malawi
7773,8573,9221,1975,Mali,Cameroon,1,2,Friendly,Bamako,Mali,False,3,-1,Cameroon
7774,8574,9222,1975,Senegal,Nigeria,0,1,Friendly,Dakar,Senegal,False,1,-1,Nigeria
7775,8575,9223,1975,Jamaica,Haiti,0,1,Friendly,Kingston,Jamaica,False,1,-1,Haiti
7776,8576,9224,1975,Spain,Scotland,1,1,UEFA Euro qualification,Valencia,Spain,False,2,0,Draw
7777,8577,9225,1975,Liberia,Nigeria,0,1,Friendly,Monrovia,Liberia,False,1,-1,Nigeria
7778,8578,9226,1975,Mali,Senegal,2,1,Friendly,Bamako,Mali,False,3,1,Mali
7779,8579,9227,1975,Italy,Norway,4,1,Friendly,Florence,Italy,False,5,3,Italy
7780,8580,9228,1975,Haiti,Jamaica,0,1,Friendly,Port-au-Prince,Haiti,False,1,-1,Jamaica
7781,8581,9229,1975,Nigeria,Senegal,1,1,Friendly,Lagos,Nigeria,False,2,0,Draw
7782,8582,9230,1975,Burkina Faso,Niger,4,1,Friendly,Ouagadougou,Upper Volta,False,5,3,Burkina Faso
7783,8583,9231,1975,Malta,Greece,2,0,UEFA Euro qualification,Gżira,Malta,False,2,2,Malta
7784,8584,9232,1975,Tanzania,Malawi,3,1,Friendly,Dar es Salaam,Tanzania,False,4,2,Tanzania
7785,8585,9233,1975,Haiti,Jamaica,3,2,Friendly,Port-au-Prince,Haiti,False,5,1,Haiti
7786,8586,9234,1975,Tanzania,Malawi,2,0,Friendly,Dar es Salaam,Tanzania,False,2,2,Tanzania
7787,8587,9236,1975,Morocco,Tunisia,0,0,Friendly,Casablanca,Morocco,False,0,0,Draw
7788,8588,9237,1975,Brazil,Portugal,2,1,Friendly,Goiânia,Brazil,False,3,1,Brazil
7789,8589,9238,1975,England,Germany,2,0,Friendly,London,England,False,2,2,England
7790,8590,9239,1975,Guadeloupe,Puerto Rico,2,1,Friendly,Basse-Terre,Guadeloupe,False,3,1,Guadeloupe
7791,8591,9240,1975,Thailand,Indonesia,3,1,AFC Asian Cup qualification,Bangkok,Thailand,False,4,2,Thailand
7792,8592,9241,1975,Luxembourg,Austria,1,2,UEFA Euro qualification,Luxembourg,Luxembourg,False,3,-1,Austria
7793,8595,9244,1975,Thailand,Malaysia,0,1,AFC Asian Cup qualification,Bangkok,Thailand,False,1,-1,Malaysia
7794,8596,9246,1975,Turkey,Romania,1,1,Friendly,Istanbul,Turkey,False,2,0,Draw
7795,8597,9247,1975,Malaysia,Indonesia,0,0,AFC Asian Cup qualification,Bangkok,Thailand,True,0,0,Draw
7796,8599,9250,1975,Ghana,Burkina Faso,3,1,Friendly,Accra,Ghana,False,4,2,Ghana
7797,8602,9253,1975,France,Hungary,2,0,Friendly,Paris,France,False,2,2,France
7798,8603,9255,1975,Poland,United States,7,0,Friendly,Poznań,Poland,False,7,7,Poland
7799,8604,9256,1975,Congo,Ivory Coast,1,0,African Cup of Nations qualification,Brazzaville,Congo,False,1,1,Congo
7800,8605,9257,1975,Guadeloupe,Suriname,4,2,Friendly,Basse-Terre,Guadeloupe,False,6,2,Guadeloupe
7801,8606,9258,1975,Barbados,Suriname,1,0,Friendly,Bridgetown,Barbados,False,1,1,Barbados
7802,8607,9260,1975,Cyprus,Greece,1,2,Friendly,Nicosia,Cyprus,False,3,-1,Greece
7803,8608,9261,1975,Austria,Hungary,0,0,UEFA Euro qualification,Vienna,Austria,False,0,0,Draw
7804,8609,9262,1975,Iraq,Qatar,1,0,AFC Asian Cup qualification,Baghdad,Iraq,False,1,1,Iraq
7805,8610,9263,1975,Italy,United States,10,0,Friendly,Rome,Italy,False,10,10,Italy
7806,8611,9264,1975,Russia,Turkey,3,0,UEFA Euro qualification,Kyïv,Soviet Union,False,3,3,Russia
7807,8612,9265,1975,Saudi Arabia,Afghanistan,2,0,AFC Asian Cup qualification,Baghdad,Iraq,True,2,2,Saudi Arabia
7808,8613,9266,1975,Iraq,Afghanistan,4,0,AFC Asian Cup qualification,Baghdad,Iraq,False,4,4,Iraq
7809,8614,9267,1975,Macau,Panama,2,1,Friendly,Macau,Macau,False,3,1,Macau
7810,8615,9268,1975,Saudi Arabia,Qatar,2,1,AFC Asian Cup qualification,Baghdad,Iraq,True,3,1,Saudi Arabia
7811,8616,9269,1975,Algeria,Tunisia,1,2,African Cup of Nations qualification,Oran,Algeria,False,3,-1,Tunisia
7812,8617,9270,1975,Iraq,Saudi Arabia,1,1,AFC Asian Cup qualification,Baghdad,Iraq,False,2,0,Draw
7813,8618,9271,1975,Qatar,Afghanistan,2,1,AFC Asian Cup qualification,Baghdad,Iraq,True,3,1,Qatar
7814,8619,9272,1975,Iraq,Qatar,3,0,AFC Asian Cup qualification,Baghdad,Iraq,False,3,3,Iraq
7815,8620,9273,1975,Saudi Arabia,Afghanistan,6,0,AFC Asian Cup qualification,Baghdad,Iraq,True,6,6,Saudi Arabia
7816,8621,9274,1975,Iraq,Saudi Arabia,2,1,AFC Asian Cup qualification,Baghdad,Iraq,False,3,1,Iraq
7817,8622,9275,1975,Qatar,Afghanistan,1,1,AFC Asian Cup qualification,Baghdad,Iraq,True,2,0,Draw
7818,8623,9276,1975,Ivory Coast,Congo,2,1,African Cup of Nations qualification,Abidjan,Ivory Coast,False,3,1,Ivory Coast
7819,8624,9277,1975,Iraq,Afghanistan,3,1,AFC Asian Cup qualification,Baghdad,Iraq,False,4,2,Iraq
7820,8625,9278,1975,Saudi Arabia,Qatar,0,1,AFC Asian Cup qualification,Baghdad,Iraq,True,1,-1,Qatar
7821,8626,9279,1975,England,Cyprus,5,0,UEFA Euro qualification,London,England,False,5,5,England
7822,8627,9280,1975,Hungary,Wales,1,2,UEFA Euro qualification,Budapest,Hungary,False,3,-1,Wales
7823,8629,9282,1975,Sweden,Scotland,1,1,Friendly,Gothenburg,Sweden,False,2,0,Draw
7824,8630,9283,1975,Spain,Romania,1,1,UEFA Euro qualification,Madrid,Spain,False,2,0,Draw
7825,8631,9284,1975,Italy,Poland,0,0,UEFA Euro qualification,Rome,Italy,False,0,0,Draw
7826,8632,9286,1975,France,Portugal,0,2,Friendly,Colombes,France,False,2,-2,Portugal
7827,8633,9287,1975,Nigeria,Togo,1,0,Friendly,Dakar,Senegal,True,1,1,Nigeria
7828,8634,9288,1975,Senegal,Ivory Coast,1,0,Friendly,Dakar,Senegal,False,1,1,Senegal
7829,8635,9289,1975,Bulgaria,Germany,1,1,UEFA Euro qualification,Sofia,Bulgaria,False,2,0,Draw
7830,8636,9290,1975,Ivory Coast,Togo,0,3,Friendly,Dakar,Senegal,True,3,-3,Togo
7831,8637,9291,1975,Senegal,Nigeria,1,0,Friendly,Dakar,Senegal,False,1,1,Senegal
7832,8638,9292,1975,Belgium,Netherlands,1,0,Friendly,Antwerp,Belgium,False,1,1,Belgium
7833,8639,9294,1975,Switzerland,Turkey,1,1,UEFA Euro qualification,Basel,Switzerland,False,2,0,Draw
7834,8640,9295,1975,Luxembourg,Wales,1,3,UEFA Euro qualification,Luxembourg,Luxembourg,False,4,-2,Wales
7835,8641,9296,1975,Republic of Ireland,Switzerland,2,1,UEFA Euro qualification,Dublin,Republic of Ireland,False,3,1,Republic of Ireland
7836,8642,9297,1975,Martinique,Guadeloupe,8,2,Friendly,Fort-de-France,Martinique,False,10,6,Martinique
7837,8643,9298,1975,Cyprus,England,0,1,UEFA Euro qualification,Limassol,Cyprus,False,1,-1,England
7838,8644,9299,1975,Romania,Denmark,6,1,UEFA Euro qualification,Bucharest,Romania,False,7,5,Romania
7839,8645,9300,1975,Scotland,Portugal,1,0,Friendly,Glasgow,Scotland,False,1,1,Scotland
7840,8646,9301,1975,Burma,Thailand,4,1,Korea Cup,Seoul,South Korea,True,5,3,Burma
7841,8647,9302,1975,Finland,Norway,3,5,Nordic Championship,Helsinki,Finland,False,8,-2,Norway
7842,8648,9304,1975,Germany,Netherlands,1,1,Friendly,Frankfurt am Main,Germany,False,2,0,Draw
7843,8649,9305,1975,Northern Ireland,England,0,0,British Championship,Belfast,Northern Ireland,False,0,0,Draw
7844,8650,9306,1975,Wales,Scotland,2,2,British Championship,Cardiff,Wales,False,4,0,Draw
7845,8651,9307,1975,Russia,Republic of Ireland,2,1,UEFA Euro qualification,Kyïv,Soviet Union,False,3,1,Russia
7846,8652,9308,1975,Sweden,Algeria,4,0,Friendly,Halmstad,Sweden,False,4,4,Sweden
7847,8653,9309,1975,Scotland,Northern Ireland,3,0,British Championship,Glasgow,Scotland,False,3,3,Scotland
7848,8654,9310,1975,England,Wales,2,2,British Championship,London,England,False,4,0,Draw
7849,8655,9311,1975,Switzerland,Republic of Ireland,1,0,UEFA Euro qualification,Berne,Switzerland,False,1,1,Switzerland
7850,8656,9314,1975,Northern Ireland,Wales,1,0,British Championship,Belfast,Northern Ireland,False,1,1,Northern Ireland
7851,8657,9315,1975,England,Scotland,5,1,British Championship,London,England,False,6,4,England
7852,8658,9316,1975,Iceland,France,0,0,UEFA Euro qualification,Reykjavík,Iceland,False,0,0,Draw
7853,8659,9318,1975,Romania,Scotland,1,1,UEFA Euro qualification,Bucharest,Romania,False,2,0,Draw
7854,8660,9319,1975,Greece,Malta,4,0,UEFA Euro qualification,Salonica,Greece,False,4,4,Greece
7855,8662,9321,1975,Uruguay,Chile,1,0,Copa Juan Pinto Durán,Montevideo,Uruguay,False,1,1,Uruguay
7856,8663,9322,1975,Finland,Italy,0,1,UEFA Euro qualification,Helsinki,Finland,False,1,-1,Italy
7857,8665,9324,1975,Kenya,Ethiopia,2,1,Friendly,Nairobi,Kenya,False,3,1,Kenya
7858,8667,9326,1975,Cyprus,Portugal,0,2,UEFA Euro qualification,Limassol,Cyprus,False,2,-2,Portugal
7859,8668,9327,1975,Guinea-Bissau,Gambia,1,0,Friendly,Bissau,Guinea-Bissau,False,1,1,Guinea-Bissau
7860,8669,9328,1975,Russia,Italy,1,0,Friendly,Moscow,Soviet Union,False,1,1,Russia
7861,8671,9330,1975,Bulgaria,Malta,5,0,UEFA Euro qualification,Sofia,Bulgaria,False,5,5,Bulgaria
7862,8672,9331,1975,Kenya,Congo,2,1,Friendly,Nairobi,Kenya,False,3,1,Kenya
7863,8674,9333,1975,Indonesia,Thailand,5,0,Indonesia Tournament,Jakarta,Indonesia,False,5,5,Indonesia
7864,8675,9334,1975,Paraguay,Uruguay,0,1,Copa Artigas,Asunción,Paraguay,False,1,-1,Uruguay
7865,8676,9335,1975,Malaysia,Thailand,1,0,Indonesia Tournament,Jakarta,Indonesia,True,1,1,Malaysia
7866,8677,9336,1975,Panama,Costa Rica,1,1,Friendly,Panama City,Panama,False,2,0,Draw
7867,8678,9337,1975,Uganda,Congo,0,1,Friendly,Kampala,Uganda,False,1,-1,Congo
7868,8679,9338,1975,Hong Kong,Japan,0,0,AFC Asian Cup qualification,So Kon Po,Hong Kong,False,0,0,Draw
7869,8680,9339,1975,Indonesia,Malaysia,3,1,Indonesia Tournament,Jakarta,Indonesia,False,4,2,Indonesia
7870,8681,9341,1975,Indonesia,Burma,0,2,Indonesia Tournament,Jakarta,Indonesia,False,2,-2,Burma
7871,8682,9344,1975,Burma,Malaysia,2,0,Indonesia Tournament,Jakarta,Indonesia,True,2,2,Burma
7872,8684,9348,1975,Uruguay,Paraguay,0,1,Copa Artigas,Montevideo,Uruguay,False,1,-1,Paraguay
7873,8686,9350,1975,Ecuador,Peru,6,0,Friendly,Quito,Ecuador,False,6,6,Ecuador
7874,8687,9351,1975,Tanzania,Zambia,1,1,Friendly,Maputo,Mozambique,True,2,0,Draw
7875,8688,9353,1975,Iceland,Faroe Islands,6,0,Friendly,Reykjavík,Iceland,False,6,6,Iceland
7876,8690,9355,1975,United States,Poland,0,4,Friendly,Seattle,United States,False,4,-4,Poland
7877,8691,9356,1975,Chile,Uruguay,1,3,Copa Juan Pinto Durán,Santiago,Chile,False,4,-2,Uruguay
7878,8692,9357,1975,Denmark,Finland,2,0,Nordic Championship,Copenhagen,Denmark,False,2,2,Denmark
7879,8693,9358,1975,Ecuador,Peru,1,0,Friendly,Guayaquil,Ecuador,False,1,1,Ecuador
7880,8694,9360,1975,Bolivia,Argentina,1,2,Friendly,Cochabamba,Bolivia,False,3,-1,Argentina
7881,8695,9361,1975,Mozambique,Zambia,2,1,Friendly,Maputo,Mozambique,False,3,1,Mozambique
7882,8696,9362,1975,Mozambique,Tanzania,2,1,Friendly,Maputo,Mozambique,False,3,1,Mozambique
7883,8697,9363,1975,Sweden,Norway,3,1,UEFA Euro qualification,Solna,Sweden,False,4,2,Sweden
7884,8698,9364,1975,Peru,Ecuador,2,0,Friendly,Lima,Peru,False,2,2,Peru
7885,8699,9366,1975,Canada,Poland,1,8,Friendly,Montréal,Canada,False,9,-7,Poland
7886,8700,9367,1975,Malawi,Kenya,3,3,Friendly,Blantyre,Malawi,False,6,0,Draw
7887,8701,9368,1975,Tunisia,Sudan,3,2,African Cup of Nations qualification,Tunis,Tunisia,False,5,1,Tunisia
7888,8702,9369,1975,Bolivia,Paraguay,1,2,Friendly,Cochabamba,Bolivia,False,3,-1,Paraguay
7889,8703,9370,1975,Hong Kong,Thailand,1,1,Friendly,Victoria,Hong Kong,False,2,0,Draw
7890,8704,9371,1975,Malawi,Kenya,1,2,Friendly,Blantyre,Malawi,False,3,-1,Kenya
7891,8705,9372,1975,Bolivia,Ecuador,1,0,Friendly,Cochabamba,Bolivia,False,1,1,Bolivia
7892,8706,9373,1975,Canada,Poland,1,4,Friendly,Toronto,Canada,False,5,-3,Poland
7893,8707,9374,1975,Malawi,Kenya,3,1,Friendly,Lilongwe,Malawi,False,4,2,Malawi
7894,8708,9375,1975,Peru,Paraguay,2,0,Friendly,Lima,Peru,False,2,2,Peru
7895,8709,9376,1975,Egypt,DR Congo,3,2,Friendly,Teheran,Iran,True,5,1,Egypt
7896,8710,9377,1975,Chile,Peru,1,1,Copa América,Santiago,Chile,False,2,0,Draw
7897,8711,9378,1975,Uruguay,Argentina,2,3,Copa Newton,Montevideo,Uruguay,False,5,-1,Argentina
7898,8712,9379,1975,Bolivia,Chile,2,1,Copa América,Oruro,Bolivia,False,3,1,Bolivia
7899,8713,9380,1975,Colombia,Paraguay,1,0,Copa América,Bogotá,Colombia,False,1,1,Colombia
7900,8716,9383,1975,Ecuador,Paraguay,2,2,Copa América,Guayaquil,Ecuador,False,4,0,Draw
7901,8718,9385,1975,Bolivia,Peru,0,1,Copa América,Oruro,Bolivia,False,1,-1,Peru
7902,8719,9386,1975,Ecuador,Colombia,1,3,Copa América,Quito,Ecuador,False,4,-2,Colombia
7903,8721,9388,1975,Bangladesh,Indonesia,0,4,Merdeka Tournament,Kuala Lumpur,Malaysia,True,4,-4,Indonesia
7904,8724,9391,1975,Burma,Thailand,1,0,Merdeka Tournament,Kuala Lumpur,Malaysia,True,1,1,Burma
7905,8725,9392,1975,Hong Kong,Japan,2,0,Merdeka Tournament,Kuala Lumpur,Malaysia,True,2,2,Hong Kong
7906,8726,9393,1975,Paraguay,Colombia,0,1,Copa América,Asunción,Paraguay,False,1,-1,Colombia
7907,8728,9395,1975,Venezuela,Brazil,0,4,Copa América,Caracas,Venezuela,False,4,-4,Brazil
7908,8729,9396,1975,Burma,Indonesia,2,0,Merdeka Tournament,Kuala Lumpur,Malaysia,True,2,2,Burma
7909,8732,9399,1975,Panama,Guatemala,2,0,Friendly,Panama City,Panama,False,2,2,Panama
7910,8733,9400,1975,Bangladesh,Thailand,1,1,Merdeka Tournament,Kuala Lumpur,Malaysia,True,2,0,Draw
7911,8735,9402,1975,Vanuatu,Papua New Guinea,3,0,South Pacific Games,Tamuning,Guam,True,3,3,Vanuatu
7912,8736,9403,1975,Guam,Solomon Islands,1,5,South Pacific Games,Tamuning,Guam,False,6,-4,Solomon Islands
7913,8738,9405,1975,Hong Kong,Indonesia,2,3,Merdeka Tournament,Kuala Lumpur,Malaysia,True,5,-1,Indonesia
7914,8740,9407,1975,Venezuela,Argentina,1,5,Copa América,Caracas,Venezuela,False,6,-4,Argentina
7915,8741,9408,1975,Bangladesh,Japan,0,3,Merdeka Tournament,Kuala Lumpur,Malaysia,True,3,-3,Japan
7916,8742,9409,1975,New Caledonia,Vanuatu,3,1,South Pacific Games,Tamuning,Guam,True,4,2,New Caledonia
7917,8744,9411,1975,Guam,Fiji,0,11,South Pacific Games,Tamuning,Guam,False,11,-11,Fiji
7918,8745,9412,1975,New Caledonia,Papua New Guinea,5,1,South Pacific Games,Tamuning,Guam,True,6,4,New Caledonia
7919,8747,9414,1975,Fiji,Solomon Islands,1,1,South Pacific Games,Tamuning,Guam,True,2,0,Draw
7920,8749,9416,1975,Brazil,Argentina,2,1,Copa América,Belo Horizonte,Brazil,False,3,1,Brazil
7921,8750,9417,1975,Burma,Hong Kong,5,0,Merdeka Tournament,Kuala Lumpur,Malaysia,True,5,5,Burma
7922,8751,9418,1975,Ghana,Ivory Coast,3,1,Friendly,Accra,Ghana,False,4,2,Ghana
7923,8753,9420,1975,Colombia,Ecuador,2,0,Copa América,Bogotá,Colombia,False,2,2,Colombia
7924,8755,9422,1975,Indonesia,Japan,1,4,Merdeka Tournament,Kuala Lumpur,Malaysia,True,5,-3,Japan
7925,8756,9424,1975,New Caledonia,Solomon Islands,4,0,South Pacific Games,Tamuning,Guam,True,4,4,New Caledonia
7926,8757,9425,1975,Peru,Bolivia,3,1,Copa América,Lima,Peru,False,4,2,Peru
7927,8758,9426,1975,Bangladesh,Burma,1,7,Merdeka Tournament,Kuala Lumpur,Malaysia,True,8,-6,Burma
7928,8759,9427,1975,Fiji,Solomon Islands,2,3,South Pacific Games,Tamuning,Guam,True,5,-1,Solomon Islands
7929,8760,9428,1975,Indonesia,Thailand,2,1,Merdeka Tournament,Kuala Lumpur,Malaysia,True,3,1,Indonesia
7930,8763,9431,1975,Argentina,Venezuela,11,0,Copa América,Rosario,Argentina,False,11,11,Argentina
7931,8764,9432,1975,Bangladesh,Hong Kong,1,9,Merdeka Tournament,Kuala Lumpur,Malaysia,True,10,-8,Hong Kong
7932,8765,9433,1975,Ghana,Ivory Coast,0,0,Friendly,Accra,Ghana,False,0,0,Draw
7933,8766,9434,1975,Iran,Hungary,1,2,Friendly,Teheran,Iran,False,3,-1,Hungary
7934,8767,9435,1975,Malaysia,Burma,2,1,Merdeka Tournament,Kuala Lumpur,Malaysia,False,3,1,Malaysia
7935,8768,9436,1975,Paraguay,Ecuador,3,1,Copa América,Asunción,Paraguay,False,4,2,Paraguay
7936,8770,9438,1975,Japan,Thailand,4,0,Merdeka Tournament,Kuala Lumpur,Malaysia,True,4,4,Japan
7937,8771,9439,1975,Brazil,Venezuela,6,0,Copa América,Belo Horizonte,Brazil,False,6,6,Brazil
7938,8772,9440,1975,Chile,Bolivia,4,0,Copa América,Santiago,Chile,False,4,4,Chile
7939,8773,9441,1975,Norway,Sweden,0,2,UEFA Euro qualification,Oslo,Norway,False,2,-2,Sweden
7940,8774,9442,1975,Burma,Japan,0,2,Merdeka Tournament,Kuala Lumpur,Malaysia,True,2,-2,Japan
7941,8776,9445,1975,Hong Kong,Thailand,3,0,Merdeka Tournament,Kuala Lumpur,Malaysia,True,3,3,Hong Kong
7942,8777,9446,1975,Panama,Haiti,2,0,Friendly,Panama City,Panama,False,2,2,Panama
7943,8778,9447,1975,Argentina,Brazil,0,1,Copa América,Rosario,Argentina,False,1,-1,Brazil
7944,8780,9449,1975,Mexico,Costa Rica,7,0,Friendly,Mexico City,Mexico,False,7,7,Mexico
7945,8781,9450,1975,Panama,Haiti,1,1,Friendly,La Chorrera,Panama,False,2,0,Draw
7946,8782,9451,1975,Costa Rica,United States,3,1,Friendly,Mexico City,Mexico,True,4,2,Costa Rica
7947,8783,9452,1975,Peru,Chile,3,1,Copa América,Lima,Peru,False,4,2,Peru
7948,8784,9453,1975,Argentina,United States,6,0,Friendly,Mexico City,Mexico,True,6,6,Argentina
7949,8785,9454,1975,Ghana,Nigeria,1,2,Friendly,Accra,Ghana,False,3,-1,Nigeria
7950,8786,9455,1975,Mexico,United States,2,0,Friendly,Mexico City,Mexico,False,2,2,Mexico
7951,8787,9456,1975,Ghana,Nigeria,3,0,Friendly,Accra,Ghana,False,3,3,Ghana
7952,8788,9457,1975,Mexico,Argentina,1,1,Friendly,Mexico City,Mexico,False,2,0,Draw
7953,8789,9458,1975,Austria,Germany,0,2,Friendly,Vienna,Austria,False,2,-2,Germany
7954,8790,9459,1975,Denmark,Scotland,0,1,UEFA Euro qualification,Copenhagen,Denmark,False,1,-1,Scotland
7955,8791,9460,1975,France,Iceland,3,0,UEFA Euro qualification,Nantes,France,False,3,3,France
7956,8792,9461,1975,Netherlands,Finland,4,1,UEFA Euro qualification,Nijmegen,Netherlands,False,5,3,Netherlands
7957,8793,9462,1975,Northern Ireland,Sweden,1,2,UEFA Euro qualification,Belfast,Northern Ireland,False,3,-1,Sweden
7958,8794,9463,1975,Switzerland,England,1,2,Friendly,Basel,Switzerland,False,3,-1,England
7959,8795,9464,1975,Mali,Nigeria,4,1,Friendly,Abidjan,Ivory Coast,True,5,3,Mali
7960,8796,9465,1975,Panama,Cuba,0,1,Friendly,Panama City,Panama,False,1,-1,Cuba
7961,8797,9466,1975,Belgium,Iceland,1,0,UEFA Euro qualification,Liège,Belgium,False,1,1,Belgium
7962,8798,9467,1975,Ivory Coast,Nigeria,1,1,Friendly,Abidjan,Ivory Coast,False,2,0,Draw
7963,8799,9468,1975,Panama,Cuba,2,2,Friendly,La Chorrera,Panama,False,4,0,Draw
7964,8800,9470,1975,Poland,Netherlands,4,1,UEFA Euro qualification,Chorzów,Poland,False,5,3,Poland
7965,8801,9471,1975,Panama,Cuba,2,3,Friendly,Panama City,Panama,False,5,-1,Cuba
7966,8802,9472,1975,Colombia,Uruguay,3,0,Copa América,Bogotá,Colombia,False,3,3,Colombia
7967,8803,9474,1975,Greece,Romania,1,1,Balkan Cup,Salonica,Greece,False,2,0,Draw
7968,8804,9475,1975,Hungary,Austria,2,1,UEFA Euro qualification,Budapest,Hungary,False,3,1,Hungary
7969,8805,9476,1975,Sweden,Denmark,0,0,Nordic Championship,Malmö,Sweden,False,0,0,Draw
7970,8806,9477,1975,Haiti,Guadeloupe,3,0,Friendly,Port-au-Prince,Haiti,False,3,3,Haiti
7971,8808,9479,1975,Italy,Finland,0,0,UEFA Euro qualification,Rome,Italy,False,0,0,Draw
7972,8809,9480,1975,Brazil,Peru,1,3,Copa América,Belo Horizonte,Brazil,False,4,-2,Peru
7973,8810,9481,1975,Uruguay,Colombia,1,0,Copa América,Montevideo,Uruguay,False,1,1,Uruguay
7974,8811,9482,1975,Peru,Brazil,0,2,Copa América,Lima,Peru,False,2,-2,Brazil
7975,8812,9483,1975,Antigua and Barbuda,Barbados,1,0,Friendly,St. John's,Antigua and Barbuda,False,1,1,Antigua and Barbuda
7976,8813,9484,1975,Poland,Hungary,4,2,Friendly,Łódź,Poland,False,6,2,Poland
7977,8814,9485,1975,Uganda,DR Congo,1,2,Friendly,Kampala,Uganda,False,3,-1,DR Congo
7978,8815,9486,1975,Germany,Greece,1,1,UEFA Euro qualification,Düsseldorf,Germany,False,2,0,Draw
7979,8816,9488,1975,Romania,Turkey,2,2,Friendly,Bucharest,Romania,False,4,0,Draw
7980,8817,9489,1975,Spain,Denmark,2,0,UEFA Euro qualification,Barcelona,Spain,False,2,2,Spain
7981,8818,9490,1975,Switzerland,Russia,0,1,UEFA Euro qualification,Zürich,Switzerland,False,1,-1,Russia
7982,8819,9491,1975,Austria,Luxembourg,6,2,UEFA Euro qualification,Vienna,Austria,False,8,4,Austria
7983,8820,9493,1975,Netherlands,Poland,3,0,UEFA Euro qualification,Amsterdam,Netherlands,False,3,3,Netherlands
7984,8821,9495,1975,Colombia,Peru,1,0,Copa América,Bogotá,Colombia,False,1,1,Colombia
7985,8822,9496,1975,Tanzania,Kenya,1,2,Friendly,Dar es Salaam,Tanzania,False,3,-1,Kenya
7986,8823,9498,1975,Hungary,Luxembourg,8,1,UEFA Euro qualification,Szombathely,Hungary,False,9,7,Hungary
7987,8824,9499,1975,Israel,Mexico,1,0,Friendly,Jaffa,Israel,False,1,1,Israel
7988,8825,9500,1975,Peru,Colombia,2,0,Copa América,Lima,Peru,False,2,2,Peru
7989,8826,9501,1975,Zambia,Mozambique,3,0,Friendly,Lusaka,Zambia,False,3,3,Zambia
7990,8827,9502,1975,Poland,Italy,0,0,UEFA Euro qualification,Warsaw,Poland,False,0,0,Draw
7991,8828,9503,1975,Colombia,Peru,0,1,Copa América,Caracas,Venezuela,True,1,-1,Peru
7992,8829,9504,1975,Republic of Ireland,Turkey,4,0,UEFA Euro qualification,Dublin,Republic of Ireland,False,4,4,Republic of Ireland
7993,8830,9505,1975,Northern Ireland,Norway,3,0,UEFA Euro qualification,Belfast,Northern Ireland,False,3,3,Northern Ireland
7994,8831,9506,1975,Scotland,Denmark,3,1,UEFA Euro qualification,Glasgow,Scotland,False,4,2,Scotland
7995,8832,9508,1975,Zambia,Kenya,1,2,CECAFA Cup,Lusaka,Zambia,False,3,-1,Kenya
7996,8833,9509,1975,Malawi,Tanzania,3,1,CECAFA Cup,Ndola,Zambia,True,4,2,Malawi
7997,8834,9510,1975,Zambia,Uganda,0,1,CECAFA Cup,Lusaka,Zambia,False,1,-1,Uganda
7998,8836,9512,1975,Kenya,Uganda,1,1,CECAFA Cup,Ndola,Zambia,True,2,0,Draw
7999,8837,9513,1975,French Guiana,Martinique,1,2,Friendly,Cayenne,French Guiana,False,3,-1,Martinique
8000,8838,9514,1975,Macau,New Zealand,1,1,Friendly,Macau,Macau,False,2,0,Draw
8001,8840,9516,1975,Kenya,Tanzania,3,2,CECAFA Cup,Lusaka,Zambia,True,5,1,Kenya
8002,8841,9517,1975,Malawi,Uganda,2,1,CECAFA Cup,Chingola,Zambia,True,3,1,Malawi
8003,8842,9518,1975,Kenya,Malawi,2,2,CECAFA Cup,Lusaka,Zambia,True,4,0,Draw
8004,8843,9519,1975,Singapore,New Zealand,2,2,Friendly,Kallang,Singapore,False,4,0,Draw
8005,8845,9521,1975,Russia,Switzerland,4,1,UEFA Euro qualification,Kyïv,Soviet Union,False,5,3,Russia
8006,8846,9522,1975,France,Belgium,0,0,UEFA Euro qualification,Paris,France,False,0,0,Draw
8007,8847,9523,1975,Romania,Spain,2,2,UEFA Euro qualification,Bucharest,Romania,False,4,0,Draw
8008,8848,9524,1975,Cameroon,DR Congo,2,1,Friendly,Yaoundé,Cameroon,False,3,1,Cameroon
8009,8849,9525,1975,Germany,Bulgaria,1,0,UEFA Euro qualification,Stuttgart,Germany,False,1,1,Germany
8010,8850,9526,1975,Portugal,England,1,1,UEFA Euro qualification,Lisbon,Portugal,False,2,0,Draw
8011,8851,9527,1975,Wales,Austria,1,0,UEFA Euro qualification,Wrexham,Wales,False,1,1,Wales
8012,8852,9529,1975,Cameroon,DR Congo,2,2,Friendly,Yaoundé,Cameroon,False,4,0,Draw
8013,8853,9530,1975,Italy,Netherlands,1,0,UEFA Euro qualification,Rome,Italy,False,1,1,Italy
8014,8855,9532,1975,Turkey,Russia,1,0,UEFA Euro qualification,Izmir,Turkey,False,1,1,Turkey
8015,8856,9533,1975,Romania,Russia,2,2,Friendly,Bucharest,Romania,False,4,0,Draw
8016,8857,9534,1975,Portugal,Cyprus,1,0,UEFA Euro qualification,Setúbal,Portugal,False,1,1,Portugal
8017,8858,9535,1975,Scotland,Romania,1,1,UEFA Euro qualification,Glasgow,Scotland,False,2,0,Draw
8018,8860,9537,1975,Palestine,Sudan,0,0,Friendly,Tunis,Tunisia,True,0,0,Draw
8019,8861,9538,1975,Tunisia,United Arab Emirates,3,0,Friendly,Tunis,Tunisia,False,3,3,Tunisia
8020,8862,9539,1975,Malawi,Eswatini,2,0,Friendly,Blantyre,Malawi,False,2,2,Malawi
8021,8863,9540,1975,Turkey,Germany,0,5,Friendly,Istanbul,Turkey,False,5,-5,Germany
8022,8865,9542,1975,Iraq,United Arab Emirates,5,0,Friendly,Tunis,Tunisia,True,5,5,Iraq
8023,8866,9543,1975,Libya,Syria,2,3,Friendly,Tunis,Tunisia,True,5,-1,Syria
8024,8867,9544,1975,Malaysia,Singapore,0,0,King's Cup,Bangkok,Thailand,True,0,0,Draw
8025,8868,9545,1975,Malta,Bulgaria,0,2,UEFA Euro qualification,Gżira,Malta,False,2,-2,Bulgaria
8026,8869,9546,1975,Palestine,Sudan,0,1,Friendly,Tunis,Tunisia,True,1,-1,Sudan
8027,8871,9548,1975,Malawi,Eswatini,0,0,Friendly,Blantyre,Malawi,False,0,0,Draw
8028,8872,9549,1975,Egypt,Saudi Arabia,2,1,Friendly,Tunis,Tunisia,True,3,1,Egypt
8029,8873,9550,1975,Libya,Syria,1,0,Friendly,Tunis,Tunisia,True,1,1,Libya
8030,8875,9552,1975,Tunisia,Iraq,1,1,Friendly,Tunis,Tunisia,False,2,0,Draw
8031,8876,9553,1975,Burma,Singapore,6,0,King's Cup,Bangkok,Thailand,True,6,6,Burma
8032,8877,9554,1975,Bermuda,Suriname,1,5,Friendly,Hamilton,Bermuda,False,6,-4,Suriname
8033,8878,9555,1975,Egypt,Sudan,3,1,Friendly,Tunis,Tunisia,True,4,2,Egypt
8034,8879,9556,1975,Iraq,Syria,4,0,Friendly,Tunis,Tunisia,True,4,4,Iraq
8035,8880,9557,1975,Thailand,Singapore,0,1,King's Cup,Bangkok,Thailand,False,1,-1,Singapore
8036,8881,9558,1975,Burma,Malaysia,2,1,King's Cup,Bangkok,Thailand,True,3,1,Burma
8037,8882,9559,1975,Egypt,Iraq,1,0,Friendly,Tunis,Tunisia,True,1,1,Egypt
8038,8883,9560,1975,Sudan,Syria,1,0,Friendly,Tunis,Tunisia,True,1,1,Sudan
8039,8884,9561,1975,Thailand,Malaysia,1,0,King's Cup,Bangkok,Thailand,False,1,1,Thailand
8040,8885,9562,1975,Italy,Greece,3,2,Friendly,Florence,Italy,False,5,1,Italy
8041,8886,9564,1976,Libya,Sudan,1,0,Friendly,Tripoli,Libya,False,1,1,Libya
8042,8887,9565,1976,Thailand,Burma,0,0,King's Cup,Bangkok,Thailand,False,0,0,Draw
8043,8889,9568,1976,Saudi Arabia,Algeria,1,3,Friendly,Riyadh,Saudi Arabia,False,4,-2,Algeria
8044,8890,9569,1976,Gambia,Guinea-Bissau,3,1,Friendly,Banjul,Gambia,False,4,2,Gambia
8045,8891,9570,1976,Gambia,Mali,0,3,Friendly,Banjul,Gambia,False,3,-3,Mali
8046,8892,9571,1976,Mauritania,Senegal,1,4,Friendly,Banjul,Gambia,True,5,-3,Senegal
8047,8893,9572,1976,Guinea,Senegal,2,2,Friendly,Banjul,Gambia,True,4,0,Draw
8048,8894,9573,1976,Guinea-Bissau,Mali,1,1,Friendly,Banjul,Gambia,True,2,0,Draw
8049,8895,9574,1976,Guinea,Mauritania,4,0,Friendly,Banjul,Gambia,True,4,4,Guinea
8050,8896,9575,1976,Guinea,Mali,0,1,Friendly,Banjul,Gambia,True,1,-1,Mali
8051,8897,9576,1976,Chad,Gabon,4,0,Friendly,N'Djamena,Chad,False,4,4,Chad
8052,8898,9577,1976,Japan,Bulgaria,1,3,Friendly,Tokyo,Japan,False,4,-2,Bulgaria
8053,8899,9578,1976,Japan,Bulgaria,1,1,Friendly,Osaka,Japan,False,2,0,Draw
8054,8900,9579,1976,Japan,Bulgaria,0,3,Friendly,Tokyo,Japan,False,3,-3,Bulgaria
8055,8901,9580,1976,Israel,Denmark,0,1,Friendly,Jaffa,Israel,False,1,-1,Denmark
8056,8902,9581,1976,Montenegro,Russia,2,1,Friendly,Podgorica,Yugoslavia,False,3,1,Montenegro
8057,8903,9582,1976,Congo,Angola,3,2,Friendly,Brazzaville,Congo,False,5,1,Congo
8058,8904,9583,1976,Iraq,Turkey,0,0,Friendly,Baghdad,Iraq,False,0,0,Draw
8059,8905,9584,1976,Kenya,Nigeria,1,1,Friendly,Nairobi,Kenya,False,2,0,Draw
8060,8906,9585,1976,Malawi,Lesotho,4,1,Friendly,Zomba,Malawi,False,5,3,Malawi
8061,8907,9586,1976,El Salvador,Hungary,1,2,Friendly,San Salvador,El Salvador,False,3,-1,Hungary
8062,8908,9587,1976,Zambia,Nigeria,1,3,Friendly,Chingola,Zambia,False,4,-2,Nigeria
8063,8909,9588,1976,Angola,Congo,1,1,Friendly,Luanda,Angola,False,2,0,Draw
8064,8912,9591,1976,Nigeria,Tanzania,0,0,Friendly,Lagos,Nigeria,False,0,0,Draw
8065,8913,9592,1976,Saudi Arabia,Morocco,0,2,Friendly,Riyadh,Saudi Arabia,False,2,-2,Morocco
8066,8914,9593,1976,Gabon,Chad,0,1,Friendly,Libreville,Gabon,False,1,-1,Chad
8067,8916,9595,1976,Paraguay,Argentina,2,3,Copa Félix Bogado,Asunción,Paraguay,False,5,-1,Argentina
8068,8917,9596,1976,Uruguay,Brazil,1,2,Copa Rio Branco,Montevideo,Uruguay,False,3,-1,Brazil
8069,8918,9597,1976,Argentina,Brazil,1,2,Copa Roca,Buenos Aires,Argentina,False,3,-1,Brazil
8070,8919,9598,1976,Germany,Malta,8,0,UEFA Euro qualification,Dortmund,Germany,False,8,8,Germany
8071,8920,9599,1976,Tunisia,Sweden,1,1,Friendly,Tunis,Tunisia,False,2,0,Draw
8072,8921,9600,1976,Egypt,Guinea,1,1,African Cup of Nations,Addis Abeba,Ethiopia,True,2,0,Draw
8073,8922,9601,1976,Ethiopia,Uganda,2,0,African Cup of Nations,Addis Abeba,Ethiopia,False,2,2,Ethiopia
8074,8923,9602,1976,New Zealand,Australia,0,1,Friendly,Auckland,New Zealand,False,1,-1,Australia
8075,8924,9603,1976,Morocco,Sudan,2,2,African Cup of Nations,Dire Dawa,Ethiopia,True,4,0,Draw
8076,8925,9604,1976,Nigeria,DR Congo,4,2,African Cup of Nations,Dire Dawa,Ethiopia,True,6,2,Nigeria
8077,8926,9605,1976,Algeria,Sweden,0,2,Friendly,Algiers,Algeria,False,2,-2,Sweden
8078,8927,9606,1976,Australia,New Zealand,3,1,Friendly,Melbourne,Australia,False,4,2,Australia
8079,8928,9607,1976,Egypt,Uganda,2,1,African Cup of Nations,Addis Abeba,Ethiopia,True,3,1,Egypt
8080,8929,9608,1976,Ethiopia,Guinea,1,2,African Cup of Nations,Addis Abeba,Ethiopia,False,3,-1,Guinea
8081,8930,9609,1976,Israel,Northern Ireland,1,1,Friendly,Jaffa,Israel,False,2,0,Draw
8082,8931,9610,1976,Morocco,DR Congo,1,0,African Cup of Nations,Dire Dawa,Ethiopia,True,1,1,Morocco
8083,8932,9611,1976,Nigeria,Sudan,1,0,African Cup of Nations,Dire Dawa,Ethiopia,True,1,1,Nigeria
8084,8933,9612,1976,Ethiopia,Egypt,1,1,African Cup of Nations,Addis Abeba,Ethiopia,False,2,0,Draw
8085,8934,9613,1976,Guinea,Uganda,2,1,African Cup of Nations,Addis Abeba,Ethiopia,True,3,1,Guinea
8086,8935,9614,1976,Morocco,Nigeria,3,1,African Cup of Nations,Dire Dawa,Ethiopia,True,4,2,Morocco
8087,8936,9615,1976,Sudan,DR Congo,1,1,African Cup of Nations,Dire Dawa,Ethiopia,True,2,0,Draw
8088,8937,9616,1976,Sierra Leone,Niger,5,1,FIFA World Cup qualification,Freetown,Sierra Leone,False,6,4,Sierra Leone
8089,8938,9617,1976,Egypt,Morocco,1,2,African Cup of Nations,Addis Abeba,Ethiopia,True,3,-1,Morocco
8090,8939,9618,1976,Guinea,Nigeria,1,1,African Cup of Nations,Addis Abeba,Ethiopia,True,2,0,Draw
8091,8940,9620,1976,Malta,Libya,2,2,Friendly,Gżira,Malta,False,4,0,Draw
8092,8941,9621,1976,Uruguay,Paraguay,2,2,Atlantic Cup,Montevideo,Uruguay,False,4,0,Draw
8093,8942,9622,1976,Egypt,Guinea,2,4,African Cup of Nations,Addis Abeba,Ethiopia,True,6,-2,Guinea
8094,8943,9623,1976,Morocco,Nigeria,2,1,African Cup of Nations,Addis Abeba,Ethiopia,True,3,1,Morocco
8095,8944,9624,1976,Burkina Faso,Mauritania,1,1,FIFA World Cup qualification,Ouagadougou,Upper Volta,True,2,0,Draw
8096,8945,9625,1976,Egypt,Nigeria,2,3,African Cup of Nations,Addis Abeba,Ethiopia,True,5,-1,Nigeria
8097,8946,9626,1976,Guinea,Morocco,1,1,African Cup of Nations,Addis Abeba,Ethiopia,True,2,0,Draw
8098,8947,9627,1976,Russia,Argentina,0,1,Friendly,Kyïv,Soviet Union,False,1,-1,Argentina
8099,8948,9628,1976,Ghana,Togo,4,0,Friendly,Accra,Ghana,False,4,4,Ghana
8100,8949,9629,1976,Ivory Coast,Senegal,4,1,Friendly,Abidjan,Ivory Coast,False,5,3,Ivory Coast
8101,8950,9630,1976,Niger,Sierra Leone,2,1,FIFA World Cup qualification,Niamey,Niger,False,3,1,Niger
8102,8951,9631,1976,Bulgaria,Russia,0,3,Friendly,Sofia,Bulgaria,False,3,-3,Russia
8103,8952,9632,1976,Republic of Ireland,Norway,3,0,Friendly,Dublin,Republic of Ireland,False,3,3,Republic of Ireland
8104,8953,9633,1976,Poland,Argentina,1,2,Friendly,Chorzów,Poland,False,3,-1,Argentina
8105,8954,9634,1976,Wales,England,1,2,Friendly,Wrexham,Wales,False,3,-1,England
8106,8955,9635,1976,Qatar,Saudi Arabia,1,0,Gulf Cup,Doha,Qatar,False,1,1,Qatar
8107,8956,9636,1976,Bahrain,United Arab Emirates,3,2,Gulf Cup,Doha,Qatar,True,5,1,Bahrain
8108,8958,9638,1976,Hungary,Argentina,2,0,Friendly,Budapest,Hungary,False,2,2,Hungary
8109,8959,9639,1976,Iraq,Oman,4,0,Gulf Cup,Doha,Qatar,True,4,4,Iraq
8110,8960,9640,1976,Gabon,Ivory Coast,0,3,Friendly,Libreville,Gabon,False,3,-3,Ivory Coast
8111,8961,9641,1976,Mauritania,Burkina Faso,0,2,FIFA World Cup qualification,Nouakchott,Mauritania,False,2,-2,Burkina Faso
8112,8962,9642,1976,Qatar,Kuwait,0,4,Gulf Cup,Doha,Qatar,False,4,-4,Kuwait
8113,8963,9643,1976,Bahrain,Iraq,1,4,Gulf Cup,Doha,Qatar,True,5,-3,Iraq
8114,8964,9644,1976,Saudi Arabia,United Arab Emirates,2,0,Gulf Cup,Doha,Qatar,True,2,2,Saudi Arabia
8115,8965,9645,1976,Kuwait,Oman,8,0,Gulf Cup,Doha,Qatar,True,8,8,Kuwait
8116,8966,9646,1976,Algeria,Libya,1,0,FIFA World Cup qualification,Algiers,Algeria,False,1,1,Algeria
8117,8967,9647,1976,Iraq,Saudi Arabia,7,1,Gulf Cup,Doha,Qatar,True,8,6,Iraq
8118,8968,9648,1976,Qatar,United Arab Emirates,3,1,Gulf Cup,Doha,Qatar,False,4,2,Qatar
8119,8969,9649,1976,Bahrain,Oman,1,0,Gulf Cup,Doha,Qatar,True,1,1,Bahrain
8120,8970,9650,1976,Dominican Republic,Haiti,0,3,FIFA World Cup qualification,Santo Domingo,Dominican Republic,False,3,-3,Haiti
8121,8971,9651,1976,Kuwait,United Arab Emirates,0,0,Gulf Cup,Doha,Qatar,True,0,0,Draw
8122,8972,9652,1976,Qatar,Iraq,0,0,Gulf Cup,Doha,Qatar,False,0,0,Draw
8123,8973,9653,1976,Oman,Saudi Arabia,1,3,Gulf Cup,Doha,Qatar,True,4,-2,Saudi Arabia
8124,8974,9654,1976,Panama,Costa Rica,3,2,FIFA World Cup qualification,Panama City,Panama,False,5,1,Panama
8125,8975,9655,1976,Bahrain,Kuwait,2,5,Gulf Cup,Doha,Qatar,True,7,-3,Kuwait
8126,8976,9656,1976,Iraq,United Arab Emirates,4,0,Gulf Cup,Doha,Qatar,True,4,4,Iraq
8127,8977,9657,1976,Italy,Portugal,3,1,Friendly,Turin,Italy,False,4,2,Italy
8128,8978,9658,1976,Paraguay,Brazil,1,1,Copa Oswaldo Cruz,Asunción,Paraguay,False,2,0,Draw
8129,8979,9659,1976,Qatar,Oman,4,1,Gulf Cup,Doha,Qatar,False,5,3,Qatar
8130,8980,9660,1976,Scotland,Switzerland,1,0,Friendly,Glasgow,Scotland,False,1,1,Scotland
8131,8981,9661,1976,Argentina,Uruguay,4,1,Copa Lipton,Buenos Aires,Argentina,False,5,3,Argentina
8132,8982,9662,1976,Bahrain,Saudi Arabia,2,1,Gulf Cup,Doha,Qatar,True,3,1,Bahrain
8133,8983,9663,1976,Iraq,Kuwait,2,2,Gulf Cup,Doha,Qatar,True,4,0,Draw
8134,8984,9664,1976,Oman,United Arab Emirates,1,1,Gulf Cup,Doha,Qatar,True,2,0,Draw
8135,8985,9665,1976,Qatar,Bahrain,3,0,Gulf Cup,Doha,Qatar,False,3,3,Qatar
8136,8986,9666,1976,Kuwait,Saudi Arabia,3,1,Gulf Cup,Doha,Qatar,True,4,2,Kuwait
8137,8987,9667,1976,Iraq,Kuwait,2,4,Gulf Cup,Doha,Qatar,True,6,-2,Kuwait
8138,8988,9668,1976,Libya,Algeria,0,0,FIFA World Cup qualification,Tripoli,Libya,False,0,0,Draw
8139,8989,9669,1976,Haiti,Dominican Republic,3,0,FIFA World Cup qualification,Port-au-Prince,Haiti,False,3,3,Haiti
8140,8990,9671,1976,Ivory Coast,Gabon,1,3,Friendly,Abidjan,Ivory Coast,False,4,-2,Gabon
8141,8991,9672,1976,Sierra Leone,Guinea,1,1,Friendly,Freetown,Sierra Leone,False,2,0,Draw
8142,8992,9673,1976,Congo,Cuba,3,1,Friendly,Brazzaville,Congo,False,4,2,Congo
8143,8993,9676,1976,France,Poland,2,0,Friendly,Lens,France,False,2,2,France
8144,8994,9677,1976,Spain,Germany,1,1,UEFA Euro qualification,Madrid,Spain,False,2,0,Draw
8145,8995,9679,1976,Netherlands,Belgium,5,0,UEFA Euro qualification,Rotterdam,Netherlands,False,5,5,Netherlands
8146,8996,9680,1976,Sierra Leone,Liberia,1,0,Friendly,Freetown,Sierra Leone,False,1,1,Sierra Leone
8147,8997,9681,1976,Argentina,Paraguay,2,2,Copa Félix Bogado,Buenos Aires,Argentina,False,4,0,Draw
8148,8998,9682,1976,Austria,Sweden,1,0,Friendly,Vienna,Austria,False,1,1,Austria
8149,8999,9683,1976,Brazil,Uruguay,2,1,Copa Rio Branco,Rio de Janeiro,Brazil,False,3,1,Brazil
8150,9000,9684,1976,Switzerland,Hungary,0,1,Friendly,Lausanne,Switzerland,False,1,-1,Hungary
8151,9001,9685,1976,Algeria,Guinea,1,2,Friendly,Algiers,Algeria,False,3,-1,Guinea
8152,9002,9686,1976,Gabon,São Tomé and Príncipe,6,1,Friendly,Libreville,Gabon,False,7,5,Gabon
8153,9003,9687,1976,Guadeloupe,Martinique,0,1,Friendly,Pointe-à-Pitre,Guadeloupe,False,1,-1,Martinique
8154,9004,9688,1976,Panama,El Salvador,1,1,FIFA World Cup qualification,Panama City,Panama,False,2,0,Draw
8155,9006,9691,1976,Greece,Poland,1,0,Friendly,Athens,Greece,False,1,1,Greece
8156,9007,9692,1976,Scotland,Wales,3,1,British Championship,Glasgow,Scotland,False,4,2,Scotland
8157,9008,9693,1976,Scotland,Northern Ireland,3,0,British Championship,Glasgow,Scotland,False,3,3,Scotland
8158,9009,9694,1976,Wales,England,0,1,British Championship,Cardiff,Wales,False,1,-1,England
8159,9010,9695,1976,Zambia,Malawi,4,0,FIFA World Cup qualification,Lusaka,Zambia,False,4,4,Zambia
8160,9011,9696,1976,England,Northern Ireland,4,0,British Championship,London,England,False,4,4,England
8161,9012,9697,1976,Martinique,Guadeloupe,3,2,Friendly,Fort-de-France,Martinique,False,5,1,Martinique
8162,9013,9698,1976,Sweden,Denmark,1,2,Friendly,Gothenburg,Sweden,False,3,-1,Denmark
8163,9014,9699,1976,Switzerland,Poland,2,1,Friendly,Basel,Switzerland,False,3,1,Switzerland
8164,9015,9700,1976,Bulgaria,Romania,1,0,Balkan Cup,Veliko Tărnovo,Bulgaria,False,1,1,Bulgaria
8165,9016,9701,1976,Wales,Northern Ireland,1,0,British Championship,Swansea,Wales,False,1,1,Wales
8166,9017,9702,1976,Scotland,England,2,1,British Championship,Glasgow,Scotland,False,3,1,Scotland
8167,9018,9703,1976,Brazil,Argentina,2,0,Copa Roca,Rio de Janeiro,Brazil,False,2,2,Brazil
8168,9019,9704,1976,Finland,Switzerland,1,0,Friendly,Kuopio,Finland,False,1,1,Finland
8169,9020,9705,1976,Norway,Iceland,0,1,Friendly,Oslo,Norway,False,1,-1,Iceland
8170,9021,9706,1976,Paraguay,Uruguay,1,0,Atlantic Cup,Asunción,Paraguay,False,1,1,Paraguay
8171,9022,9707,1976,Belgium,Netherlands,1,2,UEFA Euro qualification,Brussels,Belgium,False,3,-1,Netherlands
8172,9023,9708,1976,Germany,Spain,2,0,UEFA Euro qualification,Munich,Germany,False,2,2,Germany
8173,9024,9709,1976,Hungary,France,1,0,Friendly,Budapest,Hungary,False,1,1,Hungary
8174,9027,9712,1976,Brazil,England,1,0,Friendly,Los Angeles,United States,True,1,1,Brazil
8175,9028,9713,1976,Cyprus,Denmark,1,5,FIFA World Cup qualification,Limassol,Cyprus,False,6,-4,Denmark
8176,9029,9714,1976,United States,Italy,0,4,Friendly,Washington,United States,False,4,-4,Italy
8177,9030,9715,1976,Hungary,Russia,1,1,Friendly,Budapest,Hungary,False,2,0,Draw
8178,9031,9716,1976,Poland,Republic of Ireland,0,2,Friendly,Poznań,Poland,False,2,-2,Republic of Ireland
8179,9032,9717,1976,England,Italy,3,2,Friendly,New York,United States,True,5,1,England
8180,9033,9718,1976,United States,Brazil,0,2,Friendly,Seattle,United States,False,2,-2,Brazil
8181,9034,9719,1976,Malawi,Zambia,0,1,FIFA World Cup qualification,Blantyre,Malawi,False,1,-1,Zambia
8182,9035,9720,1976,Brazil,Italy,4,1,Friendly,New Haven,United States,True,5,3,Brazil
8183,9036,9721,1976,United States,England,1,3,Friendly,Philadelphia,United States,False,4,-2,England
8184,9037,9722,1976,Finland,Sweden,0,2,Nordic Championship,Helsinki,Finland,False,2,-2,Sweden
8185,9038,9723,1976,Kuwait,Malaysia,2,0,AFC Asian Cup,Teheran,Iran,True,2,2,Kuwait
8186,9039,9724,1976,Iran,Iraq,2,0,AFC Asian Cup,Teheran,Iran,False,2,2,Iran
8187,9040,9725,1976,Mexico,Brazil,0,3,Friendly,Guadalajara,Mexico,False,3,-3,Brazil
8188,9041,9727,1976,Italy,Romania,4,2,Friendly,Milan,Italy,False,6,2,Italy
8189,9043,9731,1976,Burma,Malaysia,3,1,Indonesia Tournament,Jakarta,Indonesia,True,4,2,Burma
8190,9045,9733,1976,Brazil,Paraguay,3,1,Copa Oswaldo Cruz,Rio de Janeiro,Brazil,False,4,2,Brazil
8191,9046,9734,1976,Uruguay,Argentina,0,3,Copa Newton,Montevideo,Uruguay,False,3,-3,Argentina
8192,9047,9735,1976,Indonesia,Malaysia,1,2,Indonesia Tournament,Jakarta,Indonesia,False,3,-1,Malaysia
8193,9049,9737,1976,Iraq,Kuwait,2,3,AFC Asian Cup,Teheran,Iran,True,5,-1,Kuwait
8194,9050,9738,1976,Hungary,Austria,2,0,Friendly,Budapest,Hungary,False,2,2,Hungary
8195,9051,9739,1976,Indonesia,Burma,1,1,Indonesia Tournament,Jakarta,Indonesia,False,2,0,Draw
8196,9052,9741,1976,Finland,England,1,4,FIFA World Cup qualification,Helsinki,Finland,False,5,-3,England
8197,9053,9742,1976,Iran,Kuwait,1,0,AFC Asian Cup,Teheran,Iran,False,1,1,Iran
8198,9054,9744,1976,Faroe Islands,Iceland,1,6,Friendly,Tórshavn,Faroe Islands,False,7,-5,Iceland
8199,9055,9745,1976,Sweden,Norway,2,0,FIFA World Cup qualification,Solna,Sweden,False,2,2,Sweden
8200,9056,9749,1976,Austria,Russia,1,2,Friendly,Vienna,Austria,False,3,-1,Russia
8201,9057,9750,1976,Norway,Denmark,0,0,Nordic Championship,Bergen,Norway,False,0,0,Draw
8202,9058,9751,1976,Réunion,Kenya,1,3,Friendly,Mahé,Seychelles,True,4,-2,Kenya
8203,9059,9752,1976,Guatemala,Costa Rica,1,0,Friendly,Guatemala,Guatemala,False,1,1,Guatemala
8204,9060,9753,1976,Gabon,DR Congo,1,1,Friendly,Libreville,Gabon,False,2,0,Draw
8205,9061,9754,1976,Seychelles,Réunion,1,4,Friendly,Victoria,Seychelles,False,5,-3,Réunion
8206,9062,9755,1976,Iran,Romania,2,2,Friendly,Teheran,Iran,False,4,0,Draw
8207,9063,9756,1976,Réunion,Mauritius,0,2,Friendly,Saint-Pierre,Réunion,False,2,-2,Mauritius
8208,9064,9757,1976,Rwanda,DR Congo,1,6,Friendly,Libreville,Gabon,True,7,-5,DR Congo
8209,9065,9758,1976,Seychelles,Kenya,1,4,Friendly,Mahé,Seychelles,False,5,-3,Kenya
8210,9066,9759,1976,Guyana,Suriname,2,0,FIFA World Cup qualification,Georgetown,Guyana,False,2,2,Guyana
8211,9067,9760,1976,Cameroon,DR Congo,2,1,Friendly,Libreville,Gabon,True,3,1,Cameroon
8212,9068,9761,1976,Malawi,Kenya,1,0,Friendly,Blantyre,Malawi,False,1,1,Malawi
8213,9069,9762,1976,Burundi,DR Congo,0,1,Friendly,Libreville,Gabon,True,1,-1,DR Congo
8214,9070,9763,1976,Guatemala,El Salvador,1,0,Friendly,Guatemala,Guatemala,False,1,1,Guatemala
8215,9071,9764,1976,Malawi,Sierra Leone,4,2,Friendly,Zomba,Malawi,False,6,2,Malawi
8216,9072,9765,1976,Costa Rica,Panama,3,0,FIFA World Cup qualification,San José,Costa Rica,False,3,3,Costa Rica
8217,9073,9766,1976,Finland,Iceland,1,0,Friendly,Helsinki,Finland,False,1,1,Finland
8218,9074,9767,1976,Afghanistan,Pakistan,1,0,Friendly,Kabul,Afghanistan,False,1,1,Afghanistan
8219,9075,9768,1976,India,Pakistan,1,1,Friendly,Kabul,Afghanistan,True,2,0,Draw
8220,9076,9769,1976,Afghanistan,India,1,1,Friendly,Kabul,Afghanistan,False,2,0,Draw
8221,9077,9770,1976,Curaçao,Haiti,1,2,FIFA World Cup qualification,Oranjestad,Netherlands Antilles,True,3,-1,Haiti
8222,9079,9772,1976,Burma,Indonesia,5,1,Merdeka Tournament,Kuala Lumpur,Malaysia,True,6,4,Burma
8223,9080,9773,1976,India,Japan,1,5,Merdeka Tournament,Kuala Lumpur,Malaysia,True,6,-4,Japan
8224,9081,9774,1976,São Tomé and Príncipe,Congo,2,3,Friendly,São Tomé,São Tomé and Príncipe,False,5,-1,Congo
8225,9083,9776,1976,Indonesia,Japan,0,6,Merdeka Tournament,Kuala Lumpur,Malaysia,True,6,-6,Japan
8226,9084,9777,1976,Australia,Hong Kong,0,1,Friendly,Canberra,Australia,False,1,-1,Hong Kong
8227,9085,9778,1976,Burma,Thailand,1,0,Merdeka Tournament,Kuala Lumpur,Malaysia,True,1,1,Burma
8228,9086,9779,1976,El Salvador,Panama,4,1,FIFA World Cup qualification,San Salvador,El Salvador,False,5,3,El Salvador
8229,9087,9780,1976,Sweden,Finland,6,0,Nordic Championship,Malmö,Sweden,False,6,6,Sweden
8230,9089,9782,1976,Burma,Japan,2,2,Merdeka Tournament,Kuala Lumpur,Malaysia,True,4,0,Draw
8231,9090,9783,1976,Haiti,Curaçao,7,0,FIFA World Cup qualification,Port-au-Prince,Haiti,False,7,7,Haiti
8232,9091,9784,1976,India,Thailand,2,6,Merdeka Tournament,Kuala Lumpur,Malaysia,True,8,-4,Thailand
8233,9092,9785,1976,Barbados,Trinidad and Tobago,2,1,FIFA World Cup qualification,Bridgetown,Barbados,False,3,1,Barbados
8234,9094,9787,1976,Jamaica,Cuba,1,3,FIFA World Cup qualification,Kingston,Jamaica,False,4,-2,Cuba
8235,9095,9788,1976,Japan,Thailand,2,2,Merdeka Tournament,Kuala Lumpur,Malaysia,True,4,0,Draw
8236,9096,9789,1976,Malaysia,Burma,3,1,Merdeka Tournament,Kuala Lumpur,Malaysia,False,4,2,Malaysia
8237,9097,9790,1976,Switzerland,Bulgaria,2,2,Friendly,Lucerne,Switzerland,False,4,0,Draw
8238,9098,9791,1976,Australia,Hong Kong,2,0,Friendly,Gosford,Australia,False,2,2,Australia
8239,9099,9792,1976,Indonesia,Thailand,0,1,Merdeka Tournament,Kuala Lumpur,Malaysia,True,1,-1,Thailand
8240,9101,9794,1976,Burma,India,2,2,Merdeka Tournament,Kuala Lumpur,Malaysia,True,4,0,Draw
8241,9102,9796,1976,Iceland,Luxembourg,3,1,Friendly,Reykjavík,Iceland,False,4,2,Iceland
8242,9103,9797,1976,Denmark,Norway,3,0,Nordic Championship,Vejle,Denmark,False,3,3,Denmark
8243,9104,9798,1976,Finland,Turkey,2,1,Friendly,Helsinki,Finland,False,3,1,Finland
8244,9105,9799,1976,Cuba,Jamaica,2,0,FIFA World Cup qualification,Havana,Cuba,False,2,2,Cuba
8245,9106,9800,1976,Suriname,Guyana,3,0,FIFA World Cup qualification,Paramaribo,Suriname,False,3,3,Suriname
8246,9107,9801,1976,Trinidad and Tobago,Barbados,1,0,FIFA World Cup qualification,Port of Spain,Trinidad and Tobago,False,1,1,Trinidad and Tobago
8247,9108,9802,1976,Denmark,France,1,1,Friendly,Copenhagen,Denmark,False,2,0,Draw
8248,9109,9803,1976,Burkina Faso,Ivory Coast,1,1,FIFA World Cup qualification,Ouagadougou,Upper Volta,True,2,0,Draw
8249,9110,9804,1976,Malawi,Uganda,1,1,Friendly,Blantyre,Malawi,False,2,0,Draw
8250,9111,9805,1976,Iceland,Belgium,0,1,FIFA World Cup qualification,Reykjavík,Iceland,False,1,-1,Belgium
8251,9112,9806,1976,Saudi Arabia,Iraq,0,0,Friendly,Riyadh,Saudi Arabia,False,0,0,Draw
8252,9113,9807,1976,Malawi,Uganda,1,2,Friendly,Blantyre,Malawi,False,3,-1,Uganda
8253,9114,9808,1976,England,Republic of Ireland,1,1,Friendly,London,England,False,2,0,Draw
8254,9115,9809,1976,Iceland,Netherlands,0,1,FIFA World Cup qualification,Reykjavík,Iceland,False,1,-1,Netherlands
8255,9116,9810,1976,Libya,Algeria,0,1,Friendly,Benghazi,Libya,False,1,-1,Algeria
8256,9117,9811,1976,Norway,Switzerland,1,0,FIFA World Cup qualification,Oslo,Norway,False,1,1,Norway
8257,9118,9812,1976,Scotland,Finland,6,0,Friendly,Glasgow,Scotland,False,6,6,Scotland
8258,9119,9813,1976,Sweden,Hungary,1,1,Friendly,Solna,Sweden,False,2,0,Draw
8259,9120,9814,1976,Ivory Coast,Ghana,3,1,Friendly,Abidjan,Ivory Coast,False,4,2,Ivory Coast
8260,9121,9815,1976,Libya,Algeria,1,0,Friendly,Tripoli,Libya,False,1,1,Libya
8261,9122,9817,1976,Burma,New Zealand,0,2,Korea Cup,Seoul,South Korea,True,2,-2,New Zealand
8262,9123,9818,1976,Saudi Arabia,Morocco,0,2,Friendly,Riyadh,Saudi Arabia,False,2,-2,Morocco
8263,9124,9820,1976,Malawi,Botswana,7,1,Friendly,Blantyre,Malawi,False,8,6,Malawi
8264,9125,9821,1976,Malaysia,Singapore,4,1,Korea Cup,Seoul,South Korea,True,5,3,Malaysia
8265,9126,9822,1976,Barbados,Trinidad and Tobago,1,3,FIFA World Cup qualification,Bridgetown,Barbados,False,4,-2,Trinidad and Tobago
8266,9127,9823,1976,India,Singapore,1,2,Korea Cup,Seoul,South Korea,True,3,-1,Singapore
8267,9128,9824,1976,Burma,Thailand,2,0,Korea Cup,Seoul,South Korea,True,2,2,Burma
8268,9129,9826,1976,Malawi,Botswana,3,0,Friendly,Blantyre,Malawi,False,3,3,Malawi
8269,9130,9827,1976,Panama,Guatemala,2,4,FIFA World Cup qualification,Panama City,Panama,False,6,-2,Guatemala
8270,9131,9828,1976,New Zealand,Thailand,3,1,Korea Cup,Seoul,South Korea,True,4,2,New Zealand
8271,9132,9829,1976,India,Malaysia,0,4,Korea Cup,Seoul,South Korea,True,4,-4,Malaysia
8272,9133,9830,1976,Austria,Switzerland,3,1,Friendly,Linz,Austria,False,4,2,Austria
8273,9134,9831,1976,Bulgaria,Turkey,2,2,Friendly,Sofia,Bulgaria,False,4,0,Draw
8274,9135,9832,1976,Denmark,Italy,0,1,Friendly,Copenhagen,Denmark,False,1,-1,Italy
8275,9136,9833,1976,Finland,Luxembourg,7,1,FIFA World Cup qualification,Helsinki,Finland,False,8,6,Finland
8276,9137,9835,1976,Greece,Israel,0,1,Friendly,Patras,Greece,False,1,-1,Israel
8277,9138,9836,1976,Norway,Sweden,3,2,Nordic Championship,Oslo,Norway,False,5,1,Norway
8278,9140,9839,1976,Canada,United States,1,1,FIFA World Cup qualification,Vancouver,Canada,False,2,0,Draw
8279,9142,9841,1976,Guatemala,Panama,7,0,FIFA World Cup qualification,Guatemala,Guatemala,False,7,7,Guatemala
8280,9143,9842,1976,Ivory Coast,Burkina Faso,2,0,FIFA World Cup qualification,Abidjan,Ivory Coast,False,2,2,Ivory Coast
8281,9144,9843,1976,Botswana,Zambia,2,3,Friendly,Gaborone,Botswana,False,5,-1,Zambia
8282,9145,9844,1976,Saudi Arabia,Tunisia,0,1,Friendly,Dammam,Saudi Arabia,False,1,-1,Tunisia
8283,9146,9845,1976,New Caledonia,New Zealand,2,1,Friendly,Nouméa,New Caledonia,False,3,1,New Caledonia
8284,9147,9846,1976,United States,Mexico,0,0,FIFA World Cup qualification,Los Angeles,United States,False,0,0,Draw
8285,9148,9847,1976,Chile,Uruguay,0,0,Copa Juan Pinto Durán,Santiago,Chile,False,0,0,Draw
8286,9149,9849,1976,Wales,Germany,0,2,Friendly,Cardiff,Wales,False,2,-2,Germany
8287,9150,9850,1976,Bulgaria,France,2,2,FIFA World Cup qualification,Sofia,Bulgaria,False,4,0,Draw
8288,9151,9851,1976,Greece,Hungary,1,1,FIFA World Cup qualification,Piraeus,Greece,False,2,0,Draw
8289,9152,9852,1976,Switzerland,Sweden,1,2,FIFA World Cup qualification,Basel,Switzerland,False,3,-1,Sweden
8290,9153,9853,1976,Uganda,Burundi,2,0,Friendly,Kampala,Uganda,False,2,2,Uganda
8291,9154,9854,1976,Albania,Algeria,3,0,Friendly,Tirana,Albania,False,3,3,Albania
8292,9155,9855,1976,Canada,Mexico,1,0,FIFA World Cup qualification,Vancouver,Canada,False,1,1,Canada
8293,9156,9856,1976,Ethiopia,Mauritius,3,0,Friendly,Addis Abeba,Ethiopia,False,3,3,Ethiopia
8294,9157,9857,1976,Ghana,Guinea,2,1,FIFA World Cup qualification,Accra,Ghana,False,3,1,Ghana
8295,9159,9859,1976,Uganda,Burundi,1,0,Friendly,Kampala,Uganda,False,1,1,Uganda
8296,9160,9860,1976,Pakistan,Afghanistan,1,0,Friendly,Karachi,Pakistan,False,1,1,Pakistan
8297,9161,9861,1976,Peru,Uruguay,0,0,Friendly,Lima,Peru,False,0,0,Draw
8298,9162,9862,1976,Argentina,Chile,2,0,Copa Carlos Dittborn,Buenos Aires,Argentina,False,2,2,Argentina
8299,9163,9863,1976,Austria,Hungary,2,4,Friendly,Vienna,Austria,False,6,-2,Hungary
8300,9164,9865,1976,England,Finland,2,1,FIFA World Cup qualification,London,England,False,3,1,England
8301,9165,9866,1976,Netherlands,Northern Ireland,2,2,FIFA World Cup qualification,Rotterdam,Netherlands,False,4,0,Draw
8302,9166,9867,1976,Turkey,Republic of Ireland,3,3,Friendly,Ankara,Turkey,False,6,0,Draw
8303,9167,9868,1976,Colombia,Uruguay,1,2,Friendly,Bogotá,Colombia,False,3,-1,Uruguay
8304,9168,9869,1976,Mexico,United States,3,0,FIFA World Cup qualification,Puebla,Mexico,False,3,3,Mexico
8305,9169,9870,1976,Luxembourg,Italy,1,4,FIFA World Cup qualification,Luxembourg,Luxembourg,False,5,-3,Italy
8306,9170,9871,1976,Portugal,Poland,0,2,FIFA World Cup qualification,Porto,Portugal,False,2,-2,Poland
8307,9171,9872,1976,Sierra Leone,Nigeria,0,0,FIFA World Cup qualification,Freetown,Sierra Leone,False,0,0,Draw
8308,9172,9873,1976,Congo,Cameroon,2,2,FIFA World Cup qualification,Brazzaville,Congo,False,4,0,Draw
8309,9173,9874,1976,Togo,Senegal,1,0,FIFA World Cup qualification,Lomé,Togo,False,1,1,Togo
8310,9174,9875,1976,Ecuador,Uruguay,2,2,Friendly,Quito,Ecuador,False,4,0,Draw
8311,9175,9876,1976,Indonesia,Australia,1,1,Friendly,Jakarta,Indonesia,False,2,0,Draw
8312,9176,9877,1976,Iraq,Libya,1,0,Friendly,Baghdad,Iraq,False,1,1,Iraq
8313,9177,9878,1976,United States,Canada,2,0,FIFA World Cup qualification,Seattle,United States,False,2,2,United States
8314,9178,9879,1976,Iraq,Libya,3,1,Friendly,Baghdad,Iraq,False,4,2,Iraq
8315,9179,9880,1976,Singapore,Australia,0,1,Friendly,Kallang,Singapore,False,1,-1,Australia
8316,9180,9881,1976,Hong Kong,Australia,0,2,Friendly,So Kon Po,Hong Kong,False,2,-2,Australia
8317,9181,9882,1976,Malawi,Mauritius,1,1,African Cup of Nations qualification,Lilongwe,Malawi,False,2,0,Draw
8318,9182,9883,1976,Uganda,Ethiopia,4,1,Friendly,Kampala,Uganda,False,5,3,Uganda
8319,9184,9885,1976,Denmark,Cyprus,5,0,FIFA World Cup qualification,Copenhagen,Denmark,False,5,5,Denmark
8320,9185,9886,1976,Mexico,Canada,0,0,FIFA World Cup qualification,Toluca,Mexico,False,0,0,Draw
8321,9186,9887,1976,Peru,Argentina,1,3,Copa Ramón Castilla,Lima,Peru,False,4,-2,Argentina
8322,9187,9888,1976,Egypt,Ethiopia,3,0,FIFA World Cup qualification,Cairo,Egypt,False,3,3,Egypt
8323,9188,9889,1976,Nigeria,Sierra Leone,6,2,FIFA World Cup qualification,Lagos,Nigeria,False,8,4,Nigeria
8324,9189,9890,1976,Cameroon,Congo,1,2,FIFA World Cup qualification,Yaoundé,Cameroon,False,3,-1,Congo
8325,9190,9891,1976,Guinea,Ghana,2,1,FIFA World Cup qualification,Conakry,Guinea,False,3,1,Guinea
8326,9191,9892,1976,Poland,Cyprus,5,0,FIFA World Cup qualification,Warsaw,Poland,False,5,5,Poland
8327,9192,9893,1976,Senegal,Togo,1,1,FIFA World Cup qualification,Dakar,Senegal,False,2,0,Draw
8328,9193,9894,1976,Turkey,Malta,4,0,FIFA World Cup qualification,Izmir,Turkey,False,4,4,Turkey
8329,9194,9895,1976,Algeria,Libya,2,0,Friendly,Algiers,Algeria,False,2,2,Algeria
8330,9195,9896,1976,Israel,Australia,1,1,Friendly,Ramat-Gan,Israel,False,2,0,Draw
8331,9196,9897,1976,Tunisia,Libya,3,0,Friendly,Tunis,Tunisia,False,3,3,Tunisia
8332,9197,9899,1976,Somalia,Uganda,0,2,CECAFA Cup,Zanzibar,Tanzania,True,2,-2,Uganda
8333,9198,9900,1976,Tanzania,Kenya,1,1,CECAFA Cup,Zanzibar,Tanzania,False,2,0,Draw
8334,9199,9901,1976,Tanzania,Malawi,1,1,CECAFA Cup,Zanzibar,Tanzania,False,2,0,Draw
8335,9200,9902,1976,Somalia,Zambia,2,4,CECAFA Cup,Zanzibar,Tanzania,True,6,-2,Zambia
8336,9201,9904,1976,Kenya,Malawi,2,2,CECAFA Cup,Zanzibar,Tanzania,True,4,0,Draw
8337,9202,9905,1976,Argentina,Peru,1,0,Copa Ramón Castilla,Buenos Aires,Argentina,False,1,1,Argentina
8338,9203,9906,1976,Belgium,Northern Ireland,2,0,FIFA World Cup qualification,Liège,Belgium,False,2,2,Belgium
8339,9204,9907,1976,Greece,Austria,0,3,Friendly,Kavála,Greece,False,3,-3,Austria
8340,9205,9908,1976,Haiti,United States,0,0,Friendly,Port-au-Prince,Haiti,False,0,0,Draw
8341,9206,9910,1976,Uganda,Zambia,2,3,CECAFA Cup,Zanzibar,Tanzania,True,5,-1,Zambia
8342,9207,9911,1976,Haiti,United States,0,0,Friendly,Port-au-Prince,Haiti,False,0,0,Draw
8343,9208,9912,1976,Kenya,Zambia,0,2,CECAFA Cup,Zanzibar,Tanzania,True,2,-2,Zambia
8344,9209,9913,1976,Malawi,Uganda,1,2,CECAFA Cup,Zanzibar,Tanzania,True,3,-1,Uganda
8345,9210,9914,1976,Saudi Arabia,Syria,2,0,FIFA World Cup qualification,Jeddah,Saudi Arabia,False,2,2,Saudi Arabia
8346,9211,9915,1976,Ethiopia,Egypt,1,2,FIFA World Cup qualification,Addis Abeba,Ethiopia,False,3,-1,Egypt
8347,9212,9916,1976,Haiti,United States,0,0,Friendly,Port-au-Prince,Haiti,False,0,0,Draw
8348,9213,9917,1976,Suriname,Trinidad and Tobago,1,1,FIFA World Cup qualification,Paramaribo,Suriname,False,2,0,Draw
8349,9214,9918,1976,Uganda,Zambia,2,0,CECAFA Cup,Zanzibar,Tanzania,True,2,2,Uganda
8350,9215,9919,1976,Tanzania,Zambia,2,3,Friendly,Dar es Salaam,Tanzania,False,5,-1,Zambia
8351,9216,9921,1976,France,Republic of Ireland,2,0,FIFA World Cup qualification,Paris,France,False,2,2,France
8352,9218,9924,1976,Italy,England,2,0,FIFA World Cup qualification,Rome,Italy,False,2,2,Italy
8353,9219,9925,1976,Portugal,Denmark,1,0,FIFA World Cup qualification,Lisbon,Portugal,False,1,1,Portugal
8354,9220,9926,1976,Scotland,Wales,1,0,FIFA World Cup qualification,Glasgow,Scotland,False,1,1,Scotland
8355,9221,9927,1976,Mali,Burkina Faso,2,1,Friendly,Bamako,Mali,False,3,1,Mali
8356,9222,9928,1976,Malta,Tunisia,1,1,Friendly,Gżira,Malta,False,2,0,Draw
8357,9223,9929,1976,Uruguay,Peru,0,0,Friendly,Montevideo,Uruguay,False,0,0,Draw
8358,9224,9930,1976,Syria,Saudi Arabia,2,1,FIFA World Cup qualification,Damascus,Syria,False,3,1,Syria
8359,9225,9931,1976,Argentina,Russia,0,0,Friendly,Buenos Aires,Argentina,False,0,0,Draw
8360,9226,9932,1976,Cuba,Haiti,1,1,FIFA World Cup qualification,Havana,Cuba,False,2,0,Draw
8361,9227,9933,1976,Romania,Bulgaria,3,2,Balkan Cup,Bucharest,Romania,False,5,1,Romania
8362,9228,9934,1976,Trinidad and Tobago,Suriname,2,2,FIFA World Cup qualification,Port of Spain,Trinidad and Tobago,False,4,0,Draw
8363,9229,9935,1976,Brazil,Russia,2,0,Friendly,Rio de Janeiro,Brazil,False,2,2,Brazil
8364,9230,9936,1976,El Salvador,Costa Rica,1,1,FIFA World Cup qualification,San Salvador,El Salvador,False,2,0,Draw
8365,9232,9938,1976,Costa Rica,Guatemala,0,0,FIFA World Cup qualification,San José,Costa Rica,False,0,0,Draw
8366,9233,9939,1976,Cyprus,Portugal,1,2,FIFA World Cup qualification,Limassol,Cyprus,False,3,-1,Portugal
8367,9234,9940,1976,Malta,Austria,0,1,FIFA World Cup qualification,Gżira,Malta,False,1,-1,Austria
8368,9235,9941,1976,Guatemala,El Salvador,3,1,FIFA World Cup qualification,Guatemala,Guatemala,False,4,2,Guatemala
8369,9236,9942,1976,Haiti,Cuba,1,1,FIFA World Cup qualification,Port-au-Prince,Haiti,False,2,0,Draw
8370,9237,9943,1976,Guatemala,Costa Rica,1,1,FIFA World Cup qualification,Guatemala,Guatemala,False,2,0,Draw
8371,9238,9944,1976,Morocco,Tunisia,1,1,FIFA World Cup qualification,Casablanca,Morocco,False,2,0,Draw
8372,9239,9945,1976,Costa Rica,El Salvador,1,1,FIFA World Cup qualification,San José,Costa Rica,False,2,0,Draw
8373,9240,9946,1976,Israel,Austria,1,3,Friendly,Ramat-Gan,Israel,False,4,-2,Austria
8374,9242,9949,1976,Bangladesh,Malaysia,0,6,King's Cup,Bangkok,Thailand,True,6,-6,Malaysia
8375,9243,9950,1976,Suriname,Trinidad and Tobago,3,2,FIFA World Cup qualification,Cayenne,French Guiana,True,5,1,Suriname
8376,9244,9951,1976,El Salvador,Guatemala,2,0,FIFA World Cup qualification,San Salvador,El Salvador,False,2,2,El Salvador
8377,9245,9952,1976,Thailand,Singapore,6,0,King's Cup,Bangkok,Thailand,False,6,6,Thailand
8378,9246,9953,1976,Canada,United States,3,0,FIFA World Cup qualification,Port-au-Prince,Haiti,True,3,3,Canada
8379,9247,9955,1976,Portugal,Italy,2,1,Friendly,Lisbon,Portugal,False,3,1,Portugal
8380,9248,9956,1976,Panama,Cuba,0,5,Friendly,Panama City,Panama,False,5,-5,Cuba
8381,9249,9957,1976,Thailand,Malaysia,1,1,King's Cup,Bangkok,Thailand,False,2,0,Draw
8382,9250,9958,1976,Cuba,Haiti,0,2,FIFA World Cup qualification,Panama City,Panama,True,2,-2,Haiti
8383,9251,9959,1977,Uruguay,Ecuador,1,1,Friendly,Montevideo,Uruguay,False,2,0,Draw
8384,9252,9961,1977,Saudi Arabia,Iran,0,3,FIFA World Cup qualification,Riyadh,Saudi Arabia,False,3,-3,Iran
8385,9253,9962,1977,Paraguay,Ecuador,2,0,Friendly,Asunción,Paraguay,False,2,2,Paraguay
8386,9254,9963,1977,Tunisia,Morocco,1,1,FIFA World Cup qualification,Tunis,Tunisia,False,2,0,Draw
8387,9255,9964,1977,Algeria,Bulgaria,1,1,Friendly,Algiers,Algeria,False,2,0,Draw
8388,9256,9965,1977,Paraguay,Uruguay,1,1,Copa Artigas,Asunción,Paraguay,False,2,0,Draw
8389,9257,9966,1977,Colombia,Ecuador,0,1,Friendly,Bogotá,Colombia,False,1,-1,Ecuador
8390,9258,9967,1977,Guinea,Ghana,2,0,FIFA World Cup qualification,Lomé,Togo,True,2,2,Guinea
8391,9259,9968,1977,Venezuela,Ecuador,1,0,Friendly,Acarigua,Venezuela,False,1,1,Venezuela
8392,9260,9969,1977,Brazil,Bulgaria,1,0,Friendly,São Paulo,Brazil,False,1,1,Brazil
8393,9261,9970,1977,Congo,Gabon,2,2,Friendly,Brazzaville,Congo,False,4,0,Draw
8394,9262,9971,1977,Uruguay,Paraguay,2,1,Copa Artigas,Montevideo,Uruguay,False,3,1,Uruguay
8395,9263,9972,1977,Uganda,Iraq,1,1,Friendly,Kampala,Uganda,False,2,0,Draw
8396,9264,9973,1977,Cameroon,Congo,2,2,Friendly,Yaoundé,Cameroon,False,4,0,Draw
8397,9265,9974,1977,Chile,Paraguay,4,0,Friendly,Santiago,Chile,False,4,4,Chile
8398,9266,9975,1977,Ecuador,Colombia,4,1,Friendly,Quito,Ecuador,False,5,3,Ecuador
8399,9267,9976,1977,Israel,Greece,1,1,Friendly,Ramat-Gan,Israel,False,2,0,Draw
8400,9268,9977,1977,Italy,Belgium,2,1,Friendly,Rome,Italy,False,3,1,Italy
8401,9269,9978,1977,Mauritius,Malawi,3,2,African Cup of Nations qualification,Curepipe,Mauritius,False,5,1,Mauritius
8402,9271,9980,1977,Cyprus,Bulgaria,1,2,Friendly,Nicosia,Cyprus,False,3,-1,Bulgaria
8403,9272,9981,1977,Gambia,Denmark,1,4,Friendly,Brikama,Gambia,False,5,-3,Denmark
8404,9273,9982,1977,Uruguay,Chile,3,0,Copa Juan Pinto Durán,Montevideo,Uruguay,False,3,3,Uruguay
8405,9275,9984,1977,Tanzania,Mozambique,2,1,Friendly,Dar es Salaam,Tanzania,False,3,1,Tanzania
8406,9276,9985,1977,France,Romania,2,0,Friendly,Bordeaux,France,False,2,2,France
8407,9277,9986,1977,Paraguay,Chile,2,0,Friendly,Asunción,Paraguay,False,2,2,Paraguay
8408,9278,9987,1977,Senegal,Denmark,2,3,Friendly,Kaolack,Senegal,False,5,-1,Denmark
8409,9279,9988,1977,Gabon,Morocco,0,1,Friendly,Libreville,Gabon,False,1,-1,Morocco
8410,9280,9989,1977,Bolivia,Paraguay,0,1,Copa Paz del Chaco,La Paz,Bolivia,False,1,-1,Paraguay
8411,9281,9990,1977,Kenya,Egypt,0,0,FIFA World Cup qualification,Nairobi,Kenya,False,0,0,Draw
8412,9282,9991,1977,Tunisia,Algeria,2,0,FIFA World Cup qualification,Tunis,Tunisia,False,2,2,Tunisia
8413,9284,9993,1977,Bolivia,Paraguay,2,2,Copa Paz del Chaco,Cochabamba,Bolivia,False,4,0,Draw
8414,9285,9994,1977,England,Netherlands,0,2,Friendly,London,England,False,2,-2,Netherlands
8415,9286,9995,1977,Republic of Ireland,Spain,0,1,Friendly,Dublin,Republic of Ireland,False,1,-1,Spain
8416,9287,9996,1977,Peru,Hungary,3,2,Friendly,Lima,Peru,False,5,1,Peru
8417,9288,9997,1977,Thailand,Israel,3,3,Friendly,Bangkok,Thailand,False,6,0,Draw
8418,9289,9998,1977,Venezuela,Uruguay,1,1,FIFA World Cup qualification,Caracas,Venezuela,False,2,0,Draw
8419,9290,9999,1977,Australia,Israel,1,1,Friendly,Melbourne,Australia,False,2,0,Draw
8420,9291,10000,1977,Ecuador,Paraguay,2,1,Friendly,Quito,Ecuador,False,3,1,Ecuador
8421,9292,10001,1977,Ivory Coast,Congo,3,2,FIFA World Cup qualification,Bouaké,Ivory Coast,False,5,1,Ivory Coast
8422,9293,10002,1977,Togo,Guinea,0,2,FIFA World Cup qualification,Lomé,Togo,False,2,-2,Guinea
8423,9294,10003,1977,Uganda,Zambia,1,0,FIFA World Cup qualification,Kampala,Uganda,False,1,1,Uganda
8424,9295,10004,1977,Nigeria,Benin,7,0,Friendly,Lagos,Nigeria,False,7,7,Nigeria
8425,9297,10006,1977,Australia,Israel,1,1,Friendly,Sydney,Australia,False,2,0,Draw
8426,9298,10007,1977,Turkey,Bulgaria,2,0,Balkan Cup,Istanbul,Turkey,False,2,2,Turkey
8427,9301,10010,1977,Colombia,Brazil,0,0,FIFA World Cup qualification,Bogotá,Colombia,False,0,0,Draw
8428,9302,10011,1977,Ecuador,Peru,1,1,FIFA World Cup qualification,Quito,Ecuador,False,2,0,Draw
8429,9303,10012,1977,Panama,Paraguay,0,4,Friendly,Panama City,Panama,False,4,-4,Paraguay
8430,9304,10013,1977,Mexico,Hungary,1,1,Friendly,Puebla,Mexico,False,2,0,Draw
8431,9305,10014,1977,France,Germany,1,0,Friendly,Paris,France,False,1,1,France
8432,9306,10015,1977,Colombia,Paraguay,0,1,FIFA World Cup qualification,Bogotá,Colombia,False,1,-1,Paraguay
8433,9307,10016,1977,Argentina,Hungary,5,1,Friendly,Buenos Aires,Argentina,False,6,4,Argentina
8434,9308,10017,1977,Bolivia,Uruguay,1,0,FIFA World Cup qualification,La Paz,Bolivia,False,1,1,Bolivia
8435,9310,10019,1977,Congo,Ivory Coast,1,3,FIFA World Cup qualification,Brazzaville,Congo,False,4,-2,Ivory Coast
8436,9311,10020,1977,Ecuador,Chile,0,1,FIFA World Cup qualification,Guayaquil,Ecuador,False,1,-1,Chile
8437,9312,10021,1977,Egypt,Kenya,1,0,FIFA World Cup qualification,Cairo,Egypt,False,1,1,Egypt
8438,9313,10022,1977,Guinea,Togo,2,1,FIFA World Cup qualification,Conakry,Guinea,False,3,1,Guinea
8439,9315,10024,1977,Singapore,Thailand,2,0,FIFA World Cup qualification,Kallang,Singapore,False,2,2,Singapore
8440,9316,10025,1977,Zambia,Uganda,4,2,FIFA World Cup qualification,Ndola,Zambia,False,6,2,Zambia
8441,9317,10026,1977,Algeria,Tunisia,1,1,FIFA World Cup qualification,Algiers,Algeria,False,2,0,Draw
8442,9318,10027,1977,Hong Kong,Indonesia,4,1,FIFA World Cup qualification,Kallang,Singapore,True,5,3,Hong Kong
8443,9319,10028,1977,Malaysia,Thailand,6,4,FIFA World Cup qualification,Kallang,Singapore,True,10,2,Malaysia
8444,9320,10029,1977,Singapore,Hong Kong,2,2,FIFA World Cup qualification,Kallang,Singapore,False,4,0,Draw
8445,9321,10030,1977,Indonesia,Malaysia,0,0,FIFA World Cup qualification,Kallang,Singapore,True,0,0,Draw
8446,9322,10031,1977,New Zealand,New Caledonia,3,0,Friendly,Auckland,New Zealand,False,3,3,New Zealand
8447,9323,10032,1977,Senegal,Guinea,1,0,Friendly,Dakar,Senegal,False,1,1,Senegal
8448,9324,10033,1977,Thailand,Hong Kong,1,2,FIFA World Cup qualification,Kallang,Singapore,True,3,-1,Hong Kong
8449,9325,10034,1977,Tunisia,Malta,0,1,Friendly,Tunis,Tunisia,False,1,-1,Malta
8450,9326,10035,1977,Chile,Peru,1,1,FIFA World Cup qualification,Santiago,Chile,False,2,0,Draw
8451,9327,10036,1977,Israel,Japan,2,0,FIFA World Cup qualification,Ramat-Gan,Israel,False,2,2,Israel
8452,9328,10037,1977,Paraguay,Colombia,1,1,FIFA World Cup qualification,Asunción,Paraguay,False,2,0,Draw
8453,9329,10038,1977,Singapore,Malaysia,1,0,FIFA World Cup qualification,Kallang,Singapore,False,1,1,Singapore
8454,9330,10039,1977,Venezuela,Bolivia,1,3,FIFA World Cup qualification,Caracas,Venezuela,False,4,-2,Bolivia
8455,9331,10040,1977,Guadeloupe,Martinique,1,3,Friendly,Capesterre-Belle-Eau,Guadeloupe,False,4,-2,Martinique
8456,9332,10041,1977,Thailand,Indonesia,3,2,FIFA World Cup qualification,Kallang,Singapore,True,5,1,Thailand
8457,9333,10042,1977,Malaysia,Hong Kong,1,1,FIFA World Cup qualification,Kallang,Singapore,True,2,0,Draw
8458,9334,10043,1977,New Zealand,New Caledonia,4,0,Friendly,Auckland,New Zealand,False,4,4,New Zealand
8459,9335,10044,1977,Qatar,Tunisia,1,0,Friendly,Doha,Qatar,False,1,1,Qatar
8460,9336,10045,1977,Austria,Greece,2,0,Friendly,Vienna,Austria,False,2,2,Austria
8461,9337,10046,1977,Brazil,Colombia,6,0,FIFA World Cup qualification,Rio de Janeiro,Brazil,False,6,6,Brazil
8462,9338,10047,1977,Singapore,Indonesia,0,4,FIFA World Cup qualification,Kallang,Singapore,False,4,-4,Indonesia
8463,9339,10048,1977,Israel,Japan,2,0,FIFA World Cup qualification,Ramat-Gan,Israel,False,2,2,Israel
8464,9340,10049,1977,Bahrain,Kuwait,0,2,FIFA World Cup qualification,Doha,Qatar,True,2,-2,Kuwait
8465,9341,10050,1977,Peru,Ecuador,4,0,FIFA World Cup qualification,Lima,Peru,False,4,4,Peru
8466,9342,10051,1977,Singapore,Hong Kong,0,1,FIFA World Cup qualification,Kallang,Singapore,False,1,-1,Hong Kong
8467,9344,10053,1977,Bolivia,Venezuela,2,0,FIFA World Cup qualification,La Paz,Bolivia,False,2,2,Bolivia
8468,9345,10054,1977,Paraguay,Brazil,0,1,FIFA World Cup qualification,Asunción,Paraguay,False,1,-1,Brazil
8469,9346,10055,1977,Qatar,Bahrain,2,0,FIFA World Cup qualification,Doha,Qatar,False,2,2,Qatar
8470,9347,10056,1977,Iran,Hungary,0,2,Friendly,Teheran,Iran,False,2,-2,Hungary
8471,9348,10057,1977,Qatar,Kuwait,0,2,FIFA World Cup qualification,Doha,Qatar,False,2,-2,Kuwait
8472,9349,10058,1977,Bahrain,Kuwait,1,2,FIFA World Cup qualification,Doha,Qatar,True,3,-1,Kuwait
8473,9350,10059,1977,Uruguay,Venezuela,2,0,FIFA World Cup qualification,Montevideo,Uruguay,False,2,2,Uruguay
8474,9351,10060,1977,Fiji,Australia,1,0,Friendly,Suva,Fiji,False,1,1,Fiji
8475,9352,10061,1977,Qatar,Bahrain,0,3,FIFA World Cup qualification,Doha,Qatar,False,3,-3,Bahrain
8476,9353,10062,1977,Brazil,Paraguay,1,1,FIFA World Cup qualification,Rio de Janeiro,Brazil,False,2,0,Draw
8477,9354,10063,1977,Burkina Faso,Ivory Coast,0,1,African Cup of Nations qualification,Ouagadougou,Upper Volta,False,1,-1,Ivory Coast
8478,9355,10064,1977,Chile,Ecuador,3,0,FIFA World Cup qualification,Santiago,Chile,False,3,3,Chile
8479,9357,10067,1977,Tunisia,Russia,0,3,Friendly,Tunis,Tunisia,False,3,-3,Russia
8480,9358,10068,1977,Qatar,Kuwait,1,4,FIFA World Cup qualification,Doha,Qatar,False,5,-3,Kuwait
8481,9359,10069,1977,Argentina,Iran,1,1,Friendly,Madrid,Spain,True,2,0,Draw
8482,9360,10071,1977,Romania,Turkey,4,0,Balkan Cup,Bucharest,Romania,False,4,4,Romania
8483,9361,10072,1977,Syria,Morocco,0,2,Friendly,Damascus,Syria,False,2,-2,Morocco
8484,9362,10074,1977,Belgium,Netherlands,0,2,FIFA World Cup qualification,Antwerp,Belgium,False,2,-2,Netherlands
8485,9364,10076,1977,Peru,Chile,2,0,FIFA World Cup qualification,Lima,Peru,False,2,2,Peru
8486,9365,10077,1977,Zambia,Malawi,8,1,Friendly,Lusaka,Zambia,False,9,7,Zambia
8487,9366,10078,1977,Australia,New Zealand,3,1,FIFA World Cup qualification,Sydney,Australia,False,4,2,Australia
8488,9367,10079,1977,Ivory Coast,Burkina Faso,4,1,African Cup of Nations qualification,Abidjan,Ivory Coast,False,5,3,Ivory Coast
8489,9368,10080,1977,Spain,Hungary,1,1,Friendly,Alicante,Spain,False,2,0,Draw
8490,9369,10081,1977,Uruguay,Bolivia,2,2,FIFA World Cup qualification,Montevideo,Uruguay,False,4,0,Draw
8491,9370,10082,1977,England,Luxembourg,5,0,FIFA World Cup qualification,London,England,False,5,5,England
8492,9371,10083,1977,Republic of Ireland,France,1,0,FIFA World Cup qualification,Dublin,Republic of Ireland,False,1,1,Republic of Ireland
8493,9372,10084,1977,New Zealand,Australia,1,1,FIFA World Cup qualification,Auckland,New Zealand,False,2,0,Draw
8494,9373,10085,1977,Portugal,Switzerland,1,0,Friendly,Funchal,Portugal,False,1,1,Portugal
8495,9376,10089,1977,Morocco,Gabon,5,1,Friendly,Rabat,Morocco,False,6,4,Morocco
8496,9377,10090,1977,Turkey,Finland,1,2,Friendly,Ankara,Turkey,False,3,-1,Finland
8497,9378,10091,1977,Guinea-Bissau,Mali,1,3,Friendly,Bissau,Guinea-Bissau,False,4,-2,Mali
8498,9379,10092,1977,South Africa,Zimbabwe,7,0,Friendly,Johannesburg,South Africa,False,7,7,South Africa
8499,9380,10093,1977,Bulgaria,Denmark,3,1,Friendly,Sofia,Bulgaria,False,4,2,Bulgaria
8500,9381,10094,1977,Hungary,Poland,2,1,Friendly,Budapest,Hungary,False,3,1,Hungary
8501,9382,10095,1977,Martinique,Guadeloupe,1,0,Friendly,Fort-de-France,Martinique,False,1,1,Martinique
8502,9383,10096,1977,Romania,Spain,1,0,FIFA World Cup qualification,Bucharest,Romania,False,1,1,Romania
8503,9384,10097,1977,Austria,Turkey,1,0,FIFA World Cup qualification,Vienna,Austria,False,1,1,Austria
8504,9386,10099,1977,Iran,Saudi Arabia,2,0,FIFA World Cup qualification,Shiraz,Iran,False,2,2,Iran
8505,9387,10100,1977,Switzerland,France,0,4,Friendly,Geneva,Switzerland,False,4,-4,France
8506,9388,10101,1977,Republic of Ireland,Poland,0,0,Friendly,Dublin,Republic of Ireland,False,0,0,Draw
8507,9389,10102,1977,Russia,Greece,2,0,FIFA World Cup qualification,Moscow,Soviet Union,True,2,2,Russia
8508,9390,10103,1977,Germany,Northern Ireland,5,0,Friendly,Cologne,Germany,False,5,5,Germany
8509,9392,10105,1977,Scotland,Sweden,3,1,Friendly,Glasgow,Scotland,False,4,2,Scotland
8510,9393,10106,1977,Austria,Malta,9,0,FIFA World Cup qualification,Salzburg,Austria,False,9,9,Austria
8511,9394,10107,1977,Hungary,Russia,2,1,FIFA World Cup qualification,Budapest,Hungary,False,3,1,Hungary
8512,9395,10109,1977,Algeria,Senegal,2,0,Friendly,Algiers,Algeria,False,2,2,Algeria
8513,9396,10110,1977,Denmark,Poland,1,2,FIFA World Cup qualification,Copenhagen,Denmark,False,3,-1,Poland
8514,9397,10111,1977,Hong Kong,Macau,2,0,Friendly,So Kon Po,Hong Kong,False,2,2,Hong Kong
8515,9398,10113,1977,Greece,Russia,1,0,FIFA World Cup qualification,Salonica,Greece,False,1,1,Greece
8516,9399,10114,1977,Cyprus,Poland,1,3,FIFA World Cup qualification,Limassol,Cyprus,False,4,-2,Poland
8517,9400,10115,1977,Mexico,Peru,1,1,Friendly,Mexico City,Mexico,False,2,0,Draw
8518,9401,10116,1977,Russia,Hungary,2,0,FIFA World Cup qualification,Tbilisi,Soviet Union,True,2,2,Russia
8519,9402,10117,1977,Mexico,Peru,2,1,Friendly,Monterrey,Mexico,False,3,1,Mexico
8520,9404,10119,1977,Haiti,Peru,1,2,Friendly,Port-au-Prince,Haiti,False,3,-1,Peru
8521,9405,10120,1977,Luxembourg,Finland,0,1,FIFA World Cup qualification,Luxembourg,Luxembourg,False,1,-1,Finland
8522,9406,10121,1977,Sweden,Norway,1,0,Nordic Championship,Gothenburg,Sweden,False,1,1,Sweden
8523,9407,10122,1977,Hungary,Greece,3,0,FIFA World Cup qualification,Budapest,Hungary,False,3,3,Hungary
8524,9408,10123,1977,Northern Ireland,England,1,2,British Championship,Belfast,Northern Ireland,False,3,-1,England
8525,9409,10124,1977,Senegal,Morocco,3,2,Friendly,Dakar,Senegal,False,5,1,Senegal
8526,9410,10125,1977,Wales,Scotland,0,0,British Championship,Wrexham,Wales,False,0,0,Draw
8527,9411,10126,1977,Argentina,Poland,3,1,Friendly,Buenos Aires,Argentina,False,4,2,Argentina
8528,9412,10127,1977,Haiti,Peru,2,2,Friendly,Port-au-Prince,Haiti,False,4,0,Draw
8529,9413,10128,1977,Togo,Ghana,0,2,Friendly,Lomé,Togo,False,2,-2,Ghana
8530,9414,10129,1977,Mozambique,Cuba,0,2,Friendly,Maputo,Mozambique,False,2,-2,Cuba
8531,9415,10130,1977,England,Wales,0,1,British Championship,London,England,False,1,-1,Wales
8532,9416,10131,1977,Bulgaria,Republic of Ireland,2,1,FIFA World Cup qualification,Sofia,Bulgaria,False,3,1,Bulgaria
8533,9417,10133,1977,Norway,Denmark,0,2,Friendly,Oslo,Norway,False,2,-2,Denmark
8534,9418,10134,1977,Scotland,Northern Ireland,3,0,British Championship,Glasgow,Scotland,False,3,3,Scotland
8535,9419,10135,1977,Libya,Cuba,1,0,Friendly,Tripoli,Libya,False,1,1,Libya
8536,9420,10136,1977,Northern Ireland,Wales,1,1,British Championship,Belfast,Northern Ireland,False,2,0,Draw
8537,9421,10137,1977,England,Scotland,1,2,British Championship,London,England,False,3,-1,Scotland
8538,9422,10138,1977,Argentina,Germany,1,3,Friendly,Buenos Aires,Argentina,False,4,-2,Germany
8539,9423,10139,1977,Guinea,Tunisia,1,0,FIFA World Cup qualification,Conakry,Guinea,False,1,1,Guinea
8540,9424,10140,1977,Mauritania,Senegal,1,2,Friendly,Nouakchott,Mauritania,False,3,-1,Senegal
8541,9425,10141,1977,Honduras,Panama,1,0,Friendly,Tegucigalpa,Honduras,False,1,1,Honduras
8542,9426,10142,1977,Brazil,England,0,0,Friendly,Rio de Janeiro,Brazil,False,0,0,Draw
8543,9427,10143,1977,Finland,Italy,0,3,FIFA World Cup qualification,Helsinki,Finland,False,3,-3,Italy
8544,9428,10144,1977,Sweden,Switzerland,2,1,FIFA World Cup qualification,Solna,Sweden,False,3,1,Sweden
8545,9429,10145,1977,Uruguay,Germany,0,2,Friendly,Montevideo,Uruguay,False,2,-2,Germany
8546,9430,10146,1977,Ethiopia,Cuba,0,0,Friendly,Addis Abeba,Ethiopia,False,0,0,Draw
8547,9431,10147,1977,Peru,Poland,1,3,Friendly,Lima,Peru,False,4,-2,Poland
8548,9432,10148,1977,Iceland,Northern Ireland,1,0,FIFA World Cup qualification,Reykjavík,Iceland,False,1,1,Iceland
8549,9433,10149,1977,Argentina,England,1,1,Friendly,Buenos Aires,Argentina,False,2,0,Draw
8550,9434,10150,1977,Bolivia,Poland,1,2,Friendly,La Paz,Bolivia,False,3,-1,Poland
8551,9435,10151,1977,Brazil,Germany,1,1,Friendly,Rio de Janeiro,Brazil,False,2,0,Draw
8552,9436,10152,1977,Ghana,Togo,2,0,Friendly,Accra,Ghana,False,2,2,Ghana
8553,9437,10153,1977,Zambia,Cuba,2,0,Friendly,Lusaka,Zambia,False,2,2,Zambia
8554,9438,10154,1977,Mexico,Germany,2,2,Friendly,Mexico City,Mexico,False,4,0,Draw
8555,9439,10155,1977,Chile,Scotland,2,4,Friendly,Santiago,Chile,False,6,-2,Scotland
8556,9440,10156,1977,Denmark,Sweden,2,1,Nordic Championship,Copenhagen,Denmark,False,3,1,Denmark
8557,9441,10158,1977,Uruguay,England,0,0,Friendly,Montevideo,Uruguay,False,0,0,Draw
8558,9442,10159,1977,Zambia,Cuba,0,1,Friendly,Kitwe,Zambia,False,1,-1,Cuba
8559,9443,10160,1977,Argentina,Scotland,1,1,Friendly,Buenos Aires,Argentina,False,2,0,Draw
8560,9444,10161,1977,Brazil,Poland,3,1,Friendly,São Paulo,Brazil,False,4,2,Brazil
8561,9445,10162,1977,Hong Kong,Iran,0,2,FIFA World Cup qualification,So Kon Po,Hong Kong,False,2,-2,Iran
8562,9446,10163,1977,Mali,Ivory Coast,1,0,African Cup of Nations qualification,Bamako,Mali,False,1,1,Mali
8563,9447,10164,1977,Tunisia,Guinea,3,1,FIFA World Cup qualification,Tunis,Tunisia,False,4,2,Tunisia
8564,9448,10165,1977,Finland,Denmark,1,2,Nordic Championship,Helsinki,Finland,False,3,-1,Denmark
8565,9449,10166,1977,Brazil,Scotland,2,0,Friendly,Rio de Janeiro,Brazil,False,2,2,Brazil
8566,9450,10167,1977,Argentina,France,0,0,Friendly,Buenos Aires,Argentina,False,0,0,Draw
8567,9453,10170,1977,Brazil,France,2,2,Friendly,Rio de Janeiro,Brazil,False,4,0,Draw
8568,9454,10171,1977,Iceland,Norway,2,1,Friendly,Reykjavík,Iceland,False,3,1,Iceland
8569,9456,10174,1977,Zimbabwe,South Africa,1,1,Friendly,Salisbury,Rhodesia,False,2,0,Draw
8570,9457,10175,1977,Malawi,Tanzania,0,0,Friendly,Zomba,Malawi,False,0,0,Draw
8571,9458,10176,1977,Malawi,Tanzania,1,0,Friendly,Zomba,Malawi,False,1,1,Malawi
8572,9459,10177,1977,Australia,Hong Kong,3,0,FIFA World Cup qualification,Adelaide,Australia,False,3,3,Australia
8573,9460,10178,1977,Nigeria,Ivory Coast,4,0,FIFA World Cup qualification,Lagos,Nigeria,False,4,4,Nigeria
8574,9461,10179,1977,Peru,Brazil,0,1,FIFA World Cup qualification,Cali,Colombia,True,1,-1,Brazil
8575,9463,10181,1977,Brazil,Bolivia,8,0,FIFA World Cup qualification,Cali,Colombia,True,8,8,Brazil
8576,9464,10182,1977,Egypt,Zambia,2,0,FIFA World Cup qualification,Cairo,Egypt,False,2,2,Egypt
8577,9465,10183,1977,Malaysia,Burma,1,0,Merdeka Tournament,Kuala Lumpur,Malaysia,False,1,1,Malaysia
8578,9466,10185,1977,Ivory Coast,Mali,2,0,African Cup of Nations qualification,Bouaké,Ivory Coast,False,2,2,Ivory Coast
8579,9467,10187,1977,Peru,Bolivia,5,0,FIFA World Cup qualification,Cali,Colombia,True,5,5,Peru
8580,9468,10189,1977,Iraq,Libya,0,0,Merdeka Tournament,Kuala Lumpur,Malaysia,True,0,0,Draw
8581,9469,10190,1977,Iceland,Sweden,0,1,Friendly,Reykjavík,Iceland,False,1,-1,Sweden
8582,9470,10192,1977,Burma,Iraq,0,3,Merdeka Tournament,Kuala Lumpur,Malaysia,True,3,-3,Iraq
8583,9471,10193,1977,Libya,Thailand,2,2,Merdeka Tournament,Kuala Lumpur,Malaysia,True,4,0,Draw
8584,9472,10194,1977,Afghanistan,India,0,3,Friendly,Kabul,Afghanistan,False,3,-3,India
8585,9474,10196,1977,Hong Kong,Iran,1,0,Friendly,Beijing,China PR,True,1,1,Hong Kong
8586,9475,10197,1977,Ivory Coast,Nigeria,2,2,FIFA World Cup qualification,Bouaké,Ivory Coast,False,4,0,Draw
8587,9476,10199,1977,Iraq,Thailand,5,0,Merdeka Tournament,Kuala Lumpur,Malaysia,True,5,5,Iraq
8588,9478,10201,1977,Burma,Libya,3,1,Merdeka Tournament,Kuala Lumpur,Malaysia,True,4,2,Burma
8589,9479,10203,1977,Iran,Morocco,1,1,Friendly,Beijing,China PR,True,2,0,Draw
8590,9481,10206,1977,Burma,Thailand,1,1,Merdeka Tournament,Kuala Lumpur,Malaysia,True,2,0,Draw
8591,9482,10207,1977,Iran,DR Congo,1,3,Friendly,Beijing,China PR,True,4,-2,DR Congo
8592,9484,10209,1977,Zambia,Egypt,0,0,FIFA World Cup qualification,Lusaka,Zambia,False,0,0,Draw
8593,9485,10210,1977,Iran,Romania,0,0,Friendly,Teheran,Iran,False,0,0,Draw
8594,9486,10211,1977,Australia,Iran,0,1,FIFA World Cup qualification,Melbourne,Australia,False,1,-1,Iran
8595,9488,10214,1977,Norway,Finland,1,1,Nordic Championship,Oslo,Norway,False,2,0,Draw
8596,9489,10215,1977,Argentina,Paraguay,2,1,Copa Félix Bogado,Buenos Aires,Argentina,False,3,1,Argentina
8597,9490,10216,1977,Austria,Poland,2,1,Friendly,Vienna,Austria,False,3,1,Austria
8598,9492,10218,1977,Netherlands,Iceland,4,1,FIFA World Cup qualification,Nijmegen,Netherlands,False,5,3,Netherlands
8599,9493,10219,1977,Paraguay,Argentina,2,0,Copa Félix Bogado,Asunción,Paraguay,False,2,2,Paraguay
8600,9494,10220,1977,India,Thailand,0,4,Korea Cup,Seoul,South Korea,True,4,-4,Thailand
8601,9495,10221,1977,Belgium,Iceland,4,0,FIFA World Cup qualification,Brussels,Belgium,False,4,4,Belgium
8602,9496,10223,1977,Nigeria,Ghana,2,1,Friendly,Lagos,Nigeria,False,3,1,Nigeria
8603,9497,10225,1977,Tunisia,Malta,2,1,Friendly,Tunis,Tunisia,False,3,1,Tunisia
8604,9498,10226,1977,Wales,Kuwait,0,0,Friendly,Wrexham,Wales,False,0,0,Draw
8605,9499,10228,1977,England,Switzerland,0,0,Friendly,London,England,False,0,0,Draw
8606,9500,10229,1977,Finland,Germany,0,1,Friendly,Helsinki,Finland,False,1,-1,Germany
8607,9501,10231,1977,Norway,Sweden,2,1,FIFA World Cup qualification,Oslo,Norway,False,3,1,Norway
8608,9502,10232,1977,Russia,Poland,4,1,Friendly,Volgograd,Soviet Union,False,5,3,Russia
8609,9503,10233,1977,Bahrain,Malaysia,1,3,Korea Cup,Daegu,South Korea,True,4,-2,Malaysia
8610,9504,10234,1977,Trinidad and Tobago,Canada,1,1,Friendly,Pointe-à-Pierre,Trinidad and Tobago,False,2,0,Draw
8611,9505,10237,1977,El Salvador,United States,1,2,Friendly,San Salvador,El Salvador,False,3,-1,United States
8612,9506,10238,1977,Malaysia,Thailand,1,1,Korea Cup,Seoul,South Korea,True,2,0,Draw
8613,9507,10239,1977,Guatemala,United States,3,1,Friendly,Guatemala,Guatemala,False,4,2,Guatemala
8614,9508,10240,1977,Réunion,Mauritius,0,2,Friendly,Saint-Pierre,Réunion,False,2,-2,Mauritius
8615,9509,10241,1977,Suriname,Trinidad and Tobago,2,1,Friendly,Paramaribo,Suriname,False,3,1,Suriname
8616,9510,10242,1977,Kuwait,Wales,0,0,Friendly,Kuwait City,Kuwait,False,0,0,Draw
8617,9511,10243,1977,Bulgaria,Turkey,3,1,Balkan Cup,Sofia,Bulgaria,False,4,2,Bulgaria
8618,9512,10244,1977,Mauritius,Seychelles,2,1,Friendly,Saint-Pierre,Réunion,True,3,1,Mauritius
8619,9513,10245,1977,Northern Ireland,Iceland,2,0,FIFA World Cup qualification,Belfast,Northern Ireland,False,2,2,Northern Ireland
8620,9514,10246,1977,Poland,Denmark,4,1,FIFA World Cup qualification,Chorzów,Poland,False,5,3,Poland
8621,9515,10247,1977,Romania,Greece,6,1,Friendly,Bucharest,Romania,False,7,5,Romania
8622,9517,10249,1977,Switzerland,Spain,1,2,Friendly,Berne,Switzerland,False,3,-1,Spain
8623,9518,10250,1977,Guyana,Trinidad and Tobago,2,1,Friendly,Linden,Guyana,False,3,1,Guyana
8624,9520,10252,1977,Guyana,Trinidad and Tobago,2,2,Friendly,Georgetown,Guyana,False,4,0,Draw
8625,9521,10253,1977,Libya,Malta,1,0,Friendly,Tripoli,Libya,False,1,1,Libya
8626,9522,10254,1977,Guatemala,United States,2,0,Friendly,Guatemala,Guatemala,False,2,2,Guatemala
8627,9523,10255,1977,Réunion,Seychelles,1,0,Friendly,Saint-Pierre,Réunion,False,1,1,Réunion
8628,9524,10256,1977,Tunisia,Nigeria,0,0,FIFA World Cup qualification,Tunis,Tunisia,False,0,0,Draw
8629,9525,10257,1977,Guyana,Trinidad and Tobago,0,2,Friendly,Georgetown,Guyana,False,2,-2,Trinidad and Tobago
8630,9526,10258,1977,Mexico,United States,3,0,Friendly,Monterrey,Mexico,False,3,3,Mexico
8631,9527,10259,1977,Libya,Cyprus,1,0,Friendly,Benghazi,Libya,False,1,1,Libya
8632,9528,10260,1977,Botswana,Malawi,0,2,Friendly,Gaborone,Botswana,False,2,-2,Malawi
8633,9529,10261,1977,United States,El Salvador,0,0,Friendly,Monterey Park,United States,False,0,0,Draw
8634,9530,10262,1977,Botswana,Malawi,1,5,Friendly,Gaborone,Botswana,False,6,-4,Malawi
8635,9531,10263,1977,Hong Kong,Kuwait,1,3,FIFA World Cup qualification,So Kon Po,Hong Kong,False,4,-2,Kuwait
8636,9532,10264,1977,Zambia,India,3,1,Friendly,Lusaka,Zambia,False,4,2,Zambia
8637,9534,10266,1977,Netherlands,Russia,0,0,Friendly,Rotterdam,Netherlands,False,0,0,Draw
8638,9535,10267,1977,Sweden,Denmark,1,0,Friendly,Malmö,Sweden,False,1,1,Sweden
8639,9536,10268,1977,Switzerland,Finland,2,0,Friendly,Zürich,Switzerland,False,2,2,Switzerland
8640,9538,10270,1977,Canada,El Salvador,1,2,FIFA World Cup qualification,Monterrey,Mexico,True,3,-1,El Salvador
8641,9539,10271,1977,France,Russia,0,0,Friendly,Paris,France,False,0,0,Draw
8642,9540,10272,1977,Germany,Italy,2,1,Friendly,Berlin,Germany,False,3,1,Germany
8643,9541,10273,1977,Guatemala,Suriname,3,2,FIFA World Cup qualification,Monterrey,Mexico,True,5,1,Guatemala
8644,9542,10274,1977,Nigeria,Egypt,4,0,FIFA World Cup qualification,Lagos,Nigeria,False,4,4,Nigeria
8645,9543,10275,1977,Denmark,Portugal,2,4,FIFA World Cup qualification,Copenhagen,Denmark,False,6,-2,Portugal
8646,9544,10277,1977,Mexico,Haiti,4,1,FIFA World Cup qualification,Mexico City,Mexico,False,5,3,Mexico
8647,9545,10278,1977,Zambia,India,3,1,Friendly,Ndola,Zambia,False,4,2,Zambia
8648,9547,10280,1977,Canada,Suriname,2,1,FIFA World Cup qualification,Mexico City,Mexico,True,3,1,Canada
8649,9548,10282,1977,Guatemala,Haiti,1,2,FIFA World Cup qualification,Monterrey,Mexico,True,3,-1,Haiti
8650,9549,10283,1977,Hungary,Sweden,3,0,Friendly,Budapest,Hungary,False,3,3,Hungary
8651,9550,10284,1977,Republic of Ireland,Bulgaria,0,0,FIFA World Cup qualification,Dublin,Republic of Ireland,False,0,0,Draw
8652,9551,10285,1977,Luxembourg,England,0,2,FIFA World Cup qualification,Luxembourg,Luxembourg,False,2,-2,England
8653,9552,10286,1977,Mexico,El Salvador,3,1,FIFA World Cup qualification,Mexico City,Mexico,False,4,2,Mexico
8654,9553,10287,1977,Northern Ireland,Netherlands,0,1,FIFA World Cup qualification,Belfast,Northern Ireland,False,1,-1,Netherlands
8655,9554,10288,1977,Wales,Scotland,0,2,FIFA World Cup qualification,Liverpool,England,True,2,-2,Scotland
8656,9555,10289,1977,Italy,Finland,6,1,FIFA World Cup qualification,Turin,Italy,False,7,5,Italy
8657,9556,10290,1977,Mexico,Suriname,8,1,FIFA World Cup qualification,Monterrey,Mexico,False,9,7,Mexico
8658,9557,10291,1977,Australia,Kuwait,1,2,FIFA World Cup qualification,Sydney,Australia,False,3,-1,Kuwait
8659,9558,10292,1977,Canada,Guatemala,2,1,FIFA World Cup qualification,Mexico City,Mexico,True,3,1,Canada
8660,9559,10293,1977,El Salvador,Haiti,0,1,FIFA World Cup qualification,Mexico City,Mexico,True,1,-1,Haiti
8661,9561,10295,1977,Mexico,Guatemala,2,1,FIFA World Cup qualification,Mexico City,Mexico,False,3,1,Mexico
8662,9562,10296,1977,Canada,Haiti,1,1,FIFA World Cup qualification,Monterrey,Mexico,True,2,0,Draw
8663,9563,10297,1977,El Salvador,Suriname,3,2,FIFA World Cup qualification,Monterrey,Mexico,True,5,1,El Salvador
8664,9564,10298,1977,Egypt,Nigeria,3,1,FIFA World Cup qualification,Cairo,Egypt,False,4,2,Egypt
8665,9565,10299,1977,Guyana,Barbados,2,0,Friendly,Linden,Guyana,False,2,2,Guyana
8666,9566,10300,1977,Guyana,Barbados,0,0,Friendly,Georgetown,Guyana,False,0,0,Draw
8667,9567,10301,1977,Mexico,Canada,3,1,FIFA World Cup qualification,Monterrey,Mexico,False,4,2,Mexico
8668,9568,10302,1977,El Salvador,Guatemala,2,2,FIFA World Cup qualification,Mexico City,Mexico,True,4,0,Draw
8669,9569,10303,1977,Haiti,Suriname,1,0,FIFA World Cup qualification,Mexico City,Mexico,True,1,1,Haiti
8670,9571,10306,1977,Bulgaria,Greece,0,0,Friendly,Sofia,Bulgaria,False,0,0,Draw
8671,9572,10307,1977,Guyana,Barbados,0,0,Friendly,Georgetown,Guyana,False,0,0,Draw
8672,9573,10308,1977,Netherlands,Belgium,1,0,FIFA World Cup qualification,Amsterdam,Netherlands,False,1,1,Netherlands
8673,9574,10309,1977,Spain,Romania,2,0,FIFA World Cup qualification,Madrid,Spain,False,2,2,Spain
8674,9575,10310,1977,Iran,Kuwait,1,0,FIFA World Cup qualification,Teheran,Iran,False,1,1,Iran
8675,9576,10311,1977,Thailand,Singapore,2,0,King's Cup,Bangkok,Thailand,False,2,2,Thailand
8676,9577,10313,1977,Hungary,Bolivia,6,0,FIFA World Cup qualification,Budapest,Hungary,False,6,6,Hungary
8677,9578,10314,1977,Poland,Portugal,1,1,FIFA World Cup qualification,Chorzów,Poland,False,2,0,Draw
8678,9579,10315,1977,Hong Kong,Australia,2,5,FIFA World Cup qualification,So Kon Po,Hong Kong,False,7,-3,Australia
8679,9580,10316,1977,Switzerland,Norway,1,0,FIFA World Cup qualification,Berne,Switzerland,False,1,1,Switzerland
8680,9581,10317,1977,Turkey,Austria,0,1,FIFA World Cup qualification,Izmir,Turkey,False,1,-1,Austria
8681,9583,10319,1977,Thailand,India,1,1,King's Cup,Bangkok,Thailand,False,2,0,Draw
8682,9584,10320,1977,Malaysia,Singapore,4,3,King's Cup,Bangkok,Thailand,True,7,1,Malaysia
8683,9585,10321,1977,India,Singapore,2,1,King's Cup,Bangkok,Thailand,True,3,1,India
8684,9587,10323,1977,Thailand,Malaysia,1,2,King's Cup,Bangkok,Thailand,False,3,-1,Malaysia
8685,9588,10325,1977,India,Malaysia,0,3,King's Cup,Bangkok,Thailand,True,3,-3,Malaysia
8686,9590,10327,1977,Malawi,Lesotho,3,0,Friendly,Zomba,Malawi,False,3,3,Malawi
8687,9591,10328,1977,Kuwait,Hong Kong,4,0,FIFA World Cup qualification,Kuwait City,Kuwait,False,4,4,Kuwait
8688,9592,10329,1977,Nigeria,Tunisia,0,1,FIFA World Cup qualification,Lagos,Nigeria,False,1,-1,Tunisia
8689,9593,10330,1977,Poland,Sweden,2,1,Friendly,Wrocław,Poland,False,3,1,Poland
8690,9594,10331,1977,Malawi,Lesotho,6,1,Friendly,Zomba,Malawi,False,7,5,Malawi
8691,9596,10333,1977,Singapore,Australia,0,2,Friendly,Kallang,Singapore,False,2,-2,Australia
8692,9597,10335,1977,England,Italy,2,0,FIFA World Cup qualification,London,England,False,2,2,England
8693,9598,10336,1977,France,Bulgaria,3,1,FIFA World Cup qualification,Paris,France,False,4,2,France
8694,9599,10337,1977,Germany,Switzerland,4,1,Friendly,Stuttgart,Germany,False,5,3,Germany
8695,9601,10339,1977,Northern Ireland,Belgium,3,0,FIFA World Cup qualification,Belfast,Northern Ireland,False,3,3,Northern Ireland
8696,9602,10340,1977,Portugal,Cyprus,4,0,FIFA World Cup qualification,Faro,Portugal,False,4,4,Portugal
8697,9604,10342,1977,Iran,Hong Kong,3,0,FIFA World Cup qualification,Teheran,Iran,False,3,3,Iran
8698,9605,10343,1977,Kuwait,Australia,1,0,FIFA World Cup qualification,Kuwait City,Kuwait,False,1,1,Kuwait
8699,9606,10344,1977,Egypt,Tunisia,3,2,FIFA World Cup qualification,Cairo,Egypt,False,5,1,Egypt
8700,9607,10345,1977,Iran,Australia,1,0,FIFA World Cup qualification,Teheran,Iran,False,1,1,Iran
8701,9609,10347,1977,Iraq,Morocco,3,0,Friendly,Baghdad,Iraq,False,3,3,Iraq
8702,9610,10348,1977,Malta,Turkey,0,3,FIFA World Cup qualification,Gżira,Malta,False,3,-3,Turkey
8703,9611,10349,1977,Tanzania,Zambia,2,4,CECAFA Cup,Mogadishu,Somalia,True,6,-2,Zambia
8704,9612,10350,1977,Kenya,Uganda,1,3,CECAFA Cup,Mogadishu,Somalia,True,4,-2,Uganda
8705,9613,10351,1977,Malawi,Zambia,1,0,CECAFA Cup,Mogadishu,Somalia,True,1,1,Malawi
8706,9614,10352,1977,Bolivia,Hungary,2,3,FIFA World Cup qualification,La Paz,Bolivia,False,5,-1,Hungary
8707,9616,10355,1977,Malawi,Tanzania,0,0,CECAFA Cup,Mogadishu,Somalia,True,0,0,Draw
8708,9618,10357,1977,Italy,Luxembourg,3,0,FIFA World Cup qualification,Rome,Italy,False,3,3,Italy
8709,9619,10358,1977,Kuwait,Iran,1,2,FIFA World Cup qualification,Kuwait City,Kuwait,False,3,-1,Iran
8710,9620,10359,1977,Morocco,Iraq,0,0,Friendly,Casablanca,Morocco,False,0,0,Draw
8711,9621,10361,1977,Kenya,Zambia,2,4,CECAFA Cup,Mogadishu,Somalia,True,6,-2,Zambia
8712,9622,10362,1977,Malawi,Uganda,0,1,CECAFA Cup,Mogadishu,Somalia,True,1,-1,Uganda
8713,9623,10363,1977,Kenya,Malawi,1,2,CECAFA Cup,Mogadishu,Somalia,True,3,-1,Malawi
8714,9624,10364,1977,Uganda,Zambia,0,0,CECAFA Cup,Mogadishu,Somalia,True,0,0,Draw
8715,9625,10365,1977,Tunisia,Egypt,4,1,FIFA World Cup qualification,Tunis,Tunisia,False,5,3,Tunisia
8716,9626,10366,1977,Kenya,Malawi,1,1,Friendly,Nairobi,Kenya,False,2,0,Draw
8717,9627,10367,1977,Germany,Wales,1,1,Friendly,Dortmund,Germany,False,2,0,Draw
8718,9628,10368,1977,Puerto Rico,Martinique,0,2,Friendly,San Juan,Puerto Rico,False,2,-2,Martinique
8719,9629,10369,1977,Belgium,Italy,0,1,Friendly,Liège,Belgium,False,1,-1,Italy
8720,9630,10370,1977,Ghana,Sierra Leone,4,0,Friendly,Accra,Ghana,False,4,4,Ghana
8721,9631,10371,1978,Cyprus,Greece,0,2,Friendly,Nicosia,Cyprus,False,2,-2,Greece
8722,9632,10372,1978,Ghana,Gambia,7,1,Friendly,Accra,Ghana,False,8,6,Ghana
8723,9633,10373,1978,Libya,Morocco,0,1,Friendly,Tripoli,Libya,False,1,-1,Morocco
8724,9634,10374,1978,Spain,Italy,2,1,Friendly,Madrid,Spain,False,3,1,Spain
8725,9635,10375,1978,Sudan,Kenya,3,0,Friendly,Khartoum,Sudan,False,3,3,Sudan
8726,9638,10378,1978,Sudan,Congo,2,1,Friendly,Khartoum,Sudan,False,3,1,Sudan
8727,9639,10379,1978,Gabon,Nigeria,0,1,Friendly,Libreville,Gabon,False,1,-1,Nigeria
8728,9640,10380,1978,Zambia,Eswatini,11,2,Friendly,Lusaka,Zambia,False,13,9,Zambia
8729,9641,10381,1978,Israel,Denmark,2,0,Friendly,Jaffa,Israel,False,2,2,Israel
8730,9642,10382,1978,Italy,France,2,2,Friendly,Naples,Italy,False,4,0,Draw
8731,9643,10383,1978,Benin,Burkina Faso,0,2,Friendly,Porto-Novo,Benin,False,2,-2,Burkina Faso
8732,9644,10384,1978,El Salvador,Mexico,1,5,Friendly,San Salvador,El Salvador,False,6,-4,Mexico
8733,9645,10385,1978,Greece,Austria,1,1,Friendly,Athens,Greece,False,2,0,Draw
8734,9646,10386,1978,Gabon,Burkina Faso,2,2,Friendly,Libreville,Gabon,False,4,0,Draw
8735,9647,10387,1978,Ghana,Ivory Coast,3,1,Friendly,Accra,Ghana,False,4,2,Ghana
8736,9648,10388,1978,Iraq,Algeria,3,0,Friendly,Baghdad,Iraq,False,3,3,Iraq
8737,9649,10389,1978,Germany,England,2,1,Friendly,Munich,Germany,False,3,1,Germany
8738,9650,10390,1978,Israel,Netherlands,1,2,Friendly,Ramat-Gan,Israel,False,3,-1,Netherlands
8739,9651,10391,1978,Scotland,Bulgaria,2,1,Friendly,Glasgow,Scotland,False,3,1,Scotland
8740,9652,10392,1978,Iraq,Algeria,1,0,Friendly,Baghdad,Iraq,False,1,1,Iraq
8741,9653,10393,1978,Burkina Faso,Benin,3,0,Friendly,Ouagadougou,Upper Volta,False,3,3,Burkina Faso
8742,9654,10394,1978,Morocco,Russia,2,3,Friendly,Marrakech,Morocco,False,5,-1,Russia
8743,9655,10395,1978,Syria,Algeria,0,1,Friendly,Damascus,Syria,False,1,-1,Algeria
8744,9657,10397,1978,Martinique,Antigua and Barbuda,5,0,Friendly,Saint-Pierre,Martinique,False,5,5,Martinique
8745,9658,10399,1978,Ghana,Zambia,2,1,African Cup of Nations,Accra,Ghana,False,3,1,Ghana
8746,9659,10400,1978,Nigeria,Burkina Faso,4,2,African Cup of Nations,Accra,Ghana,True,6,2,Nigeria
8747,9660,10401,1978,Congo,Uganda,1,3,African Cup of Nations,Kumasi,Ghana,True,4,-2,Uganda
8748,9661,10402,1978,Morocco,Tunisia,1,1,African Cup of Nations,Kumasi,Ghana,True,2,0,Draw
8749,9662,10403,1978,Burkina Faso,Zambia,0,2,African Cup of Nations,Accra,Ghana,True,2,-2,Zambia
8750,9663,10404,1978,France,Portugal,2,0,Friendly,Paris,France,False,2,2,France
8751,9664,10406,1978,Germany,Russia,1,0,Friendly,Frankfurt am Main,Germany,False,1,1,Germany
8752,9665,10407,1978,Ghana,Nigeria,1,1,African Cup of Nations,Accra,Ghana,False,2,0,Draw
8753,9666,10408,1978,Congo,Morocco,0,1,African Cup of Nations,Kumasi,Ghana,True,1,-1,Morocco
8754,9667,10409,1978,Tunisia,Uganda,3,1,African Cup of Nations,Kumasi,Ghana,True,4,2,Tunisia
8755,9668,10410,1978,Ghana,Burkina Faso,3,0,African Cup of Nations,Accra,Ghana,False,3,3,Ghana
8756,9669,10411,1978,Nigeria,Zambia,0,0,African Cup of Nations,Accra,Ghana,True,0,0,Draw
8757,9670,10412,1978,Congo,Tunisia,0,0,African Cup of Nations,Kumasi,Ghana,True,0,0,Draw
8758,9671,10413,1978,Morocco,Uganda,0,3,African Cup of Nations,Kumasi,Ghana,True,3,-3,Uganda
8759,9672,10414,1978,Lesotho,Kenya,0,1,Friendly,Maseru,Lesotho,False,1,-1,Kenya
8760,9673,10415,1978,Libya,Algeria,1,0,Friendly,Tripoli,Libya,False,1,1,Libya
8761,9674,10416,1978,Ghana,Tunisia,1,0,African Cup of Nations,Accra,Ghana,False,1,1,Ghana
8762,9675,10417,1978,Nigeria,Uganda,1,2,African Cup of Nations,Kumasi,Ghana,True,3,-1,Uganda
8763,9676,10418,1978,Ghana,Uganda,2,0,African Cup of Nations,Accra,Ghana,False,2,2,Ghana
8764,9677,10419,1978,Nigeria,Tunisia,2,0,African Cup of Nations,Accra,Ghana,True,2,2,Nigeria
8765,9678,10420,1978,Argentina,Peru,2,1,Copa Ramón Castilla,Buenos Aires,Argentina,False,3,1,Argentina
8766,9679,10421,1978,Belgium,Austria,1,0,Friendly,Charleroi,Belgium,False,1,1,Belgium
8767,9681,10423,1978,Luxembourg,Poland,1,3,Friendly,Luxembourg,Luxembourg,False,4,-2,Poland
8768,9682,10424,1978,Turkey,Romania,1,1,Balkan Cup,Istanbul,Turkey,False,2,0,Draw
8769,9683,10425,1978,Peru,Argentina,1,3,Copa Ramón Castilla,Lima,Peru,False,4,-2,Argentina
8770,9684,10426,1978,Martinique,Guadeloupe,1,2,Friendly,Fort-de-France,Martinique,False,3,-1,Guadeloupe
8771,9685,10427,1978,Argentina,Bulgaria,3,1,Friendly,Buenos Aires,Argentina,False,4,2,Argentina
8772,9686,10428,1978,Spain,Norway,3,0,Friendly,Gijón,Spain,False,3,3,Spain
8773,9688,10430,1978,France,Brazil,1,0,Friendly,Paris,France,False,1,1,France
8774,9689,10431,1978,Peru,Bulgaria,1,1,Friendly,Lima,Peru,False,2,0,Draw
8775,9690,10433,1978,Switzerland,Austria,0,1,Friendly,Basel,Switzerland,False,1,-1,Austria
8776,9691,10434,1978,Argentina,Romania,2,0,Friendly,Buenos Aires,Argentina,False,2,2,Argentina
8777,9692,10435,1978,Germany,Brazil,0,1,Friendly,Hamburg,Germany,False,1,-1,Brazil
8778,9694,10437,1978,Republic of Ireland,Turkey,4,2,Friendly,Dublin,Republic of Ireland,False,6,2,Republic of Ireland
8779,9695,10438,1978,Poland,Greece,5,2,Friendly,Poznań,Poland,False,7,3,Poland
8780,9696,10439,1978,Russia,Finland,10,2,Friendly,Yerevan,Soviet Union,False,12,8,Russia
8781,9697,10440,1978,Tunisia,Netherlands,0,4,Friendly,Tunis,Tunisia,False,4,-4,Netherlands
8782,9698,10441,1978,Mexico,Peru,0,1,Friendly,Los Angeles,United States,True,1,-1,Peru
8783,9699,10442,1978,Poland,Republic of Ireland,3,0,Friendly,Łódź,Poland,False,3,3,Poland
8784,9701,10444,1978,Martinique,Puerto Rico,3,1,Friendly,Fort-de-France,Martinique,False,4,2,Martinique
8785,9702,10445,1978,Iran,Wales,0,1,Friendly,Teheran,Iran,False,1,-1,Wales
8786,9703,10446,1978,England,Brazil,1,1,Friendly,London,England,False,2,0,Draw
8787,9704,10448,1978,Sweden,Germany,3,1,Friendly,Solna,Sweden,False,4,2,Sweden
8788,9705,10449,1978,Puerto Rico,Martinique,4,1,Friendly,San Juan,Puerto Rico,False,5,3,Puerto Rico
8789,9707,10452,1978,Uruguay,Argentina,2,0,Friendly,Montevideo,Uruguay,False,2,2,Uruguay
8790,9708,10453,1978,Iran,Bulgaria,1,1,Friendly,Teheran,Iran,False,2,0,Draw
8791,9709,10454,1978,Malaysia,Singapore,0,1,King's Cup,Bangkok,Thailand,True,1,-1,Singapore
8792,9710,10455,1978,Poland,Bulgaria,1,0,Friendly,Warsaw,Poland,False,1,1,Poland
8793,9711,10456,1978,Spain,Mexico,2,0,Friendly,Granada,Spain,False,2,2,Spain
8794,9712,10457,1978,Kenya,Lesotho,1,0,Friendly,Nairobi,Kenya,False,1,1,Kenya
8795,9713,10458,1978,Barbados,Guyana,1,0,Friendly,Bridgetown,Barbados,False,1,1,Barbados
8796,9714,10459,1978,Brazil,Peru,3,0,Friendly,Rio de Janeiro,Brazil,False,3,3,Brazil
8797,9715,10460,1978,Argentina,Uruguay,3,0,Friendly,Buenos Aires,Argentina,False,3,3,Argentina
8798,9716,10461,1978,Barbados,Guyana,3,0,Friendly,Bridgetown,Barbados,False,3,3,Barbados
8799,9717,10462,1978,Finland,Mexico,0,1,Friendly,Helsinki,Finland,False,1,-1,Mexico
8800,9718,10463,1978,Romania,Bulgaria,2,0,Balkan Cup,Bucharest,Romania,False,2,2,Romania
8801,9719,10464,1978,Thailand,Singapore,2,2,King's Cup,Bangkok,Thailand,False,4,0,Draw
8802,9720,10465,1978,Trinidad and Tobago,Guyana,3,0,Friendly,Port of Spain,Trinidad and Tobago,False,3,3,Trinidad and Tobago
8803,9721,10466,1978,France,Iran,2,1,Friendly,Toulouse,France,False,3,1,France
8804,9722,10467,1978,Trinidad and Tobago,Guyana,5,1,Friendly,Port of Spain,Trinidad and Tobago,False,6,4,Trinidad and Tobago
8805,9723,10468,1978,Réunion,Seychelles,4,1,Friendly,Saint-Pierre,Réunion,False,5,3,Réunion
8806,9724,10469,1978,Scotland,Northern Ireland,1,1,British Championship,Glasgow,Scotland,False,2,0,Draw
8807,9725,10470,1978,Wales,England,1,3,British Championship,Cardiff,Wales,False,4,-2,England
8808,9726,10471,1978,Libya,Malta,1,0,Friendly,Tripoli,Libya,False,1,1,Libya
8809,9727,10472,1978,Romania,Russia,0,1,Friendly,Bucharest,Romania,False,1,-1,Russia
8810,9728,10473,1978,Mauritius,Seychelles,2,0,Friendly,Saint-Pierre,Réunion,True,2,2,Mauritius
8811,9729,10474,1978,England,Northern Ireland,1,0,British Championship,London,England,False,1,1,England
8812,9731,10476,1978,Scotland,Wales,1,1,British Championship,Glasgow,Scotland,False,2,0,Draw
8813,9733,10478,1978,Réunion,Mauritius,5,3,Friendly,Saint-Pierre,Réunion,False,8,2,Réunion
8814,9734,10479,1978,France,Tunisia,2,0,Friendly,Villeneuve-d'Ascq,France,False,2,2,France
8815,9735,10480,1978,Iran,Ghana,3,0,Friendly,Teheran,Iran,False,3,3,Iran
8816,9736,10481,1978,Wales,Northern Ireland,1,0,British Championship,Wrexham,Wales,False,1,1,Wales
8817,9737,10482,1978,Austria,Netherlands,0,1,Friendly,Vienna,Austria,False,1,-1,Netherlands
8818,9738,10483,1978,Scotland,England,0,1,British Championship,Glasgow,Scotland,False,1,-1,England
8819,9739,10484,1978,Norway,Republic of Ireland,0,0,Friendly,Oslo,Norway,False,0,0,Draw
8820,9741,10486,1978,Japan,Thailand,3,0,Kirin Cup,Nagoya,Japan,False,3,3,Japan
8821,9742,10487,1978,Denmark,Republic of Ireland,3,3,UEFA Euro qualification,Copenhagen,Denmark,False,6,0,Draw
8822,9743,10488,1978,England,Hungary,4,1,Friendly,London,England,False,5,3,England
8823,9744,10489,1978,Finland,Greece,3,0,UEFA Euro qualification,Helsinki,Finland,False,3,3,Finland
8824,9745,10490,1978,Uruguay,Spain,0,0,Friendly,Montevideo,Uruguay,False,0,0,Draw
8825,9746,10491,1978,Bulgaria,Romania,1,1,Balkan Cup,Sofia,Bulgaria,False,2,0,Draw
8826,9747,10492,1978,Norway,Denmark,1,2,Nordic Championship,Oslo,Norway,False,3,-1,Denmark
8827,9748,10493,1978,Germany,Poland,0,0,FIFA World Cup,Buenos Aires,Argentina,True,0,0,Draw
8828,9749,10494,1978,Argentina,Hungary,2,1,FIFA World Cup,Buenos Aires,Argentina,False,3,1,Argentina
8829,9750,10495,1978,France,Italy,1,2,FIFA World Cup,Mar del Plata,Argentina,True,3,-1,Italy
8830,9751,10496,1978,Mexico,Tunisia,1,3,FIFA World Cup,Rosario,Argentina,True,4,-2,Tunisia
8831,9752,10497,1978,Austria,Spain,2,1,FIFA World Cup,Buenos Aires,Argentina,True,3,1,Austria
8832,9753,10498,1978,Brazil,Sweden,1,1,FIFA World Cup,Mar del Plata,Argentina,True,2,0,Draw
8833,9754,10499,1978,Iran,Netherlands,0,3,FIFA World Cup,Mendoza,Argentina,True,3,-3,Netherlands
8834,9755,10500,1978,Peru,Scotland,3,1,FIFA World Cup,Córdoba,Argentina,True,4,2,Peru
8835,9756,10501,1978,Argentina,France,2,1,FIFA World Cup,Buenos Aires,Argentina,False,3,1,Argentina
8836,9757,10502,1978,Germany,Mexico,6,0,FIFA World Cup,Córdoba,Argentina,True,6,6,Germany
8837,9758,10503,1978,Hungary,Italy,1,3,FIFA World Cup,Mar del Plata,Argentina,True,4,-2,Italy
8838,9759,10504,1978,Poland,Tunisia,1,0,FIFA World Cup,Rosario,Argentina,True,1,1,Poland
8839,9760,10505,1978,Austria,Sweden,1,0,FIFA World Cup,Buenos Aires,Argentina,True,1,1,Austria
8840,9761,10506,1978,Brazil,Spain,0,0,FIFA World Cup,Mar del Plata,Argentina,True,0,0,Draw
8841,9762,10507,1978,Iran,Scotland,1,1,FIFA World Cup,Córdoba,Argentina,True,2,0,Draw
8842,9763,10508,1978,Netherlands,Peru,0,0,FIFA World Cup,Mendoza,Argentina,True,0,0,Draw
8843,9764,10509,1978,Argentina,Italy,0,1,FIFA World Cup,Buenos Aires,Argentina,False,1,-1,Italy
8844,9765,10510,1978,France,Hungary,3,1,FIFA World Cup,Mar del Plata,Argentina,True,4,2,France
8845,9766,10511,1978,Germany,Tunisia,0,0,FIFA World Cup,Córdoba,Argentina,True,0,0,Draw
8846,9767,10512,1978,Mexico,Poland,1,3,FIFA World Cup,Rosario,Argentina,True,4,-2,Poland
8847,9768,10513,1978,Australia,Greece,1,2,Friendly,Melbourne,Australia,False,3,-1,Greece
8848,9769,10514,1978,Austria,Brazil,0,1,FIFA World Cup,Mar del Plata,Argentina,True,1,-1,Brazil
8849,9770,10515,1978,Iran,Peru,1,4,FIFA World Cup,Córdoba,Argentina,True,5,-3,Peru
8850,9771,10516,1978,Macau,Hong Kong,0,4,Friendly,Macau,Macau,False,4,-4,Hong Kong
8851,9772,10517,1978,Netherlands,Scotland,2,3,FIFA World Cup,Mendoza,Argentina,True,5,-1,Scotland
8852,9773,10518,1978,Spain,Sweden,1,0,FIFA World Cup,Buenos Aires,Argentina,True,1,1,Spain
8853,9774,10519,1978,Indonesia,Malaysia,3,0,Indonesia Tournament,Jakarta,Indonesia,False,3,3,Indonesia
8854,9775,10520,1978,Argentina,Poland,2,0,FIFA World Cup,Rosario,Argentina,False,2,2,Argentina
8855,9776,10521,1978,Australia,Greece,0,1,Friendly,Adelaide,Australia,False,1,-1,Greece
8856,9777,10522,1978,Austria,Netherlands,1,5,FIFA World Cup,Córdoba,Argentina,True,6,-4,Netherlands
8857,9778,10523,1978,Brazil,Peru,3,0,FIFA World Cup,Mendoza,Argentina,True,3,3,Brazil
8858,9779,10524,1978,Germany,Italy,0,0,FIFA World Cup,Buenos Aires,Argentina,True,0,0,Draw
8859,9780,10525,1978,Indonesia,Thailand,1,0,Indonesia Tournament,Jakarta,Indonesia,False,1,1,Indonesia
8860,9781,10526,1978,Malaysia,Singapore,1,1,Indonesia Tournament,Jakarta,Indonesia,True,2,0,Draw
8861,9782,10527,1978,Singapore,Thailand,1,3,Indonesia Tournament,Jakarta,Indonesia,True,4,-2,Thailand
8862,9783,10528,1978,Argentina,Brazil,0,0,FIFA World Cup,Rosario,Argentina,False,0,0,Draw
8863,9784,10529,1978,Austria,Italy,0,1,FIFA World Cup,Buenos Aires,Argentina,True,1,-1,Italy
8864,9785,10530,1978,Germany,Netherlands,2,2,FIFA World Cup,Córdoba,Argentina,True,4,0,Draw
8865,9786,10531,1978,Malawi,Zambia,1,2,Friendly,Blantyre,Malawi,False,3,-1,Zambia
8866,9787,10532,1978,Peru,Poland,0,1,FIFA World Cup,Mendoza,Argentina,True,1,-1,Poland
8867,9788,10533,1978,Argentina,Peru,6,0,FIFA World Cup,Rosario,Argentina,False,6,6,Argentina
8868,9789,10534,1978,Austria,Germany,3,2,FIFA World Cup,Córdoba,Argentina,True,5,1,Austria
8869,9790,10535,1978,Brazil,Poland,3,1,FIFA World Cup,Mendoza,Argentina,True,4,2,Brazil
8870,9791,10536,1978,Indonesia,Singapore,2,2,Indonesia Tournament,Jakarta,Indonesia,False,4,0,Draw
8871,9792,10537,1978,Italy,Netherlands,1,2,FIFA World Cup,Buenos Aires,Argentina,True,3,-1,Netherlands
8872,9793,10538,1978,Malaysia,Thailand,1,1,Indonesia Tournament,Jakarta,Indonesia,True,2,0,Draw
8873,9795,10540,1978,Malaysia,Thailand,3,3,Indonesia Tournament,Jakarta,Indonesia,True,6,0,Draw
8874,9796,10541,1978,Brazil,Italy,2,1,FIFA World Cup,Buenos Aires,Argentina,True,3,1,Brazil
8875,9797,10542,1978,Argentina,Netherlands,3,1,FIFA World Cup,Buenos Aires,Argentina,False,4,2,Argentina
8876,9798,10543,1978,Barbados,Curaçao,0,0,CFU Caribbean Cup qualification,Bridgetown,Barbados,False,0,0,Draw
8877,9799,10544,1978,Zambia,Malawi,0,0,Friendly,Lusaka,Zambia,False,0,0,Draw
8878,9800,10545,1978,Iceland,Denmark,0,0,Friendly,Reykjavík,Iceland,False,0,0,Draw
8879,9801,10546,1978,Sweden,Finland,2,1,Nordic Championship,Borås,Sweden,False,3,1,Sweden
8880,9802,10547,1978,Algeria,Iraq,1,1,Friendly,Algiers,Algeria,False,2,0,Draw
8881,9803,10548,1978,Guadeloupe,Jamaica,1,0,CFU Caribbean Cup qualification,Pointe-à-Pitre,Guadeloupe,False,1,1,Guadeloupe
8882,9804,10549,1978,Algeria,Iraq,0,0,Friendly,Algiers,Algeria,False,0,0,Draw
8883,9805,10550,1978,Malawi,Sierra Leone,5,0,Friendly,Lilongwe,Malawi,False,5,5,Malawi
8884,9806,10551,1978,Guyana,Suriname,0,2,CFU Caribbean Cup qualification,Linden,Guyana,False,2,-2,Suriname
8885,9807,10552,1978,Malawi,Sierra Leone,4,2,Friendly,Lilongwe,Malawi,False,6,2,Malawi
8886,9809,10554,1978,Indonesia,Syria,1,0,Merdeka Tournament,Kuala Lumpur,Malaysia,True,1,1,Indonesia
8887,9810,10555,1978,Iraq,Japan,0,0,Merdeka Tournament,Kuala Lumpur,Malaysia,True,0,0,Draw
8888,9811,10557,1978,Indonesia,Japan,2,1,Merdeka Tournament,Kuala Lumpur,Malaysia,True,3,1,Indonesia
8889,9812,10558,1978,Iraq,Syria,2,1,Merdeka Tournament,Kuala Lumpur,Malaysia,True,3,1,Iraq
8890,9813,10560,1978,Indonesia,Iraq,0,4,Merdeka Tournament,Kuala Lumpur,Malaysia,True,4,-4,Iraq
8891,9814,10561,1978,Japan,Syria,3,2,Merdeka Tournament,Kuala Lumpur,Malaysia,True,5,1,Japan
8892,9815,10562,1978,Singapore,Thailand,1,2,Merdeka Tournament,Kuala Lumpur,Malaysia,True,3,-1,Thailand
8893,9817,10564,1978,Iraq,Singapore,3,0,Merdeka Tournament,Kuala Lumpur,Malaysia,True,3,3,Iraq
8894,9818,10565,1978,Syria,Thailand,1,3,Merdeka Tournament,Kuala Lumpur,Malaysia,True,4,-2,Thailand
8895,9819,10566,1978,Indonesia,Thailand,0,3,Merdeka Tournament,Kuala Lumpur,Malaysia,True,3,-3,Thailand
8896,9821,10568,1978,Japan,Singapore,1,2,Merdeka Tournament,Kuala Lumpur,Malaysia,True,3,-1,Singapore
8897,9822,10569,1978,Iraq,Thailand,1,0,Merdeka Tournament,Kuala Lumpur,Malaysia,True,1,1,Iraq
8898,9824,10571,1978,Singapore,Syria,4,1,Merdeka Tournament,Kuala Lumpur,Malaysia,True,5,3,Singapore
8899,9825,10572,1978,Japan,Thailand,4,0,Merdeka Tournament,Kuala Lumpur,Malaysia,True,4,4,Japan
8900,9826,10573,1978,Indonesia,Singapore,0,0,Merdeka Tournament,Kuala Lumpur,Malaysia,True,0,0,Draw
8901,9827,10575,1978,Curaçao,Barbados,1,0,CFU Caribbean Cup qualification,Oranjestad,Netherlands Antilles,True,1,1,Curaçao
8902,9829,10577,1978,Grenada,Trinidad and Tobago,1,1,Friendly,St. George's,Grenada,False,2,0,Draw
8903,9830,10578,1978,Jamaica,Guadeloupe,1,2,CFU Caribbean Cup qualification,Kingston,Jamaica,False,3,-1,Guadeloupe
8904,9831,10579,1978,Suriname,Guyana,2,1,CFU Caribbean Cup qualification,Paramaribo,Suriname,False,3,1,Suriname
8905,9833,10581,1978,Finland,Norway,1,1,Nordic Championship,Helsinki,Finland,False,2,0,Draw
8906,9835,10583,1978,Denmark,Sweden,2,1,Nordic Championship,Copenhagen,Denmark,False,3,1,Denmark
8907,9836,10584,1978,São Tomé and Príncipe,Angola,3,3,Friendly,São Tomé,São Tomé and Príncipe,False,6,0,Draw
8908,9838,10586,1978,Puerto Rico,Haiti,1,1,CFU Caribbean Cup qualification,San Juan,Puerto Rico,False,2,0,Draw
8909,9839,10587,1978,Trinidad and Tobago,French Guiana,2,4,CFU Caribbean Cup qualification,Port of Spain,Trinidad and Tobago,False,6,-2,French Guiana
8910,9840,10588,1978,Haiti,Puerto Rico,1,0,CFU Caribbean Cup qualification,Port-au-Prince,Haiti,False,1,1,Haiti
8911,9841,10589,1978,Finland,Poland,0,1,Friendly,Helsinki,Finland,False,1,-1,Poland
8912,9842,10591,1978,Norway,Austria,0,2,UEFA Euro qualification,Oslo,Norway,False,2,-2,Austria
8913,9843,10592,1978,France,Sweden,2,2,UEFA Euro qualification,Paris,France,False,4,0,Draw
8914,9844,10593,1978,French Guiana,Trinidad and Tobago,1,4,CFU Caribbean Cup qualification,Cayenne,French Guiana,False,5,-3,Trinidad and Tobago
8915,9845,10595,1978,Iceland,United States,0,0,Friendly,Reykjavík,Iceland,False,0,0,Draw
8916,9846,10597,1978,Iceland,Poland,0,2,UEFA Euro qualification,Reykjavík,Iceland,False,2,-2,Poland
8917,9847,10598,1978,Iran,Russia,0,1,Friendly,Teheran,Iran,False,1,-1,Russia
8918,9848,10599,1978,Eswatini,Zambia,1,6,Friendly,Lobamba,Eswatini,False,7,-5,Zambia
8919,9849,10600,1978,Switzerland,United States,2,0,Friendly,Lucerne,Switzerland,False,2,2,Switzerland
8920,9850,10601,1978,Eswatini,Zambia,2,5,Friendly,Lobamba,Eswatini,False,7,-3,Zambia
8921,9851,10602,1978,Bahrain,Malaysia,1,2,Korea Cup,Seoul,South Korea,True,3,-1,Malaysia
8922,9852,10603,1978,French Guiana,Martinique,4,2,Friendly,Cayenne,French Guiana,False,6,2,French Guiana
8923,9853,10604,1978,Indonesia,Thailand,0,2,Korea Cup,Seoul,South Korea,True,2,-2,Thailand
8924,9854,10605,1978,Lebanon,Mexico,1,7,Korea Cup,Seoul,South Korea,True,8,-6,Mexico
8925,9855,10608,1978,Haiti,Martinique,0,0,CFU Caribbean Cup qualification,Port-au-Prince,Haiti,False,0,0,Draw
8926,9856,10609,1978,Seychelles,Réunion,1,0,Friendly,Victoria,Seychelles,False,1,1,Seychelles
8927,9857,10610,1978,Austria,Scotland,3,2,UEFA Euro qualification,Vienna,Austria,False,5,1,Austria
8928,9858,10611,1978,Belgium,Norway,1,1,UEFA Euro qualification,Lokeren,Belgium,False,2,0,Draw
8929,9859,10612,1978,Denmark,England,3,4,UEFA Euro qualification,Copenhagen,Denmark,False,7,-1,England
8930,9860,10613,1978,Finland,Hungary,2,1,UEFA Euro qualification,Helsinki,Finland,False,3,1,Finland
8931,9861,10614,1978,Republic of Ireland,Northern Ireland,0,0,UEFA Euro qualification,Dublin,Republic of Ireland,False,0,0,Draw
8932,9862,10615,1978,Italy,Bulgaria,1,0,Friendly,Turin,Italy,False,1,1,Italy
8933,9864,10617,1978,Netherlands,Iceland,3,0,UEFA Euro qualification,Nijmegen,Netherlands,False,3,3,Netherlands
8934,9865,10618,1978,Portugal,United States,1,0,Friendly,Setúbal,Portugal,False,1,1,Portugal
8935,9866,10619,1978,Russia,Greece,2,0,UEFA Euro qualification,Yerevan,Soviet Union,False,2,2,Russia
8936,9867,10620,1978,Italy,Turkey,1,0,Friendly,Florence,Italy,False,1,1,Italy
8937,9868,10621,1978,Réunion,Mauritius,0,2,Friendly,Saint-Denis,Réunion,False,2,-2,Mauritius
8938,9869,10622,1978,Botswana,Mozambique,1,4,Friendly,Gaborone,Botswana,False,5,-3,Mozambique
8939,9870,10623,1978,Curaçao,Suriname,0,2,CFU Caribbean Cup qualification,Oranjestad,Netherlands Antilles,True,2,-2,Suriname
8940,9871,10624,1978,Botswana,Mozambique,0,2,Friendly,Gaborone,Botswana,False,2,-2,Mozambique
8941,9872,10625,1978,Martinique,Haiti,0,0,CFU Caribbean Cup qualification,Fort-de-France,Martinique,False,0,0,Draw
8942,9873,10626,1978,Singapore,New Zealand,0,2,Friendly,Kallang,Singapore,False,2,-2,New Zealand
8943,9875,10630,1978,Turkey,Russia,0,2,Friendly,Ankara,Turkey,False,2,-2,Russia
8944,9876,10631,1978,Luxembourg,France,1,3,UEFA Euro qualification,Luxembourg,Luxembourg,False,4,-2,France
8945,9877,10633,1978,Denmark,Bulgaria,2,2,UEFA Euro qualification,Copenhagen,Denmark,False,4,0,Draw
8946,9878,10634,1978,Greece,Finland,8,1,UEFA Euro qualification,Athens,Greece,False,9,7,Greece
8947,9879,10635,1978,Hungary,Russia,2,0,UEFA Euro qualification,Budapest,Hungary,False,2,2,Hungary
8948,9880,10636,1978,Portugal,Belgium,1,1,UEFA Euro qualification,Lisbon,Portugal,False,2,0,Draw
8949,9881,10637,1978,Romania,Poland,1,0,Friendly,Bucharest,Romania,False,1,1,Romania
8950,9882,10638,1978,Switzerland,Netherlands,1,3,UEFA Euro qualification,Berne,Switzerland,False,4,-2,Netherlands
8951,9883,10639,1978,Suriname,Curaçao,3,0,CFU Caribbean Cup qualification,Paramaribo,Suriname,False,3,3,Suriname
8952,9884,10640,1978,Tanzania,Kenya,1,0,Friendly,Arusha,Tanzania,False,1,1,Tanzania
8953,9885,10641,1978,Kenya,Tanzania,0,0,Friendly,Nairobi,Kenya,False,0,0,Draw
8954,9886,10642,1978,Haiti,Suriname,0,3,CFU Caribbean Cup,Port of Spain,Trinidad and Tobago,True,3,-3,Suriname
8955,9887,10643,1978,Malawi,Algeria,1,1,Friendly,Blantyre,Malawi,False,2,0,Draw
8956,9888,10644,1978,Trinidad and Tobago,Antigua and Barbuda,3,1,CFU Caribbean Cup,San Fernando,Trinidad and Tobago,False,4,2,Trinidad and Tobago
8957,9889,10645,1978,Malawi,Algeria,2,1,Friendly,Lilongwe,Malawi,False,3,1,Malawi
8958,9890,10646,1978,Republic of Ireland,England,1,1,UEFA Euro qualification,Dublin,Republic of Ireland,False,2,0,Draw
8959,9891,10647,1978,Northern Ireland,Denmark,2,1,UEFA Euro qualification,Belfast,Northern Ireland,False,3,1,Northern Ireland
8960,9893,10649,1978,Scotland,Norway,3,2,UEFA Euro qualification,Glasgow,Scotland,False,5,1,Scotland
8961,9894,10650,1978,Trinidad and Tobago,Suriname,0,1,CFU Caribbean Cup,Port of Spain,Trinidad and Tobago,False,1,-1,Suriname
8962,9895,10651,1978,Wales,Malta,7,0,UEFA Euro qualification,Wrexham,Wales,False,7,7,Wales
8963,9896,10652,1978,Antigua and Barbuda,Haiti,0,1,CFU Caribbean Cup,San Fernando,Trinidad and Tobago,True,1,-1,Haiti
8964,9897,10653,1978,Antigua and Barbuda,Suriname,0,4,CFU Caribbean Cup,San Fernando,Trinidad and Tobago,True,4,-4,Suriname
8965,9898,10654,1978,Zambia,Algeria,0,3,Friendly,Lusaka,Zambia,False,3,-3,Algeria
8966,9899,10655,1978,Greece,Hungary,4,1,UEFA Euro qualification,Salonica,Greece,False,5,3,Greece
8967,9900,10656,1978,Trinidad and Tobago,Haiti,2,2,CFU Caribbean Cup,Port of Spain,Trinidad and Tobago,False,4,0,Draw
8968,9901,10657,1978,Malawi,Kenya,1,0,CECAFA Cup,Blantyre,Malawi,False,1,1,Malawi
8969,9902,10658,1978,Malawi,Somalia,3,1,CECAFA Cup,Lilongwe,Malawi,False,4,2,Malawi
8970,9903,10659,1978,Malawi,Uganda,0,2,CECAFA Cup,Lilongwe,Malawi,False,2,-2,Uganda
8971,9904,10660,1978,Uganda,Zambia,1,2,CECAFA Cup,Blantyre,Malawi,True,3,-1,Zambia
8972,9905,10662,1978,France,Spain,1,0,Friendly,Paris,France,False,1,1,France
8973,9906,10663,1978,Kenya,Uganda,0,1,CECAFA Cup,Blantyre,Malawi,True,1,-1,Uganda
8974,9907,10664,1978,Somalia,Zambia,0,4,CECAFA Cup,Blantyre,Malawi,True,4,-4,Zambia
8975,9908,10665,1978,Burkina Faso,Mali,3,1,Friendly,Ouagadougou,Upper Volta,False,4,2,Burkina Faso
8976,9909,10666,1978,Kenya,Somalia,1,0,CECAFA Cup,Blantyre,Malawi,True,1,1,Kenya
8977,9910,10667,1978,Malawi,Zambia,2,1,CECAFA Cup,Blantyre,Malawi,False,3,1,Malawi
8978,9911,10668,1978,Kenya,Zambia,0,9,CECAFA Cup,Blantyre,Malawi,True,9,-9,Zambia
8979,9912,10669,1978,Somalia,Uganda,2,2,CECAFA Cup,Lilongwe,Malawi,True,4,0,Draw
8980,9913,10670,1978,Austria,Portugal,1,2,UEFA Euro qualification,Vienna,Austria,False,3,-1,Portugal
8981,9914,10671,1978,Germany,Hungary,0,0,Friendly,Frankfurt am Main,Germany,False,0,0,Draw
8982,9915,10672,1978,Israel,Belgium,1,0,Friendly,Jaffa,Israel,False,1,1,Israel
8983,9917,10674,1978,Poland,Switzerland,2,0,UEFA Euro qualification,Wrocław,Poland,False,2,2,Poland
8984,9918,10675,1978,Spain,Romania,1,0,UEFA Euro qualification,Valencia,Spain,False,1,1,Spain
8985,9919,10677,1978,Algeria,Congo,3,0,Friendly,Constantine,Algeria,False,3,3,Algeria
8986,9920,10678,1978,Malawi,Kenya,2,0,CECAFA Cup,Blantyre,Malawi,False,2,2,Malawi
8987,9921,10679,1978,Uganda,Zambia,0,4,CECAFA Cup,Blantyre,Malawi,True,4,-4,Zambia
8988,9922,10680,1978,Japan,Russia,1,4,Friendly,Tokyo,Japan,False,5,-3,Russia
8989,9923,10681,1978,Kenya,Uganda,2,0,CECAFA Cup,Blantyre,Malawi,True,2,2,Kenya
8990,9924,10682,1978,Malawi,Zambia,3,2,CECAFA Cup,Blantyre,Malawi,False,5,1,Malawi
8991,9925,10683,1978,Japan,Russia,1,4,Friendly,Tokyo,Japan,False,5,-3,Russia
8992,9926,10684,1978,Grenada,Barbados,2,0,Friendly,St. George's,Grenada,False,2,2,Grenada
8993,9927,10685,1978,Grenada,Barbados,0,0,Friendly,St. George's,Grenada,False,0,0,Draw
8994,9928,10686,1978,Japan,Russia,0,3,Friendly,Osaka,Japan,False,3,-3,Russia
8995,9929,10687,1978,Bulgaria,Northern Ireland,0,2,UEFA Euro qualification,Sofia,Bulgaria,False,2,-2,Northern Ireland
8996,9931,10689,1978,Portugal,Scotland,1,0,UEFA Euro qualification,Lisbon,Portugal,False,1,1,Portugal
8997,9932,10690,1978,Wales,Turkey,1,0,UEFA Euro qualification,Wrexham,Wales,False,1,1,Wales
8998,9933,10691,1978,Madagascar,Malawi,2,1,African Cup of Nations qualification,Antananarivo,Madagascar,False,3,1,Madagascar
8999,9934,10692,1978,Mauritius,Lesotho,0,1,African Cup of Nations qualification,Port Louis,Mauritius,False,1,-1,Lesotho
9000,9935,10693,1978,Antigua and Barbuda,Martinique,0,2,Friendly,St. John's,Antigua and Barbuda,False,2,-2,Martinique
9001,9936,10694,1978,Greece,Romania,2,1,Friendly,Athens,Greece,False,3,1,Greece
9002,9937,10695,1978,Spain,Cyprus,5,0,UEFA Euro qualification,Salamanca,Spain,False,5,5,Spain
9003,9938,10696,1978,Lesotho,Mauritius,1,2,African Cup of Nations qualification,Maseru,Lesotho,False,3,-1,Mauritius
9004,9939,10697,1978,Malawi,Madagascar,5,1,African Cup of Nations qualification,Blantyre,Malawi,False,6,4,Malawi
9005,9940,10698,1978,Israel,Romania,1,1,Friendly,Jaffa,Israel,False,2,0,Draw
9006,9941,10699,1978,Syria,Tunisia,2,1,Friendly,Damascus,Syria,False,3,1,Syria
9007,9942,10700,1978,Germany,Netherlands,3,1,Friendly,Düsseldorf,Germany,False,4,2,Germany
9008,9943,10701,1978,Italy,Spain,1,0,Friendly,Rome,Italy,False,1,1,Italy
9009,9947,10708,1979,Gambia,Mauritania,3,1,Amílcar Cabral Cup,Bissau,Guinea-Bissau,True,4,2,Gambia
9010,9948,10709,1979,Guinea,Mali,0,1,Amílcar Cabral Cup,Bissau,Guinea-Bissau,True,1,-1,Mali
9011,9949,10711,1979,Gambia,Mali,0,1,Amílcar Cabral Cup,Bissau,Guinea-Bissau,True,1,-1,Mali
9012,9950,10712,1979,Guinea,Mauritania,4,1,Amílcar Cabral Cup,Bissau,Guinea-Bissau,True,5,3,Guinea
9013,9951,10713,1979,Rwanda,Gabon,2,2,Friendly,Kigali,Rwanda,False,4,0,Draw
9014,9952,10714,1979,Guinea-Bissau,Senegal,0,2,Amílcar Cabral Cup,Bissau,Guinea-Bissau,False,2,-2,Senegal
9015,9953,10715,1979,Gambia,Guinea,1,1,Amílcar Cabral Cup,Bissau,Guinea-Bissau,True,2,0,Draw
9016,9954,10716,1979,Mali,Mauritania,4,2,Amílcar Cabral Cup,Bissau,Guinea-Bissau,True,6,2,Mali
9017,9955,10717,1979,Guinea,Senegal,1,3,Amílcar Cabral Cup,Bissau,Guinea-Bissau,True,4,-2,Senegal
9018,9956,10718,1979,Guinea-Bissau,Mali,1,1,Amílcar Cabral Cup,Bissau,Guinea-Bissau,False,2,0,Draw
9019,9957,10719,1979,Guinea-Bissau,Guinea,2,2,Amílcar Cabral Cup,Bissau,Guinea-Bissau,False,4,0,Draw
9020,9958,10720,1979,Mali,Senegal,0,1,Amílcar Cabral Cup,Bissau,Guinea-Bissau,True,1,-1,Senegal
9021,9959,10721,1979,Cyprus,Bulgaria,0,1,Friendly,Larnaca,Cyprus,False,1,-1,Bulgaria
9022,9960,10722,1979,Ivory Coast,Togo,0,1,Friendly,Monrovia,Liberia,True,1,-1,Togo
9023,9961,10723,1979,Liberia,Guinea,2,1,Friendly,Monrovia,Liberia,False,3,1,Liberia
9024,9962,10724,1979,Gambia,Ivory Coast,2,1,Friendly,Monrovia,Liberia,True,3,1,Gambia
9025,9963,10725,1979,Guinea,Senegal,1,1,Friendly,Monrovia,Liberia,True,2,0,Draw
9026,9964,10726,1979,Israel,Austria,0,1,Friendly,Jaffa,Israel,False,1,-1,Austria
9027,9965,10727,1979,Gambia,Togo,2,2,Friendly,Monrovia,Liberia,True,4,0,Draw
9028,9966,10728,1979,Liberia,Senegal,1,1,Friendly,Monrovia,Liberia,False,2,0,Draw
9029,9967,10729,1979,Senegal,Togo,0,1,Friendly,Monrovia,Liberia,True,1,-1,Togo
9030,9968,10730,1979,Liberia,Gambia,1,0,Friendly,Monrovia,Liberia,False,1,1,Liberia
9031,9969,10731,1979,Iraq,Finland,1,0,Friendly,Baghdad,Iraq,False,1,1,Iraq
9032,9970,10732,1979,England,Northern Ireland,4,0,UEFA Euro qualification,London,England,False,4,4,England
9033,9971,10733,1979,Iraq,Finland,2,0,Friendly,Baghdad,Iraq,False,2,2,Iraq
9034,9972,10734,1979,Libya,Greece,2,2,Friendly,Tripoli,Libya,False,4,0,Draw
9035,9973,10735,1979,Bahrain,Finland,0,1,Friendly,Isa Town,Bahrain,False,1,-1,Finland
9036,9976,10738,1979,Israel,Greece,4,1,Friendly,Ramat-Gan,Israel,False,5,3,Israel
9037,9977,10739,1979,Libya,Poland,1,0,Friendly,Tripoli,Libya,False,1,1,Libya
9038,9978,10740,1979,Tunisia,Poland,0,2,Friendly,Tunis,Tunisia,False,2,-2,Poland
9039,9979,10741,1979,Italy,Netherlands,3,0,Friendly,Milan,Italy,False,3,3,Italy
9040,9980,10742,1979,France,Luxembourg,3,0,UEFA Euro qualification,Paris,France,False,3,3,France
9041,9981,10743,1979,Malta,Germany,0,0,UEFA Euro qualification,Gżira,Malta,False,0,0,Draw
9042,9983,10745,1979,Turkey,Algeria,0,1,Friendly,Bursa,Turkey,False,1,-1,Algeria
9043,9984,10746,1979,Barbados,Trinidad and Tobago,2,2,Friendly,Bridgetown,Barbados,False,4,0,Draw
9044,9986,10748,1979,Bangladesh,Afghanistan,3,2,AFC Asian Cup qualification,Dhaka,Bangladesh,False,5,1,Bangladesh
9045,9987,10749,1979,Bangladesh,Qatar,1,3,AFC Asian Cup qualification,Dhaka,Bangladesh,False,4,-2,Qatar
9046,9988,10750,1979,Senegal,Mali,2,1,Friendly,Dakar,Senegal,False,3,1,Senegal
9047,9989,10752,1979,Martinique,Trinidad and Tobago,0,0,Friendly,Bridgetown,Barbados,True,0,0,Draw
9048,9990,10753,1979,Turkey,Malta,2,1,UEFA Euro qualification,Izmir,Turkey,False,3,1,Turkey
9049,9991,10754,1979,Romania,Greece,3,0,Friendly,Bucharest,Romania,False,3,3,Romania
9050,9992,10755,1979,Iraq,Bahrain,4,0,Gulf Cup,Baghdad,Iraq,False,4,4,Iraq
9051,9993,10756,1979,Kuwait,Qatar,3,1,Gulf Cup,Baghdad,Iraq,True,4,2,Kuwait
9052,9994,10757,1979,Saudi Arabia,United Arab Emirates,2,1,Gulf Cup,Baghdad,Iraq,True,3,1,Saudi Arabia
9053,9995,10758,1979,Mali,Senegal,2,1,Friendly,Bamako,Mali,False,3,1,Mali
9054,9996,10759,1979,Belgium,Austria,1,1,UEFA Euro qualification,Brussels,Belgium,False,2,0,Draw
9055,9998,10761,1979,Netherlands,Switzerland,3,0,UEFA Euro qualification,Eindhoven,Netherlands,False,3,3,Netherlands
9056,9999,10762,1979,Russia,Bulgaria,3,1,Friendly,Simferopol,Soviet Union,False,4,2,Russia
9057,10001,10764,1979,Oman,Qatar,0,1,Gulf Cup,Baghdad,Iraq,True,1,-1,Qatar
9058,10002,10765,1979,Turkey,Germany,0,0,UEFA Euro qualification,Izmir,Turkey,False,0,0,Draw
9059,10003,10766,1979,Barbados,Martinique,1,2,Friendly,Bridgetown,Barbados,False,3,-1,Martinique
9060,10004,10768,1979,Poland,Hungary,1,1,Friendly,Chorzów,Poland,False,2,0,Draw
9061,10005,10769,1979,Romania,Spain,2,2,UEFA Euro qualification,Craiova,Romania,False,4,0,Draw
9062,10006,10770,1979,Iraq,Oman,7,0,Gulf Cup,Baghdad,Iraq,False,7,7,Iraq
9063,10007,10771,1979,Bahrain,Qatar,1,1,Gulf Cup,Baghdad,Iraq,True,2,0,Draw
9064,10008,10772,1979,Gabon,Ivory Coast,2,1,Friendly,Libreville,Gabon,False,3,1,Gabon
9065,10009,10773,1979,Iraq,Saudi Arabia,2,0,Gulf Cup,Baghdad,Iraq,False,2,2,Iraq
9066,10010,10774,1979,Bahrain,Kuwait,0,2,Gulf Cup,Baghdad,Iraq,True,2,-2,Kuwait
9067,10011,10775,1979,Oman,United Arab Emirates,0,4,Gulf Cup,Baghdad,Iraq,True,4,-4,United Arab Emirates
9068,10012,10776,1979,Benin,Ivory Coast,1,0,African Cup of Nations qualification,Cotonou,Benin,False,1,1,Benin
9069,10013,10777,1979,Congo,DR Congo,4,2,African Cup of Nations qualification,Brazzaville,Congo,False,6,2,Congo
9070,10014,10778,1979,Guadeloupe,Martinique,0,1,Friendly,Capesterre-Belle-Eau,Guadeloupe,False,1,-1,Martinique
9071,10015,10779,1979,Malawi,Zambia,0,2,African Cup of Nations qualification,Blantyre,Malawi,False,2,-2,Zambia
9072,10016,10781,1979,Russia,Sweden,2,0,Friendly,Tbilisi,Soviet Union,False,2,2,Russia
9073,10017,10782,1979,Argentina,Bulgaria,2,1,Friendly,Buenos Aires,Argentina,False,3,1,Argentina
9074,10018,10783,1979,São Tomé and Príncipe,Angola,1,2,Friendly,São Tomé,São Tomé and Príncipe,False,3,-1,Angola
9075,10019,10784,1979,DR Congo,Congo,4,1,African Cup of Nations qualification,Kinshasa,Zaïre,False,5,3,DR Congo
9076,10020,10785,1979,Ivory Coast,Benin,4,1,African Cup of Nations qualification,Abidjan,Ivory Coast,False,5,3,Ivory Coast
9077,10021,10786,1979,Madagascar,Kenya,4,0,Friendly,Antananarivo,Madagascar,False,4,4,Madagascar
9078,10022,10787,1979,Zambia,Malawi,2,0,African Cup of Nations qualification,Ndola,Zambia,False,2,2,Zambia
9079,10024,10789,1979,Austria,Belgium,0,0,UEFA Euro qualification,Vienna,Austria,False,0,0,Draw
9080,10025,10790,1979,Hungary,Greece,0,0,UEFA Euro qualification,Budapest,Hungary,False,0,0,Draw
9081,10026,10791,1979,Republic of Ireland,Denmark,2,0,UEFA Euro qualification,Dublin,Republic of Ireland,False,2,2,Republic of Ireland
9082,10027,10793,1979,Northern Ireland,Bulgaria,2,0,UEFA Euro qualification,Belfast,Northern Ireland,False,2,2,Northern Ireland
9083,10028,10794,1979,Poland,Netherlands,2,0,UEFA Euro qualification,Chorzów,Poland,False,2,2,Poland
9084,10029,10795,1979,United States,France,0,6,Friendly,East Rutherford,United States,False,6,-6,France
9085,10030,10796,1979,Wales,Germany,0,2,UEFA Euro qualification,Wrexham,Wales,False,2,-2,Germany
9086,10032,10798,1979,Saint Vincent and the Grenadines,Martinique,2,2,CFU Caribbean Cup qualification,Kingstown,Saint Vincent and the Grenadines,False,4,0,Draw
9087,10034,10801,1979,Denmark,Sweden,2,2,Friendly,Copenhagen,Denmark,False,4,0,Draw
9088,10036,10803,1979,Norway,Portugal,0,1,UEFA Euro qualification,Oslo,Norway,False,1,-1,Portugal
9089,10037,10804,1979,Malaysia,Hong Kong,0,0,AFC Asian Cup qualification,Bangkok,Thailand,True,0,0,Draw
9090,10039,10806,1979,Cyprus,Romania,1,1,UEFA Euro qualification,Limassol,Cyprus,False,2,0,Draw
9091,10040,10808,1979,Brazil,Paraguay,6,0,Friendly,Rio de Janeiro,Brazil,False,6,6,Brazil
9092,10041,10809,1979,Bulgaria,Republic of Ireland,1,0,UEFA Euro qualification,Sofia,Bulgaria,False,1,1,Bulgaria
9093,10042,10810,1979,Mozambique,Zimbabwe,0,6,Friendly,Maputo,Mozambique,False,6,-6,Zimbabwe
9094,10043,10811,1979,Northern Ireland,England,0,2,British Championship,Belfast,Northern Ireland,False,2,-2,England
9095,10044,10812,1979,Russia,Hungary,2,2,UEFA Euro qualification,Tbilisi,Soviet Union,False,4,0,Draw
9096,10045,10813,1979,Wales,Scotland,3,0,British Championship,Cardiff,Wales,False,3,3,Wales
9097,10046,10814,1979,Argentina,Netherlands,0,0,Friendly,Berne,Switzerland,True,0,0,Draw
9098,10047,10815,1979,Republic of Ireland,Germany,1,3,Friendly,Dublin,Republic of Ireland,False,4,-2,Germany
9099,10048,10816,1979,Scotland,Northern Ireland,1,0,British Championship,Glasgow,Scotland,False,1,1,Scotland
9100,10049,10817,1979,Switzerland,Iceland,2,0,UEFA Euro qualification,Berne,Switzerland,False,2,2,Switzerland
9101,10050,10818,1979,England,Wales,0,0,British Championship,London,England,False,0,0,Draw
9102,10051,10819,1979,Martinique,Trinidad and Tobago,3,1,Friendly,Fort-de-France,Martinique,False,4,2,Martinique
9103,10052,10820,1979,England,Scotland,3,1,British Championship,London,England,False,4,2,England
9104,10053,10821,1979,Iceland,Germany,1,3,Friendly,Reykjavík,Iceland,False,4,-2,Germany
9105,10054,10822,1979,Italy,Argentina,2,2,Friendly,Rome,Italy,False,4,0,Draw
9106,10055,10823,1979,Northern Ireland,Wales,1,1,British Championship,Belfast,Northern Ireland,False,2,0,Draw
9107,10056,10824,1979,Republic of Ireland,Argentina,0,0,Friendly,Dublin,Republic of Ireland,False,0,0,Draw
9108,10057,10825,1979,Brazil,Uruguay,5,1,Friendly,Rio de Janeiro,Brazil,False,6,4,Brazil
9109,10058,10826,1979,Japan,Indonesia,4,0,Kirin Cup,Tokyo,Japan,False,4,4,Japan
9110,10059,10828,1979,Malta,Wales,0,2,UEFA Euro qualification,Gżira,Malta,False,2,-2,Wales
9111,10060,10829,1979,Scotland,Argentina,1,3,Friendly,Glasgow,Scotland,False,4,-2,Argentina
9112,10061,10830,1979,Benin,Togo,0,1,Friendly,Cotonou,Benin,False,1,-1,Togo
9113,10062,10831,1979,Jamaica,Saint Kitts and Nevis,2,1,CFU Caribbean Cup qualification,Kingston,Jamaica,False,3,1,Jamaica
9114,10063,10832,1979,Bulgaria,England,0,3,UEFA Euro qualification,Sofia,Bulgaria,False,3,-3,England
9115,10064,10833,1979,Denmark,Northern Ireland,4,0,UEFA Euro qualification,Copenhagen,Denmark,False,4,4,Denmark
9116,10065,10834,1979,Norway,Scotland,0,4,UEFA Euro qualification,Oslo,Norway,False,4,-4,Scotland
9117,10066,10835,1979,Sweden,Luxembourg,3,0,UEFA Euro qualification,Malmö,Sweden,False,3,3,Sweden
9118,10067,10836,1979,Iceland,Switzerland,1,2,UEFA Euro qualification,Reykjavík,Iceland,False,3,-1,Switzerland
9119,10068,10837,1979,Martinique,Saint Vincent and the Grenadines,0,1,CFU Caribbean Cup qualification,Fort-de-France,Martinique,False,1,-1,Saint Vincent and the Grenadines
9120,10069,10838,1979,Sweden,England,0,0,Friendly,Solna,Sweden,False,0,0,Draw
9121,10070,10839,1979,Austria,England,4,3,Friendly,Vienna,Austria,False,7,1,Austria
9122,10071,10840,1979,Chile,Ecuador,0,0,Friendly,Santiago,Chile,False,0,0,Draw
9123,10072,10841,1979,New Zealand,Australia,1,0,Friendly,Auckland,New Zealand,False,1,1,New Zealand
9124,10073,10844,1979,Saint Kitts and Nevis,Jamaica,1,2,CFU Caribbean Cup qualification,Basseterre,Saint Kitts and Nevis,False,3,-1,Jamaica
9125,10074,10845,1979,Ecuador,Chile,2,1,Friendly,Guayaquil,Ecuador,False,3,1,Ecuador
9126,10075,10846,1979,Ghana,Liberia,0,0,Friendly,Accra,Ghana,False,0,0,Draw
9127,10076,10847,1979,Malawi,Lesotho,1,0,Friendly,Lilongwe,Malawi,False,1,1,Malawi
9128,10077,10848,1979,Zambia,DR Congo,4,1,Friendly,Lusaka,Zambia,False,5,3,Zambia
9129,10078,10849,1979,Malawi,Lesotho,1,2,Friendly,Blantyre,Malawi,False,3,-1,Lesotho
9130,10079,10850,1979,Denmark,Russia,1,2,Friendly,Copenhagen,Denmark,False,3,-1,Russia
9131,10080,10851,1979,Sweden,Norway,2,0,Nordic Championship,Gothenburg,Sweden,False,2,2,Sweden
9132,10081,10852,1979,Fiji,New Zealand,0,6,Friendly,Suva,Fiji,False,6,-6,New Zealand
9133,10082,10853,1979,Japan,Thailand,2,0,Merdeka Tournament,Kuala Lumpur,Malaysia,True,2,2,Japan
9134,10083,10854,1979,Malaysia,Burma,4,1,Merdeka Tournament,Kuala Lumpur,Malaysia,False,5,3,Malaysia
9135,10084,10855,1979,Sudan,Ivory Coast,2,0,African Cup of Nations qualification,Khartoum,Sudan,False,2,2,Sudan
9136,10085,10856,1979,DR Congo,Zambia,1,2,Friendly,Lubumbashi,Zaïre,False,3,-1,Zambia
9137,10086,10857,1979,Indonesia,Singapore,0,0,Merdeka Tournament,Kuala Lumpur,Malaysia,True,0,0,Draw
9138,10087,10858,1979,Burma,Japan,0,1,Merdeka Tournament,Kuala Lumpur,Malaysia,True,1,-1,Japan
9139,10088,10859,1979,Fiji,New Zealand,0,3,Friendly,Lautoka,Fiji,False,3,-3,New Zealand
9140,10089,10860,1979,Burma,Thailand,2,0,Merdeka Tournament,Kuala Lumpur,Malaysia,True,2,2,Burma
9141,10090,10861,1979,Finland,Russia,1,1,UEFA Euro qualification,Helsinki,Finland,False,2,0,Draw
9142,10091,10862,1979,Singapore,Thailand,1,1,Merdeka Tournament,Kuala Lumpur,Malaysia,True,2,0,Draw
9143,10092,10863,1979,Ivory Coast,Sudan,4,0,African Cup of Nations qualification,Abidjan,Ivory Coast,False,4,4,Ivory Coast
9144,10093,10864,1979,Malawi,Kenya,1,0,Friendly,Blantyre,Malawi,False,1,1,Malawi
9145,10094,10865,1979,DR Congo,Togo,4,1,Friendly,Kinshasa,Zaïre,False,5,3,DR Congo
9146,10095,10866,1979,Indonesia,Thailand,2,1,Merdeka Tournament,Kuala Lumpur,Malaysia,True,3,1,Indonesia
9147,10096,10867,1979,Malawi,Kenya,0,0,Friendly,Lilongwe,Malawi,False,0,0,Draw
9148,10097,10868,1979,Bolivia,Paraguay,3,1,Copa Paz del Chaco,La Paz,Bolivia,False,4,2,Bolivia
9149,10098,10869,1979,Burma,Singapore,4,1,Merdeka Tournament,Kuala Lumpur,Malaysia,True,5,3,Burma
9150,10099,10870,1979,Chile,Uruguay,1,0,Copa Juan Pinto Durán,Santiago,Chile,False,1,1,Chile
9151,10100,10871,1979,Indonesia,Japan,0,0,Merdeka Tournament,Kuala Lumpur,Malaysia,True,0,0,Draw
9152,10101,10872,1979,Peru,Ecuador,2,1,Friendly,Lima,Peru,False,3,1,Peru
9153,10102,10873,1979,Bolivia,Paraguay,1,1,Friendly,Cochabamba,Bolivia,False,2,0,Draw
9154,10103,10874,1979,Burma,Indonesia,4,0,Merdeka Tournament,Kuala Lumpur,Malaysia,True,4,4,Burma
9155,10104,10875,1979,Japan,Singapore,3,1,Merdeka Tournament,Kuala Lumpur,Malaysia,True,4,2,Japan
9156,10105,10876,1979,Kenya,DR Congo,2,2,Friendly,Nairobi,Kenya,False,4,0,Draw
9157,10106,10877,1979,Malawi,Tanzania,2,0,Friendly,Blantyre,Malawi,False,2,2,Malawi
9158,10107,10878,1979,Malawi,Tanzania,2,0,Friendly,Blantyre,Malawi,False,2,2,Malawi
9159,10108,10879,1979,Bolivia,Argentina,2,1,Copa América,La Paz,Bolivia,False,3,1,Bolivia
9160,10109,10880,1979,Peru,Colombia,0,1,Friendly,Lima,Peru,False,1,-1,Colombia
9161,10110,10881,1979,Uruguay,Chile,2,1,Copa Juan Pinto Durán,Montevideo,Uruguay,False,3,1,Uruguay
9162,10111,10882,1979,Malawi,Tanzania,0,1,Friendly,Blantyre,Malawi,False,1,-1,Tanzania
9163,10112,10883,1979,Kyrgyzstan,Lithuania,0,0,Friendly,Moscow,Soviet Union,True,0,0,Draw
9164,10113,10884,1979,Belarus,Armenia,3,0,Friendly,Minsk,Soviet Union,False,3,3,Belarus
9165,10114,10885,1979,Georgia,Lithuania,5,0,Friendly,Moscow,Soviet Union,True,5,5,Georgia
9166,10115,10886,1979,Grenada,Trinidad and Tobago,0,1,CFU Caribbean Cup qualification,St. George's,Grenada,False,1,-1,Trinidad and Tobago
9167,10116,10887,1979,Belarus,Latvia,2,1,Friendly,Minsk,Soviet Union,False,3,1,Belarus
9168,10117,10888,1979,Azerbaijan,Lithuania,0,1,Friendly,Moscow,Soviet Union,True,1,-1,Lithuania
9169,10118,10889,1979,Belarus,Russia,2,3,Friendly,Minsk,Soviet Union,False,5,-1,Russia
9170,10119,10890,1979,Benin,DR Congo,0,1,Friendly,Porto-Novo,Benin,False,1,-1,DR Congo
9171,10120,10891,1979,Colombia,Peru,1,2,Friendly,Bogotá,Colombia,False,3,-1,Peru
9172,10121,10892,1979,Bolivia,Brazil,2,1,Copa América,La Paz,Bolivia,False,3,1,Bolivia
9173,10122,10893,1979,Liberia,Ghana,3,1,Friendly,Monrovia,Liberia,False,4,2,Liberia
9174,10123,10894,1979,Benin,DR Congo,0,3,Friendly,Cotonou,Benin,False,3,-3,DR Congo
9175,10124,10895,1979,Lithuania,Ukraine,0,2,Friendly,Moscow,Soviet Union,True,2,-2,Ukraine
9176,10125,10896,1979,Russia,Belarus,0,0,Friendly,Moscow,Soviet Union,False,0,0,Draw
9177,10126,10897,1979,Madagascar,Tanzania,2,4,Friendly,Antananarivo,Madagascar,False,6,-2,Tanzania
9178,10127,10898,1979,Belarus,Ukraine,0,0,Friendly,Moscow,Soviet Union,True,0,0,Draw
9179,10128,10899,1979,Russia,Lithuania,2,0,Friendly,Moscow,Soviet Union,False,2,2,Russia
9180,10129,10900,1979,Belarus,Lithuania,0,2,Friendly,Moscow,Soviet Union,True,2,-2,Lithuania
9181,10130,10901,1979,Madagascar,Tanzania,1,0,Friendly,Antananarivo,Madagascar,False,1,1,Madagascar
9182,10131,10902,1979,Paraguay,Bolivia,2,0,Copa Paz del Chaco,Asunción,Paraguay,False,2,2,Paraguay
9183,10132,10903,1979,Venezuela,Colombia,0,0,Copa América,San Cristóbal,Venezuela,False,0,0,Draw
9184,10133,10904,1979,Brazil,Argentina,2,1,Copa América,Rio de Janeiro,Brazil,False,3,1,Brazil
9185,10134,10905,1979,Belarus,Kazakhstan,0,1,Friendly,Moscow,Soviet Union,True,1,-1,Kazakhstan
9186,10135,10906,1979,Trinidad and Tobago,Grenada,2,1,CFU Caribbean Cup qualification,San Fernando,Trinidad and Tobago,False,3,1,Trinidad and Tobago
9187,10136,10907,1979,DR Congo,Guinea,3,2,African Cup of Nations qualification,Kinshasa,Zaïre,False,5,1,DR Congo
9188,10137,10908,1979,Russia,Lithuania,2,1,Friendly,Moscow,Soviet Union,False,3,1,Russia
9189,10138,10909,1979,Argentina,Bolivia,3,0,Copa América,Buenos Aires,Argentina,False,3,3,Argentina
9190,10139,10910,1979,Ecuador,Peru,2,1,Friendly,Quito,Ecuador,False,3,1,Ecuador
9191,10140,10911,1979,Venezuela,Chile,1,1,Copa América,San Cristóbal,Venezuela,False,2,0,Draw
9192,10141,10912,1979,Colombia,Chile,1,0,Copa América,Bogotá,Colombia,False,1,1,Colombia
9193,10142,10913,1979,Norway,Sweden,2,0,Nordic Championship,Oslo,Norway,False,2,2,Norway
9194,10143,10914,1979,Brazil,Bolivia,2,0,Copa América,São Paulo,Brazil,False,2,2,Brazil
9195,10144,10915,1979,Guinea,DR Congo,3,1,African Cup of Nations qualification,Conakry,Guinea,False,4,2,Guinea
9196,10145,10916,1979,Poland,Libya,5,0,Friendly,Słupsk,Poland,False,5,5,Poland
9197,10146,10917,1979,Colombia,Venezuela,4,0,Copa América,Bogotá,Colombia,False,4,4,Colombia
9198,10147,10918,1979,Argentina,Brazil,2,2,Copa América,Buenos Aires,Argentina,False,4,0,Draw
9199,10148,10920,1979,Lesotho,Malawi,0,3,Friendly,Maseru,Lesotho,False,3,-3,Malawi
9200,10149,10921,1979,Tunisia,Malta,4,0,Friendly,Tunis,Tunisia,False,4,4,Tunisia
9201,10150,10922,1979,Austria,Norway,4,0,UEFA Euro qualification,Vienna,Austria,False,4,4,Austria
9202,10151,10923,1979,Chile,Venezuela,7,0,Copa América,Santiago,Chile,False,7,7,Chile
9203,10152,10924,1979,Ecuador,Paraguay,1,2,Copa América,Quito,Ecuador,False,3,-1,Paraguay
9204,10153,10925,1979,Finland,Denmark,0,0,Nordic Championship,Mikkeli,Finland,False,0,0,Draw
9205,10154,10926,1979,Guam,Vanuatu,0,4,South Pacific Games,Suva,Fiji,True,4,-4,Vanuatu
9206,10155,10927,1979,Poland,Romania,3,0,Friendly,Warsaw,Poland,False,3,3,Poland
9207,10157,10930,1979,Fiji,Papua New Guinea,0,0,South Pacific Games,Suva,Fiji,True,0,0,Draw
9208,10158,10931,1979,Fiji,Kiribati,24,0,South Pacific Games,Nausori,Fiji,False,24,24,Fiji
9209,10159,10932,1979,Guam,New Caledonia,1,10,South Pacific Games,Suva,Fiji,True,11,-9,New Caledonia
9210,10160,10933,1979,Peru,Uruguay,2,0,Friendly,Lima,Peru,False,2,2,Peru
9211,10161,10935,1979,Kiribati,Papua New Guinea,0,13,South Pacific Games,Suva,Fiji,True,13,-13,Papua New Guinea
9212,10162,10936,1979,Solomon Islands,Samoa,12,0,South Pacific Games,Suva,Fiji,True,12,12,Solomon Islands
9213,10163,10937,1979,New Caledonia,Vanuatu,3,0,South Pacific Games,Suva,Fiji,True,3,3,New Caledonia
9214,10164,10938,1979,Tonga,Tuvalu,3,5,South Pacific Games,Nausori,Fiji,True,8,-2,Tuvalu
9215,10166,10941,1979,Libya,Palestine,0,0,Friendly,Tripoli,Libya,False,0,0,Draw
9216,10167,10942,1979,New Caledonia,Tuvalu,11,0,South Pacific Games,Suva,Fiji,True,11,11,New Caledonia
9217,10168,10943,1979,Papua New Guinea,Solomon Islands,2,3,South Pacific Games,Nausori,Fiji,True,5,-1,Solomon Islands
9218,10170,10946,1979,Fiji,Solomon Islands,2,0,South Pacific Games,Suva,Fiji,False,2,2,Fiji
9219,10171,10947,1979,Chile,Colombia,2,0,Copa América,Santiago,Chile,False,2,2,Chile
9220,10172,10948,1979,Ecuador,Uruguay,2,1,Copa América,Quito,Ecuador,False,3,1,Ecuador
9221,10173,10949,1979,Guam,Samoa,4,2,South Pacific Games,Nausori,Fiji,True,6,2,Guam
9222,10174,10950,1979,Iceland,Netherlands,0,4,UEFA Euro qualification,Reykjavík,Iceland,False,4,-4,Netherlands
9223,10175,10951,1979,Kiribati,Tuvalu,3,3,South Pacific Games,Nausori,Fiji,True,6,0,Draw
9224,10177,10953,1979,Sweden,France,1,3,UEFA Euro qualification,Solna,Sweden,False,4,-2,France
9225,10179,10955,1979,Vanuatu,Papua New Guinea,2,0,South Pacific Games,Nausori,Fiji,True,2,2,Vanuatu
9226,10180,10956,1979,Guam,Tuvalu,7,2,South Pacific Games,Nausori,Fiji,True,9,5,Guam
9227,10181,10957,1979,Vanuatu,Tonga,7,1,South Pacific Games,Nausori,Fiji,True,8,6,Vanuatu
9228,10182,10958,1979,New Caledonia,Solomon Islands,1,3,South Pacific Games,Suva,Fiji,True,4,-2,Solomon Islands
9229,10184,10961,1979,Indonesia,Thailand,0,2,Korea Cup,Seoul,South Korea,True,2,-2,Thailand
9230,10185,10962,1979,Bangladesh,Sudan,1,4,Korea Cup,Seoul,South Korea,True,5,-3,Sudan
9231,10186,10963,1979,Wales,Republic of Ireland,2,1,Friendly,Swansea,Wales,False,3,1,Wales
9232,10187,10964,1979,England,Denmark,1,0,UEFA Euro qualification,London,England,False,1,1,England
9233,10188,10965,1979,Germany,Argentina,2,1,Friendly,Berlin,Germany,False,3,1,Germany
9234,10189,10966,1979,Greece,Russia,1,0,UEFA Euro qualification,Athens,Greece,False,1,1,Greece
9235,10192,10970,1979,Norway,Belgium,1,2,UEFA Euro qualification,Oslo,Norway,False,3,-1,Belgium
9236,10193,10971,1979,Scotland,Peru,1,1,Friendly,Glasgow,Scotland,False,2,0,Draw
9237,10194,10972,1979,Switzerland,Poland,0,2,UEFA Euro qualification,Lausanne,Switzerland,False,2,-2,Poland
9238,10195,10973,1979,Paraguay,Ecuador,2,0,Copa América,Asunción,Paraguay,False,2,2,Paraguay
9239,10196,10976,1979,Sri Lanka,Sudan,0,1,Korea Cup,Incheon,South Korea,True,1,-1,Sudan
9240,10197,10977,1979,Uruguay,Ecuador,2,1,Copa América,Montevideo,Uruguay,False,3,1,Uruguay
9241,10198,10979,1979,Paraguay,Uruguay,0,0,Copa América,Asunción,Paraguay,False,0,0,Draw
9242,10199,10980,1979,Austria,Hungary,3,1,Friendly,Vienna,Austria,False,4,2,Austria
9243,10200,10982,1979,Denmark,Finland,1,0,Nordic Championship,Copenhagen,Denmark,False,1,1,Denmark
9244,10201,10983,1979,Italy,Sweden,1,0,Friendly,Florence,Italy,False,1,1,Italy
9245,10202,10984,1979,Netherlands,Belgium,1,0,Friendly,Rotterdam,Netherlands,False,1,1,Netherlands
9246,10204,10986,1979,Spain,Portugal,1,1,Friendly,Vigo,Spain,False,2,0,Draw
9247,10205,10987,1979,Uruguay,Paraguay,2,2,Copa América,Montevideo,Uruguay,False,4,0,Draw
9248,10206,10988,1979,Haiti,Antigua and Barbuda,1,0,CFU Caribbean Cup qualification,Port-au-Prince,Haiti,False,1,1,Haiti
9249,10207,10989,1979,Senegal,Nigeria,0,2,Friendly,Dakar,Senegal,False,2,-2,Nigeria
9250,10208,10990,1979,Sierra Leone,Gambia,2,0,Friendly,Freetown,Sierra Leone,False,2,2,Sierra Leone
9251,10209,10991,1979,Bahrain,New Zealand,0,2,Friendly,Isa Town,Bahrain,False,2,-2,New Zealand
9252,10210,10992,1979,Bermuda,United States,1,3,Friendly,Hamilton,Bermuda,False,4,-2,United States
9253,10211,10993,1979,Bahrain,New Zealand,1,2,Friendly,Isa Town,Bahrain,False,3,-1,New Zealand
9254,10212,10995,1979,France,United States,3,0,Friendly,Paris,France,False,3,3,France
9255,10213,10996,1979,Peru,Paraguay,2,3,Friendly,Lima,Peru,False,5,-1,Paraguay
9256,10214,10997,1979,Poland,Iceland,2,0,UEFA Euro qualification,Cracow,Poland,False,2,2,Poland
9257,10216,11000,1979,Benin,Nigeria,1,1,Friendly,Cotonou,Benin,False,2,0,Draw
9258,10217,11001,1979,Russia,Romania,3,1,Friendly,Moscow,Soviet Union,False,4,2,Russia
9259,10218,11002,1979,Antigua and Barbuda,Haiti,1,2,CFU Caribbean Cup qualification,St. John's,Antigua and Barbuda,False,3,-1,Haiti
9260,10219,11003,1979,Belgium,Portugal,2,0,UEFA Euro qualification,Brussels,Belgium,False,2,2,Belgium
9261,10220,11004,1979,Germany,Wales,5,1,UEFA Euro qualification,Cologne,Germany,False,6,4,Germany
9262,10221,11005,1979,Hungary,Finland,3,1,UEFA Euro qualification,Debrecen,Hungary,False,4,2,Hungary
9263,10222,11006,1979,Republic of Ireland,Bulgaria,3,0,UEFA Euro qualification,Dublin,Republic of Ireland,False,3,3,Republic of Ireland
9264,10223,11007,1979,Netherlands,Poland,1,1,UEFA Euro qualification,Amsterdam,Netherlands,False,2,0,Draw
9265,10224,11008,1979,Northern Ireland,England,1,5,UEFA Euro qualification,Belfast,Northern Ireland,False,6,-4,England
9266,10225,11009,1979,Peru,Chile,1,2,Copa América,Lima,Peru,False,3,-1,Chile
9267,10226,11010,1979,Scotland,Austria,1,1,UEFA Euro qualification,Glasgow,Scotland,False,2,0,Draw
9268,10227,11011,1979,Benin,Burkina Faso,3,2,Friendly,Abidjan,Ivory Coast,True,5,1,Benin
9269,10228,11012,1979,Ivory Coast,Togo,3,0,Friendly,Abidjan,Ivory Coast,False,3,3,Ivory Coast
9270,10229,11013,1979,United Arab Emirates,India,0,0,Friendly,Abu Dhabi,United Arab Emirates,False,0,0,Draw
9271,10230,11014,1979,Guadeloupe,Saint Vincent and the Grenadines,1,3,CFU Caribbean Cup qualification,Basse-Terre,Guadeloupe,False,4,-2,Saint Vincent and the Grenadines
9272,10231,11015,1979,Saint Vincent and the Grenadines,Guadeloupe,0,0,CFU Caribbean Cup qualification,Kingstown,Saint Vincent and the Grenadines,False,0,0,Draw
9273,10232,11016,1979,Luxembourg,Sweden,1,1,UEFA Euro qualification,Esch-sur-Alzette,Luxembourg,False,2,0,Draw
9274,10233,11017,1979,Togo,Burkina Faso,5,3,Friendly,Abidjan,Ivory Coast,True,8,2,Togo
9275,10234,11018,1979,Chile,Peru,0,0,Copa América,Santiago,Chile,False,0,0,Draw
9276,10235,11019,1979,Paraguay,Brazil,2,1,Copa América,Asunción,Paraguay,False,3,1,Paraguay
9277,10236,11020,1979,Liberia,Nigeria,2,2,Friendly,Monrovia,Liberia,False,4,0,Draw
9278,10237,11021,1979,Hungary,United States,0,2,Friendly,Budapest,Hungary,False,2,-2,United States
9279,10238,11022,1979,Ivory Coast,Benin,3,1,Friendly,Abidjan,Ivory Coast,False,4,2,Ivory Coast
9280,10239,11023,1979,Niger,Togo,2,2,Friendly,Abidjan,Ivory Coast,True,4,0,Draw
9281,10240,11024,1979,Sierra Leone,Nigeria,0,0,Friendly,Freetown,Sierra Leone,False,0,0,Draw
9282,10241,11025,1979,Benin,Niger,0,1,Friendly,Abidjan,Ivory Coast,True,1,-1,Niger
9283,10242,11026,1979,Haiti,Jamaica,3,0,CFU Caribbean Cup qualification,Port-au-Prince,Haiti,False,3,3,Haiti
9284,10243,11027,1979,Ivory Coast,Togo,0,1,Friendly,Abidjan,Ivory Coast,False,1,-1,Togo
9285,10244,11028,1979,Malta,Turkey,1,2,UEFA Euro qualification,Gżira,Malta,False,3,-1,Turkey
9286,10245,11029,1979,Republic of Ireland,United States,3,2,Friendly,Dublin,Republic of Ireland,False,5,1,Republic of Ireland
9287,10246,11030,1979,Brazil,Paraguay,2,2,Copa América,Rio de Janeiro,Brazil,False,4,0,Draw
9288,10247,11031,1979,Bulgaria,Denmark,3,0,UEFA Euro qualification,Sofia,Bulgaria,False,3,3,Bulgaria
9289,10248,11032,1979,Russia,Finland,2,2,UEFA Euro qualification,Moscow,Soviet Union,False,4,0,Draw
9290,10249,11034,1979,Mexico,Peru,1,0,Friendly,Monterrey,Mexico,False,1,1,Mexico
9291,10250,11035,1979,Portugal,Norway,3,1,UEFA Euro qualification,Oeiras,Portugal,False,4,2,Portugal
9292,10251,11036,1979,Jamaica,Haiti,0,4,CFU Caribbean Cup qualification,Kingston,Jamaica,False,4,-4,Haiti
9293,10252,11037,1979,Kenya,Tanzania,0,0,CECAFA Cup,Nairobi,Kenya,False,0,0,Draw
9294,10253,11038,1979,Sierra Leone,Senegal,1,0,Friendly,Freetown,Sierra Leone,False,1,1,Sierra Leone
9295,10255,11040,1979,Nigeria,Benin,5,0,Friendly,Lagos,Nigeria,False,5,5,Nigeria
9296,10256,11041,1979,Uganda,Zambia,1,2,CECAFA Cup,Nairobi,Kenya,True,3,-1,Zambia
9297,10257,11042,1979,Tanzania,Zambia,2,2,CECAFA Cup,Nairobi,Kenya,True,4,0,Draw
9298,10258,11043,1979,Kenya,Uganda,3,1,CECAFA Cup,Nairobi,Kenya,False,4,2,Kenya
9299,10259,11044,1979,Malawi,Sudan,4,0,CECAFA Cup,Mombasa,Kenya,True,4,4,Malawi
9300,10261,11046,1979,Tanzania,Uganda,5,3,CECAFA Cup,Nairobi,Kenya,True,8,2,Tanzania
9301,10262,11047,1979,Kenya,Zambia,3,1,CECAFA Cup,Nairobi,Kenya,False,4,2,Kenya
9302,10263,11048,1979,Haiti,Trinidad and Tobago,1,0,CFU Caribbean Cup,Paramaribo,Suriname,True,1,1,Haiti
9303,10264,11049,1979,Suriname,Saint Vincent and the Grenadines,2,3,CFU Caribbean Cup,Paramaribo,Suriname,False,5,-1,Saint Vincent and the Grenadines
9304,10265,11050,1979,Malawi,Tanzania,1,1,CECAFA Cup,Mombasa,Kenya,True,2,0,Draw
9305,10266,11051,1979,Haiti,Saint Vincent and the Grenadines,3,1,CFU Caribbean Cup,Paramaribo,Suriname,True,4,2,Haiti
9306,10268,11053,1979,Malawi,Tanzania,4,0,CECAFA Cup,Nairobi,Kenya,True,4,4,Malawi
9307,10269,11054,1979,Malaysia,Sweden,1,3,Friendly,Kuala Lumpur,Malaysia,False,4,-2,Sweden
9308,10270,11055,1979,Spain,Denmark,1,3,Friendly,Cádiz,Spain,False,4,-2,Denmark
9309,10271,11057,1979,Suriname,Trinidad and Tobago,3,0,CFU Caribbean Cup,Paramaribo,Suriname,False,3,3,Suriname
9310,10274,11060,1979,Italy,Switzerland,2,0,Friendly,Udine,Italy,False,2,2,Italy
9311,10275,11061,1979,Kenya,Malawi,2,3,CECAFA Cup,Nairobi,Kenya,False,5,-1,Malawi
9312,10276,11062,1979,Singapore,Sweden,0,5,Friendly,Kallang,Singapore,False,5,-5,Sweden
9313,10277,11063,1979,Romania,Cyprus,2,0,UEFA Euro qualification,Bucharest,Romania,False,2,2,Romania
9314,10278,11064,1979,Suriname,Haiti,0,1,CFU Caribbean Cup,Paramaribo,Suriname,False,1,-1,Haiti
9315,10279,11065,1979,Belgium,Scotland,2,0,UEFA Euro qualification,Brussels,Belgium,False,2,2,Belgium
9316,10281,11068,1979,Northern Ireland,Republic of Ireland,1,0,UEFA Euro qualification,Belfast,Northern Ireland,False,1,1,Northern Ireland
9317,10282,11069,1979,Portugal,Austria,1,2,UEFA Euro qualification,Lisbon,Portugal,False,3,-1,Austria
9318,10283,11070,1979,Russia,Germany,1,3,Friendly,Tbilisi,Soviet Union,False,4,-2,Germany
9319,10284,11071,1979,Turkey,Wales,1,0,UEFA Euro qualification,Izmir,Turkey,False,1,1,Turkey
9320,10285,11072,1979,England,Bulgaria,2,0,UEFA Euro qualification,London,England,False,2,2,England
9321,10286,11073,1979,Thailand,Sri Lanka,5,1,King's Cup,Bangkok,Thailand,False,6,4,Thailand
9322,10287,11075,1979,Thailand,Indonesia,3,0,King's Cup,Bangkok,Thailand,False,3,3,Thailand
9323,10288,11076,1979,Angola,Gabon,1,0,Friendly,Luanda,Angola,False,1,1,Angola
9324,10289,11077,1979,Bermuda,Finland,0,2,Friendly,Hamilton,Bermuda,False,2,-2,Finland
9325,10290,11078,1979,Indonesia,Sri Lanka,0,0,King's Cup,Bangkok,Thailand,True,0,0,Draw
9326,10291,11079,1979,Angola,Cameroon,0,1,Friendly,Luanda,Angola,False,1,-1,Cameroon
9327,10292,11080,1979,Cameroon,Congo,1,3,Friendly,Luanda,Angola,True,4,-2,Congo
9328,10293,11081,1979,Paraguay,Chile,3,0,Copa América,Asunción,Paraguay,False,3,3,Paraguay
9329,10294,11082,1979,Angola,Congo,0,1,Friendly,Luanda,Angola,False,1,-1,Congo
9330,10295,11083,1979,Cameroon,Gabon,3,1,Friendly,Luanda,Angola,True,4,2,Cameroon
9331,10296,11084,1979,El Salvador,Mexico,0,2,Friendly,San Salvador,El Salvador,False,2,-2,Mexico
9332,10297,11085,1979,Chile,Paraguay,1,0,Copa América,Santiago,Chile,False,1,1,Chile
9333,10298,11086,1979,Cyprus,Spain,1,3,UEFA Euro qualification,Limassol,Cyprus,False,4,-2,Spain
9334,10299,11087,1979,Chile,Paraguay,0,0,Copa América,Buenos Aires,Argentina,True,0,0,Draw
9335,10300,11088,1979,Mexico,El Salvador,1,1,Friendly,Texcoco,Mexico,False,2,0,Draw
9336,10301,11089,1979,Scotland,Belgium,1,3,UEFA Euro qualification,Glasgow,Scotland,False,4,-2,Belgium
9337,10302,11090,1979,Germany,Turkey,2,0,UEFA Euro qualification,Gelsenkirchen,Germany,False,2,2,Germany
9338,10303,11092,1979,Tunisia,Senegal,3,1,Friendly,Tunis,Tunisia,False,4,2,Tunisia
9339,10304,11093,1980,Sierra Leone,Ghana,2,4,Friendly,Freetown,Sierra Leone,False,6,-2,Ghana
9340,10305,11094,1980,Cyprus,Greece,1,1,Friendly,Nicosia,Cyprus,False,2,0,Draw
9341,10306,11095,1980,Congo,Ivory Coast,2,0,Friendly,Brazzaville,Congo,False,2,2,Congo
9342,10307,11096,1980,Congo,Ivory Coast,0,2,Friendly,Brazzaville,Congo,False,2,-2,Ivory Coast
9343,10308,11097,1980,Spain,Netherlands,1,0,Friendly,Vigo,Spain,False,1,1,Spain
9344,10309,11098,1980,Nigeria,Liberia,1,0,Friendly,Lagos,Nigeria,False,1,1,Nigeria
9345,10311,11100,1980,Cameroon,Ivory Coast,1,1,Friendly,Douala,Cameroon,False,2,0,Draw
9346,10312,11101,1980,Ghana,Tunisia,4,1,Friendly,Accra,Ghana,False,5,3,Ghana
9347,10313,11102,1980,Ivory Coast,Tunisia,1,1,Friendly,Abidjan,Ivory Coast,False,2,0,Draw
9348,10315,11104,1980,Congo,Gabon,3,0,Friendly,Brazzaville,Congo,False,3,3,Congo
9349,10317,11106,1980,Nigeria,Cameroon,0,0,Friendly,Ibadan,Nigeria,False,0,0,Draw
9350,10319,11108,1980,England,Republic of Ireland,2,0,UEFA Euro qualification,London,England,False,2,2,England
9351,10321,11110,1980,Gambia,Guinea-Bissau,2,0,Amílcar Cabral Cup,Banjul,Gambia,False,2,2,Gambia
9352,10322,11111,1980,Mali,Senegal,1,0,Amílcar Cabral Cup,Banjul,Gambia,True,1,1,Mali
9353,10323,11112,1980,Guinea-Bissau,Guinea,1,2,Amílcar Cabral Cup,Banjul,Gambia,True,3,-1,Guinea
9354,10324,11113,1980,Ivory Coast,Morocco,4,4,Friendly,Abidjan,Ivory Coast,False,8,0,Draw
9355,10325,11114,1980,Mali,Mauritania,0,1,Amílcar Cabral Cup,Banjul,Gambia,True,1,-1,Mauritania
9356,10326,11115,1980,Gambia,Guinea,0,0,Amílcar Cabral Cup,Banjul,Gambia,False,0,0,Draw
9357,10328,11117,1980,Mauritania,Senegal,1,2,Amílcar Cabral Cup,Banjul,Gambia,True,3,-1,Senegal
9358,10329,11118,1980,Gambia,Mauritania,2,2,Amílcar Cabral Cup,Banjul,Gambia,False,4,0,Draw
9359,10330,11119,1980,Guinea,Senegal,1,2,Amílcar Cabral Cup,Banjul,Gambia,True,3,-1,Senegal
9360,10331,11120,1980,Italy,Romania,2,1,Friendly,Naples,Italy,False,3,1,Italy
9361,10332,11121,1980,Guinea-Bissau,Mali,2,4,Amílcar Cabral Cup,Banjul,Gambia,True,6,-2,Mali
9362,10333,11122,1980,Morocco,Poland,1,0,Friendly,Marrakech,Morocco,False,1,1,Morocco
9363,10334,11123,1980,Gambia,Senegal,0,1,Amílcar Cabral Cup,Banjul,Gambia,False,1,-1,Senegal
9364,10335,11124,1980,Fiji,New Zealand,1,1,Friendly,Suva,Fiji,False,2,0,Draw
9365,10336,11125,1980,Fiji,New Zealand,0,2,Friendly,Lautoka,Fiji,False,2,-2,New Zealand
9366,10337,11126,1980,New Caledonia,Australia,0,8,Oceania Nations Cup,Nouméa,New Caledonia,False,8,-8,Australia
9367,10338,11127,1980,Vanuatu,Papua New Guinea,3,4,Oceania Nations Cup,Nouméa,New Caledonia,True,7,-1,Papua New Guinea
9368,10339,11128,1980,Fiji,Solomon Islands,3,1,Oceania Nations Cup,Nouméa,New Caledonia,True,4,2,Fiji
9369,10340,11129,1980,Morocco,Senegal,3,2,Friendly,Casablanca,Morocco,False,5,1,Morocco
9370,10342,11131,1980,Australia,Papua New Guinea,11,2,Oceania Nations Cup,Nouméa,New Caledonia,True,13,9,Australia
9371,10344,11133,1980,New Caledonia,Vanuatu,4,3,Oceania Nations Cup,Nouméa,New Caledonia,False,7,1,New Caledonia
9372,10345,11134,1980,Belgium,Luxembourg,5,0,Friendly,Brussels,Belgium,False,5,5,Belgium
9373,10346,11135,1980,Fiji,New Zealand,4,0,Oceania Nations Cup,Nouméa,New Caledonia,True,4,4,Fiji
9374,10347,11136,1980,France,Greece,5,1,Friendly,Paris,France,False,6,4,France
9375,10348,11137,1980,Germany,Malta,8,0,UEFA Euro qualification,Bremen,Germany,False,8,8,Germany
9376,10349,11138,1980,Iraq,Poland,1,1,Friendly,Baghdad,Iraq,False,2,0,Draw
9377,10350,11139,1980,Morocco,Tunisia,0,0,Friendly,Meknès,Morocco,False,0,0,Draw
9378,10352,11141,1980,Australia,Vanuatu,1,0,Oceania Nations Cup,Nouméa,New Caledonia,True,1,1,Australia
9379,10353,11142,1980,New Caledonia,Papua New Guinea,8,0,Oceania Nations Cup,Nouméa,New Caledonia,False,8,8,New Caledonia
9380,10355,11144,1980,Iraq,Poland,1,0,Friendly,Baghdad,Iraq,False,1,1,Iraq
9381,10356,11145,1980,New Zealand,Solomon Islands,6,1,Oceania Nations Cup,Nouméa,New Caledonia,True,7,5,New Zealand
9382,10358,11147,1980,New Caledonia,Fiji,2,1,Oceania Nations Cup,Nouméa,New Caledonia,False,3,1,New Caledonia
9383,10359,11148,1980,Sierra Leone,Guinea,3,2,Friendly,Freetown,Sierra Leone,False,5,1,Sierra Leone
9384,10360,11149,1980,Honduras,Costa Rica,1,1,Friendly,Tegucigalpa,Honduras,False,2,0,Draw
9385,10361,11150,1980,Egypt,Ivory Coast,2,1,African Cup of Nations,Lagos,Nigeria,True,3,1,Egypt
9386,10362,11151,1980,Kuwait,Bulgaria,1,1,Friendly,Kuwait City,Kuwait,False,2,0,Draw
9387,10363,11152,1980,Nigeria,Tanzania,3,1,African Cup of Nations,Lagos,Nigeria,False,4,2,Nigeria
9388,10364,11153,1980,Algeria,Ghana,0,0,African Cup of Nations,Ibadan,Nigeria,True,0,0,Draw
9389,10365,11154,1980,Guinea,Morocco,1,1,African Cup of Nations,Ibadan,Nigeria,True,2,0,Draw
9390,10366,11155,1980,Egypt,Tanzania,2,1,African Cup of Nations,Lagos,Nigeria,True,3,1,Egypt
9391,10367,11156,1980,Malaysia,Saudi Arabia,3,0,Friendly,Kuala Lumpur,Malaysia,False,3,3,Malaysia
9392,10368,11157,1980,Nigeria,Ivory Coast,0,0,African Cup of Nations,Lagos,Nigeria,False,0,0,Draw
9393,10369,11158,1980,Algeria,Morocco,1,0,African Cup of Nations,Ibadan,Nigeria,True,1,1,Algeria
9394,10370,11159,1980,Ghana,Guinea,1,0,African Cup of Nations,Ibadan,Nigeria,True,1,1,Ghana
9395,10371,11160,1980,Italy,Uruguay,1,0,Friendly,Milan,Italy,False,1,1,Italy
9396,10372,11161,1980,Ivory Coast,Tanzania,1,1,African Cup of Nations,Lagos,Nigeria,True,2,0,Draw
9397,10373,11162,1980,Nigeria,Egypt,1,0,African Cup of Nations,Lagos,Nigeria,False,1,1,Nigeria
9398,10374,11163,1980,Algeria,Guinea,3,2,African Cup of Nations,Ibadan,Nigeria,True,5,1,Algeria
9399,10375,11164,1980,Ghana,Morocco,0,1,African Cup of Nations,Ibadan,Nigeria,True,1,-1,Morocco
9400,10377,11166,1980,Belgium,Uruguay,2,0,Friendly,Brussels,Belgium,False,2,2,Belgium
9401,10378,11167,1980,Honduras,Mexico,0,1,Friendly,Tegucigalpa,Honduras,False,1,-1,Mexico
9402,10379,11168,1980,Algeria,Egypt,2,2,African Cup of Nations,Ibadan,Nigeria,True,4,0,Draw
9403,10380,11169,1980,Nigeria,Morocco,1,0,African Cup of Nations,Lagos,Nigeria,False,1,1,Nigeria
9404,10381,11171,1980,Egypt,Morocco,0,2,African Cup of Nations,Lagos,Nigeria,True,2,-2,Morocco
9405,10382,11172,1980,Nigeria,Algeria,3,0,African Cup of Nations,Lagos,Nigeria,False,3,3,Nigeria
9406,10383,11174,1980,Bulgaria,Russia,1,3,Friendly,Sofia,Bulgaria,False,4,-2,Russia
9407,10384,11175,1980,Cyprus,Republic of Ireland,2,3,FIFA World Cup qualification,Nicosia,Cyprus,False,5,-1,Republic of Ireland
9408,10385,11176,1980,France,Netherlands,0,0,Friendly,Paris,France,False,0,0,Draw
9409,10386,11177,1980,Hungary,Poland,2,1,Friendly,Budapest,Hungary,False,3,1,Hungary
9410,10387,11178,1980,Israel,Northern Ireland,0,0,FIFA World Cup qualification,Ramat-Gan,Israel,False,0,0,Draw
9411,10388,11179,1980,Luxembourg,Uruguay,0,1,Friendly,Esch-sur-Alzette,Luxembourg,False,1,-1,Uruguay
9412,10389,11180,1980,Scotland,Portugal,4,1,UEFA Euro qualification,Glasgow,Scotland,False,5,3,Scotland
9413,10390,11181,1980,Spain,England,0,2,Friendly,Barcelona,Spain,False,2,-2,England
9414,10392,11183,1980,Guyana,Grenada,5,2,FIFA World Cup qualification,Georgetown,Guyana,False,7,3,Guyana
9415,10393,11185,1980,Switzerland,Greece,2,0,Friendly,Zürich,Switzerland,False,2,2,Switzerland
9416,10394,11186,1980,Belgium,Poland,2,1,Friendly,Brussels,Belgium,False,3,1,Belgium
9417,10395,11187,1980,Germany,Austria,1,0,Friendly,Munich,Germany,False,1,1,Germany
9418,10397,11189,1980,Senegal,Tunisia,0,2,Friendly,Dakar,Senegal,False,2,-2,Tunisia
9419,10398,11190,1980,Ivory Coast,Gabon,4,1,Friendly,Abidjan,Ivory Coast,False,5,3,Ivory Coast
9420,10399,11191,1980,Mexico,Honduras,5,0,Friendly,Toluca,Mexico,False,5,5,Mexico
9421,10400,11192,1980,Grenada,Guyana,2,3,FIFA World Cup qualification,St. George's,Grenada,False,5,-1,Guyana
9422,10401,11193,1980,Guatemala,Mexico,2,4,Friendly,Guatemala,Guatemala,False,6,-2,Mexico
9423,10402,11194,1980,Costa Rica,Honduras,1,1,Friendly,San José,Costa Rica,False,2,0,Draw
9424,10404,11197,1980,Italy,Poland,2,2,Friendly,Turin,Italy,False,4,0,Draw
9425,10405,11198,1980,Tanzania,Zambia,0,2,Friendly,Bulawayo,Zimbabwe,True,2,-2,Zambia
9426,10406,11199,1980,Zimbabwe,Mozambique,6,0,Friendly,Salisbury,Zimbabwe,False,6,6,Zimbabwe
9427,10407,11200,1980,Mozambique,Tanzania,0,2,Friendly,Bulawayo,Zimbabwe,True,2,-2,Tanzania
9428,10408,11201,1980,Zimbabwe,Zambia,2,1,Friendly,Salisbury,Zimbabwe,False,3,1,Zimbabwe
9429,10409,11203,1980,Malta,Libya,0,3,Friendly,Gzira,Malta,False,3,-3,Libya
9430,10410,11204,1980,Mexico,Guatemala,2,2,Friendly,Toluca,Mexico,False,4,0,Draw
9431,10411,11205,1980,Sweden,Russia,1,5,Friendly,Malmö,Sweden,False,6,-4,Russia
9432,10412,11207,1980,Republic of Ireland,Switzerland,2,0,Friendly,Dublin,Republic of Ireland,False,2,2,Republic of Ireland
9433,10413,11208,1980,Senegal,Guinea,1,0,Friendly,Dakar,Senegal,False,1,1,Senegal
9434,10414,11209,1980,Thailand,Luxembourg,0,1,Friendly,Medan,Indonesia,True,1,-1,Luxembourg
9435,10415,11210,1980,Zambia,Malawi,1,1,Friendly,Lusaka,Zambia,False,2,0,Draw
9436,10416,11211,1980,Sweden,Denmark,0,1,Nordic Championship,Gothenburg,Sweden,False,1,-1,Denmark
9437,10417,11212,1980,Libya,Gambia,2,1,FIFA World Cup qualification,Tripoli,Libya,False,3,1,Libya
9438,10418,11214,1980,Martinique,Guadeloupe,1,0,Friendly,Fort-de-France,Martinique,False,1,1,Martinique
9439,10419,11215,1980,Panama,El Salvador,0,0,Friendly,Panama City,Panama,False,0,0,Draw
9440,10420,11216,1980,Japan,Luxembourg,1,0,Friendly,Medan,Indonesia,True,1,1,Japan
9441,10421,11217,1980,Burma,Luxembourg,2,0,Friendly,Medan,Indonesia,True,2,2,Burma
9442,10422,11218,1980,England,Argentina,3,1,Friendly,London,England,False,4,2,England
9443,10423,11219,1980,Germany,Poland,3,1,Friendly,Frankfurt am Main,Germany,False,4,2,Germany
9444,10424,11220,1980,Haiti,El Salvador,2,0,Friendly,Port-au-Prince,Haiti,False,2,2,Haiti
9445,10425,11221,1980,Greece,Bulgaria,0,0,Friendly,Athens,Greece,False,0,0,Draw
9446,10426,11223,1980,Republic of Ireland,Argentina,0,1,Friendly,Dublin,Republic of Ireland,False,1,-1,Argentina
9447,10427,11224,1980,Northern Ireland,Scotland,1,0,British Championship,Belfast,Northern Ireland,False,1,1,Northern Ireland
9448,10428,11225,1980,Wales,England,4,1,British Championship,Wrexham,Wales,False,5,3,Wales
9449,10429,11226,1980,Ethiopia,Zambia,0,0,FIFA World Cup qualification,Addis Abeba,Ethiopia,False,0,0,Draw
9450,10430,11227,1980,England,Northern Ireland,1,1,British Championship,London,England,False,2,0,Draw
9451,10431,11228,1980,Guatemala,Costa Rica,0,0,Friendly,Guatemala,Guatemala,False,0,0,Draw
9452,10432,11229,1980,Austria,Argentina,1,5,Friendly,Vienna,Austria,False,6,-4,Argentina
9453,10433,11230,1980,Denmark,Spain,2,2,Friendly,Copenhagen,Denmark,False,4,0,Draw
9454,10434,11231,1980,Scotland,Wales,1,0,British Championship,Glasgow,Scotland,False,1,1,Scotland
9455,10435,11232,1980,Finland,Sweden,0,2,Nordic Championship,Helsinki,Finland,False,2,-2,Sweden
9456,10436,11233,1980,Norway,Bulgaria,1,0,Friendly,Oslo,Norway,False,1,1,Norway
9457,10437,11234,1980,Russia,France,1,0,Friendly,Moscow,Soviet Union,False,1,1,Russia
9458,10438,11235,1980,Wales,Northern Ireland,0,1,British Championship,Cardiff,Wales,False,1,-1,Northern Ireland
9459,10439,11236,1980,Scotland,England,0,2,British Championship,Glasgow,Scotland,False,2,-2,England
9460,10440,11237,1980,Poland,Scotland,1,0,Friendly,Poznań,Poland,False,1,1,Poland
9461,10441,11238,1980,Costa Rica,Guatemala,2,1,Friendly,San José,Costa Rica,False,3,1,Costa Rica
9462,10442,11239,1980,Australia,England,1,2,Friendly,Sydney,Australia,False,3,-1,England
9463,10443,11240,1980,Hungary,Scotland,3,1,Friendly,Budapest,Hungary,False,4,2,Hungary
9464,10444,11241,1980,Sierra Leone,Algeria,2,2,FIFA World Cup qualification,Freetown,Sierra Leone,False,4,0,Draw
9465,10445,11242,1980,Macau,Hong Kong,0,2,Friendly,Macau,Macau,False,2,-2,Hong Kong
9466,10446,11243,1980,Zambia,Ethiopia,4,0,FIFA World Cup qualification,Ndola,Zambia,False,4,4,Zambia
9467,10447,11244,1980,Iceland,Wales,0,4,FIFA World Cup qualification,Reykjavík,Iceland,False,4,-4,Wales
9468,10448,11245,1980,Denmark,Norway,3,1,Nordic Championship,Copenhagen,Denmark,False,4,2,Denmark
9469,10449,11246,1980,El Salvador,Haiti,3,0,Friendly,San Salvador,El Salvador,False,3,3,El Salvador
9470,10450,11247,1980,Finland,Bulgaria,0,2,FIFA World Cup qualification,Helsinki,Finland,False,2,-2,Bulgaria
9471,10451,11248,1980,Hungary,Austria,1,1,Friendly,Budapest,Hungary,False,2,0,Draw
9472,10452,11249,1980,Belgium,Romania,2,1,Friendly,Brussels,Belgium,False,3,1,Belgium
9473,10453,11250,1980,Honduras,Haiti,3,1,Friendly,Tegucigalpa,Honduras,False,4,2,Honduras
9474,10454,11251,1980,Zambia,Zimbabwe,2,1,Friendly,Ndola,Zambia,False,3,1,Zambia
9475,10455,11252,1980,Brazil,Mexico,2,0,Friendly,Rio de Janeiro,Brazil,False,2,2,Brazil
9476,10456,11253,1980,Tunisia,Morocco,0,1,Friendly,Tunis,Tunisia,False,1,-1,Morocco
9477,10457,11254,1980,Zambia,Zimbabwe,1,3,Friendly,Lusaka,Zambia,False,4,-2,Zimbabwe
9478,10458,11255,1980,Hong Kong,Japan,1,3,Friendly,Guangzhou,China PR,True,4,-2,Japan
9479,10459,11256,1980,Honduras,Haiti,1,0,Friendly,San Pedro Sula,Honduras,False,1,1,Honduras
9480,10460,11259,1980,Netherlands,Greece,1,0,UEFA Euro,Naples,Italy,True,1,1,Netherlands
9481,10461,11260,1980,Belgium,England,1,1,UEFA Euro,Turin,Italy,True,2,0,Draw
9482,10462,11261,1980,Guatemala,Haiti,1,2,Friendly,Guatemala,Guatemala,False,3,-1,Haiti
9483,10463,11262,1980,Italy,Spain,0,0,UEFA Euro,Milan,Italy,False,0,0,Draw
9484,10464,11263,1980,Algeria,Sierra Leone,3,1,FIFA World Cup qualification,Oran,Algeria,False,4,2,Algeria
9485,10465,11265,1980,Honduras,Panama,0,0,Friendly,Tegucigalpa,Honduras,False,0,0,Draw
9486,10466,11266,1980,Togo,Nigeria,0,1,Friendly,Lomé,Togo,False,1,-1,Nigeria
9487,10467,11267,1980,Germany,Netherlands,3,2,UEFA Euro,Naples,Italy,True,5,1,Germany
9488,10469,11269,1980,Australia,Northern Ireland,1,1,Friendly,Melbourne,Australia,False,2,0,Draw
9489,10470,11270,1980,Belgium,Spain,2,1,UEFA Euro,Milan,Italy,True,3,1,Belgium
9490,10471,11271,1980,Brazil,Russia,1,2,Friendly,Rio de Janeiro,Brazil,False,3,-1,Russia
9491,10472,11272,1980,Honduras,Panama,2,0,Friendly,Tegucigalpa,Honduras,False,2,2,Honduras
9492,10473,11273,1980,Italy,England,1,0,UEFA Euro,Turin,Italy,False,1,1,Italy
9493,10474,11274,1980,Malawi,Zambia,2,0,Friendly,Blantyre,Malawi,False,2,2,Malawi
9494,10475,11275,1980,Greece,Germany,0,0,UEFA Euro,Turin,Italy,True,0,0,Draw
9495,10477,11277,1980,Australia,Northern Ireland,1,2,Friendly,Adelaide,Australia,False,3,-1,Northern Ireland
9496,10478,11278,1980,Hong Kong,Japan,0,2,Friendly,Guangzhou,China PR,True,2,-2,Japan
9497,10479,11279,1980,Italy,Belgium,0,0,UEFA Euro,Rome,Italy,False,0,0,Draw
9498,10480,11280,1980,Spain,England,1,2,UEFA Euro,Naples,Italy,True,3,-1,England
9499,10481,11281,1980,Sweden,Israel,1,1,FIFA World Cup qualification,Solna,Sweden,False,2,0,Draw
9500,10482,11282,1980,Madagascar,Tanzania,2,1,Friendly,Antananarivo,Madagascar,False,3,1,Madagascar
9501,10484,11284,1980,Belgium,Germany,1,2,UEFA Euro,Rome,Italy,True,3,-1,Germany
9502,10485,11285,1980,Guinea,Lesotho,3,1,FIFA World Cup qualification,Conakry,Guinea,False,4,2,Guinea
9503,10486,11286,1980,Madagascar,Tanzania,1,1,Friendly,Antananarivo,Madagascar,False,2,0,Draw
9504,10487,11287,1980,Poland,Iraq,3,0,Friendly,Warsaw,Poland,False,3,3,Poland
9505,10488,11288,1980,Senegal,Morocco,0,1,FIFA World Cup qualification,Dakar,Senegal,False,1,-1,Morocco
9506,10489,11289,1980,Brazil,Chile,2,1,Friendly,Belo Horizonte,Brazil,False,3,1,Brazil
9507,10490,11290,1980,Congo,Guinea,1,1,Friendly,Brazzaville,Congo,False,2,0,Draw
9508,10491,11291,1980,Costa Rica,Cuba,3,0,Friendly,San José,Costa Rica,False,3,3,Costa Rica
9509,10492,11292,1980,DR Congo,Congo,1,2,Friendly,Kinshasa,Zaïre,False,3,-1,Congo
9510,10493,11293,1980,Iceland,Finland,1,1,Friendly,Reykjavík,Iceland,False,2,0,Draw
9511,10494,11294,1980,DR Congo,Gabon,1,1,Friendly,Kinshasa,Zaïre,False,2,0,Draw
9512,10495,11295,1980,Brazil,Poland,1,1,Friendly,São Paulo,Brazil,False,2,0,Draw
9513,10496,11296,1980,Cameroon,Malawi,3,0,FIFA World Cup qualification,Yaoundé,Cameroon,False,3,3,Cameroon
9514,10497,11297,1980,Tunisia,Nigeria,2,0,FIFA World Cup qualification,Tunis,Tunisia,False,2,2,Tunisia
9515,10498,11298,1980,Zambia,Kenya,5,0,Friendly,Ndola,Zambia,False,5,5,Zambia
9516,10499,11299,1980,Iceland,Faroe Islands,2,1,Friendly,Akureyri,Iceland,False,3,1,Iceland
9517,10500,11300,1980,Bolivia,Poland,0,1,Friendly,Santa Cruz,Bolivia,False,1,-1,Poland
9518,10501,11301,1980,Faroe Islands,Greenland,6,0,Friendly,Sauðárkrókur,Iceland,True,6,6,Faroe Islands
9519,10502,11302,1980,Mauritania,Senegal,1,3,Friendly,Nouakchott,Mauritania,False,4,-2,Senegal
9520,10503,11303,1980,Panama,Guatemala,0,2,FIFA World Cup qualification,Panama City,Panama,False,2,-2,Guatemala
9521,10504,11304,1980,Iceland,Greenland,4,1,Friendly,Húsavík,Iceland,False,5,3,Iceland
9522,10505,11305,1980,Kenya,Tanzania,3,1,FIFA World Cup qualification,Nairobi,Kenya,False,4,2,Kenya
9523,10506,11306,1980,Gambia,Libya,0,0,FIFA World Cup qualification,Banjul,Gambia,False,0,0,Draw
9524,10507,11307,1980,Lesotho,Guinea,1,1,FIFA World Cup qualification,Maseru,Lesotho,False,2,0,Draw
9525,10508,11308,1980,Malawi,Zimbabwe,0,1,Friendly,Blantyre,Malawi,False,1,-1,Zimbabwe
9526,10509,11309,1980,Morocco,Senegal,0,0,FIFA World Cup qualification,Casablanca,Morocco,False,0,0,Draw
9527,10510,11310,1980,Malawi,Zimbabwe,1,1,Friendly,Blantyre,Malawi,False,2,0,Draw
9528,10511,11311,1980,Colombia,Poland,1,4,Friendly,Bogotá,Colombia,False,5,-3,Poland
9529,10513,11313,1980,Nigeria,Tunisia,2,0,FIFA World Cup qualification,Lagos,Nigeria,False,2,2,Nigeria
9530,10514,11314,1980,Russia,Denmark,2,0,Friendly,Moscow,Soviet Union,False,2,2,Russia
9531,10515,11315,1980,DR Congo,Mozambique,5,2,FIFA World Cup qualification,Kinshasa,Zaïre,False,7,3,DR Congo
9532,10516,11316,1980,Norway,Iceland,3,1,Friendly,Oslo,Norway,False,4,2,Norway
9533,10517,11317,1980,Guatemala,Honduras,1,1,Friendly,Guatemala,Guatemala,False,2,0,Draw
9534,10518,11318,1980,Niger,Somalia,0,0,FIFA World Cup qualification,Niamey,Niger,False,0,0,Draw
9535,10519,11319,1980,Sweden,Iceland,1,1,Friendly,Halmstad,Sweden,False,2,0,Draw
9536,10520,11320,1980,Uruguay,Peru,0,0,Friendly,Montevideo,Uruguay,False,0,0,Draw
9537,10521,11321,1980,Tanzania,Kenya,5,0,FIFA World Cup qualification,Dar es Salaam,Tanzania,False,5,5,Tanzania
9538,10522,11322,1980,Malawi,Cameroon,1,1,FIFA World Cup qualification,Blantyre,Malawi,False,2,0,Draw
9539,10523,11323,1980,Mozambique,DR Congo,1,2,FIFA World Cup qualification,Maputo,Mozambique,False,3,-1,DR Congo
9540,10524,11324,1980,Somalia,Niger,1,1,FIFA World Cup qualification,Mogadishu,Somalia,False,2,0,Draw
9541,10525,11325,1980,Panama,Honduras,0,2,FIFA World Cup qualification,Panama City,Panama,False,2,-2,Honduras
9542,10526,11326,1980,Haiti,Trinidad and Tobago,2,0,FIFA World Cup qualification,Port-au-Prince,Haiti,False,2,2,Haiti
9543,10527,11328,1980,United Arab Emirates,Iran,0,2,Friendly,al-Ain,United Arab Emirates,False,2,-2,Iran
9544,10528,11329,1980,United Arab Emirates,Iran,0,3,Friendly,Abu Dhabi,United Arab Emirates,False,3,-3,Iran
9545,10529,11330,1980,Mozambique,Lesotho,6,1,African Cup of Nations qualification,Maputo,Mozambique,False,7,5,Mozambique
9546,10530,11331,1980,Panama,Costa Rica,1,1,FIFA World Cup qualification,Panama City,Panama,False,2,0,Draw
9547,10531,11332,1980,Cuba,Suriname,3,0,FIFA World Cup qualification,Havana,Cuba,False,3,3,Cuba
9548,10532,11333,1980,Guatemala,El Salvador,1,1,Friendly,Guatemala,Guatemala,False,2,0,Draw
9549,10533,11334,1980,Trinidad and Tobago,Haiti,1,0,FIFA World Cup qualification,San Fernando,Trinidad and Tobago,False,1,1,Trinidad and Tobago
9550,10534,11335,1980,Hungary,Sweden,2,0,Friendly,Budapest,Hungary,False,2,2,Hungary
9551,10535,11336,1980,New Zealand,Mexico,4,0,Friendly,Auckland,New Zealand,False,4,4,New Zealand
9552,10536,11337,1980,Norway,Finland,6,1,Nordic Championship,Oslo,Norway,False,7,5,Norway
9553,10537,11338,1980,Uruguay,Chile,0,0,Friendly,Montevideo,Uruguay,False,0,0,Draw
9554,10538,11339,1980,Indonesia,Thailand,2,1,Korea Cup,Seoul,South Korea,True,3,1,Indonesia
9555,10539,11341,1980,Australia,Mexico,2,2,Friendly,Sydney,Australia,False,4,0,Draw
9556,10540,11342,1980,Lesotho,Mozambique,2,1,African Cup of Nations qualification,Maseru,Lesotho,False,3,1,Lesotho
9557,10541,11343,1980,Panama,El Salvador,1,3,FIFA World Cup qualification,Panama City,Panama,False,4,-2,El Salvador
9558,10542,11344,1980,Bahrain,Malaysia,1,1,Korea Cup,Seoul,South Korea,True,2,0,Draw
9559,10543,11346,1980,Australia,Mexico,1,1,Friendly,Melbourne,Australia,False,2,0,Draw
9560,10544,11347,1980,Bolivia,Paraguay,1,1,Copa Paz del Chaco,La Paz,Bolivia,False,2,0,Draw
9561,10545,11348,1980,Bahrain,Indonesia,2,3,Korea Cup,Seoul,South Korea,True,5,-1,Indonesia
9562,10546,11349,1980,Brazil,Uruguay,1,0,Friendly,Fortaleza,Brazil,False,1,1,Brazil
9563,10547,11350,1980,Hungary,Russia,1,4,Friendly,Budapest,Hungary,False,5,-3,Russia
9564,10549,11353,1980,Switzerland,Denmark,1,1,Friendly,Lausanne,Switzerland,False,2,0,Draw
9565,10550,11354,1980,Bolivia,Paraguay,1,3,Friendly,Santa Cruz,Bolivia,False,4,-2,Paraguay
9566,10551,11356,1980,Malaysia,Thailand,1,4,Korea Cup,Seoul,South Korea,True,5,-3,Thailand
9567,10552,11357,1980,Fiji,Mexico,0,2,Friendly,Suva,Fiji,False,2,-2,Mexico
9568,10553,11358,1980,Zimbabwe,Zambia,1,1,Friendly,Bulawayo,Zimbabwe,False,2,0,Draw
9569,10554,11359,1980,Bahrain,Thailand,0,1,Korea Cup,Seoul,South Korea,True,1,-1,Thailand
9570,10555,11360,1980,Indonesia,Malaysia,1,1,Korea Cup,Seoul,South Korea,True,2,0,Draw
9571,10556,11361,1980,Zimbabwe,Zambia,1,2,Friendly,Salisbury,Zimbabwe,False,3,-1,Zambia
9572,10557,11364,1980,Albania,Finland,2,0,FIFA World Cup qualification,Tirana,Albania,False,2,2,Albania
9573,10558,11365,1980,Iceland,Russia,1,2,FIFA World Cup qualification,Reykjavík,Iceland,False,3,-1,Russia
9574,10559,11366,1980,Suriname,Cuba,0,0,FIFA World Cup qualification,Paramaribo,Suriname,False,0,0,Draw
9575,10561,11368,1980,Bulgaria,Romania,1,2,Friendly,Varna,Bulgaria,False,3,-1,Romania
9576,10562,11369,1980,England,Norway,4,0,FIFA World Cup qualification,London,England,False,4,4,England
9577,10563,11370,1980,Republic of Ireland,Netherlands,2,1,FIFA World Cup qualification,Dublin,Republic of Ireland,False,3,1,Republic of Ireland
9578,10565,11372,1980,Sweden,Scotland,0,1,FIFA World Cup qualification,Solna,Sweden,False,1,-1,Scotland
9579,10566,11373,1980,Switzerland,Germany,2,3,Friendly,Berne,Switzerland,False,5,-1,Germany
9580,10567,11374,1980,Haiti,Curaçao,1,0,FIFA World Cup qualification,Port-au-Prince,Haiti,False,1,1,Haiti
9581,10568,11375,1980,Madagascar,Mauritius,0,0,African Cup of Nations qualification,Antananarivo,Madagascar,False,0,0,Draw
9582,10569,11376,1980,Canada,New Zealand,4,0,Friendly,Vancouver,Canada,False,4,4,Canada
9583,10570,11377,1980,Kuwait,United Arab Emirates,1,1,AFC Asian Cup,Kuwait City,Kuwait,False,2,0,Draw
9584,10572,11380,1980,Canada,New Zealand,3,0,Friendly,Edmonton,Canada,False,3,3,Canada
9585,10573,11381,1980,Iran,Syria,0,0,AFC Asian Cup,Kuwait City,Kuwait,True,0,0,Draw
9586,10574,11382,1980,Qatar,United Arab Emirates,2,1,AFC Asian Cup,Kuwait City,Kuwait,True,3,1,Qatar
9587,10575,11383,1980,Argentina,Chile,2,2,Friendly,Mendoza,Argentina,False,4,0,Draw
9588,10576,11385,1980,Kuwait,Malaysia,3,1,AFC Asian Cup,Kuwait City,Kuwait,False,4,2,Kuwait
9589,10577,11386,1980,Paraguay,Bolivia,2,1,Copa Paz del Chaco,Asunción,Paraguay,False,3,1,Paraguay
9590,10578,11387,1980,Bangladesh,Syria,0,1,AFC Asian Cup,Kuwait City,Kuwait,True,1,-1,Syria
9591,10580,11390,1980,United Arab Emirates,Malaysia,0,2,AFC Asian Cup,Kuwait City,Kuwait,True,2,-2,Malaysia
9592,10582,11392,1980,Bangladesh,Iran,0,7,AFC Asian Cup,Kuwait City,Kuwait,True,7,-7,Iran
9593,10583,11393,1980,Malaysia,Qatar,1,1,AFC Asian Cup,Kuwait City,Kuwait,True,2,0,Draw
9594,10585,11395,1980,Bulgaria,Sweden,2,3,Friendly,Burgas,Bulgaria,False,5,-1,Sweden
9595,10586,11396,1980,Finland,Austria,0,2,FIFA World Cup qualification,Helsinki,Finland,False,2,-2,Austria
9596,10587,11397,1980,Hungary,Spain,2,2,Friendly,Budapest,Hungary,False,4,0,Draw
9597,10589,11399,1980,Italy,Portugal,3,1,Friendly,Genoa,Italy,False,4,2,Italy
9598,10590,11401,1980,Norway,Romania,1,1,FIFA World Cup qualification,Oslo,Norway,False,2,0,Draw
9599,10592,11403,1980,Turkey,Iceland,1,3,FIFA World Cup qualification,Izmir,Turkey,False,4,-2,Iceland
9600,10593,11405,1980,Kuwait,Qatar,4,0,AFC Asian Cup,Kuwait City,Kuwait,False,4,4,Kuwait
9601,10594,11406,1980,Paraguay,Brazil,1,2,Friendly,Asunción,Paraguay,False,3,-1,Brazil
9602,10596,11409,1980,Guyana,Suriname,0,1,FIFA World Cup qualification,Georgetown,Guyana,False,1,-1,Suriname
9603,10597,11411,1980,Kuwait,Iran,2,1,AFC Asian Cup,Kuwait City,Kuwait,False,3,1,Kuwait
9604,10598,11412,1980,Mali,Mauritania,2,0,African Cup of Nations qualification,Bamako,Mali,False,2,2,Mali
9605,10599,11413,1980,Mauritius,Madagascar,1,1,African Cup of Nations qualification,Curepipe,Mauritius,False,2,0,Draw
9606,10602,11416,1980,El Salvador,Guatemala,3,2,Friendly,San Salvador,El Salvador,False,5,1,El Salvador
9607,10604,11419,1980,Costa Rica,Honduras,2,3,FIFA World Cup qualification,San José,Costa Rica,False,5,-1,Honduras
9608,10605,11420,1980,Turkey,Libya,1,2,Friendly,Izmir,Turkey,False,3,-1,Libya
9609,10606,11421,1980,Turkey,Saudi Arabia,3,0,Friendly,Izmir,Turkey,False,3,3,Turkey
9610,10607,11422,1980,Libya,Saudi Arabia,2,0,Friendly,Izmir,Turkey,True,2,2,Libya
9611,10608,11423,1980,Luxembourg,United States,0,2,Friendly,Luxembourg,Luxembourg,False,2,-2,United States
9612,10609,11424,1980,El Salvador,Panama,4,1,FIFA World Cup qualification,San Salvador,El Salvador,False,5,3,El Salvador
9613,10610,11425,1980,Portugal,United States,1,1,Friendly,Lisbon,Portugal,False,2,0,Draw
9614,10611,11426,1980,Austria,Hungary,3,1,Friendly,Vienna,Austria,False,4,2,Austria
9615,10612,11428,1980,Argentina,Bulgaria,2,0,Friendly,Buenos Aires,Argentina,False,2,2,Argentina
9616,10613,11429,1980,Cyprus,France,0,7,FIFA World Cup qualification,Limassol,Cyprus,False,7,-7,France
9617,10614,11430,1980,Luxembourg,Italy,0,2,FIFA World Cup qualification,Luxembourg,Luxembourg,False,2,-2,Italy
9618,10615,11431,1980,Netherlands,Germany,1,1,Friendly,Eindhoven,Netherlands,False,2,0,Draw
9619,10616,11432,1980,Argentina,Poland,2,1,Friendly,Buenos Aires,Argentina,False,3,1,Argentina
9620,10617,11433,1980,Cameroon,Zimbabwe,2,0,FIFA World Cup qualification,Douala,Cameroon,False,2,2,Cameroon
9621,10618,11434,1980,Guatemala,Costa Rica,0,0,FIFA World Cup qualification,Guatemala,Guatemala,False,0,0,Draw
9622,10619,11435,1980,Mauritania,Mali,2,1,African Cup of Nations qualification,Nouakchott,Mauritania,False,3,1,Mauritania
9623,10620,11436,1980,Suriname,Guyana,4,0,FIFA World Cup qualification,Paramaribo,Suriname,False,4,4,Suriname
9624,10622,11438,1980,Denmark,Greece,0,1,FIFA World Cup qualification,Copenhagen,Denmark,False,1,-1,Greece
9625,10623,11440,1980,Republic of Ireland,Belgium,1,1,FIFA World Cup qualification,Dublin,Republic of Ireland,False,2,0,Draw
9626,10624,11441,1980,Northern Ireland,Sweden,3,0,FIFA World Cup qualification,Belfast,Northern Ireland,False,3,3,Northern Ireland
9627,10625,11442,1980,Romania,England,2,1,FIFA World Cup qualification,Bucharest,Romania,False,3,1,Romania
9628,10626,11443,1980,Russia,Iceland,5,0,FIFA World Cup qualification,Moscow,Soviet Union,True,5,5,Russia
9629,10627,11444,1980,Scotland,Portugal,0,0,FIFA World Cup qualification,Glasgow,Scotland,False,0,0,Draw
9630,10628,11445,1980,Wales,Turkey,4,0,FIFA World Cup qualification,Cardiff,Wales,False,4,4,Wales
9631,10629,11446,1980,Malaysia,Burma,3,2,Merdeka Tournament,Kuala Lumpur,Malaysia,False,5,1,Malaysia
9632,10630,11447,1980,Morocco,Thailand,2,1,Merdeka Tournament,Kuala Lumpur,Malaysia,True,3,1,Morocco
9633,10631,11448,1980,Canada,Mexico,1,1,FIFA World Cup qualification,Toronto,Canada,False,2,0,Draw
9634,10632,11449,1980,Bulgaria,Albania,2,1,FIFA World Cup qualification,Sofia,Bulgaria,False,3,1,Bulgaria
9635,10633,11450,1980,Burma,Morocco,2,2,Merdeka Tournament,Kuala Lumpur,Malaysia,True,4,0,Draw
9636,10634,11451,1980,Malaysia,Thailand,2,2,Merdeka Tournament,Kuala Lumpur,Malaysia,False,4,0,Draw
9637,10635,11452,1980,Indonesia,New Zealand,0,0,Merdeka Tournament,Kuala Lumpur,Malaysia,True,0,0,Draw
9638,10636,11453,1980,Burma,Thailand,1,2,Merdeka Tournament,Kuala Lumpur,Malaysia,True,3,-1,Thailand
9639,10637,11454,1980,Trinidad and Tobago,Guyana,1,1,Friendly,Port of Spain,Trinidad and Tobago,False,2,0,Draw
9640,10638,11455,1980,Burma,New Zealand,1,1,Merdeka Tournament,Kuala Lumpur,Malaysia,True,2,0,Draw
9641,10639,11456,1980,Trinidad and Tobago,Guyana,2,0,Friendly,Port of Spain,Trinidad and Tobago,False,2,2,Trinidad and Tobago
9642,10640,11457,1980,Liberia,Mali,1,1,Friendly,Monrovia,Liberia,False,2,0,Draw
9643,10641,11458,1980,United States,Canada,0,0,FIFA World Cup qualification,Fort Lauderdale,United States,False,0,0,Draw
9644,10642,11459,1980,Honduras,Guatemala,0,0,FIFA World Cup qualification,Tegucigalpa,Honduras,False,0,0,Draw
9645,10643,11460,1980,Indonesia,Thailand,1,1,Merdeka Tournament,Kuala Lumpur,Malaysia,True,2,0,Draw
9646,10644,11461,1980,Malawi,Zimbabwe,0,1,African Cup of Nations qualification,Blantyre,Malawi,False,1,-1,Zimbabwe
9647,10645,11462,1980,Morocco,New Zealand,3,0,Merdeka Tournament,Kuala Lumpur,Malaysia,True,3,3,Morocco
9648,10646,11463,1980,France,Republic of Ireland,2,0,FIFA World Cup qualification,Paris,France,False,2,2,France
9649,10647,11464,1980,New Zealand,Thailand,1,1,Merdeka Tournament,Kuala Lumpur,Malaysia,True,2,0,Draw
9650,10648,11465,1980,Indonesia,Morocco,0,2,Merdeka Tournament,Kuala Lumpur,Malaysia,True,2,-2,Morocco
9651,10649,11466,1980,Switzerland,Norway,1,2,FIFA World Cup qualification,Berne,Switzerland,False,3,-1,Norway
9652,10650,11467,1980,Brazil,Paraguay,6,0,Friendly,Goiânia,Brazil,False,6,6,Brazil
9653,10651,11468,1980,Malaysia,New Zealand,2,0,Merdeka Tournament,Kuala Lumpur,Malaysia,False,2,2,Malaysia
9654,10652,11469,1980,Burma,Indonesia,1,0,Merdeka Tournament,Kuala Lumpur,Malaysia,True,1,1,Burma
9655,10653,11470,1980,Canada,United States,2,1,FIFA World Cup qualification,Vancouver,Canada,False,3,1,Canada
9656,10654,11471,1980,Italy,Denmark,2,0,FIFA World Cup qualification,Rome,Italy,False,2,2,Italy
9657,10655,11472,1980,Tanzania,Madagascar,0,0,Friendly,Dar es Salaam,Tanzania,False,0,0,Draw
9658,10656,11473,1980,Zambia,Angola,0,0,Friendly,Lusaka,Zambia,False,0,0,Draw
9659,10657,11474,1980,Malaysia,Morocco,1,2,Merdeka Tournament,Kuala Lumpur,Malaysia,False,3,-1,Morocco
9660,10658,11475,1980,Zambia,Angola,1,1,Friendly,Lusaka,Zambia,False,2,0,Draw
9661,10659,11476,1980,Costa Rica,Panama,2,0,FIFA World Cup qualification,San José,Costa Rica,False,2,2,Costa Rica
9662,10660,11477,1980,Bolivia,Uruguay,1,3,Friendly,Cochabamba,Bolivia,False,4,-2,Uruguay
9663,10661,11478,1980,Cuba,Guyana,1,0,FIFA World Cup qualification,Havana,Cuba,False,1,1,Cuba
9664,10662,11479,1980,Guatemala,El Salvador,0,0,FIFA World Cup qualification,Guatemala,Guatemala,False,0,0,Draw
9665,10663,11480,1980,Honduras,Canada,2,0,Friendly,Tegucigalpa,Honduras,False,2,2,Honduras
9666,10664,11481,1980,Liberia,Gambia,0,0,African Cup of Nations qualification,Monrovia,Liberia,False,0,0,Draw
9667,10665,11482,1980,Mexico,United States,5,1,FIFA World Cup qualification,Mexico City,Mexico,False,6,4,Mexico
9668,10666,11483,1980,Senegal,Mauritania,3,0,Friendly,Dakar,Senegal,False,3,3,Senegal
9669,10667,11484,1980,Trinidad and Tobago,Curaçao,0,0,FIFA World Cup qualification,Port of Spain,Trinidad and Tobago,False,0,0,Draw
9670,10668,11485,1980,Zimbabwe,Malawi,1,1,African Cup of Nations qualification,Salisbury,Zimbabwe,False,2,0,Draw
9671,10669,11486,1980,Greece,Australia,3,3,Friendly,Athens,Greece,False,6,0,Draw
9672,10670,11487,1980,Guatemala,Canada,0,1,Friendly,Guatemala,Guatemala,False,1,-1,Canada
9673,10671,11488,1980,Ethiopia,Mozambique,3,2,Friendly,Addis Abeba,Ethiopia,False,5,1,Ethiopia
9674,10672,11489,1980,Israel,Sweden,0,0,FIFA World Cup qualification,Ramat-Gan,Israel,False,0,0,Draw
9675,10673,11490,1980,Peru,Uruguay,1,1,Friendly,Lima,Peru,False,2,0,Draw
9676,10674,11491,1980,Spain,Poland,1,2,Friendly,Barcelona,Spain,False,3,-1,Poland
9677,10675,11492,1980,Sudan,Tanzania,0,1,CECAFA Cup,Khartoum,Sudan,False,1,-1,Tanzania
9678,10676,11493,1980,Austria,Albania,5,0,FIFA World Cup qualification,Vienna,Austria,False,5,5,Austria
9679,10677,11494,1980,Benin,Niger,1,0,Friendly,Cotonou,Benin,False,1,1,Benin
9680,10680,11497,1980,Guatemala,Panama,5,0,FIFA World Cup qualification,Guatemala,Guatemala,False,5,5,Guatemala
9681,10681,11498,1980,Honduras,Costa Rica,1,1,FIFA World Cup qualification,Tegucigalpa,Honduras,False,2,0,Draw
9682,10682,11499,1980,Madagascar,DR Congo,1,1,FIFA World Cup qualification,Antananarivo,Madagascar,False,2,0,Draw
9683,10684,11501,1980,Mexico,Canada,1,1,FIFA World Cup qualification,Mexico City,Mexico,False,2,0,Draw
9684,10685,11502,1980,Morocco,Zambia,2,0,FIFA World Cup qualification,Fès,Morocco,False,2,2,Morocco
9685,10686,11503,1980,Zimbabwe,Cameroon,1,0,FIFA World Cup qualification,Harare,Zimbabwe,False,1,1,Zimbabwe
9686,10687,11504,1980,Senegal,Sierra Leone,2,0,African Cup of Nations qualification,Dakar,Senegal,False,2,2,Senegal
9687,10688,11505,1980,Somalia,Tanzania,1,1,CECAFA Cup,Khartoum,Sudan,True,2,0,Draw
9688,10689,11506,1980,Belgium,Netherlands,1,0,FIFA World Cup qualification,Brussels,Belgium,False,1,1,Belgium
9689,10690,11507,1980,Denmark,Luxembourg,4,0,FIFA World Cup qualification,Copenhagen,Denmark,False,4,4,Denmark
9690,10691,11508,1980,England,Switzerland,2,1,FIFA World Cup qualification,London,England,False,3,1,England
9691,10692,11510,1980,Germany,France,4,1,Friendly,Hanover,Germany,False,5,3,Germany
9692,10693,11511,1980,Republic of Ireland,Cyprus,6,0,FIFA World Cup qualification,Dublin,Republic of Ireland,False,6,6,Republic of Ireland
9693,10694,11512,1980,Kenya,Malawi,0,1,CECAFA Cup,Port Sudan,Sudan,True,1,-1,Malawi
9694,10695,11513,1980,Poland,Algeria,5,1,Friendly,Cracow,Poland,False,6,4,Poland
9695,10696,11514,1980,Portugal,Northern Ireland,1,0,FIFA World Cup qualification,Lisbon,Portugal,False,1,1,Portugal
9696,10698,11516,1980,Brunei,Singapore,0,3,King's Cup,Bangkok,Thailand,True,3,-3,Singapore
9697,10699,11517,1980,Sudan,Somalia,2,0,CECAFA Cup,Khartoum,Sudan,False,2,2,Sudan
9698,10701,11519,1980,Trinidad and Tobago,Cuba,2,2,Friendly,San Fernando,Trinidad and Tobago,False,4,0,Draw
9699,10702,11520,1980,El Salvador,Honduras,2,1,FIFA World Cup qualification,San Salvador,El Salvador,False,3,1,El Salvador
9700,10703,11521,1980,Gambia,Liberia,1,1,African Cup of Nations qualification,Banjul,Gambia,False,2,0,Draw
9701,10704,11522,1980,Guinea,DR Congo,2,1,Friendly,Conakry,Guinea,False,3,1,Guinea
9702,10705,11523,1980,United States,Mexico,2,1,FIFA World Cup qualification,Fort Lauderdale,United States,False,3,1,United States
9703,10706,11524,1980,Malawi,Tanzania,0,1,CECAFA Cup,Khartoum,Sudan,True,1,-1,Tanzania
9704,10708,11526,1980,Costa Rica,Guatemala,0,3,FIFA World Cup qualification,San José,Costa Rica,False,3,-3,Guatemala
9705,10709,11527,1980,Sudan,Tanzania,1,0,CECAFA Cup,Khartoum,Sudan,False,1,1,Sudan
9706,10710,11528,1980,Curaçao,Trinidad and Tobago,0,0,FIFA World Cup qualification,Willemstad,Netherlands Antilles,True,0,0,Draw
9707,10711,11529,1980,Bolivia,Finland,3,0,Friendly,La Paz,Bolivia,False,3,3,Bolivia
9708,10712,11530,1980,Congo,Angola,0,0,African Cup of Nations qualification,Brazzaville,Congo,False,0,0,Draw
9709,10713,11531,1980,Guyana,Cuba,0,3,FIFA World Cup qualification,Linden,Guyana,False,3,-3,Cuba
9710,10714,11532,1980,Honduras,El Salvador,2,0,FIFA World Cup qualification,Tegucigalpa,Honduras,False,2,2,Honduras
9711,10715,11533,1980,Sierra Leone,Senegal,1,2,African Cup of Nations qualification,Freetown,Sierra Leone,False,3,-1,Senegal
9712,10716,11534,1980,Zambia,Morocco,2,0,FIFA World Cup qualification,Lusaka,Zambia,False,2,2,Zambia
9713,10717,11535,1980,Israel,Australia,0,1,Friendly,Beersheba,Israel,False,1,-1,Australia
9714,10718,11536,1980,Bulgaria,Germany,1,3,FIFA World Cup qualification,Sofia,Bulgaria,False,4,-2,Germany
9715,10719,11538,1980,Argentina,Russia,1,1,Friendly,Mar del Plata,Argentina,False,2,0,Draw
9716,10720,11539,1980,Bolivia,Finland,2,2,Friendly,Santa Cruz,Bolivia,False,4,0,Draw
9717,10721,11540,1980,Hong Kong,Australia,1,0,Friendly,So Kon Po,Hong Kong,False,1,1,Hong Kong
9718,10722,11541,1980,Albania,Austria,0,1,FIFA World Cup qualification,Tirana,Albania,False,1,-1,Austria
9719,10723,11542,1980,Greece,Italy,0,2,FIFA World Cup qualification,Athens,Greece,False,2,-2,Italy
9720,10724,11543,1980,Nigeria,Tanzania,1,1,FIFA World Cup qualification,Lagos,Nigeria,False,2,0,Draw
9721,10725,11544,1980,Guatemala,Honduras,0,1,FIFA World Cup qualification,Guatemala,Guatemala,False,1,-1,Honduras
9722,10726,11545,1980,Indonesia,Australia,1,1,Friendly,Jakarta,Indonesia,False,2,0,Draw
9723,10727,11546,1980,Kenya,Zambia,1,1,Friendly,Kisumu,Kenya,False,2,0,Draw
9724,10728,11547,1980,Liberia,Guinea,0,0,FIFA World Cup qualification,Monrovia,Liberia,False,0,0,Draw
9725,10729,11548,1980,Mali,Togo,1,2,Friendly,Bamako,Mali,False,3,-1,Togo
9726,10730,11549,1980,Malta,Poland,0,2,FIFA World Cup qualification,Gżira,Malta,False,2,-2,Poland
9727,10731,11550,1980,Uruguay,Finland,6,0,Friendly,Montevideo,Uruguay,False,6,6,Uruguay
9728,10732,11551,1980,Mali,Togo,4,0,Friendly,Bamako,Mali,False,4,4,Mali
9729,10733,11552,1980,Costa Rica,El Salvador,0,0,FIFA World Cup qualification,San José,Costa Rica,False,0,0,Draw
9730,10734,11553,1980,Kenya,Zambia,2,0,Friendly,Nakuru,Kenya,False,2,2,Kenya
9731,10735,11554,1980,Uruguay,Bolivia,5,0,Friendly,Maldonado,Uruguay,False,5,5,Uruguay
9732,10736,11555,1980,Algeria,Sudan,2,0,FIFA World Cup qualification,Constantine,Algeria,False,2,2,Algeria
9733,10737,11556,1980,Curaçao,Haiti,1,1,FIFA World Cup qualification,Willemstad,Netherlands Antilles,True,2,0,Draw
9734,10738,11557,1980,Kenya,Zambia,2,1,Friendly,Nairobi,Kenya,False,3,1,Kenya
9735,10739,11558,1980,Saudi Arabia,Indonesia,8,0,Friendly,Riyadh,Saudi Arabia,False,8,8,Saudi Arabia
9736,10740,11559,1980,Honduras,Panama,5,0,FIFA World Cup qualification,Tegucigalpa,Honduras,False,5,5,Honduras
9737,10741,11560,1980,Niger,Togo,0,1,FIFA World Cup qualification,Niamey,Niger,False,1,-1,Togo
9738,10742,11561,1980,Saudi Arabia,Indonesia,3,0,Friendly,Jeddah,Saudi Arabia,False,3,3,Saudi Arabia
9739,10743,11562,1980,Argentina,Switzerland,5,0,Friendly,Córdoba,Argentina,False,5,5,Argentina
9740,10744,11563,1980,Portugal,Israel,3,0,FIFA World Cup qualification,Lisbon,Portugal,False,3,3,Portugal
9741,10745,11564,1980,Uruguay,Switzerland,4,0,Friendly,Montevideo,Uruguay,False,4,4,Uruguay
9742,10746,11565,1980,Tanzania,Nigeria,0,2,FIFA World Cup qualification,Dar es Salaam,Tanzania,False,2,-2,Nigeria
9743,10747,11566,1980,Brazil,Switzerland,2,0,Friendly,Cuiabá,Brazil,False,2,2,Brazil
9744,10748,11567,1980,DR Congo,Madagascar,3,2,FIFA World Cup qualification,Kinshasa,Zaïre,False,5,1,DR Congo
9745,10749,11568,1980,Cyprus,Belgium,0,2,FIFA World Cup qualification,Nicosia,Cyprus,False,2,-2,Belgium
9746,10750,11569,1980,El Salvador,Guatemala,1,0,FIFA World Cup qualification,San Salvador,El Salvador,False,1,1,El Salvador
9747,10751,11570,1980,Guinea,Liberia,1,0,FIFA World Cup qualification,Conakry,Guinea,False,1,1,Guinea
9748,10753,11573,1980,Singapore,Japan,0,1,FIFA World Cup qualification,So Kon Po,Hong Kong,True,1,-1,Japan
9749,10754,11575,1980,Hong Kong,Singapore,1,1,FIFA World Cup qualification,So Kon Po,Hong Kong,False,2,0,Draw
9750,10757,11579,1980,Japan,Macau,3,0,FIFA World Cup qualification,So Kon Po,Hong Kong,True,3,3,Japan
9751,10758,11580,1980,Sudan,Algeria,1,1,FIFA World Cup qualification,Khartoum,Sudan,False,2,0,Draw
9752,10759,11581,1980,Togo,Niger,1,2,FIFA World Cup qualification,Lomé,Togo,False,3,-1,Niger
9753,10760,11583,1980,Uruguay,Netherlands,2,0,Mundialito,Montevideo,Uruguay,False,2,2,Uruguay
9754,10762,11585,1981,Argentina,Germany,2,1,Mundialito,Montevideo,Uruguay,True,3,1,Argentina
9755,10763,11586,1981,Uruguay,Italy,2,0,Mundialito,Montevideo,Uruguay,False,2,2,Uruguay
9756,10764,11587,1981,Argentina,Brazil,1,1,Mundialito,Montevideo,Uruguay,True,2,0,Draw
9757,10765,11589,1981,Netherlands,Italy,1,1,Mundialito,Montevideo,Uruguay,True,2,0,Draw
9758,10766,11590,1981,Brazil,Germany,4,1,Mundialito,Montevideo,Uruguay,True,5,3,Brazil
9759,10767,11591,1981,Uruguay,Brazil,2,1,Mundialito,Montevideo,Uruguay,False,3,1,Uruguay
9760,10768,11592,1981,Curaçao,Venezuela,3,1,Friendly,Willemstad,Netherlands Antilles,False,4,2,Curaçao
9761,10769,11593,1981,Tunisia,Qatar,4,0,Friendly,Tunis,Tunisia,False,4,4,Tunisia
9762,10770,11594,1981,Venezuela,Curaçao,1,0,Friendly,Valencia,Venezuela,False,1,1,Venezuela
9763,10771,11595,1981,Mexico,Bulgaria,1,1,Friendly,Mexico City,Mexico,False,2,0,Draw
9764,10772,11596,1981,Japan,Poland,0,2,Friendly,Tokyo,Japan,False,2,-2,Poland
9765,10773,11597,1981,Ecuador,Bulgaria,1,3,Friendly,Quito,Ecuador,False,4,-2,Bulgaria
9766,10774,11598,1981,Japan,Poland,2,4,Friendly,Naruto,Japan,False,6,-2,Poland
9767,10775,11599,1981,Greece,Luxembourg,2,0,FIFA World Cup qualification,Salonica,Greece,False,2,2,Greece
9768,10776,11600,1981,Japan,Poland,1,4,Friendly,Nagoya,Japan,False,5,-3,Poland
9769,10777,11601,1981,Bolivia,Bulgaria,1,3,Friendly,La Paz,Bolivia,False,4,-2,Bulgaria
9770,10778,11602,1981,Colombia,Brazil,1,1,Friendly,Bogotá,Colombia,False,2,0,Draw
9771,10779,11603,1981,Japan,Poland,0,3,Friendly,Tokyo,Japan,False,3,-3,Poland
9772,10780,11604,1981,Gambia,Guinea,1,1,Amílcar Cabral Cup,Bamako,Mali,True,2,0,Draw
9773,10781,11605,1981,Mali,Mauritania,2,0,Amílcar Cabral Cup,Bamako,Mali,False,2,2,Mali
9774,10782,11607,1981,Mali,Guinea,1,1,Amílcar Cabral Cup,Bamako,Mali,False,2,0,Draw
9775,10783,11608,1981,Guinea-Bissau,Senegal,0,1,Amílcar Cabral Cup,Bamako,Mali,True,1,-1,Senegal
9776,10784,11609,1981,Guinea,Mauritania,2,1,Amílcar Cabral Cup,Bamako,Mali,True,3,1,Guinea
9777,10785,11610,1981,Jordan,Iraq,0,2,Friendly,Amman,Jordan,False,2,-2,Iraq
9778,10786,11611,1981,Mali,Gambia,4,1,Amílcar Cabral Cup,Bamako,Mali,False,5,3,Mali
9779,10787,11613,1981,Jordan,Iraq,0,2,Friendly,Amman,Jordan,False,2,-2,Iraq
9780,10788,11614,1981,Malaysia,Japan,1,0,Friendly,Kuantan,Malaysia,False,1,1,Malaysia
9781,10789,11615,1981,Venezuela,Brazil,0,1,FIFA World Cup qualification,Caracas,Venezuela,False,1,-1,Brazil
9782,10791,11617,1981,Guinea,Senegal,1,0,Amílcar Cabral Cup,Bamako,Mali,True,1,1,Guinea
9783,10792,11618,1981,Malaysia,Japan,1,1,Friendly,Kuala Lumpur,Malaysia,False,2,0,Draw
9784,10793,11619,1981,Guinea-Bissau,Mauritania,4,3,Amílcar Cabral Cup,Bamako,Mali,True,7,1,Guinea-Bissau
9785,10795,11621,1981,Peru,Bulgaria,1,2,Friendly,Lima,Peru,False,3,-1,Bulgaria
9786,10796,11623,1981,Mali,Guinea,0,0,Amílcar Cabral Cup,Bamako,Mali,False,0,0,Draw
9787,10797,11624,1981,Ecuador,Brazil,0,6,Friendly,Quito,Ecuador,False,6,-6,Brazil
9788,10798,11625,1981,Oman,Jordan,0,1,Friendly,Muscat,Oman,False,1,-1,Jordan
9789,10799,11626,1981,Bolivia,Venezuela,3,0,FIFA World Cup qualification,La Paz,Bolivia,False,3,3,Bolivia
9790,10800,11627,1981,Morocco,Syria,3,0,Friendly,Fès,Morocco,False,3,3,Morocco
9791,10801,11628,1981,Oman,Jordan,0,2,Friendly,Muscat,Oman,False,2,-2,Jordan
9792,10802,11629,1981,Singapore,Japan,0,1,Friendly,Kallang,Singapore,False,1,-1,Japan
9793,10803,11630,1981,Belgium,Cyprus,3,2,FIFA World Cup qualification,Brussels,Belgium,False,5,1,Belgium
9794,10804,11631,1981,Spain,France,1,0,Friendly,Madrid,Spain,False,1,1,Spain
9795,10805,11632,1981,Singapore,Japan,0,0,Friendly,Kallang,Singapore,False,0,0,Draw
9796,10806,11633,1981,Bolivia,Brazil,1,2,FIFA World Cup qualification,La Paz,Bolivia,False,3,-1,Brazil
9797,10807,11634,1981,Netherlands,Cyprus,3,0,FIFA World Cup qualification,Groningen,Netherlands,False,3,3,Netherlands
9798,10808,11635,1981,Indonesia,Japan,2,0,Friendly,Jakarta,Indonesia,False,2,2,Indonesia
9799,10809,11636,1981,Republic of Ireland,Wales,1,3,Friendly,Dublin,Republic of Ireland,False,4,-2,Wales
9800,10810,11637,1981,Israel,Scotland,0,1,FIFA World Cup qualification,Ramat-Gan,Israel,False,1,-1,Scotland
9801,10811,11638,1981,Bahrain,Jordan,1,0,Friendly,Manama,Bahrain,False,1,1,Bahrain
9802,10812,11639,1981,Norway,Sweden,2,4,Friendly,Lahti,Finland,True,6,-2,Sweden
9803,10813,11640,1981,Finland,Sweden,2,1,Friendly,Lahti,Finland,False,3,1,Finland
9804,10814,11642,1981,Bahrain,Tunisia,0,3,Friendly,Manama,Bahrain,False,3,-3,Tunisia
9805,10816,11644,1981,Liberia,Togo,2,0,Friendly,Monrovia,Liberia,False,2,2,Liberia
9806,10817,11645,1981,Morocco,Iraq,1,1,Friendly,Rabat,Morocco,False,2,0,Draw
9807,10818,11646,1981,Saudi Arabia,Tunisia,1,2,Friendly,Riyadh,Saudi Arabia,False,3,-1,Tunisia
9808,10819,11647,1981,Chile,Colombia,1,0,Friendly,Santiago,Chile,False,1,1,Chile
9809,10820,11649,1981,Luxembourg,Greece,0,2,FIFA World Cup qualification,Luxembourg,Luxembourg,False,2,-2,Greece
9810,10821,11650,1981,Saudi Arabia,Jordan,2,1,Friendly,Riyadh,Saudi Arabia,False,3,1,Saudi Arabia
9811,10822,11651,1981,Brazil,Chile,2,1,Friendly,Ribeirão Preto,Brazil,False,3,1,Brazil
9812,10823,11652,1981,Paraguay,Colombia,0,2,Friendly,Asunción,Paraguay,False,2,-2,Colombia
9813,10824,11653,1981,Venezuela,Bolivia,1,0,FIFA World Cup qualification,Caracas,Venezuela,False,1,1,Venezuela
9814,10825,11654,1981,Qatar,Iraq,0,1,FIFA World Cup qualification,Riyadh,Saudi Arabia,True,1,-1,Iraq
9815,10826,11655,1981,Colombia,Chile,1,2,Friendly,Bogotá,Colombia,False,3,-1,Chile
9816,10827,11656,1981,Syria,Bahrain,0,1,FIFA World Cup qualification,Riyadh,Saudi Arabia,True,1,-1,Bahrain
9817,10828,11657,1981,Saudi Arabia,Iraq,1,0,FIFA World Cup qualification,Riyadh,Saudi Arabia,False,1,1,Saudi Arabia
9818,10829,11658,1981,Brazil,Bolivia,3,1,FIFA World Cup qualification,Rio de Janeiro,Brazil,False,4,2,Brazil
9819,10830,11659,1981,Morocco,Liberia,3,1,African Cup of Nations qualification,Rabat,Morocco,False,4,2,Morocco
9820,10831,11660,1981,Qatar,Bahrain,3,0,FIFA World Cup qualification,Riyadh,Saudi Arabia,True,3,3,Qatar
9821,10832,11662,1981,Saudi Arabia,Syria,2,0,FIFA World Cup qualification,Riyadh,Saudi Arabia,False,2,2,Saudi Arabia
9822,10833,11663,1981,Belgium,Republic of Ireland,1,0,FIFA World Cup qualification,Brussels,Belgium,False,1,1,Belgium
9823,10834,11664,1981,England,Spain,1,2,Friendly,London,England,False,3,-1,Spain
9824,10835,11665,1981,Iraq,Bahrain,2,0,FIFA World Cup qualification,Riyadh,Saudi Arabia,True,2,2,Iraq
9825,10836,11666,1981,Netherlands,France,1,0,FIFA World Cup qualification,Rotterdam,Netherlands,False,1,1,Netherlands
9826,10837,11667,1981,Romania,Poland,2,0,Friendly,Bucharest,Romania,False,2,2,Romania
9827,10838,11668,1981,Scotland,Northern Ireland,1,1,FIFA World Cup qualification,Glasgow,Scotland,False,2,0,Draw
9828,10839,11669,1981,Senegal,Guinea,0,1,Friendly,Dakar,Senegal,False,1,-1,Guinea
9829,10840,11670,1981,Turkey,Wales,0,1,FIFA World Cup qualification,Ankara,Turkey,False,1,-1,Wales
9830,10841,11672,1981,Qatar,Syria,2,1,FIFA World Cup qualification,Riyadh,Saudi Arabia,True,3,1,Qatar
9831,10842,11673,1981,Saudi Arabia,Bahrain,1,0,FIFA World Cup qualification,Riyadh,Saudi Arabia,False,1,1,Saudi Arabia
9832,10843,11674,1981,Brazil,Venezuela,5,0,FIFA World Cup qualification,Goiânia,Brazil,False,5,5,Brazil
9833,10844,11675,1981,Iraq,Syria,2,1,FIFA World Cup qualification,Riyadh,Saudi Arabia,True,3,1,Iraq
9834,10845,11676,1981,Saudi Arabia,Qatar,1,0,FIFA World Cup qualification,Riyadh,Saudi Arabia,False,1,1,Saudi Arabia
9835,10846,11677,1981,Albania,Germany,0,2,FIFA World Cup qualification,Tirana,Albania,False,2,-2,Germany
9836,10847,11678,1981,Cameroon,Niger,2,0,Friendly,Yaoundé,Cameroon,False,2,2,Cameroon
9837,10848,11679,1981,Algeria,Senegal,2,0,Friendly,Oran,Algeria,False,2,2,Algeria
9838,10849,11680,1981,Kenya,Egypt,3,5,African Cup of Nations qualification,Nairobi,Kenya,False,8,-2,Egypt
9839,10850,11681,1981,Liberia,Morocco,0,5,African Cup of Nations qualification,Monrovia,Liberia,False,5,-5,Morocco
9840,10852,11683,1981,Nigeria,Angola,0,0,Friendly,Lagos,Nigeria,False,0,0,Draw
9841,10853,11684,1981,Cameroon,Togo,4,0,African Cup of Nations qualification,Douala,Cameroon,False,4,4,Cameroon
9842,10854,11685,1981,DR Congo,Mozambique,2,1,African Cup of Nations qualification,Kinshasa,Zaïre,False,3,1,DR Congo
9843,10855,11686,1981,Singapore,Malaysia,1,1,Friendly,Kallang,Singapore,False,2,0,Draw
9844,10856,11687,1981,Zambia,Congo,1,1,Friendly,Lusaka,Zambia,False,2,0,Draw
9845,10857,11688,1981,Israel,Romania,2,1,Friendly,Jaffa,Israel,False,3,1,Israel
9846,10858,11689,1981,Algeria,Mali,5,1,African Cup of Nations qualification,Oran,Algeria,False,6,4,Algeria
9847,10859,11690,1981,Ghana,Congo,1,1,African Cup of Nations qualification,Accra,Ghana,False,2,0,Draw
9848,10860,11691,1981,Zimbabwe,Zambia,0,1,African Cup of Nations qualification,Salisbury,Zimbabwe,False,1,-1,Zambia
9849,10861,11692,1981,DR Congo,Cameroon,1,0,FIFA World Cup qualification,Kinshasa,Zaïre,False,1,1,DR Congo
9850,10862,11693,1981,Ethiopia,Kenya,0,0,Friendly,Addis Abeba,Ethiopia,False,0,0,Draw
9851,10863,11694,1981,Guinea,Nigeria,1,1,FIFA World Cup qualification,Conakry,Guinea,False,2,0,Draw
9852,10864,11695,1981,Tunisia,Senegal,1,0,African Cup of Nations qualification,Tunis,Tunisia,False,1,1,Tunisia
9853,10865,11696,1981,Togo,Congo,2,1,Friendly,Lomé,Togo,False,3,1,Togo
9854,10866,11697,1981,Cyprus,Greece,0,1,Friendly,Nicosia,Cyprus,False,1,-1,Greece
9855,10867,11698,1981,Denmark,Romania,2,1,Friendly,Copenhagen,Denmark,False,3,1,Denmark
9856,10868,11699,1981,Portugal,Bulgaria,1,1,Friendly,Porto,Portugal,False,2,0,Draw
9857,10869,11700,1981,Spain,Hungary,0,3,Friendly,Valencia,Spain,False,3,-3,Hungary
9858,10871,11702,1981,Malaysia,Singapore,1,2,Friendly,Kuala Lumpur,Malaysia,False,3,-1,Singapore
9859,10872,11703,1981,Botswana,Malawi,2,5,Friendly,Gwelo,Zimbabwe,True,7,-3,Malawi
9860,10873,11704,1981,Egypt,Kenya,2,0,African Cup of Nations qualification,Cairo,Egypt,False,2,2,Egypt
9861,10874,11705,1981,Lesotho,Mozambique,0,2,Friendly,Umtali,Zimbabwe,True,2,-2,Mozambique
9862,10875,11706,1981,Eswatini,Zambia,1,6,Friendly,Bulawayo,Zimbabwe,True,7,-5,Zambia
9863,10876,11707,1981,Chile,Peru,3,0,Friendly,Santiago,Chile,False,3,3,Chile
9864,10877,11708,1981,Ethiopia,Sudan,1,1,Friendly,Addis Abeba,Ethiopia,False,2,0,Draw
9865,10879,11710,1981,Malawi,Zambia,2,1,Friendly,Salisbury,Zimbabwe,True,3,1,Malawi
9866,10880,11711,1981,Mali,Algeria,3,0,African Cup of Nations qualification,Bamako,Mali,False,3,3,Mali
9867,10881,11712,1981,Mozambique,DR Congo,3,3,African Cup of Nations qualification,Maputo,Mozambique,False,6,0,Draw
9868,10882,11713,1981,Togo,Cameroon,2,2,African Cup of Nations qualification,Lomé,Togo,False,4,0,Draw
9869,10883,11714,1981,Zimbabwe,Malawi,4,0,Friendly,Bulawayo,Zimbabwe,False,4,4,Zimbabwe
9870,10884,11715,1981,Ethiopia,Sudan,2,0,Friendly,Addis Abeba,Ethiopia,False,2,2,Ethiopia
9871,10885,11717,1981,Kuwait,Thailand,6,0,FIFA World Cup qualification,Kuwait City,Kuwait,False,6,6,Kuwait
9872,10886,11719,1981,Kuwait,Malaysia,4,0,FIFA World Cup qualification,Kuwait City,Kuwait,False,4,4,Kuwait
9873,10887,11720,1981,New Zealand,Australia,3,3,FIFA World Cup qualification,Auckland,New Zealand,False,6,0,Draw
9874,10888,11721,1981,Nigeria,Guinea,1,0,FIFA World Cup qualification,Lagos,Nigeria,False,1,1,Nigeria
9875,10889,11722,1981,Zambia,Zimbabwe,2,0,African Cup of Nations qualification,Lusaka,Zambia,False,2,2,Zambia
9876,10890,11723,1981,Cameroon,DR Congo,6,1,FIFA World Cup qualification,Douala,Cameroon,False,7,5,Cameroon
9877,10891,11724,1981,Congo,Ghana,0,1,African Cup of Nations qualification,Brazzaville,Congo,False,1,-1,Ghana
9878,10892,11725,1981,Ethiopia,Rwanda,1,0,African Cup of Nations qualification,Addis Abeba,Ethiopia,False,1,1,Ethiopia
9879,10893,11726,1981,Morocco,Egypt,1,0,FIFA World Cup qualification,Casablanca,Morocco,False,1,1,Morocco
9880,10894,11727,1981,Senegal,Tunisia,0,0,African Cup of Nations qualification,Dakar,Senegal,False,0,0,Draw
9881,10895,11728,1981,Malaysia,Thailand,2,2,FIFA World Cup qualification,Kuwait City,Kuwait,True,4,0,Draw
9882,10896,11729,1981,Scotland,Israel,3,1,FIFA World Cup qualification,Glasgow,Scotland,False,4,2,Scotland
9883,10897,11730,1981,Switzerland,Hungary,2,2,FIFA World Cup qualification,Lucerne,Switzerland,False,4,0,Draw
9884,10898,11731,1981,Bulgaria,Norway,1,0,Friendly,Pleven,Bulgaria,False,1,1,Bulgaria
9885,10899,11732,1981,Chile,Uruguay,1,2,Copa Juan Pinto Durán,Santiago,Chile,False,3,-1,Uruguay
9886,10900,11733,1981,Cyprus,Netherlands,0,1,FIFA World Cup qualification,Nicosia,Cyprus,False,1,-1,Netherlands
9887,10901,11734,1981,England,Romania,0,0,FIFA World Cup qualification,London,England,False,0,0,Draw
9888,10902,11735,1981,France,Belgium,3,2,FIFA World Cup qualification,Paris,France,False,5,1,France
9889,10903,11736,1981,Germany,Austria,2,0,FIFA World Cup qualification,Hamburg,Germany,False,2,2,Germany
9890,10906,11739,1981,Northern Ireland,Portugal,1,0,FIFA World Cup qualification,Belfast,Northern Ireland,False,1,1,Northern Ireland
9891,10907,11741,1981,Algeria,Niger,4,0,FIFA World Cup qualification,Constantine,Algeria,False,4,4,Algeria
9892,10908,11742,1981,Luxembourg,Denmark,1,2,FIFA World Cup qualification,Luxembourg,Luxembourg,False,3,-1,Denmark
9893,10910,11744,1981,Fiji,New Zealand,0,4,FIFA World Cup qualification,Suva,Fiji,False,4,-4,New Zealand
9894,10911,11745,1981,Liberia,Guinea,2,1,Friendly,Monrovia,Liberia,False,3,1,Liberia
9895,10912,11746,1981,Egypt,Morocco,0,0,FIFA World Cup qualification,Cairo,Egypt,False,0,0,Draw
9896,10913,11747,1981,Rwanda,Ethiopia,1,0,African Cup of Nations qualification,Kigali,Rwanda,False,1,1,Rwanda
9897,10914,11748,1981,Indonesia,New Zealand,0,2,FIFA World Cup qualification,Jakarta,Indonesia,False,2,-2,New Zealand
9898,10915,11749,1981,England,Brazil,0,1,Friendly,London,England,False,1,-1,Brazil
9899,10916,11750,1981,Bulgaria,Finland,4,0,FIFA World Cup qualification,Sofia,Bulgaria,False,4,4,Bulgaria
9900,10917,11751,1981,Hungary,Romania,1,0,FIFA World Cup qualification,Budapest,Hungary,False,1,1,Hungary
9901,10918,11752,1981,Sweden,Denmark,1,2,Nordic Championship,Malmö,Sweden,False,3,-1,Denmark
9902,10919,11753,1981,France,Brazil,1,3,Friendly,Paris,France,False,4,-2,Brazil
9903,10920,11754,1981,Australia,New Zealand,0,2,FIFA World Cup qualification,Sydney,Australia,False,2,-2,New Zealand
9904,10921,11755,1981,Wales,Scotland,2,0,British Championship,Swansea,Wales,False,2,2,Wales
9905,10922,11756,1981,Ecuador,Paraguay,1,0,FIFA World Cup qualification,Guayaquil,Ecuador,False,1,1,Ecuador
9906,10924,11759,1981,Germany,Brazil,1,2,Friendly,Stuttgart,Germany,False,3,-1,Brazil
9907,10925,11760,1981,Scotland,Northern Ireland,2,0,British Championship,Glasgow,Scotland,False,2,2,Scotland
9908,10926,11761,1981,Australia,Indonesia,2,0,FIFA World Cup qualification,Melbourne,Australia,False,2,2,Australia
9909,10927,11762,1981,England,Wales,0,0,British Championship,London,England,False,0,0,Draw
9910,10928,11763,1981,Norway,Hungary,1,2,FIFA World Cup qualification,Oslo,Norway,False,3,-1,Hungary
9911,10929,11764,1981,England,Scotland,0,1,British Championship,London,England,False,1,-1,Scotland
9912,10930,11765,1981,New Zealand,Indonesia,5,0,FIFA World Cup qualification,Auckland,New Zealand,False,5,5,New Zealand
9913,10931,11766,1981,Poland,Republic of Ireland,3,0,Friendly,Bydgoszcz,Poland,False,3,3,Poland
9914,10932,11767,1981,Ecuador,Chile,0,0,FIFA World Cup qualification,Guayaquil,Ecuador,False,0,0,Draw
9915,10933,11768,1981,Finland,Germany,0,4,FIFA World Cup qualification,Lahti,Finland,False,4,-4,Germany
9916,10934,11770,1981,Austria,Bulgaria,2,0,FIFA World Cup qualification,Vienna,Austria,False,2,2,Austria
9917,10936,11772,1981,Switzerland,England,2,1,FIFA World Cup qualification,Basel,Switzerland,False,3,1,Switzerland
9918,10937,11773,1981,Wales,Russia,0,0,FIFA World Cup qualification,Wrexham,Wales,False,0,0,Draw
9919,10938,11774,1981,Fiji,Indonesia,0,0,FIFA World Cup qualification,Suva,Fiji,False,0,0,Draw
9920,10939,11775,1981,Niger,Algeria,1,0,FIFA World Cup qualification,Niamey,Niger,False,1,1,Niger
9921,10940,11776,1981,Paraguay,Ecuador,3,1,FIFA World Cup qualification,Asunción,Paraguay,False,4,2,Paraguay
9922,10941,11777,1981,Equatorial Guinea,São Tomé and Príncipe,1,1,Friendly,Malabo,Equatorial Guinea,False,2,0,Draw
9923,10943,11779,1981,Denmark,Italy,3,1,FIFA World Cup qualification,Copenhagen,Denmark,False,4,2,Denmark
9924,10944,11780,1981,Romania,Norway,1,0,FIFA World Cup qualification,Bucharest,Romania,False,1,1,Romania
9925,10945,11781,1981,Sweden,Northern Ireland,1,0,FIFA World Cup qualification,Solna,Sweden,False,1,1,Sweden
9926,10947,11783,1981,Hungary,England,1,3,FIFA World Cup qualification,Budapest,Hungary,False,4,-2,England
9927,10948,11784,1981,Paraguay,Chile,0,1,FIFA World Cup qualification,Asunción,Paraguay,False,1,-1,Chile
9928,10949,11785,1981,Suriname,French Guiana,3,1,CFU Caribbean Cup qualification,Paramaribo,Suriname,False,4,2,Suriname
9929,10951,11787,1981,Haiti,El Salvador,0,0,Friendly,Port-au-Prince,Haiti,False,0,0,Draw
9930,10952,11788,1981,Haiti,El Salvador,0,0,Friendly,Port-au-Prince,Haiti,False,0,0,Draw
9931,10953,11789,1981,Chile,Ecuador,2,0,FIFA World Cup qualification,Santiago,Chile,False,2,2,Chile
9932,10954,11790,1981,Liechtenstein,Malta,1,1,Korea Cup,Daejeon,South Korea,True,2,0,Draw
9933,10956,11792,1981,Liechtenstein,Thailand,0,2,Korea Cup,Jeonju,South Korea,True,2,-2,Thailand
9934,10957,11793,1981,Austria,Finland,5,1,FIFA World Cup qualification,Linz,Austria,False,6,4,Austria
9935,10958,11795,1981,Norway,Switzerland,1,1,FIFA World Cup qualification,Oslo,Norway,False,2,0,Draw
9936,10959,11796,1981,Indonesia,Malta,0,1,Korea Cup,Daegu,South Korea,True,1,-1,Malta
9937,10960,11797,1981,Japan,Malaysia,2,0,Korea Cup,Daegu,South Korea,True,2,2,Japan
9938,10961,11798,1981,Malawi,Tanzania,4,1,Friendly,Blantyre,Malawi,False,5,3,Malawi
9939,10962,11799,1981,Indonesia,Thailand,1,3,Korea Cup,Seoul,South Korea,True,4,-2,Thailand
9940,10963,11800,1981,Portugal,Spain,2,0,Friendly,Porto,Portugal,False,2,2,Portugal
9941,10964,11801,1981,Chile,Paraguay,3,0,FIFA World Cup qualification,Santiago,Chile,False,3,3,Chile
9942,10965,11802,1981,French Guiana,Suriname,3,1,CFU Caribbean Cup qualification,Cayenne,French Guiana,False,4,2,French Guiana
9943,10966,11803,1981,Guadeloupe,Dominica,5,0,CFU Caribbean Cup qualification,Basse-Terre,Guadeloupe,False,5,5,Guadeloupe
9944,10967,11805,1981,Malawi,Tanzania,3,1,Friendly,Lilongwe,Malawi,False,4,2,Malawi
9945,10968,11806,1981,Indonesia,Liechtenstein,2,3,Korea Cup,Seoul,South Korea,True,5,-1,Liechtenstein
9946,10969,11807,1981,Malta,Thailand,2,0,Korea Cup,Seoul,South Korea,True,2,2,Malta
9947,10970,11808,1981,Malawi,Tanzania,0,0,Friendly,Nchalo,Malawi,False,0,0,Draw
9948,10971,11809,1981,Hong Kong,Macau,3,1,Friendly,So Kon Po,Hong Kong,False,4,2,Hong Kong
9949,10972,11810,1981,Sweden,Portugal,3,0,FIFA World Cup qualification,Solna,Sweden,False,3,3,Sweden
9950,10973,11811,1981,Mozambique,Angola,0,1,Friendly,Maputo,Mozambique,False,1,-1,Angola
9951,10974,11812,1981,Zambia,DR Congo,3,1,Friendly,Lusaka,Zambia,False,4,2,Zambia
9952,10975,11813,1981,Angola,Zimbabwe,1,1,Friendly,Maputo,Mozambique,True,2,0,Draw
9953,10976,11814,1981,Liberia,Ghana,0,0,Friendly,Monrovia,Liberia,False,0,0,Draw
9954,10977,11815,1981,Guinea,Ethiopia,2,2,African Cup of Nations qualification,Conakry,Guinea,False,4,0,Draw
9955,10978,11816,1981,Venezuela,Spain,0,2,Friendly,Caracas,Venezuela,False,2,-2,Spain
9956,10979,11817,1981,Zambia,DR Congo,2,2,Friendly,Lusaka,Zambia,False,4,0,Draw
9957,10980,11818,1981,Colombia,Spain,1,1,Friendly,Bogotá,Colombia,False,2,0,Draw
9958,10981,11819,1981,Finland,Norway,3,1,Nordic Championship,Helsinki,Finland,False,4,2,Finland
9959,10982,11820,1981,Barbados,Trinidad and Tobago,1,1,CFU Caribbean Cup qualification,Bridgetown,Barbados,False,2,0,Draw
9960,10983,11821,1981,Chile,Spain,1,1,Friendly,Santiago,Chile,False,2,0,Draw
9961,10984,11822,1981,Dominica,Guadeloupe,2,3,CFU Caribbean Cup qualification,Roseau,Dominica,False,5,-1,Guadeloupe
9962,10985,11823,1981,Saint Vincent and the Grenadines,Martinique,2,1,CFU Caribbean Cup qualification,Kingstown,Saint Vincent and the Grenadines,False,3,1,Saint Vincent and the Grenadines
9963,10986,11824,1981,Malawi,Mozambique,3,1,Friendly,Blantyre,Malawi,False,4,2,Malawi
9964,10987,11825,1981,Brazil,Spain,1,0,Friendly,Salvador,Brazil,False,1,1,Brazil
9965,10988,11826,1981,Mozambique,Zimbabwe,2,4,Friendly,Lilongwe,Malawi,True,6,-2,Zimbabwe
9966,10989,11827,1981,Malawi,Zimbabwe,2,0,Friendly,Blantyre,Malawi,False,2,2,Malawi
9967,10990,11828,1981,Kenya,Mauritius,2,1,Friendly,Saint-Paul,Réunion,True,3,1,Kenya
9968,10991,11829,1981,Réunion,Madagascar,2,3,Friendly,Saint-Pierre,Réunion,False,5,-1,Madagascar
9969,10992,11830,1981,Réunion,Madagascar,0,3,Friendly,Saint-Pierre,Réunion,False,3,-3,Madagascar
9970,10993,11831,1981,Madagascar,Mauritius,0,0,Friendly,Saint-Pierre,Réunion,True,0,0,Draw
9971,10994,11832,1981,Réunion,Kenya,1,3,Friendly,Saint-Paul,Réunion,False,4,-2,Kenya
9972,10995,11833,1981,Uruguay,Chile,0,0,Copa Juan Pinto Durán,Montevideo,Uruguay,False,0,0,Draw
9973,10996,11834,1981,Benin,DR Congo,1,2,Friendly,Cotonou,Benin,False,3,-1,DR Congo
9974,10997,11835,1981,Trinidad and Tobago,Barbados,1,1,CFU Caribbean Cup qualification,Port of Spain,Trinidad and Tobago,False,2,0,Draw
9975,10998,11836,1981,Nigeria,Burkina Faso,1,0,Friendly,Lagos,Nigeria,False,1,1,Nigeria
9976,10999,11837,1981,Benin,Ghana,1,2,Friendly,Cotonou,Benin,False,3,-1,Ghana
9977,11000,11838,1981,Kenya,Madagascar,1,0,Friendly,Saint-Paul,Réunion,True,1,1,Kenya
9978,11001,11839,1981,Martinique,Saint Vincent and the Grenadines,1,2,CFU Caribbean Cup qualification,Fort-de-France,Martinique,False,3,-1,Saint Vincent and the Grenadines
9979,11002,11840,1981,Réunion,Mauritius,1,2,Friendly,Saint-Pierre,Réunion,False,3,-1,Mauritius
9980,11003,11841,1981,Suriname,French Guiana,1,0,CFU Caribbean Cup qualification,Paramaribo,Suriname,False,1,1,Suriname
9981,11004,11842,1981,Ghana,DR Congo,2,2,African Cup of Nations qualification,Accra,Ghana,False,4,0,Draw
9982,11005,11843,1981,Colombia,Peru,1,1,FIFA World Cup qualification,Bogotá,Colombia,False,2,0,Draw
9983,11006,11844,1981,El Salvador,Haiti,4,0,Friendly,San Salvador,El Salvador,False,4,4,El Salvador
9984,11007,11845,1981,Fiji,Australia,1,4,FIFA World Cup qualification,Suva,Fiji,False,5,-3,Australia
9985,11008,11846,1981,Congo,DR Congo,2,2,Friendly,Brazzaville,Congo,False,4,0,Draw
9986,11009,11847,1981,Sweden,Finland,1,0,Nordic Championship,Halmstad,Sweden,False,1,1,Sweden
9987,11010,11848,1981,Zimbabwe,Nigeria,2,0,Friendly,Salisbury,Zimbabwe,False,2,2,Zimbabwe
9988,11011,11849,1981,DR Congo,Ghana,1,2,African Cup of Nations qualification,Kinshasa,Zaïre,False,3,-1,Ghana
9989,11012,11850,1981,Guadeloupe,Saint Vincent and the Grenadines,3,0,CFU Caribbean Cup qualification,Basse-Terre,Guadeloupe,False,3,3,Guadeloupe
9990,11013,11851,1981,Suriname,Trinidad and Tobago,1,1,CFU Caribbean Cup qualification,Paramaribo,Suriname,False,2,0,Draw
9991,11014,11852,1981,Kenya,Nigeria,1,3,Friendly,Nairobi,Kenya,False,4,-2,Nigeria
9992,11015,11853,1981,Peru,Chile,1,2,Friendly,Lima,Peru,False,3,-1,Chile
9993,11016,11854,1981,Uganda,Burundi,2,2,Friendly,Kampala,Uganda,False,4,0,Draw
9994,11017,11855,1981,Uruguay,Colombia,3,2,FIFA World Cup qualification,Montevideo,Uruguay,False,5,1,Uruguay
9995,11018,11856,1981,Indonesia,Fiji,3,3,FIFA World Cup qualification,Jakarta,Indonesia,False,6,0,Draw
9996,11019,11857,1981,Finland,Denmark,1,2,Nordic Championship,Tampere,Finland,False,3,-1,Denmark
9997,11020,11858,1981,Norway,Nigeria,2,2,Friendly,Oslo,Norway,False,4,0,Draw
9998,11021,11859,1981,Sweden,Bulgaria,1,0,Friendly,Uddevalla,Sweden,False,1,1,Sweden
9999,11022,11860,1981,Australia,Fiji,10,0,FIFA World Cup qualification,Melbourne,Australia,False,10,10,Australia
10000,11023,11861,1981,Indonesia,Philippines,3,0,Indonesia Tournament,Jakarta,Indonesia,False,3,3,Indonesia
10001,11024,11862,1981,Trinidad and Tobago,Suriname,3,2,CFU Caribbean Cup qualification,San Fernando,Trinidad and Tobago,False,5,1,Trinidad and Tobago
10002,11025,11863,1981,Cameroon,Madagascar,5,1,African Cup of Nations qualification,Yaoundé,Cameroon,False,6,4,Cameroon
10003,11026,11864,1981,Morocco,Zambia,2,1,African Cup of Nations qualification,Rabat,Morocco,False,3,1,Morocco
10004,11027,11865,1981,New Zealand,Fiji,13,0,FIFA World Cup qualification,Auckland,New Zealand,False,13,13,New Zealand
10005,11028,11866,1981,Peru,Colombia,2,0,FIFA World Cup qualification,Lima,Peru,False,2,2,Peru
10006,11029,11867,1981,Saint Vincent and the Grenadines,Guadeloupe,3,1,CFU Caribbean Cup qualification,Kingstown,Saint Vincent and the Grenadines,False,4,2,Saint Vincent and the Grenadines
10007,11031,11869,1981,Iceland,Nigeria,3,0,Friendly,Reykjavík,Iceland,False,3,3,Iceland
10008,11032,11870,1981,Iraq,Ghana,4,0,Friendly,Baghdad,Iraq,False,4,4,Iraq
10009,11033,11871,1981,Uruguay,Peru,1,2,FIFA World Cup qualification,Montevideo,Uruguay,False,3,-1,Peru
10010,11034,11872,1981,Iraq,Ghana,2,2,Friendly,Baghdad,Iraq,False,4,0,Draw
10011,11035,11873,1981,Chile,Brazil,0,0,Friendly,Santiago,Chile,False,0,0,Draw
10012,11036,11874,1981,Denmark,Iceland,3,0,Friendly,Copenhagen,Denmark,False,3,3,Denmark
10013,11037,11875,1981,Algeria,Burkina Faso,7,0,African Cup of Nations qualification,Oran,Algeria,False,7,7,Algeria
10014,11038,11876,1981,Indonesia,Australia,1,0,FIFA World Cup qualification,Surabaya,Indonesia,False,1,1,Indonesia
10015,11039,11877,1981,Madagascar,Cameroon,2,1,African Cup of Nations qualification,Antananarivo,Madagascar,False,3,1,Madagascar
10016,11040,11878,1981,Malaysia,Japan,0,2,Merdeka Tournament,Kuala Lumpur,Malaysia,False,2,-2,Japan
10017,11041,11879,1981,Zambia,Morocco,2,0,African Cup of Nations qualification,Lusaka,Zambia,False,2,2,Zambia
10018,11042,11880,1981,India,New Zealand,0,0,Merdeka Tournament,Kuala Lumpur,Malaysia,True,0,0,Draw
10019,11043,11881,1981,Singapore,Thailand,1,3,Merdeka Tournament,Kuala Lumpur,Malaysia,True,4,-2,Thailand
10020,11044,11882,1981,Switzerland,Netherlands,2,1,Friendly,Zürich,Switzerland,False,3,1,Switzerland
10021,11045,11883,1981,Finland,Albania,2,1,FIFA World Cup qualification,Kotka,Finland,False,3,1,Finland
10022,11046,11884,1981,Indonesia,United Arab Emirates,5,2,Merdeka Tournament,Kuala Lumpur,Malaysia,True,7,3,Indonesia
10023,11047,11885,1981,Poland,Germany,0,2,Friendly,Chorzów,Poland,False,2,-2,Germany
10024,11048,11886,1981,India,Japan,2,3,Merdeka Tournament,Kuala Lumpur,Malaysia,True,5,-1,Japan
10025,11049,11888,1981,Malawi,Zimbabwe,1,2,Friendly,Mbabane,Eswatini,True,3,-1,Zimbabwe
10026,11050,11889,1981,Malaysia,New Zealand,0,1,Merdeka Tournament,Kuala Lumpur,Malaysia,False,1,-1,New Zealand
10027,11051,11890,1981,Eswatini,Lesotho,1,1,Friendly,Mbabane,Eswatini,False,2,0,Draw
10028,11052,11891,1981,India,United Arab Emirates,2,0,Merdeka Tournament,Kuala Lumpur,Malaysia,True,2,2,India
10029,11053,11892,1981,Lesotho,Malawi,1,4,Friendly,Mbabane,Eswatini,True,5,-3,Malawi
10030,11054,11893,1981,Eswatini,Zimbabwe,0,2,Friendly,Mbabane,Eswatini,False,2,-2,Zimbabwe
10031,11055,11894,1981,Lesotho,Zimbabwe,2,5,Friendly,Mbabane,Eswatini,True,7,-3,Zimbabwe
10032,11056,11895,1981,Niger,Burkina Faso,2,1,Friendly,Niamey,Niger,False,3,1,Niger
10033,11057,11896,1981,Peru,Uruguay,0,0,FIFA World Cup qualification,Lima,Peru,False,0,0,Draw
10034,11058,11897,1981,Eswatini,Malawi,0,0,Friendly,Mbabane,Eswatini,False,0,0,Draw
10035,11059,11898,1981,Indonesia,New Zealand,0,0,Merdeka Tournament,Kuala Lumpur,Malaysia,True,0,0,Draw
10036,11060,11899,1981,Japan,United Arab Emirates,3,2,Merdeka Tournament,Kuala Lumpur,Malaysia,True,5,1,Japan
10037,11061,11900,1981,Belgium,France,2,0,FIFA World Cup qualification,Brussels,Belgium,False,2,2,Belgium
10038,11063,11903,1981,Iceland,Turkey,2,0,FIFA World Cup qualification,Reykjavík,Iceland,False,2,2,Iceland
10039,11064,11904,1981,Malaysia,Indonesia,2,0,Merdeka Tournament,Kuala Lumpur,Malaysia,False,2,2,Malaysia
10040,11065,11905,1981,Netherlands,Republic of Ireland,2,2,FIFA World Cup qualification,Rotterdam,Netherlands,False,4,0,Draw
10041,11066,11906,1981,Norway,England,2,1,FIFA World Cup qualification,Oslo,Norway,False,3,1,Norway
10042,11067,11907,1981,Romania,Bulgaria,1,2,Friendly,Bucharest,Romania,False,3,-1,Bulgaria
10043,11068,11908,1981,Scotland,Sweden,2,0,FIFA World Cup qualification,Glasgow,Scotland,False,2,2,Scotland
10044,11069,11909,1981,Iraq,Thailand,7,1,Merdeka Tournament,Kuala Lumpur,Malaysia,True,8,6,Iraq
10045,11070,11910,1981,New Zealand,United Arab Emirates,0,1,Merdeka Tournament,Kuala Lumpur,Malaysia,True,1,-1,United Arab Emirates
10046,11071,11911,1981,India,Indonesia,1,0,Merdeka Tournament,Kuala Lumpur,Malaysia,True,1,1,India
10047,11072,11912,1981,Japan,New Zealand,0,1,Merdeka Tournament,Kuala Lumpur,Malaysia,True,1,-1,New Zealand
10048,11073,11913,1981,Malaysia,United Arab Emirates,0,1,Merdeka Tournament,Kuala Lumpur,Malaysia,False,1,-1,United Arab Emirates
10049,11074,11914,1981,Colombia,Uruguay,1,1,FIFA World Cup qualification,Bogotá,Colombia,False,2,0,Draw
10050,11076,11916,1981,Saint Vincent and the Grenadines,Suriname,2,1,CFU Caribbean Cup qualification,Kingstown,Saint Vincent and the Grenadines,False,3,1,Saint Vincent and the Grenadines
10051,11077,11917,1981,Indonesia,Japan,0,2,Merdeka Tournament,Kuala Lumpur,Malaysia,True,2,-2,Japan
10052,11078,11918,1981,Malaysia,India,2,2,Merdeka Tournament,Kuala Lumpur,Malaysia,False,4,0,Draw
10053,11079,11919,1981,Iraq,Singapore,4,0,Merdeka Tournament,Kuala Lumpur,Malaysia,True,4,4,Iraq
10054,11080,11921,1981,Iraq,Japan,2,0,Merdeka Tournament,Kuala Lumpur,Malaysia,True,2,2,Iraq
10055,11081,11922,1981,Burkina Faso,Algeria,1,1,African Cup of Nations qualification,Ouagadougou,Upper Volta,False,2,0,Draw
10056,11082,11923,1981,Venezuela,Cuba,1,0,Friendly,Barquisimeto,Venezuela,False,1,1,Venezuela
10057,11083,11924,1981,Austria,Spain,0,0,Friendly,Vienna,Austria,False,0,0,Draw
10058,11084,11925,1981,Denmark,Norway,2,1,Nordic Championship,Copenhagen,Denmark,False,3,1,Denmark
10059,11085,11926,1981,Germany,Finland,7,1,FIFA World Cup qualification,Bochum,Germany,False,8,6,Germany
10060,11086,11927,1981,Greece,Sweden,2,1,Friendly,Salonica,Greece,False,3,1,Greece
10061,11088,11929,1981,Italy,Bulgaria,3,2,Friendly,Bologna,Italy,False,5,1,Italy
10062,11089,11930,1981,Portugal,Poland,2,0,Friendly,Lisbon,Portugal,False,2,2,Portugal
10063,11090,11931,1981,Romania,Hungary,0,0,FIFA World Cup qualification,Bucharest,Romania,False,0,0,Draw
10064,11091,11932,1981,Russia,Turkey,4,0,FIFA World Cup qualification,Moscow,Soviet Union,True,4,4,Russia
10065,11092,11934,1981,Uganda,Nigeria,1,0,Friendly,Kampala,Uganda,False,1,1,Uganda
10066,11093,11935,1981,Morocco,Tunisia,2,2,Friendly,Kénitra,Morocco,False,4,0,Draw
10067,11094,11936,1981,Suriname,Saint Vincent and the Grenadines,3,3,CFU Caribbean Cup qualification,Paramaribo,Suriname,False,6,0,Draw
10068,11095,11937,1981,Botswana,Zimbabwe,0,1,Friendly,Gaborone,Botswana,False,1,-1,Zimbabwe
10069,11096,11938,1981,Trinidad and Tobago,Grenada,3,1,Friendly,Arima,Trinidad and Tobago,False,4,2,Trinidad and Tobago
10070,11097,11939,1981,Trinidad and Tobago,Grenada,5,1,Friendly,San Fernando,Trinidad and Tobago,False,6,4,Trinidad and Tobago
10071,11099,11941,1981,Nigeria,Liberia,3,0,Friendly,Calabar,Nigeria,False,3,3,Nigeria
10072,11100,11942,1981,Ethiopia,Guinea,1,1,African Cup of Nations qualification,Addis Abeba,Ethiopia,False,2,0,Draw
10073,11101,11943,1981,Turkey,Russia,0,3,FIFA World Cup qualification,Izmir,Turkey,False,3,-3,Russia
10074,11102,11945,1981,New Zealand,Kuwait,1,2,FIFA World Cup qualification,Auckland,New Zealand,False,3,-1,Kuwait
10075,11103,11946,1981,Nigeria,Algeria,0,2,FIFA World Cup qualification,Lagos,Nigeria,False,2,-2,Algeria
10076,11104,11947,1981,Romania,Switzerland,1,2,FIFA World Cup qualification,Bucharest,Romania,False,3,-1,Switzerland
10077,11105,11948,1981,Trinidad and Tobago,Canada,2,4,Friendly,San Fernando,Trinidad and Tobago,False,6,-2,Canada
10078,11106,11949,1981,Albania,Bulgaria,0,2,FIFA World Cup qualification,Tirana,Albania,False,2,-2,Bulgaria
10079,11107,11950,1981,Austria,Germany,1,3,FIFA World Cup qualification,Vienna,Austria,False,4,-2,Germany
10080,11108,11951,1981,Greece,Denmark,2,3,FIFA World Cup qualification,Salonica,Greece,False,5,-1,Denmark
10081,11109,11952,1981,Hungary,Switzerland,3,0,FIFA World Cup qualification,Budapest,Hungary,False,3,3,Hungary
10082,11110,11953,1981,Republic of Ireland,France,3,2,FIFA World Cup qualification,Dublin,Republic of Ireland,False,5,1,Republic of Ireland
10083,11111,11954,1981,Netherlands,Belgium,3,0,FIFA World Cup qualification,Rotterdam,Netherlands,False,3,3,Netherlands
10084,11112,11955,1981,Northern Ireland,Scotland,0,0,FIFA World Cup qualification,Belfast,Northern Ireland,False,0,0,Draw
10085,11113,11956,1981,Portugal,Sweden,1,2,FIFA World Cup qualification,Lisbon,Portugal,False,3,-1,Sweden
10086,11114,11957,1981,Spain,Luxembourg,3,0,Friendly,Valencia,Spain,False,3,3,Spain
10087,11115,11958,1981,Wales,Iceland,2,2,FIFA World Cup qualification,Swansea,Wales,False,4,0,Draw
10088,11117,11962,1981,Puerto Rico,Guadeloupe,1,1,CFU Caribbean Cup,San Juan,Puerto Rico,False,2,0,Draw
10089,11118,11963,1981,Saint Vincent and the Grenadines,Trinidad and Tobago,0,2,CFU Caribbean Cup,San Juan,Puerto Rico,True,2,-2,Trinidad and Tobago
10090,11119,11964,1981,Guadeloupe,Trinidad and Tobago,0,2,CFU Caribbean Cup,San Juan,Puerto Rico,True,2,-2,Trinidad and Tobago
10091,11120,11965,1981,Puerto Rico,Saint Vincent and the Grenadines,0,2,CFU Caribbean Cup,San Juan,Puerto Rico,False,2,-2,Saint Vincent and the Grenadines
10092,11121,11966,1981,Guadeloupe,Saint Vincent and the Grenadines,1,3,CFU Caribbean Cup,San Juan,Puerto Rico,True,4,-2,Saint Vincent and the Grenadines
10093,11122,11967,1981,Tunisia,Malta,0,1,Friendly,Tunis,Tunisia,False,1,-1,Malta
10094,11123,11968,1981,United Arab Emirates,India,2,0,Friendly,Abu Dhabi,United Arab Emirates,False,2,2,United Arab Emirates
10095,11124,11969,1981,Argentina,Poland,1,2,Friendly,Buenos Aires,Argentina,False,3,-1,Poland
10096,11125,11970,1981,Brazil,Bulgaria,3,0,Friendly,Porto Alegre,Brazil,False,3,3,Brazil
10097,11126,11971,1981,Israel,Portugal,4,1,FIFA World Cup qualification,Ramat-Gan,Israel,False,5,3,Israel
10098,11128,11973,1981,Saudi Arabia,Sweden,1,2,Friendly,Riyadh,Saudi Arabia,False,3,-1,Sweden
10099,11129,11974,1981,United Arab Emirates,India,3,1,Friendly,Sharjah,United Arab Emirates,False,4,2,United Arab Emirates
10100,11130,11975,1981,Algeria,Nigeria,2,1,FIFA World Cup qualification,Constantine,Algeria,False,3,1,Algeria
10101,11131,11976,1981,Burundi,Tanzania,1,2,Friendly,Bujumbura,Burundi,False,3,-1,Tanzania
10102,11132,11977,1981,Hungary,Norway,4,1,FIFA World Cup qualification,Budapest,Hungary,False,5,3,Hungary
10103,11133,11978,1981,Mexico,Cuba,4,0,FIFA World Cup qualification,Tegucigalpa,Honduras,True,4,4,Mexico
10104,11134,11979,1981,Senegal,Morocco,2,0,Friendly,Dakar,Senegal,False,2,2,Senegal
10105,11135,11980,1981,Burundi,Tanzania,0,1,Friendly,Bujumbura,Burundi,False,1,-1,Tanzania
10106,11136,11981,1981,Canada,El Salvador,1,0,FIFA World Cup qualification,Tegucigalpa,Honduras,True,1,1,Canada
10107,11137,11982,1981,Honduras,Haiti,4,0,FIFA World Cup qualification,Tegucigalpa,Honduras,False,4,4,Honduras
10108,11138,11983,1981,Saudi Arabia,Kuwait,0,1,FIFA World Cup qualification,Riyadh,Saudi Arabia,False,1,-1,Kuwait
10109,11139,11984,1981,Trinidad and Tobago,Barbados,2,1,Friendly,Arima,Trinidad and Tobago,False,3,1,Trinidad and Tobago
10110,11140,11985,1981,Canada,Haiti,1,1,FIFA World Cup qualification,Tegucigalpa,Honduras,True,2,0,Draw
10111,11141,11986,1981,Mexico,El Salvador,0,1,FIFA World Cup qualification,Tegucigalpa,Honduras,True,1,-1,El Salvador
10112,11142,11987,1981,Trinidad and Tobago,Barbados,0,0,Friendly,Port of Spain,Trinidad and Tobago,False,0,0,Draw
10113,11143,11988,1981,Honduras,Cuba,2,0,FIFA World Cup qualification,Tegucigalpa,Honduras,False,2,2,Honduras
10114,11144,11989,1981,Tunisia,Cameroon,1,1,Friendly,Tunis,Tunisia,False,2,0,Draw
10115,11145,11990,1981,Thailand,Singapore,2,1,King's Cup,Bangkok,Thailand,False,3,1,Thailand
10116,11147,11992,1981,Bulgaria,Austria,0,0,FIFA World Cup qualification,Sofia,Bulgaria,False,0,0,Draw
10117,11148,11993,1981,Cuba,El Salvador,0,0,FIFA World Cup qualification,Tegucigalpa,Honduras,True,0,0,Draw
10118,11149,11995,1981,Haiti,Mexico,1,1,FIFA World Cup qualification,Tegucigalpa,Honduras,True,2,0,Draw
10119,11150,11996,1981,Malaysia,Singapore,0,1,King's Cup,Chonburi,Thailand,True,1,-1,Singapore
10120,11151,11997,1981,Switzerland,Romania,0,0,FIFA World Cup qualification,Berne,Switzerland,False,0,0,Draw
10121,11152,11998,1981,Thailand,Pakistan,1,0,King's Cup,Bangkok,Thailand,False,1,1,Thailand
10122,11153,11999,1981,Honduras,Canada,2,1,FIFA World Cup qualification,Tegucigalpa,Honduras,False,3,1,Honduras
10123,11155,12001,1981,Malaysia,Pakistan,2,3,King's Cup,Bangkok,Thailand,True,5,-1,Pakistan
10124,11156,12002,1981,Italy,Greece,1,1,FIFA World Cup qualification,Turin,Italy,False,2,0,Draw
10125,11157,12003,1981,Kenya,Malawi,1,0,CECAFA Cup,Dar es Salaam,Tanzania,True,1,1,Kenya
10126,11158,12004,1981,Haiti,Cuba,0,2,FIFA World Cup qualification,Tegucigalpa,Honduras,True,2,-2,Cuba
10127,11159,12005,1981,Mexico,Canada,1,1,FIFA World Cup qualification,Tegucigalpa,Honduras,True,2,0,Draw
10128,11160,12006,1981,Morocco,Cameroon,0,2,FIFA World Cup qualification,Kenitra,Morocco,False,2,-2,Cameroon
10129,11161,12007,1981,Poland,Malta,6,0,FIFA World Cup qualification,Wrocław,Poland,False,6,6,Poland
10130,11162,12008,1981,Sudan,Uganda,2,2,CECAFA Cup,Dodoma,Tanzania,True,4,0,Draw
10131,11164,12010,1981,Thailand,Malaysia,2,0,King's Cup,Bangkok,Thailand,False,2,2,Thailand
10132,11165,12011,1981,Honduras,El Salvador,0,0,FIFA World Cup qualification,Tegucigalpa,Honduras,False,0,0,Draw
10133,11167,12013,1981,Pakistan,Singapore,1,0,King's Cup,Bangkok,Thailand,True,1,1,Pakistan
10134,11168,12014,1981,Sudan,Zimbabwe,0,0,CECAFA Cup,Dodoma,Tanzania,True,0,0,Draw
10135,11169,12015,1981,Tanzania,Malawi,2,2,CECAFA Cup,Dar es Salaam,Tanzania,False,4,0,Draw
10136,11170,12016,1981,Uganda,Zambia,3,1,CECAFA Cup,Dodoma,Tanzania,True,4,2,Uganda
10137,11171,12017,1981,England,Hungary,1,0,FIFA World Cup qualification,London,England,False,1,1,England
10138,11172,12018,1981,France,Netherlands,2,0,FIFA World Cup qualification,Paris,France,False,2,2,France
10139,11173,12019,1981,Germany,Albania,8,0,FIFA World Cup qualification,Dortmund,Germany,False,8,8,Germany
10140,11174,12020,1981,Northern Ireland,Israel,1,0,FIFA World Cup qualification,Belfast,Northern Ireland,False,1,1,Northern Ireland
10141,11175,12021,1981,Poland,Spain,2,3,Friendly,Łódź,Poland,False,5,-1,Spain
10142,11176,12022,1981,Portugal,Scotland,2,1,FIFA World Cup qualification,Lisbon,Portugal,False,3,1,Portugal
10143,11177,12023,1981,Russia,Wales,3,0,FIFA World Cup qualification,Tbilisi,Soviet Union,True,3,3,Russia
10144,11178,12025,1981,El Salvador,Haiti,1,0,FIFA World Cup qualification,Tegucigalpa,Honduras,True,1,1,El Salvador
10145,11179,12026,1981,Zambia,Zimbabwe,1,1,CECAFA Cup,Dar es Salaam,Tanzania,True,2,0,Draw
10146,11181,12028,1981,Tanzania,Kenya,1,0,CECAFA Cup,Dodoma,Tanzania,False,1,1,Tanzania
10147,11182,12029,1981,Cuba,Canada,2,2,FIFA World Cup qualification,Tegucigalpa,Honduras,True,4,0,Draw
10148,11183,12030,1981,Sudan,Zambia,0,2,CECAFA Cup,Dar es Salaam,Tanzania,True,2,-2,Zambia
10149,11184,12032,1981,Germany,Bulgaria,4,0,FIFA World Cup qualification,Düsseldorf,Germany,False,4,4,Germany
10150,11185,12033,1981,Honduras,Mexico,0,0,FIFA World Cup qualification,Tegucigalpa,Honduras,False,0,0,Draw
10151,11186,12034,1981,Kenya,Uganda,3,1,CECAFA Cup,Dar es Salaam,Tanzania,True,4,2,Kenya
10152,11187,12035,1981,Tanzania,Zambia,2,1,CECAFA Cup,Dodoma,Tanzania,False,3,1,Tanzania
10153,11188,12036,1981,Uganda,Zambia,0,1,CECAFA Cup,Dodoma,Tanzania,True,1,-1,Zambia
10154,11189,12037,1981,New Zealand,Saudi Arabia,2,2,FIFA World Cup qualification,Auckland,New Zealand,False,4,0,Draw
10155,11190,12038,1981,Tanzania,Kenya,0,1,CECAFA Cup,Dar es Salaam,Tanzania,False,1,-1,Kenya
10156,11191,12039,1981,Cameroon,Morocco,2,1,FIFA World Cup qualification,Yaoundé,Cameroon,False,3,1,Cameroon
10157,11194,12043,1981,France,Cyprus,4,0,FIFA World Cup qualification,Paris,France,False,4,4,France
10158,11195,12044,1981,Italy,Luxembourg,1,0,FIFA World Cup qualification,Naples,Italy,False,1,1,Italy
10159,11196,12045,1981,Kuwait,Saudi Arabia,2,0,FIFA World Cup qualification,Kuwait City,Kuwait,False,2,2,Kuwait
10160,11197,12046,1981,Kuwait,New Zealand,2,2,FIFA World Cup qualification,Kuwait City,Kuwait,False,4,0,Draw
10161,11198,12047,1981,Bulgaria,Portugal,5,2,Friendly,Haskovo,Bulgaria,False,7,3,Bulgaria
10162,11199,12048,1981,Spain,Belgium,2,0,Friendly,Valencia,Spain,False,2,2,Spain
10163,11200,12049,1981,Saudi Arabia,New Zealand,0,5,FIFA World Cup qualification,Riyadh,Saudi Arabia,False,5,-5,New Zealand
10164,11201,12050,1981,United Arab Emirates,Tunisia,1,4,Friendly,al-Ain,United Arab Emirates,False,5,-3,Tunisia
10165,11202,12052,1982,Cameroon,Congo,2,1,Friendly,Yaoundé,Cameroon,False,3,1,Cameroon
10166,11203,12053,1982,Ethiopia,Tanzania,0,2,Friendly,Addis Abeba,Ethiopia,False,2,-2,Tanzania
10167,11204,12054,1982,Singapore,Bahrain,2,0,Friendly,Kallang,Singapore,False,2,2,Singapore
10168,11205,12055,1982,Ethiopia,Tanzania,0,0,Friendly,Addis Abeba,Ethiopia,False,0,0,Draw
10169,11206,12056,1982,Greece,Portugal,1,2,Friendly,Athens,Greece,False,3,-1,Portugal
10170,11207,12057,1982,Benin,Mali,2,3,Friendly,Cotonou,Benin,False,5,-1,Mali
10171,11208,12058,1982,Burkina Faso,Senegal,0,0,Friendly,Bobo Dioulasso,Upper Volta,False,0,0,Draw
10172,11210,12060,1982,Senegal,Benin,1,0,Friendly,Dakar,Senegal,False,1,1,Senegal
10173,11211,12061,1982,Libya,Guinea,3,0,Friendly,Tripoli,Libya,False,3,3,Libya
10174,11212,12062,1982,Mali,Niger,2,2,Friendly,Bamako,Mali,False,4,0,Draw
10175,11213,12063,1982,Tunisia,Algeria,0,1,Friendly,Tunis,Tunisia,False,1,-1,Algeria
10176,11215,12066,1982,Guinea,Senegal,1,1,Amílcar Cabral Cup,Praia,Cape Verde,True,2,0,Draw
10177,11216,12067,1982,Guinea-Bissau,Sierra Leone,1,2,Amílcar Cabral Cup,Praia,Cape Verde,True,3,-1,Sierra Leone
10178,11217,12068,1982,Mali,Mauritania,4,0,Amílcar Cabral Cup,Praia,Cape Verde,True,4,4,Mali
10179,11218,12069,1982,New Zealand,Hungary,1,2,Friendly,Auckland,New Zealand,False,3,-1,Hungary
10180,11219,12070,1982,Benin,Ghana,0,4,West African Cup,Cotonou,Benin,False,4,-4,Ghana
10181,11220,12072,1982,Gambia,Mauritania,3,1,Amílcar Cabral Cup,Praia,Cape Verde,True,4,2,Gambia
10182,11221,12073,1982,Guinea,Sierra Leone,1,0,Amílcar Cabral Cup,Praia,Cape Verde,True,1,1,Guinea
10183,11222,12074,1982,Guinea-Bissau,Senegal,0,1,Amílcar Cabral Cup,Praia,Cape Verde,True,1,-1,Senegal
10184,11223,12075,1982,Liberia,Togo,0,1,West African Cup,Cotonou,Benin,True,1,-1,Togo
10185,11224,12076,1982,Ethiopia,Uganda,1,2,Friendly,Addis Abeba,Ethiopia,False,3,-1,Uganda
10186,11225,12077,1982,New Zealand,Hungary,1,2,Friendly,Christchurch,New Zealand,False,3,-1,Hungary
10187,11226,12078,1982,Benin,Niger,2,0,West African Cup,Cotonou,Benin,False,2,2,Benin
10188,11227,12080,1982,Gambia,Mali,1,1,Amílcar Cabral Cup,Praia,Cape Verde,True,2,0,Draw
10189,11228,12081,1982,Ghana,Ivory Coast,5,5,West African Cup,Cotonou,Benin,True,10,0,Draw
10190,11229,12082,1982,Guinea-Bissau,Guinea,0,0,Amílcar Cabral Cup,Praia,Cape Verde,True,0,0,Draw
10191,11230,12083,1982,Liberia,Burkina Faso,1,2,West African Cup,Cotonou,Benin,True,3,-1,Burkina Faso
10192,11231,12084,1982,Senegal,Sierra Leone,2,0,Amílcar Cabral Cup,Praia,Cape Verde,True,2,2,Senegal
10193,11232,12085,1982,Bangladesh,Nepal,1,1,Friendly,Karachi,Pakistan,True,2,0,Draw
10194,11234,12087,1982,Benin,Ivory Coast,3,3,West African Cup,Cotonou,Benin,False,6,0,Draw
10195,11235,12089,1982,Germany,Portugal,3,1,Friendly,Hanover,Germany,False,4,2,Germany
10196,11236,12090,1982,Ghana,Niger,2,2,West African Cup,Cotonou,Benin,True,4,0,Draw
10197,11237,12091,1982,Mali,Senegal,0,1,Amílcar Cabral Cup,Praia,Cape Verde,True,1,-1,Senegal
10198,11238,12092,1982,Nepal,Oman,0,1,Friendly,Karachi,Pakistan,True,1,-1,Oman
10199,11239,12093,1982,Togo,Burkina Faso,2,1,West African Cup,Cotonou,Benin,True,3,1,Togo
10200,11240,12094,1982,Ethiopia,Uganda,1,0,Friendly,Asmara,Ethiopia,False,1,1,Ethiopia
10201,11242,12096,1982,Zambia,Botswana,2,0,Friendly,Lusaka,Zambia,False,2,2,Zambia
10202,11243,12097,1982,Bangladesh,Oman,1,3,Friendly,Karachi,Pakistan,True,4,-2,Oman
10203,11244,12099,1982,Ghana,Burkina Faso,1,0,West African Cup,Cotonou,Benin,True,1,1,Ghana
10204,11245,12100,1982,Guinea,Senegal,3,0,Amílcar Cabral Cup,Praia,Cape Verde,True,3,3,Guinea
10205,11246,12101,1982,Ivory Coast,Niger,1,1,West African Cup,Cotonou,Benin,True,2,0,Draw
10206,11247,12102,1982,Libya,Qatar,2,1,Friendly,Tripoli,Libya,False,3,1,Libya
10207,11248,12103,1982,Finland,Sweden,2,2,Friendly,Lahti,Finland,False,4,0,Draw
10208,11249,12105,1982,Finland,Sweden,2,1,Friendly,Lahti,Finland,False,3,1,Finland
10209,11250,12106,1982,Ivory Coast,Togo,1,1,West African Cup,Cotonou,Benin,True,2,0,Draw
10210,11251,12108,1982,Ivory Coast,Burkina Faso,1,1,West African Cup,Cotonou,Benin,True,2,0,Draw
10211,11252,12109,1982,England,Northern Ireland,4,0,British Championship,London,England,False,4,4,England
10212,11253,12110,1982,France,Italy,2,0,Friendly,Paris,France,False,2,2,France
10213,11254,12111,1982,Ghana,Togo,2,1,West African Cup,Cotonou,Benin,True,3,1,Ghana
10214,11255,12112,1982,Spain,Scotland,3,0,Friendly,Valencia,Spain,False,3,3,Spain
10215,11256,12113,1982,India,Uruguay,1,3,Nehru Cup,Calcutta,India,False,4,-2,Uruguay
10216,11257,12115,1982,United Arab Emirates,Honduras,0,1,Friendly,Abu Dhabi,United Arab Emirates,False,1,-1,Honduras
10217,11260,12118,1982,United Arab Emirates,Honduras,0,0,Friendly,Abu Dhabi,United Arab Emirates,False,0,0,Draw
10218,11261,12120,1982,Cameroon,Tunisia,1,1,African Cup of Nations,Tripoli,Libya,True,2,0,Draw
10219,11262,12121,1982,Libya,Ghana,2,2,African Cup of Nations,Tripoli,Libya,False,4,0,Draw
10220,11264,12123,1982,Algeria,Zambia,1,0,African Cup of Nations,Benghazi,Libya,True,1,1,Algeria
10221,11265,12124,1982,Ethiopia,Nigeria,0,3,African Cup of Nations,Benghazi,Libya,True,3,-3,Nigeria
10222,11268,12127,1982,Cameroon,Ghana,0,0,African Cup of Nations,Tripoli,Libya,True,0,0,Draw
10223,11269,12128,1982,Libya,Tunisia,2,0,African Cup of Nations,Tripoli,Libya,False,2,2,Libya
10224,11270,12129,1982,Liechtenstein,Switzerland,0,1,Friendly,Balzers,Liechtenstein,False,1,-1,Switzerland
10225,11271,12130,1982,Algeria,Nigeria,2,1,African Cup of Nations,Benghazi,Libya,True,3,1,Algeria
10226,11272,12131,1982,Ethiopia,Zambia,0,1,African Cup of Nations,Benghazi,Libya,True,1,-1,Zambia
10227,11273,12132,1982,Greece,Russia,0,2,Friendly,Athens,Greece,False,2,-2,Russia
10228,11275,12134,1982,United Arab Emirates,Singapore,3,0,Friendly,Abu Dhabi,United Arab Emirates,False,3,3,United Arab Emirates
10229,11276,12135,1982,Ghana,Tunisia,1,0,African Cup of Nations,Tripoli,Libya,True,1,1,Ghana
10230,11277,12136,1982,Libya,Cameroon,0,0,African Cup of Nations,Tripoli,Libya,False,0,0,Draw
10231,11278,12137,1982,United Arab Emirates,Singapore,5,3,Friendly,Abu Dhabi,United Arab Emirates,False,8,2,United Arab Emirates
10232,11279,12138,1982,Algeria,Ethiopia,0,0,African Cup of Nations,Benghazi,Libya,True,0,0,Draw
10233,11280,12139,1982,Nigeria,Zambia,0,3,African Cup of Nations,Benghazi,Libya,True,3,-3,Zambia
10234,11281,12140,1982,Kuwait,Iceland,0,0,Friendly,Kuwait City,Kuwait,False,0,0,Draw
10235,11282,12141,1982,Algeria,Ghana,2,3,African Cup of Nations,Benghazi,Libya,True,5,-1,Ghana
10236,11283,12142,1982,Libya,Zambia,2,1,African Cup of Nations,Tripoli,Libya,False,3,1,Libya
10237,11284,12143,1982,Algeria,Zambia,0,2,African Cup of Nations,Tripoli,Libya,True,2,-2,Zambia
10238,11285,12144,1982,Libya,Ghana,1,1,African Cup of Nations,Tripoli,Libya,False,2,0,Draw
10239,11286,12145,1982,United Arab Emirates,Qatar,1,0,Gulf Cup,Abu Dhabi,United Arab Emirates,False,1,1,United Arab Emirates
10240,11287,12146,1982,Bahrain,Kuwait,0,2,Gulf Cup,Abu Dhabi,United Arab Emirates,True,2,-2,Kuwait
10241,11288,12147,1982,Iraq,Oman,4,0,Gulf Cup,Abu Dhabi,United Arab Emirates,True,4,4,Iraq
10242,11289,12148,1982,Brazil,Germany,1,0,Friendly,Rio de Janeiro,Brazil,False,1,1,Brazil
10243,11290,12150,1982,Trinidad and Tobago,United States,1,2,Friendly,Port of Spain,Trinidad and Tobago,False,3,-1,United States
10244,11291,12151,1982,United Arab Emirates,Saudi Arabia,1,0,Gulf Cup,Abu Dhabi,United Arab Emirates,False,1,1,United Arab Emirates
10245,11292,12152,1982,Oman,Qatar,0,3,Gulf Cup,Abu Dhabi,United Arab Emirates,True,3,-3,Qatar
10246,11293,12153,1982,Chile,Peru,2,1,Friendly,Santiago,Chile,False,3,1,Chile
10247,11294,12154,1982,Scotland,Netherlands,2,1,Friendly,Glasgow,Scotland,False,3,1,Scotland
10248,11295,12155,1982,Argentina,Germany,1,1,Friendly,Buenos Aires,Argentina,False,2,0,Draw
10249,11296,12156,1982,Belgium,Romania,4,1,Friendly,Brussels,Belgium,False,5,3,Belgium
10250,11297,12158,1982,France,Northern Ireland,4,0,Friendly,Paris,France,False,4,4,France
10251,11298,12159,1982,Hungary,Austria,2,3,Friendly,Budapest,Hungary,False,5,-1,Austria
10252,11299,12160,1982,Iraq,Saudi Arabia,1,1,Gulf Cup,Abu Dhabi,United Arab Emirates,True,2,0,Draw
10253,11300,12161,1982,Spain,Wales,1,1,Friendly,Valencia,Spain,False,2,0,Draw
10254,11301,12162,1982,Switzerland,Portugal,2,1,Friendly,Lugano,Switzerland,False,3,1,Switzerland
10255,11302,12163,1982,United Arab Emirates,Kuwait,0,2,Gulf Cup,Abu Dhabi,United Arab Emirates,False,2,-2,Kuwait
10256,11303,12164,1982,Bahrain,Oman,4,1,Gulf Cup,Abu Dhabi,United Arab Emirates,True,5,3,Bahrain
10257,11304,12165,1982,Iraq,Qatar,2,1,Gulf Cup,Abu Dhabi,United Arab Emirates,True,3,1,Iraq
10258,11305,12166,1982,Saudi Arabia,Kuwait,0,1,Gulf Cup,Abu Dhabi,United Arab Emirates,True,1,-1,Kuwait
10259,11306,12167,1982,United Arab Emirates,Bahrain,2,3,Gulf Cup,Abu Dhabi,United Arab Emirates,False,5,-1,Bahrain
10260,11307,12168,1982,Kuwait,Oman,2,0,Gulf Cup,Abu Dhabi,United Arab Emirates,True,2,2,Kuwait
10261,11308,12169,1982,Saudi Arabia,Qatar,1,0,Gulf Cup,Abu Dhabi,United Arab Emirates,True,1,1,Saudi Arabia
10262,11309,12170,1982,Peru,Chile,1,0,Copa del Pacífico,Lima,Peru,False,1,1,Peru
10263,11310,12171,1982,Bahrain,Qatar,1,0,Gulf Cup,Abu Dhabi,United Arab Emirates,True,1,1,Bahrain
10264,11311,12172,1982,Saudi Arabia,Oman,3,0,Gulf Cup,Abu Dhabi,United Arab Emirates,True,3,3,Saudi Arabia
10265,11312,12173,1982,Nepal,Bhutan,3,1,Friendly,Kathmandu,Nepal,False,4,2,Nepal
10266,11313,12174,1982,Bahrain,Saudi Arabia,2,2,Gulf Cup,Abu Dhabi,United Arab Emirates,True,4,0,Draw
10267,11314,12175,1982,United Arab Emirates,Oman,3,1,Gulf Cup,Abu Dhabi,United Arab Emirates,False,4,2,United Arab Emirates
10268,11315,12176,1982,Kuwait,Qatar,1,2,Gulf Cup,Abu Dhabi,United Arab Emirates,True,3,-1,Qatar
10269,11316,12177,1982,India,Thailand,1,1,Friendly,Kathmandu,Nepal,True,2,0,Draw
10270,11317,12178,1982,Argentina,Russia,1,1,Friendly,Buenos Aires,Argentina,False,2,0,Draw
10271,11318,12179,1982,Bulgaria,Romania,1,2,Friendly,Ruse,Bulgaria,False,3,-1,Romania
10272,11320,12182,1982,Netherlands,Greece,1,0,Friendly,Eindhoven,Netherlands,False,1,1,Netherlands
10273,11321,12183,1982,El Salvador,Honduras,3,2,Friendly,San Salvador,El Salvador,False,5,1,El Salvador
10274,11322,12184,1982,Hungary,Peru,1,2,Friendly,Budapest,Hungary,False,3,-1,Peru
10275,11323,12185,1982,Nepal,Thailand,1,0,Friendly,Kathmandu,Nepal,False,1,1,Nepal
10276,11324,12186,1982,Honduras,El Salvador,1,1,Friendly,San Pedro Sula,Honduras,False,2,0,Draw
10277,11325,12187,1982,Algeria,Peru,1,1,Friendly,Algiers,Algeria,False,2,0,Draw
10278,11326,12188,1982,Wales,England,0,1,British Championship,Cardiff,Wales,False,1,-1,England
10279,11327,12189,1982,Algeria,Republic of Ireland,2,0,Friendly,Algiers,Algeria,False,2,2,Algeria
10280,11329,12191,1982,Belgium,Bulgaria,2,1,Friendly,Brussels,Belgium,False,3,1,Belgium
10281,11330,12192,1982,France,Peru,0,1,Friendly,Paris,France,False,1,-1,Peru
10282,11331,12193,1982,Northern Ireland,Scotland,1,1,British Championship,Belfast,Northern Ireland,False,2,0,Draw
10283,11332,12194,1982,Norway,Finland,1,1,Nordic Championship,Stavanger,Norway,False,2,0,Draw
10284,11333,12195,1982,Spain,Switzerland,2,0,Friendly,Valencia,Spain,False,2,2,Spain
10285,11334,12196,1982,Cameroon,Senegal,2,1,Friendly,Douala,Cameroon,False,3,1,Cameroon
10286,11335,12197,1982,Romania,Cyprus,3,1,UEFA Euro qualification,Hunedoara,Romania,False,4,2,Romania
10287,11336,12198,1982,Thailand,Singapore,1,1,King's Cup,Bangkok,Thailand,False,2,0,Draw
10288,11337,12199,1982,Cameroon,Guinea,1,1,Friendly,Yaoundé,Cameroon,False,2,0,Draw
10289,11338,12200,1982,Ghana,Senegal,0,0,Friendly,Yaoundé,Cameroon,True,0,0,Draw
10290,11339,12201,1982,Argentina,Bulgaria,2,1,Friendly,Buenos Aires,Argentina,False,3,1,Argentina
10291,11340,12202,1982,Brazil,Portugal,3,1,Friendly,São Luís,Brazil,False,4,2,Brazil
10292,11341,12203,1982,Cameroon,Ghana,0,0,Friendly,Yaoundé,Cameroon,False,0,0,Draw
10293,11342,12204,1982,Denmark,Sweden,1,1,Nordic Championship,Copenhagen,Denmark,False,2,0,Draw
10294,11343,12205,1982,Guinea,Senegal,1,1,Friendly,Yaoundé,Cameroon,True,2,0,Draw
10295,11344,12207,1982,Nepal,Singapore,0,2,King's Cup,Bangkok,Thailand,True,2,-2,Singapore
10296,11346,12209,1982,Philippines,Singapore,0,1,King's Cup,Bangkok,Thailand,True,1,-1,Singapore
10297,11347,12210,1982,Ghana,Guinea,0,0,Friendly,Yaoundé,Cameroon,True,0,0,Draw
10298,11348,12211,1982,Trinidad and Tobago,Bermuda,2,2,Friendly,Arima,Trinidad and Tobago,False,4,0,Draw
10299,11349,12212,1982,Macau,Hong Kong,1,0,Friendly,Macau,Macau,False,1,1,Macau
10300,11351,12214,1982,Argentina,Romania,1,0,Friendly,Rosario,Argentina,False,1,1,Argentina
10301,11352,12215,1982,Morocco,Senegal,2,1,Friendly,Casablanca,Morocco,False,3,1,Morocco
10302,11353,12216,1982,Norway,Germany,2,4,Friendly,Oslo,Norway,False,6,-2,Germany
10303,11354,12217,1982,Trinidad and Tobago,Bermuda,4,2,Friendly,Port of Spain,Trinidad and Tobago,False,6,2,Trinidad and Tobago
10304,11355,12218,1982,Thailand,Singapore,1,0,King's Cup,Bangkok,Thailand,False,1,1,Thailand
10305,11356,12219,1982,Barbados,Bermuda,2,1,Friendly,Bridgetown,Barbados,False,3,1,Barbados
10306,11357,12220,1982,Thailand,Singapore,2,2,King's Cup,Bangkok,Thailand,False,4,0,Draw
10307,11358,12221,1982,Barbados,Bermuda,0,0,Friendly,Bridgetown,Barbados,False,0,0,Draw
10308,11360,12223,1982,Austria,Denmark,1,0,Friendly,Vienna,Austria,False,1,1,Austria
10309,11361,12224,1982,Brazil,Switzerland,1,1,Friendly,Recife,Brazil,False,2,0,Draw
10310,11363,12226,1982,Chile,Republic of Ireland,1,0,Friendly,Santiago,Chile,False,1,1,Chile
10311,11364,12227,1982,Scotland,Wales,1,0,British Championship,Glasgow,Scotland,False,1,1,Scotland
10312,11365,12228,1982,England,Netherlands,2,0,Friendly,London,England,False,2,2,England
10313,11366,12229,1982,Brazil,Republic of Ireland,7,0,Friendly,Uberlândia,Brazil,False,7,7,Brazil
10314,11367,12230,1982,Denmark,Belgium,1,0,Friendly,Copenhagen,Denmark,False,1,1,Denmark
10315,11368,12231,1982,Wales,Northern Ireland,3,0,British Championship,Wrexham,Wales,False,3,3,Wales
10316,11369,12232,1982,Switzerland,Italy,1,1,Friendly,Geneva,Switzerland,False,2,0,Draw
10317,11370,12233,1982,Scotland,England,0,1,British Championship,Glasgow,Scotland,False,1,-1,England
10318,11371,12234,1982,Trinidad and Tobago,Republic of Ireland,2,1,Friendly,Arima,Trinidad and Tobago,False,3,1,Trinidad and Tobago
10319,11372,12235,1982,France,Wales,0,1,Friendly,Toulouse,France,False,1,-1,Wales
10320,11373,12236,1982,Iceland,England,1,1,Friendly,Reykjavík,Iceland,False,2,0,Draw
10321,11374,12237,1982,Japan,Singapore,2,0,Kirin Cup,Hiroshima,Japan,False,2,2,Japan
10322,11375,12238,1982,Finland,England,1,4,Friendly,Helsinki,Finland,False,5,-3,England
10323,11376,12239,1982,Sweden,Russia,1,1,Friendly,Solna,Sweden,False,2,0,Draw
10324,11377,12240,1982,Malta,Iceland,2,1,UEFA Euro qualification,Messina,Italy,True,3,1,Malta
10325,11379,12242,1982,Zimbabwe,Uganda,2,1,Friendly,Bulawayo,Zimbabwe,False,3,1,Zimbabwe
10326,11380,12244,1982,Malaysia,Thailand,1,1,Korea Cup,Busan,South Korea,True,2,0,Draw
10327,11381,12246,1982,Argentina,Belgium,0,1,FIFA World Cup,Barcelona,Spain,True,1,-1,Belgium
10328,11382,12247,1982,Bahrain,India,0,0,Korea Cup,Incheon,South Korea,True,0,0,Draw
10329,11383,12248,1982,Zimbabwe,Uganda,1,1,Friendly,Harare,Zimbabwe,False,2,0,Draw
10330,11384,12249,1982,Brazil,Russia,2,1,FIFA World Cup,Seville,Spain,True,3,1,Brazil
10331,11385,12250,1982,Italy,Poland,0,0,FIFA World Cup,Vigo,Spain,True,0,0,Draw
10332,11386,12251,1982,Hungary,El Salvador,10,1,FIFA World Cup,Elche,Spain,True,11,9,Hungary
10333,11387,12252,1982,Norway,Denmark,2,1,Nordic Championship,Oslo,Norway,False,3,1,Norway
10334,11388,12253,1982,Peru,Cameroon,0,0,FIFA World Cup,La Coruña,Spain,True,0,0,Draw
10335,11389,12254,1982,Scotland,New Zealand,5,2,FIFA World Cup,Málaga,Spain,True,7,3,Scotland
10336,11390,12255,1982,England,France,3,1,FIFA World Cup,Bilbao,Spain,True,4,2,England
10337,11391,12256,1982,Germany,Algeria,1,2,FIFA World Cup,Gijón,Spain,True,3,-1,Algeria
10338,11392,12257,1982,Spain,Honduras,1,1,FIFA World Cup,Valencia,Spain,False,2,0,Draw
10339,11393,12258,1982,Chile,Austria,0,1,FIFA World Cup,Oviedo,Spain,True,1,-1,Austria
10340,11394,12261,1982,Argentina,Hungary,4,1,FIFA World Cup,Alicante,Spain,True,5,3,Argentina
10341,11395,12262,1982,Brazil,Scotland,4,1,FIFA World Cup,Seville,Spain,True,5,3,Brazil
10342,11396,12263,1982,Italy,Peru,1,1,FIFA World Cup,Vigo,Spain,True,2,0,Draw
10343,11397,12264,1982,Belgium,El Salvador,1,0,FIFA World Cup,Elche,Spain,True,1,1,Belgium
10344,11398,12265,1982,Poland,Cameroon,0,0,FIFA World Cup,La Coruña,Spain,True,0,0,Draw
10345,11399,12266,1982,Russia,New Zealand,3,0,FIFA World Cup,Málaga,Spain,True,3,3,Russia
10346,11401,12268,1982,Germany,Chile,4,1,FIFA World Cup,Gijón,Spain,True,5,3,Germany
10347,11403,12270,1982,Algeria,Austria,0,2,FIFA World Cup,Oviedo,Spain,True,2,-2,Austria
10348,11404,12271,1982,France,Kuwait,4,1,FIFA World Cup,Valladolid,Spain,True,5,3,France
10349,11405,12272,1982,Honduras,Northern Ireland,1,1,FIFA World Cup,Zaragoza,Spain,True,2,0,Draw
10350,11406,12273,1982,Belgium,Hungary,1,1,FIFA World Cup,Elche,Spain,True,2,0,Draw
10351,11407,12274,1982,Poland,Peru,5,1,FIFA World Cup,La Coruña,Spain,True,6,4,Poland
10352,11408,12275,1982,Russia,Scotland,2,2,FIFA World Cup,Málaga,Spain,True,4,0,Draw
10353,11410,12277,1982,Argentina,El Salvador,2,0,FIFA World Cup,Alicante,Spain,True,2,2,Argentina
10354,11411,12278,1982,Brazil,New Zealand,4,0,FIFA World Cup,Seville,Spain,True,4,4,Brazil
10355,11412,12279,1982,Italy,Cameroon,1,1,FIFA World Cup,Vigo,Spain,True,2,0,Draw
10356,11413,12280,1982,Algeria,Chile,3,2,FIFA World Cup,Oviedo,Spain,True,5,1,Algeria
10357,11416,12283,1982,England,Kuwait,1,0,FIFA World Cup,Bilbao,Spain,True,1,1,England
10358,11417,12284,1982,Germany,Austria,1,0,FIFA World Cup,Gijón,Spain,True,1,1,Germany
10359,11418,12285,1982,Spain,Northern Ireland,0,1,FIFA World Cup,Valencia,Spain,False,1,-1,Northern Ireland
10360,11420,12287,1982,Mozambique,Zimbabwe,1,1,Friendly,Maputo,Mozambique,False,2,0,Draw
10361,11421,12288,1982,Trinidad and Tobago,Suriname,2,3,Friendly,Port of Spain,Trinidad and Tobago,False,5,-1,Suriname
10362,11422,12289,1982,Austria,France,0,1,FIFA World Cup,Madrid,Spain,True,1,-1,France
10363,11423,12290,1982,Poland,Belgium,3,0,FIFA World Cup,Barcelona,Spain,True,3,3,Poland
10364,11424,12291,1982,Germany,England,0,0,FIFA World Cup,Madrid,Spain,True,0,0,Draw
10365,11425,12292,1982,Italy,Argentina,2,1,FIFA World Cup,Barcelona,Spain,True,3,1,Italy
10366,11426,12293,1982,Austria,Northern Ireland,2,2,FIFA World Cup,Madrid,Spain,True,4,0,Draw
10367,11427,12294,1982,Belgium,Russia,0,1,FIFA World Cup,Barcelona,Spain,True,1,-1,Russia
10368,11428,12295,1982,Argentina,Brazil,1,3,FIFA World Cup,Barcelona,Spain,True,4,-2,Brazil
10369,11429,12296,1982,Spain,Germany,1,2,FIFA World Cup,Madrid,Spain,False,3,-1,Germany
10370,11430,12297,1982,France,Northern Ireland,4,1,FIFA World Cup,Madrid,Spain,True,5,3,France
10371,11431,12298,1982,Poland,Russia,0,0,FIFA World Cup,Barcelona,Spain,True,0,0,Draw
10372,11432,12299,1982,Italy,Brazil,3,2,FIFA World Cup,Barcelona,Spain,True,5,1,Italy
10373,11433,12300,1982,Spain,England,0,0,FIFA World Cup,Madrid,Spain,False,0,0,Draw
10374,11434,12301,1982,Malawi,Tanzania,0,1,Friendly,Blantyre,Malawi,False,1,-1,Tanzania
10375,11435,12302,1982,Germany,France,3,3,FIFA World Cup,Seville,Spain,True,6,0,Draw
10376,11436,12303,1982,Malawi,Tanzania,2,0,Friendly,Lilongwe,Malawi,False,2,2,Malawi
10377,11437,12304,1982,Poland,Italy,0,2,FIFA World Cup,Barcelona,Spain,True,2,-2,Italy
10378,11438,12305,1982,Poland,France,3,2,FIFA World Cup,Alicante,Spain,True,5,1,Poland
10379,11439,12306,1982,Finland,Iceland,3,2,Friendly,Helsinki,Finland,False,5,1,Finland
10380,11440,12307,1982,Italy,Germany,3,1,FIFA World Cup,Madrid,Spain,True,4,2,Italy
10381,11441,12310,1982,Hong Kong,Morocco,0,0,Friendly,Beijing,China PR,True,0,0,Draw
10382,11442,12311,1982,Zimbabwe,Réunion,2,3,Friendly,Salisbury,Zimbabwe,False,5,-1,Réunion
10383,11443,12312,1982,Faroe Islands,Iceland,1,4,Friendly,Tórshavn,Faroe Islands,False,5,-3,Iceland
10384,11444,12313,1982,Faroe Islands,Iceland,0,4,Friendly,Gøta,Faroe Islands,False,4,-4,Iceland
10385,11445,12314,1982,Malaysia,Indonesia,0,2,Merdeka Tournament,Kuala Lumpur,Malaysia,False,2,-2,Indonesia
10386,11446,12315,1982,India,Thailand,0,0,Merdeka Tournament,Kuala Lumpur,Malaysia,True,0,0,Draw
10387,11447,12316,1982,Singapore,Ghana,0,3,Merdeka Tournament,Kuala Lumpur,Malaysia,True,3,-3,Ghana
10388,11448,12317,1982,Ghana,India,1,0,Merdeka Tournament,Kuala Lumpur,Malaysia,True,1,1,Ghana
10389,11449,12318,1982,Malaysia,Pakistan,4,1,Friendly,Dhaka,Bangladesh,True,5,3,Malaysia
10390,11450,12319,1982,Denmark,Finland,3,2,Nordic Championship,Copenhagen,Denmark,False,5,1,Denmark
10391,11451,12320,1982,Indonesia,Senegal,2,2,Merdeka Tournament,Kuala Lumpur,Malaysia,True,4,0,Draw
10392,11452,12321,1982,Norway,Sweden,1,0,Nordic Championship,Oslo,Norway,False,1,1,Norway
10393,11453,12322,1982,Thailand,Ghana,1,4,Merdeka Tournament,Kota Bharu,Malaysia,True,5,-3,Ghana
10394,11454,12323,1982,Singapore,India,3,0,Merdeka Tournament,George Town,Malaysia,True,3,3,Singapore
10395,11455,12324,1982,Malaysia,Senegal,1,0,Merdeka Tournament,Kuantan,Malaysia,False,1,1,Malaysia
10396,11456,12325,1982,Singapore,Thailand,2,0,Merdeka Tournament,Kuala Lumpur,Malaysia,True,2,2,Singapore
10397,11457,12326,1982,Ghana,Senegal,2,2,Merdeka Tournament,Kuala Lumpur,Malaysia,True,4,0,Draw
10398,11458,12327,1982,Mauritius,Zimbabwe,2,0,Friendly,Saint-Pierre,Réunion,True,2,2,Mauritius
10399,11459,12328,1982,Burundi,Rwanda,1,0,Friendly,Bujumbura,Burundi,False,1,1,Burundi
10400,11460,12329,1982,France,Poland,0,4,Friendly,Paris,France,False,4,-4,Poland
10401,11461,12330,1982,Iceland,Netherlands,1,1,UEFA Euro qualification,Reykjavík,Iceland,False,2,0,Draw
10402,11462,12331,1982,Réunion,Zimbabwe,0,1,Friendly,Saint-Pierre,Réunion,False,1,-1,Zimbabwe
10403,11463,12332,1982,Romania,Denmark,1,0,Friendly,Bucharest,Romania,False,1,1,Romania
10404,11464,12333,1982,Réunion,Mauritius,1,1,Friendly,Saint-Pierre,Réunion,False,2,0,Draw
10405,11465,12334,1982,Switzerland,Bulgaria,3,2,Friendly,St. Gallen,Switzerland,False,5,1,Switzerland
10406,11466,12335,1982,Finland,Poland,2,3,UEFA Euro qualification,Kuopio,Finland,False,5,-1,Poland
10407,11468,12337,1982,Romania,Sweden,2,0,UEFA Euro qualification,Bucharest,Romania,False,2,2,Romania
10408,11469,12338,1982,Malawi,Zimbabwe,2,0,African Cup of Nations qualification,Lilongwe,Malawi,False,2,2,Malawi
10409,11470,12339,1982,Tanzania,Uganda,1,1,African Cup of Nations qualification,Dar es Salaam,Tanzania,False,2,0,Draw
10410,11471,12340,1982,Somalia,Rwanda,0,1,African Cup of Nations qualification,Mogadishu,Somalia,False,1,-1,Rwanda
10411,11472,12341,1982,Austria,Albania,5,0,UEFA Euro qualification,Vienna,Austria,False,5,5,Austria
10412,11474,12343,1982,Denmark,England,2,2,UEFA Euro qualification,Copenhagen,Denmark,False,4,0,Draw
10413,11475,12344,1982,Finland,Portugal,0,2,UEFA Euro qualification,Helsinki,Finland,False,2,-2,Portugal
10414,11476,12345,1982,Germany,Belgium,0,0,Friendly,Munich,Germany,False,0,0,Draw
10415,11477,12346,1982,Hungary,Turkey,5,0,Friendly,Győr,Hungary,False,5,5,Hungary
10416,11478,12347,1982,Netherlands,Republic of Ireland,2,1,UEFA Euro qualification,Rotterdam,Netherlands,False,3,1,Netherlands
10417,11479,12348,1982,Wales,Norway,1,0,UEFA Euro qualification,Swansea,Wales,False,1,1,Wales
10418,11480,12349,1982,Uganda,Tanzania,3,2,African Cup of Nations qualification,Kampala,Uganda,False,5,1,Uganda
10419,11481,12350,1982,Egypt,Zambia,3,5,Friendly,Cairo,Egypt,False,8,-2,Zambia
10420,11482,12351,1982,Burkina Faso,Niger,1,1,Friendly,Bobo Dioulasso,Upper Volta,False,2,0,Draw
10421,11483,12352,1982,Egypt,Zambia,0,0,Friendly,Cairo,Egypt,False,0,0,Draw
10422,11484,12353,1982,Saudi Arabia,Morocco,2,1,Friendly,Riyadh,Saudi Arabia,False,3,1,Saudi Arabia
10423,11485,12354,1982,Zimbabwe,Malawi,0,2,African Cup of Nations qualification,Harare,Zimbabwe,False,2,-2,Malawi
10424,11486,12355,1982,Singapore,Malaysia,0,1,Merlion Cup,Kallang,Singapore,False,1,-1,Malaysia
10425,11487,12356,1982,Belgium,Switzerland,3,0,UEFA Euro qualification,Brussels,Belgium,False,3,3,Belgium
10426,11488,12358,1982,France,Hungary,1,0,Friendly,Paris,France,False,1,1,France
10427,11489,12359,1982,Singapore,Brunei,7,0,Merlion Cup,Kallang,Singapore,False,7,7,Singapore
10428,11490,12360,1982,Luxembourg,Greece,0,2,UEFA Euro qualification,Luxembourg,Luxembourg,False,2,-2,Greece
10429,11491,12361,1982,Brunei,Malaysia,0,4,Merlion Cup,Kallang,Singapore,True,4,-4,Malaysia
10430,11492,12362,1982,Portugal,Poland,2,1,UEFA Euro qualification,Lisbon,Portugal,False,3,1,Portugal
10431,11493,12363,1982,Australia,Indonesia,2,0,Merlion Cup,Kallang,Singapore,True,2,2,Australia
10432,11494,12364,1982,Saudi Arabia,Cameroon,0,0,Friendly,Riyadh,Saudi Arabia,False,0,0,Draw
10433,11495,12365,1982,Austria,Northern Ireland,2,0,UEFA Euro qualification,Vienna,Austria,False,2,2,Austria
10434,11496,12366,1982,England,Germany,1,2,Friendly,London,England,False,3,-1,Germany
10435,11497,12367,1982,Republic of Ireland,Iceland,2,0,UEFA Euro qualification,Dublin,Republic of Ireland,False,2,2,Republic of Ireland
10436,11499,12369,1982,Russia,Finland,2,0,UEFA Euro qualification,Moscow,Soviet Union,False,2,2,Russia
10437,11501,12371,1982,Australia,Malaysia,5,0,Merlion Cup,Kallang,Singapore,True,5,5,Australia
10438,11502,12372,1982,Bulgaria,Malta,7,0,Friendly,Sofia,Bulgaria,False,7,7,Bulgaria
10439,11503,12373,1982,Indonesia,Malaysia,0,0,Merlion Cup,Kallang,Singapore,True,0,0,Draw
10440,11504,12374,1982,Bulgaria,Norway,2,2,UEFA Euro qualification,Sofia,Bulgaria,False,4,0,Draw
10441,11505,12375,1982,Cyprus,Greece,1,1,Friendly,Nicosia,Cyprus,False,2,0,Draw
10442,11507,12377,1982,Italy,Switzerland,0,1,Friendly,Rome,Italy,False,1,-1,Switzerland
10443,11508,12378,1982,Senegal,Togo,1,2,Friendly,Dakar,Senegal,False,3,-1,Togo
10444,11509,12379,1982,Spain,Iceland,1,0,UEFA Euro qualification,Málaga,Spain,False,1,1,Spain
10445,11510,12380,1982,Turkey,Albania,1,0,UEFA Euro qualification,Izmir,Turkey,False,1,1,Turkey
10446,11511,12381,1982,Liberia,Sierra Leone,1,0,Friendly,Monrovia,Liberia,False,1,1,Liberia
10447,11512,12382,1982,Togo,Benin,2,2,Friendly,Lomé,Togo,False,4,0,Draw
10448,11513,12383,1982,Luxembourg,Denmark,1,2,UEFA Euro qualification,Luxembourg,Luxembourg,False,3,-1,Denmark
10449,11514,12384,1982,Netherlands,France,1,2,Friendly,Rotterdam,Netherlands,False,3,-1,France
10450,11515,12385,1982,Singapore,Malaysia,3,1,Friendly,Kallang,Singapore,False,4,2,Singapore
10451,11516,12386,1982,Angola,Ghana,1,2,Friendly,Luanda,Angola,False,3,-1,Ghana
10452,11517,12387,1982,Cyprus,Sweden,0,1,UEFA Euro qualification,Nicosia,Cyprus,False,1,-1,Sweden
10453,11519,12389,1982,Kuwait,Norway,1,0,Friendly,Kuwait City,Kuwait,False,1,1,Kuwait
10454,11520,12390,1982,Uganda,Malawi,2,1,CECAFA Cup,Kampala,Uganda,False,3,1,Uganda
10455,11521,12391,1982,Kenya,Sudan,2,0,CECAFA Cup,Jinja,Uganda,True,2,2,Kenya
10456,11522,12392,1982,Mali,Gambia,3,1,African Cup of Nations qualification,Bamako,Mali,False,4,2,Mali
10457,11523,12393,1982,Niger,Senegal,0,0,African Cup of Nations qualification,Niamey,Niger,False,0,0,Draw
10458,11524,12394,1982,Tanzania,Zimbabwe,0,3,CECAFA Cup,Kampala,Uganda,True,3,-3,Zimbabwe
10459,11525,12395,1982,Togo,Sierra Leone,3,0,African Cup of Nations qualification,Lomé,Togo,False,3,3,Togo
10460,11526,12396,1982,Malawi,Zimbabwe,1,1,CECAFA Cup,Kampala,Uganda,True,2,0,Draw
10461,11527,12397,1982,Austria,Turkey,4,0,UEFA Euro qualification,Vienna,Austria,False,4,4,Austria
10462,11529,12400,1982,Greece,England,0,3,UEFA Euro qualification,Salonica,Greece,False,3,-3,England
10463,11530,12401,1982,Republic of Ireland,Spain,3,3,UEFA Euro qualification,Dublin,Republic of Ireland,False,6,0,Draw
10464,11531,12402,1982,Northern Ireland,Germany,1,0,UEFA Euro qualification,Belfast,Northern Ireland,False,1,1,Northern Ireland
10465,11532,12403,1982,Switzerland,Scotland,2,0,UEFA Euro qualification,Berne,Switzerland,False,2,2,Switzerland
10466,11533,12404,1982,Uganda,Tanzania,1,0,CECAFA Cup,Kampala,Uganda,False,1,1,Uganda
10467,11535,12406,1982,Malawi,Tanzania,2,0,CECAFA Cup,Kampala,Uganda,True,2,2,Malawi
10468,11536,12407,1982,Uganda,Zimbabwe,1,1,CECAFA Cup,Kampala,Uganda,False,2,0,Draw
10469,11538,12409,1982,Kenya,Zimbabwe,2,1,CECAFA Cup,Jinja,Uganda,True,3,1,Kenya
10470,11540,12412,1982,Uganda,Kenya,1,1,CECAFA Cup,Kampala,Uganda,False,2,0,Draw
10471,11541,12413,1982,Gambia,Mali,1,0,African Cup of Nations qualification,Banjul,Gambia,False,1,1,Gambia
10472,11542,12414,1982,Senegal,Niger,1,0,African Cup of Nations qualification,Dakar,Senegal,False,1,1,Senegal
10473,11543,12415,1982,Sierra Leone,Togo,0,1,African Cup of Nations qualification,Freetown,Sierra Leone,False,1,-1,Togo
10474,11544,12416,1982,Greece,Switzerland,1,3,Friendly,Athens,Greece,False,4,-2,Switzerland
10475,11545,12417,1982,Italy,Romania,0,0,UEFA Euro qualification,Florence,Italy,False,0,0,Draw
10476,11546,12418,1982,Tunisia,Angola,3,1,Friendly,Tunis,Tunisia,False,4,2,Tunisia
10477,11547,12419,1982,Albania,Northern Ireland,0,0,UEFA Euro qualification,Tirana,Albania,False,0,0,Draw
10478,11548,12420,1982,Belgium,Scotland,3,2,UEFA Euro qualification,Brussels,Belgium,False,5,1,Belgium
10479,11549,12421,1982,England,Luxembourg,9,0,UEFA Euro qualification,London,England,False,9,9,England
10480,11550,12423,1982,Malta,Netherlands,0,6,UEFA Euro qualification,Aachen,Germany,True,6,-6,Netherlands
10481,11551,12424,1982,Tunisia,Algeria,0,1,Friendly,Tunis,Tunisia,False,1,-1,Algeria
10482,11552,12425,1982,Greece,Cyprus,1,0,Friendly,Ioannina,Greece,False,1,1,Greece
10483,11553,12426,1982,Bermuda,Trinidad and Tobago,2,2,Friendly,Hamilton,Bermuda,False,4,0,Draw
10484,11554,12427,1982,Malta,Bulgaria,0,0,Friendly,Attard,Malta,False,0,0,Draw
10485,11555,12428,1982,Malta,Bulgaria,1,7,Friendly,Attard,Malta,False,8,-6,Bulgaria
10486,11556,12429,1982,Bermuda,Trinidad and Tobago,2,2,Friendly,Hamilton,Bermuda,False,4,0,Draw
10487,11557,12430,1983,Ivory Coast,Mali,0,1,Friendly,Abidjan,Ivory Coast,False,1,-1,Mali
10488,11558,12431,1983,Benin,Mauritania,1,1,Friendly,Porto-Novo,Benin,False,2,0,Draw
10489,11559,12432,1983,Egypt,Hungary,1,0,Friendly,Cairo,Egypt,False,1,1,Egypt
10490,11560,12433,1983,Egypt,Hungary,0,2,Friendly,Cairo,Egypt,False,2,-2,Hungary
10491,11561,12434,1983,Niger,Senegal,2,0,Friendly,Niamey,Niger,False,2,2,Niger
10492,11562,12435,1983,Turkey,Romania,1,1,Friendly,Istanbul,Turkey,False,2,0,Draw
10493,11563,12436,1983,Malta,Tunisia,1,2,Friendly,Marsa,Malta,False,3,-1,Tunisia
10494,11564,12437,1983,Senegal,Guinea,1,0,Friendly,Dakar,Senegal,False,1,1,Senegal
10495,11565,12438,1983,Greece,Romania,1,3,Friendly,Lárisa,Greece,False,4,-2,Romania
10496,11566,12439,1983,Mauritania,Benin,2,0,Friendly,Nouakchott,Mauritania,False,2,2,Mauritania
10497,11567,12440,1983,Senegal,Niger,2,0,Friendly,Dakar,Senegal,False,2,2,Senegal
10498,11568,12441,1983,Sierra Leone,Gambia,0,1,Friendly,Freetown,Sierra Leone,False,1,-1,Gambia
10499,11571,12444,1983,Cyprus,Italy,1,1,UEFA Euro qualification,Limassol,Cyprus,False,2,0,Draw
10500,11572,12445,1983,Syria,Japan,2,2,Friendly,Damascus,Syria,False,4,0,Draw
10501,11573,12446,1983,Guinea,Mali,1,1,Friendly,Conakry,Guinea,False,2,0,Draw
10502,11574,12447,1983,Portugal,France,0,3,Friendly,Guimarães,Portugal,False,3,-3,France
10503,11575,12448,1983,Spain,Netherlands,1,0,UEFA Euro qualification,Seville,Spain,False,1,1,Spain
10504,11576,12449,1983,Nigeria,Egypt,0,0,Friendly,Lagos,Nigeria,False,0,0,Draw
10505,11577,12450,1983,Gambia,Sierra Leone,0,1,Friendly,Banjul,Gambia,False,1,-1,Sierra Leone
10506,11578,12451,1983,Guadeloupe,Dominica,1,0,CFU Caribbean Cup qualification,Basse-Terre,Guadeloupe,False,1,1,Guadeloupe
10507,11579,12452,1983,Nigeria,Egypt,1,1,Friendly,Kaduna,Nigeria,False,2,0,Draw
10508,11580,12453,1983,Saint Vincent and the Grenadines,Martinique,1,3,CFU Caribbean Cup qualification,Kingstown,Saint Vincent and the Grenadines,False,4,-2,Martinique
10509,11581,12454,1983,New Zealand,Australia,2,1,Friendly,Auckland,New Zealand,False,3,1,New Zealand
10510,11582,12455,1983,Cameroon,Egypt,2,0,Friendly,Yaoundé,Cameroon,False,2,2,Cameroon
10511,11583,12456,1983,England,Wales,2,1,British Championship,London,England,False,3,1,England
10512,11584,12458,1983,Ivory Coast,Guinea,3,2,Friendly,Abidjan,Ivory Coast,False,5,1,Ivory Coast
10513,11585,12459,1983,Portugal,Germany,1,0,Friendly,Lisbon,Portugal,False,1,1,Portugal
10514,11586,12460,1983,Cameroon,Egypt,1,1,Friendly,Douala,Cameroon,False,2,0,Draw
10515,11587,12461,1983,Australia,New Zealand,0,2,Friendly,Melbourne,Australia,False,2,-2,New Zealand
10516,11588,12462,1983,Mali,Guinea,1,1,Friendly,Bamako,Mali,False,2,0,Draw
10517,11589,12463,1983,Gabon,Nigeria,0,0,Friendly,Libreville,Gabon,False,0,0,Draw
10518,11590,12464,1983,Barbados,Suriname,1,0,CFU Caribbean Cup qualification,Bridgetown,Barbados,False,1,1,Barbados
10519,11591,12465,1983,Dominica,Guadeloupe,1,2,CFU Caribbean Cup qualification,Roseau,Dominica,False,3,-1,Guadeloupe
10520,11593,12467,1983,Barbados,Suriname,0,0,CFU Caribbean Cup qualification,Bridgetown,Barbados,False,0,0,Draw
10521,11594,12468,1983,Romania,Turkey,3,1,Friendly,Târgu Mureș,Romania,False,4,2,Romania
10522,11595,12469,1983,Senegal,Morocco,1,0,Friendly,Dakar,Senegal,False,1,1,Senegal
10523,11596,12470,1983,Senegal,Morocco,0,0,Friendly,Dakar,Senegal,False,0,0,Draw
10524,11597,12471,1983,Costa Rica,Mexico,0,1,Friendly,San José,Costa Rica,False,1,-1,Mexico
10525,11598,12473,1983,Gabon,Congo,2,3,Friendly,Libreville,Gabon,False,5,-1,Congo
10526,11599,12474,1983,Benin,Congo,0,2,Friendly,Porto-Novo,Benin,False,2,-2,Congo
10527,11600,12475,1983,Ethiopia,Kenya,2,2,Friendly,Addis Abeba,Ethiopia,False,4,0,Draw
10528,11601,12476,1983,Ethiopia,Kenya,0,0,Friendly,Addis Abeba,Ethiopia,False,0,0,Draw
10529,11602,12477,1983,Mexico,Costa Rica,1,0,Friendly,Mexico City,Mexico,False,1,1,Mexico
10530,11603,12478,1983,France,Russia,1,1,Friendly,Paris,France,False,2,0,Draw
10531,11604,12479,1983,Poland,Bulgaria,3,1,Friendly,Łódź,Poland,False,4,2,Poland
10532,11605,12480,1983,Tunisia,Morocco,1,0,Friendly,Sousse,Tunisia,False,1,1,Tunisia
10533,11606,12481,1983,Togo,Congo,0,2,Friendly,Lomé,Togo,False,2,-2,Congo
10534,11608,12483,1983,Ethiopia,Djibouti,8,1,Friendly,Addis Abeba,Ethiopia,False,9,7,Ethiopia
10535,11609,12484,1983,Luxembourg,Hungary,2,6,UEFA Euro qualification,Luxembourg,Luxembourg,False,8,-4,Hungary
10536,11610,12485,1983,Ethiopia,Djibouti,4,2,Friendly,Addis Abeba,Ethiopia,False,6,2,Ethiopia
10537,11611,12486,1983,Albania,Germany,1,2,UEFA Euro qualification,Tirana,Albania,False,3,-1,Germany
10538,11612,12487,1983,Benin,Togo,0,2,Friendly,Cotonou,Benin,False,2,-2,Togo
10539,11613,12488,1983,England,Greece,0,0,UEFA Euro qualification,London,England,False,0,0,Draw
10540,11614,12490,1983,Malta,Republic of Ireland,0,1,UEFA Euro qualification,Attard,Malta,False,1,-1,Republic of Ireland
10541,11615,12491,1983,Northern Ireland,Turkey,2,1,UEFA Euro qualification,Belfast,Northern Ireland,False,3,1,Northern Ireland
10542,11617,12493,1983,Scotland,Switzerland,2,2,UEFA Euro qualification,Glasgow,Scotland,False,4,0,Draw
10543,11618,12494,1983,Ethiopia,Uganda,0,1,Friendly,Addis Abeba,Ethiopia,False,1,-1,Uganda
10544,11619,12495,1983,Guadeloupe,Antigua and Barbuda,2,3,CFU Caribbean Cup qualification,Basse-Terre,Guadeloupe,False,5,-1,Antigua and Barbuda
10545,11620,12496,1983,Congo,Angola,1,0,Friendly,Brazzaville,Congo,False,1,1,Congo
10546,11621,12497,1983,Ethiopia,Uganda,2,1,Friendly,Addis Abeba,Ethiopia,False,3,1,Ethiopia
10547,11622,12498,1983,Mozambique,Cameroon,3,0,African Cup of Nations qualification,Maputo,Mozambique,False,3,3,Mozambique
10548,11623,12499,1983,Guatemala,Mexico,0,2,Friendly,Los Angeles,United States,True,2,-2,Mexico
10549,11624,12500,1983,Algeria,Benin,6,2,African Cup of Nations qualification,Algiers,Algeria,False,8,4,Algeria
10550,11625,12501,1983,Haiti,United States,0,2,Friendly,Port-au-Prince,Haiti,False,2,-2,United States
10551,11626,12502,1983,Libya,Senegal,2,1,African Cup of Nations qualification,Tripoli,Libya,False,3,1,Libya
10552,11627,12503,1983,Congo,Egypt,2,0,African Cup of Nations qualification,Brazzaville,Congo,False,2,2,Congo
10553,11628,12504,1983,Ethiopia,Mauritius,1,0,African Cup of Nations qualification,Addis Abeba,Ethiopia,False,1,1,Ethiopia
10554,11629,12505,1983,Guinea,Togo,0,1,African Cup of Nations qualification,Conakry,Guinea,False,1,-1,Togo
10555,11630,12506,1983,Madagascar,Uganda,1,0,African Cup of Nations qualification,Antananarivo,Madagascar,False,1,1,Madagascar
10556,11631,12507,1983,Morocco,Mali,4,0,African Cup of Nations qualification,Rabat,Morocco,False,4,4,Morocco
10557,11632,12508,1983,Sudan,Zambia,2,1,African Cup of Nations qualification,Khartoum,Sudan,False,3,1,Sudan
10558,11633,12509,1983,Tunisia,Rwanda,5,0,African Cup of Nations qualification,Tunis,Tunisia,False,5,5,Tunisia
10559,11634,12511,1983,Portugal,Hungary,0,0,Friendly,Coimbra,Portugal,False,0,0,Draw
10560,11635,12512,1983,Switzerland,Russia,0,1,Friendly,Lausanne,Switzerland,False,1,-1,Russia
10561,11636,12514,1983,Romania,Italy,1,0,UEFA Euro qualification,Bucharest,Romania,False,1,1,Romania
10562,11637,12515,1983,Guinea-Bissau,Togo,2,0,Friendly,Bissau,Guinea-Bissau,False,2,2,Guinea-Bissau
10563,11638,12516,1983,Hungary,Luxembourg,6,2,UEFA Euro qualification,Budapest,Hungary,False,8,4,Hungary
10564,11639,12517,1983,Mali,Ivory Coast,1,2,Friendly,Bamako,Mali,False,3,-1,Ivory Coast
10565,11640,12518,1983,Poland,Finland,1,1,UEFA Euro qualification,Warsaw,Poland,False,2,0,Draw
10566,11641,12519,1983,Sierra Leone,Jordan,2,1,Friendly,Freetown,Sierra Leone,False,3,1,Sierra Leone
10567,11642,12520,1983,Egypt,Congo,2,0,African Cup of Nations qualification,Cairo,Egypt,False,2,2,Egypt
10568,11644,12522,1983,Turkey,Germany,0,3,UEFA Euro qualification,Izmir,Turkey,False,3,-3,Germany
10569,11645,12523,1983,Angola,Nigeria,1,0,African Cup of Nations qualification,Luanda,Angola,False,1,1,Angola
10570,11646,12524,1983,Barbados,Guyana,1,1,CFU Caribbean Cup qualification,Bridgetown,Barbados,False,2,0,Draw
10571,11647,12525,1983,Cameroon,Mozambique,4,0,African Cup of Nations qualification,Yaoundé,Cameroon,False,4,4,Cameroon
10572,11648,12526,1983,Mali,Morocco,2,0,African Cup of Nations qualification,Bamako,Mali,False,2,2,Mali
10573,11649,12527,1983,Mauritius,Ethiopia,1,0,African Cup of Nations qualification,Curepipe,Mauritius,False,1,1,Mauritius
10574,11650,12528,1983,Rwanda,Tunisia,0,1,African Cup of Nations qualification,Kigali,Rwanda,False,1,-1,Tunisia
10575,11651,12529,1983,Senegal,Libya,1,0,African Cup of Nations qualification,Dakar,Senegal,False,1,1,Senegal
10576,11652,12530,1983,Togo,Guinea,2,0,African Cup of Nations qualification,Lomé,Togo,False,2,2,Togo
10577,11653,12531,1983,Uganda,Madagascar,1,2,African Cup of Nations qualification,Kampala,Uganda,False,3,-1,Madagascar
10578,11654,12532,1983,Zambia,Sudan,0,0,African Cup of Nations qualification,Lusaka,Zambia,False,0,0,Draw
10579,11655,12533,1983,Austria,Germany,0,0,UEFA Euro qualification,Vienna,Austria,False,0,0,Draw
10580,11657,12535,1983,Denmark,Greece,1,0,UEFA Euro qualification,Copenhagen,Denmark,False,1,1,Denmark
10581,11658,12536,1983,England,Hungary,2,0,UEFA Euro qualification,London,England,False,2,2,England
10582,11659,12537,1983,Netherlands,Sweden,0,3,Friendly,Utrecht,Netherlands,False,3,-3,Sweden
10583,11660,12538,1983,Northern Ireland,Albania,1,0,UEFA Euro qualification,Belfast,Northern Ireland,False,1,1,Northern Ireland
10584,11661,12539,1983,Russia,Portugal,5,0,UEFA Euro qualification,Moscow,Soviet Union,False,5,5,Russia
10585,11662,12540,1983,Spain,Republic of Ireland,2,0,UEFA Euro qualification,Zaragoza,Spain,False,2,2,Spain
10586,11663,12541,1983,Wales,Bulgaria,1,0,UEFA Euro qualification,Wrexham,Wales,False,1,1,Wales
10587,11664,12542,1983,Brazil,Chile,3,2,Friendly,Rio de Janeiro,Brazil,False,5,1,Brazil
10588,11665,12543,1983,Ghana,Libya,1,0,Friendly,Addis Abeba,Ethiopia,True,1,1,Ghana
10589,11666,12544,1983,Iraq,Egypt,2,1,Friendly,Baghdad,Iraq,False,3,1,Iraq
10590,11667,12545,1983,Ethiopia,Nigeria,0,1,Friendly,Addis Abeba,Ethiopia,False,1,-1,Nigeria
10591,11668,12546,1983,Ethiopia,Libya,1,0,Friendly,Addis Abeba,Ethiopia,False,1,1,Ethiopia
10592,11669,12547,1983,Ghana,Nigeria,1,0,Friendly,Addis Abeba,Ethiopia,True,1,1,Ghana
10593,11670,12548,1983,Guinea,Guinea-Bissau,3,0,Friendly,Conakry,Guinea,False,3,3,Guinea
10594,11671,12549,1983,Ethiopia,Libya,0,1,Friendly,Addis Abeba,Ethiopia,False,1,-1,Libya
10595,11672,12550,1983,Guatemala,Honduras,0,2,Friendly,Guatemala,Guatemala,False,2,-2,Honduras
10596,11674,12552,1983,Antigua and Barbuda,Guadeloupe,3,3,CFU Caribbean Cup qualification,St. John's,Antigua and Barbuda,False,6,0,Draw
10597,11675,12553,1983,Guyana,Barbados,2,0,CFU Caribbean Cup qualification,Georgetown,Guyana,False,2,2,Guyana
10598,11676,12554,1983,Togo,Guinea-Bissau,3,0,Friendly,Lomé,Togo,False,3,3,Togo
10599,11677,12555,1983,Albania,Turkey,1,1,UEFA Euro qualification,Tirana,Albania,False,2,0,Draw
10600,11678,12556,1983,Chile,Argentina,2,2,Friendly,Santiago,Chile,False,4,0,Draw
10601,11680,12558,1983,Hungary,Greece,2,3,UEFA Euro qualification,Budapest,Hungary,False,5,-1,Greece
10602,11681,12559,1983,Malta,Spain,2,3,UEFA Euro qualification,Attard,Malta,False,5,-1,Spain
10603,11683,12561,1983,Sweden,Cyprus,5,0,UEFA Euro qualification,Malmö,Sweden,False,5,5,Sweden
10604,11684,12562,1983,Austria,Russia,2,2,Friendly,Vienna,Austria,False,4,0,Draw
10605,11685,12563,1983,Poland,Russia,1,1,UEFA Euro qualification,Chorzów,Poland,False,2,0,Draw
10606,11686,12564,1983,Kenya,Madagascar,1,2,Friendly,Nairobi,Kenya,False,3,-1,Madagascar
10607,11687,12565,1983,Scotland,Northern Ireland,0,0,British Championship,Glasgow,Scotland,False,0,0,Draw
10608,11688,12566,1983,Martinique,Saint Kitts and Nevis,7,0,CFU Caribbean Cup qualification,Fort-de-France,Martinique,False,7,7,Martinique
10609,11689,12567,1983,Northern Ireland,England,0,0,British Championship,Belfast,Northern Ireland,False,0,0,Draw
10610,11690,12568,1983,Wales,Scotland,0,2,British Championship,Cardiff,Wales,False,2,-2,Scotland
10611,11691,12569,1983,Egypt,Cameroon,4,0,Friendly,Cairo,Egypt,False,4,4,Egypt
10612,11692,12570,1983,Guyana,Antigua and Barbuda,0,0,CFU Caribbean Cup qualification,Georgetown,Guyana,False,0,0,Draw
10613,11693,12571,1983,Iceland,Spain,0,1,UEFA Euro qualification,Reykjavík,Iceland,False,1,-1,Spain
10614,11694,12572,1983,Sweden,Italy,2,0,UEFA Euro qualification,Gothenburg,Sweden,False,2,2,Sweden
10615,11695,12573,1983,Belgium,France,1,1,Friendly,Luxembourg,Luxembourg,True,2,0,Draw
10616,11696,12574,1983,Northern Ireland,Wales,0,1,British Championship,Belfast,Northern Ireland,False,1,-1,Wales
10617,11697,12575,1983,Denmark,Hungary,3,1,UEFA Euro qualification,Copenhagen,Denmark,False,4,2,Denmark
10618,11698,12576,1983,England,Scotland,2,0,British Championship,London,England,False,2,2,England
10619,11699,12577,1983,Finland,Russia,0,1,UEFA Euro qualification,Helsinki,Finland,False,1,-1,Russia
10620,11700,12579,1983,Paraguay,Uruguay,0,0,Copa Artigas,Asunción,Paraguay,False,0,0,Draw
10621,11701,12580,1983,Nigeria,Thailand,0,0,Korea Cup,Seoul,South Korea,True,0,0,Draw
10622,11702,12581,1983,Antigua and Barbuda,Guyana,4,0,CFU Caribbean Cup qualification,St. John's,Antigua and Barbuda,False,4,4,Antigua and Barbuda
10623,11703,12582,1983,Iceland,Malta,1,0,UEFA Euro qualification,Reykjavík,Iceland,False,1,1,Iceland
10624,11704,12583,1983,Saint Kitts and Nevis,Martinique,0,5,CFU Caribbean Cup qualification,Basseterre,Saint Kitts and Nevis,False,5,-5,Martinique
10625,11706,12586,1983,Ghana,New Zealand,0,2,Korea Cup,Seoul,South Korea,True,2,-2,New Zealand
10626,11707,12587,1983,Japan,Syria,1,0,Kirin Cup,Tokyo,Japan,False,1,1,Japan
10627,11708,12588,1983,Albania,Austria,1,2,UEFA Euro qualification,Tirana,Albania,False,3,-1,Austria
10628,11709,12589,1983,Indonesia,Thailand,0,3,Korea Cup,Seoul,South Korea,True,3,-3,Thailand
10629,11710,12591,1983,Portugal,Brazil,0,4,Friendly,Coimbra,Portugal,False,4,-4,Brazil
10630,11711,12592,1983,New Zealand,Sudan,1,1,Korea Cup,Daegu,South Korea,True,2,0,Draw
10631,11712,12593,1983,Sweden,Romania,0,1,UEFA Euro qualification,Solna,Sweden,False,1,-1,Romania
10632,11713,12594,1983,Uruguay,Paraguay,3,0,Copa Artigas,Montevideo,Uruguay,False,3,3,Uruguay
10633,11714,12595,1983,Indonesia,Nigeria,1,2,Korea Cup,Seoul,South Korea,True,3,-1,Nigeria
10634,11715,12596,1983,Australia,England,0,0,Friendly,Sydney,Australia,False,0,0,Draw
10635,11716,12597,1983,Canada,Scotland,0,2,Friendly,Vancouver,Canada,False,2,-2,Scotland
10636,11717,12599,1983,Wales,Brazil,1,1,Friendly,Cardiff,Wales,False,2,0,Draw
10637,11718,12600,1983,Ghana,Sudan,3,1,Korea Cup,Seoul,South Korea,True,4,2,Ghana
10638,11719,12601,1983,Australia,England,0,1,Friendly,Brisbane,Australia,False,1,-1,England
10639,11720,12603,1983,Canada,Scotland,0,3,Friendly,Edmonton,Canada,False,3,-3,Scotland
10640,11721,12604,1983,Malawi,Mozambique,2,0,Friendly,Lilongwe,Malawi,False,2,2,Malawi
10641,11722,12605,1983,Switzerland,Brazil,1,2,Friendly,Basel,Switzerland,False,3,-1,Brazil
10642,11723,12606,1983,Malawi,Mozambique,0,0,Friendly,Blantyre,Malawi,False,0,0,Draw
10643,11724,12607,1983,Australia,England,1,1,Friendly,Melbourne,Australia,False,2,0,Draw
10644,11725,12608,1983,Réunion,Seychelles,2,1,Friendly,Saint-Pierre,Réunion,False,3,1,Réunion
10645,11726,12609,1983,Sweden,Brazil,3,3,Friendly,Gothenburg,Sweden,False,6,0,Draw
10646,11727,12610,1983,Argentina,Chile,1,0,Friendly,Buenos Aires,Argentina,False,1,1,Argentina
10647,11728,12611,1983,Réunion,Seychelles,0,0,Friendly,Saint-Pierre,Réunion,False,0,0,Draw
10648,11729,12612,1983,Niger,Mauritania,1,0,Friendly,Niamey,Niger,False,1,1,Niger
10649,11730,12613,1983,Greenland,Faroe Islands,0,0,Friendly,Nuuk,Greenland,False,0,0,Draw
10650,11731,12614,1983,Hong Kong,Macau,1,0,Friendly,So Kon Po,Hong Kong,False,1,1,Hong Kong
10651,11732,12615,1983,Ethiopia,Togo,2,1,African Cup of Nations qualification,Addis Abeba,Ethiopia,False,3,1,Ethiopia
10652,11733,12616,1983,Gambia,Mali,1,1,Friendly,Banjul,Gambia,False,2,0,Draw
10653,11734,12617,1983,Greenland,Faroe Islands,2,3,Friendly,Nuuk,Greenland,False,5,-1,Faroe Islands
10654,11735,12618,1983,Seychelles,Mauritius,1,2,Friendly,Victoria,Seychelles,False,3,-1,Mauritius
10655,11736,12619,1983,Malawi,Zimbabwe,0,0,Friendly,Blantyre,Malawi,False,0,0,Draw
10656,11737,12620,1983,Malawi,Zimbabwe,1,0,Friendly,Blantyre,Malawi,False,1,1,Malawi
10657,11738,12621,1983,Qatar,Sudan,3,1,Friendly,Doha,Qatar,False,4,2,Qatar
10658,11739,12622,1983,Madagascar,Mauritius,1,1,Friendly,Saint-Pierre,Réunion,True,2,0,Draw
10659,11740,12623,1983,Qatar,Sudan,2,0,Friendly,Doha,Qatar,False,2,2,Qatar
10660,11741,12624,1983,Réunion,Madagascar,0,3,Friendly,Saint-Pierre,Réunion,False,3,-3,Madagascar
10661,11742,12625,1983,Colombia,Chile,2,2,Friendly,Bogotá,Colombia,False,4,0,Draw
10662,11743,12626,1983,Mauritania,Niger,0,0,Friendly,Nouakchott,Mauritania,False,0,0,Draw
10663,11744,12627,1983,Paraguay,Argentina,1,0,Copa Félix Bogado,Asunción,Paraguay,False,1,1,Paraguay
10664,11745,12628,1983,Réunion,Mauritius,1,1,Friendly,Saint-Pierre,Réunion,False,2,0,Draw
10665,11746,12629,1983,Hong Kong,Thailand,1,1,Friendly,Beijing,China PR,True,2,0,Draw
10666,11747,12630,1983,Uruguay,Peru,1,1,Friendly,Montevideo,Uruguay,False,2,0,Draw
10667,11748,12631,1983,Bolivia,Chile,1,2,Friendly,La Paz,Bolivia,False,3,-1,Chile
10668,11749,12633,1983,Guinea-Bissau,Senegal,1,1,Amílcar Cabral Cup,Nouakchott,Mauritania,True,2,0,Draw
10669,11751,12635,1983,Argentina,Paraguay,0,0,Copa Félix Bogado,Buenos Aires,Argentina,False,0,0,Draw
10670,11752,12636,1983,Gambia,Guinea,4,1,Amílcar Cabral Cup,Nouakchott,Mauritania,True,5,3,Gambia
10671,11753,12637,1983,Peru,Chile,0,1,Copa del Pacífico,Lima,Peru,False,1,-1,Chile
10672,11754,12639,1983,Guinea-Bissau,Guinea,2,1,Amílcar Cabral Cup,Nouakchott,Mauritania,True,3,1,Guinea-Bissau
10673,11755,12640,1983,Antigua and Barbuda,Martinique,0,2,CFU Caribbean Cup,Cayenne,French Guiana,True,2,-2,Martinique
10674,11756,12641,1983,French Guiana,Trinidad and Tobago,0,1,CFU Caribbean Cup,Cayenne,French Guiana,False,1,-1,Trinidad and Tobago
10675,11757,12642,1983,Gambia,Senegal,1,2,Amílcar Cabral Cup,Nouakchott,Mauritania,True,3,-1,Senegal
10676,11758,12643,1983,Guinea,Senegal,1,1,Amílcar Cabral Cup,Nouakchott,Mauritania,True,2,0,Draw
10677,11759,12644,1983,Mauritania,Mali,0,2,Amílcar Cabral Cup,Nouakchott,Mauritania,False,2,-2,Mali
10678,11760,12645,1983,Paraguay,Chile,1,0,Friendly,Asunción,Paraguay,False,1,1,Paraguay
10679,11761,12646,1983,French Guiana,Antigua and Barbuda,1,0,CFU Caribbean Cup,Cayenne,French Guiana,False,1,1,French Guiana
10680,11762,12647,1983,Gambia,Guinea-Bissau,2,2,Amílcar Cabral Cup,Nouakchott,Mauritania,True,4,0,Draw
10681,11763,12648,1983,Martinique,Trinidad and Tobago,3,1,CFU Caribbean Cup,Cayenne,French Guiana,True,4,2,Martinique
10682,11764,12649,1983,Ecuador,Colombia,0,0,Friendly,Quito,Ecuador,False,0,0,Draw
10683,11765,12650,1983,El Salvador,Guatemala,0,0,Friendly,Los Angeles,United States,True,0,0,Draw
10684,11766,12652,1983,Antigua and Barbuda,Trinidad and Tobago,1,2,CFU Caribbean Cup,Cayenne,French Guiana,True,3,-1,Trinidad and Tobago
10685,11767,12653,1983,French Guiana,Martinique,0,0,CFU Caribbean Cup,Cayenne,French Guiana,False,0,0,Draw
10686,11768,12654,1983,Mali,Senegal,1,2,Amílcar Cabral Cup,Nouakchott,Mauritania,True,3,-1,Senegal
10687,11769,12655,1983,Mauritania,Guinea-Bissau,1,2,Amílcar Cabral Cup,Nouakchott,Mauritania,False,3,-1,Guinea-Bissau
10688,11770,12656,1983,Panama,Cuba,0,0,Friendly,Panama City,Panama,False,0,0,Draw
10689,11771,12657,1983,Chile,Brazil,0,0,Friendly,Santiago,Chile,False,0,0,Draw
10690,11772,12658,1983,Mauritania,Mali,0,2,Amílcar Cabral Cup,Nouakchott,Mauritania,False,2,-2,Mali
10691,11773,12659,1983,Colombia,Ecuador,0,0,Friendly,Bogotá,Colombia,False,0,0,Draw
10692,11775,12661,1983,Guinea-Bissau,Senegal,0,3,Amílcar Cabral Cup,Nouakchott,Mauritania,True,3,-3,Senegal
10693,11776,12662,1983,Panama,Cuba,1,0,Friendly,La Chorrera,Panama,False,1,1,Panama
10694,11777,12663,1983,Congo,Cameroon,2,2,Friendly,Brazzaville,Congo,False,4,0,Draw
10695,11778,12664,1983,Costa Rica,Cuba,3,0,Friendly,Alajuela,Costa Rica,False,3,3,Costa Rica
10696,11779,12665,1983,Bolivia,Paraguay,2,1,Friendly,La Paz,Bolivia,False,3,1,Bolivia
10697,11780,12666,1983,Chile,Peru,2,0,Copa del Pacífico,Arica,Chile,False,2,2,Chile
10698,11782,12668,1983,Costa Rica,Cuba,2,0,Friendly,San José,Costa Rica,False,2,2,Costa Rica
10699,11783,12669,1983,Bolivia,Paraguay,1,3,Friendly,Santa Cruz,Bolivia,False,4,-2,Paraguay
10700,11784,12670,1983,Algeria,Bulgaria,2,3,Friendly,Saint-Denis,France,True,5,-1,Bulgaria
10701,11786,12672,1983,Iceland,Faroe Islands,6,0,Friendly,Njarðvík,Iceland,False,6,6,Iceland
10702,11788,12674,1983,Ecuador,Argentina,2,2,Copa América,Quito,Ecuador,False,4,0,Draw
10703,11789,12675,1983,Norway,Romania,0,0,Friendly,Oslo,Norway,False,0,0,Draw
10704,11790,12676,1983,Peru,Uruguay,1,1,Friendly,Lima,Peru,False,2,0,Draw
10705,11792,12678,1983,Mauritania,Togo,0,4,Friendly,Nouakchott,Mauritania,False,4,-4,Togo
10706,11793,12679,1983,Bolivia,Colombia,0,1,Copa América,La Paz,Bolivia,False,1,-1,Colombia
10707,11794,12680,1983,Cameroon,Sudan,5,0,African Cup of Nations qualification,Yaoundé,Cameroon,False,5,5,Cameroon
10708,11795,12681,1983,Egypt,Tunisia,1,0,African Cup of Nations qualification,Cairo,Egypt,False,1,1,Egypt
10709,11796,12682,1983,Madagascar,Malawi,0,1,African Cup of Nations qualification,Antananarivo,Madagascar,False,1,-1,Malawi
10710,11797,12683,1983,Nigeria,Morocco,0,0,African Cup of Nations qualification,Benin City,Nigeria,False,0,0,Draw
10711,11799,12685,1983,Fiji,New Zealand,2,0,Friendly,Suva,Fiji,False,2,2,Fiji
10712,11800,12686,1983,Chile,Paraguay,3,2,Friendly,Antofagasta,Chile,False,5,1,Chile
10713,11801,12687,1983,Ecuador,Brazil,0,1,Copa América,Quito,Ecuador,False,1,-1,Brazil
10714,11802,12688,1983,Iceland,Sweden,0,4,Friendly,Reykjavík,Iceland,False,4,-4,Sweden
10715,11803,12689,1983,Peru,Colombia,1,0,Copa América,Lima,Peru,False,1,1,Peru
10716,11804,12690,1983,Fiji,New Zealand,0,1,Friendly,Nadi,Fiji,False,1,-1,New Zealand
10717,11805,12691,1983,Greece,Libya,3,2,Friendly,Athens,Greece,False,5,1,Greece
10718,11808,12694,1983,Samoa,American Samoa,3,1,South Pacific Games,Apia,Western Samoa,False,4,2,Samoa
10719,11809,12695,1983,Bolivia,Peru,1,1,Copa América,La Paz,Bolivia,False,2,0,Draw
10720,11811,12697,1983,Niue,Papua New Guinea,0,19,South Pacific Games,Apia,Western Samoa,True,19,-19,Papua New Guinea
10721,11812,12698,1983,Samoa,Tonga,3,3,South Pacific Games,Apia,Western Samoa,False,6,0,Draw
10722,11813,12699,1983,Fiji,Solomon Islands,10,0,South Pacific Games,Apia,Western Samoa,True,10,10,Fiji
10723,11814,12700,1983,American Samoa,Tonga,2,3,South Pacific Games,Apia,Western Samoa,True,5,-1,Tonga
10724,11815,12701,1983,Argentina,Brazil,1,0,Copa América,Buenos Aires,Argentina,False,1,1,Argentina
10725,11816,12702,1983,Chile,Bolivia,4,2,Friendly,Arica,Chile,False,6,2,Chile
10726,11819,12705,1983,Turkey,Libya,0,0,Friendly,Istanbul,Turkey,False,0,0,Draw
10727,11821,12707,1983,Algeria,Ivory Coast,3,0,Friendly,Algiers,Algeria,False,3,3,Algeria
10728,11822,12708,1983,Uruguay,Paraguay,0,0,Friendly,Montevideo,Uruguay,False,0,0,Draw
10729,11823,12709,1983,Fiji,Vanuatu,6,0,South Pacific Games,Apia,Western Samoa,True,6,6,Fiji
10730,11824,12710,1983,Algeria,Senegal,2,0,African Cup of Nations qualification,Algiers,Algeria,False,2,2,Algeria
10731,11825,12711,1983,Colombia,Peru,2,2,Copa América,Bogotá,Colombia,False,4,0,Draw
10732,11826,12712,1983,Malawi,Madagascar,1,1,African Cup of Nations qualification,Blantyre,Malawi,False,2,0,Draw
10733,11827,12713,1983,Morocco,Nigeria,0,0,African Cup of Nations qualification,Rabat,Morocco,False,0,0,Draw
10734,11828,12714,1983,Sudan,Cameroon,2,0,African Cup of Nations qualification,Khartoum,Sudan,False,2,2,Sudan
10735,11829,12715,1983,Togo,Ethiopia,3,0,African Cup of Nations qualification,Lomé,Togo,False,3,3,Togo
10736,11830,12716,1983,Tunisia,Egypt,0,0,African Cup of Nations qualification,Tunis,Tunisia,False,0,0,Draw
10737,11831,12717,1983,Libya,Zimbabwe,3,1,Friendly,Tripoli,Libya,False,4,2,Libya
10738,11832,12718,1983,Colombia,Bolivia,2,2,Copa América,Bogotá,Colombia,False,4,0,Draw
10739,11833,12719,1983,Greece,Bulgaria,2,3,Friendly,Athens,Greece,False,5,-1,Bulgaria
10740,11834,12720,1983,Brazil,Ecuador,5,0,Copa América,Goiânia,Brazil,False,5,5,Brazil
10741,11835,12721,1983,Uruguay,Chile,2,1,Copa América,Montevideo,Uruguay,False,3,1,Uruguay
10742,11836,12722,1983,Malaysia,Singapore,0,0,Friendly,Kuala Lumpur,Malaysia,False,0,0,Draw
10743,11837,12723,1983,Peru,Bolivia,2,1,Copa América,Lima,Peru,False,3,1,Peru
10744,11838,12724,1983,Uruguay,Venezuela,3,0,Copa América,Montevideo,Uruguay,False,3,3,Uruguay
10745,11839,12725,1983,Argentina,Ecuador,2,2,Copa América,Buenos Aires,Argentina,False,4,0,Draw
10746,11840,12726,1983,Denmark,France,3,1,Friendly,Copenhagen,Denmark,False,4,2,Denmark
10747,11841,12727,1983,Finland,Sweden,0,3,Nordic Championship,Helsinki,Finland,False,3,-3,Sweden
10748,11842,12728,1983,Hungary,Germany,1,1,Friendly,Budapest,Hungary,False,2,0,Draw
10749,11843,12729,1983,Netherlands,Iceland,3,0,UEFA Euro qualification,Groningen,Netherlands,False,3,3,Netherlands
10750,11844,12730,1983,Norway,Bulgaria,1,2,UEFA Euro qualification,Oslo,Norway,False,3,-1,Bulgaria
10751,11845,12731,1983,Poland,Romania,2,2,Friendly,Cracow,Poland,False,4,0,Draw
10752,11847,12733,1983,Chile,Venezuela,5,0,Copa América,Santiago,Chile,False,5,5,Chile
10753,11848,12734,1983,Singapore,Malaysia,0,1,Friendly,Kallang,Singapore,False,1,-1,Malaysia
10754,11849,12735,1983,Chile,Uruguay,2,0,Copa América,Santiago,Chile,False,2,2,Chile
10755,11850,12736,1983,New Caledonia,Vanuatu,6,2,South Pacific Games,Apia,Western Samoa,True,8,4,New Caledonia
10756,11851,12737,1983,New Caledonia,Solomon Islands,1,0,South Pacific Games,Apia,Western Samoa,True,1,1,New Caledonia
10757,11852,12738,1983,Fiji,New Caledonia,5,1,South Pacific Games,Apia,Western Samoa,True,6,4,Fiji
10758,11853,12739,1983,Brazil,Argentina,0,0,Copa América,Rio de Janeiro,Brazil,False,0,0,Draw
10759,11854,12740,1983,Fiji,New Caledonia,3,2,South Pacific Games,Apia,Western Samoa,True,5,1,Fiji
10760,11855,12741,1983,Fiji,Papua New Guinea,2,0,South Pacific Games,Apia,Western Samoa,True,2,2,Fiji
10761,11861,12747,1983,New Caledonia,Papua New Guinea,2,1,South Pacific Games,Apia,Western Samoa,True,3,1,New Caledonia
10762,11862,12748,1983,Venezuela,Uruguay,1,2,Copa América,Caracas,Venezuela,False,3,-1,Uruguay
10763,11863,12749,1983,Ghana,Thailand,2,1,Merdeka Tournament,Kuala Lumpur,Malaysia,True,3,1,Ghana
10764,11864,12750,1983,Malaysia,Nepal,7,0,Merdeka Tournament,Kota Bharu,Malaysia,False,7,7,Malaysia
10765,11866,12752,1983,Belgium,Netherlands,1,1,Friendly,Brussels,Belgium,False,2,0,Draw
10766,11867,12753,1983,England,Denmark,0,1,UEFA Euro qualification,London,England,False,1,-1,Denmark
10767,11868,12754,1983,Iceland,Republic of Ireland,0,3,UEFA Euro qualification,Reykjavík,Iceland,False,3,-3,Republic of Ireland
10768,11869,12755,1983,Northern Ireland,Austria,3,1,UEFA Euro qualification,Belfast,Northern Ireland,False,4,2,Northern Ireland
10769,11870,12756,1983,Norway,Wales,0,0,UEFA Euro qualification,Oslo,Norway,False,0,0,Draw
10770,11871,12757,1983,Portugal,Finland,5,0,UEFA Euro qualification,Lisbon,Portugal,False,5,5,Portugal
10771,11872,12758,1983,Scotland,Uruguay,2,0,Friendly,Glasgow,Scotland,False,2,2,Scotland
10772,11874,12760,1983,Venezuela,Chile,0,0,Copa América,Caracas,Venezuela,False,0,0,Draw
10773,11875,12761,1983,Bangladesh,Nepal,1,0,Merdeka Tournament,Seremban,Malaysia,True,1,1,Bangladesh
10774,11876,12762,1983,Malaysia,Algeria,0,0,Merdeka Tournament,Kuala Lumpur,Malaysia,False,0,0,Draw
10775,11877,12763,1983,Algeria,Bangladesh,1,0,Merdeka Tournament,Kuala Lumpur,Malaysia,True,1,1,Algeria
10776,11878,12765,1983,Ivory Coast,Liberia,0,0,West African Cup,Abidjan,Ivory Coast,False,0,0,Draw
10777,11880,12767,1983,Israel,Uruguay,2,2,Friendly,Jaffa,Israel,False,4,0,Draw
10778,11881,12768,1983,Ghana,Togo,1,1,West African Cup,Abidjan,Ivory Coast,True,2,0,Draw
10779,11882,12769,1983,Algeria,Nepal,2,0,Merdeka Tournament,Alor Setar,Malaysia,True,2,2,Algeria
10780,11883,12770,1983,Ghana,Liberia,1,0,West African Cup,Abidjan,Ivory Coast,True,1,1,Ghana
10781,11884,12771,1983,Ivory Coast,Togo,3,0,West African Cup,Abidjan,Ivory Coast,False,3,3,Ivory Coast
10782,11885,12772,1983,Ivory Coast,Ghana,0,2,West African Cup,Abidjan,Ivory Coast,False,2,-2,Ghana
10783,11886,12773,1983,Liberia,Togo,0,4,West African Cup,Abidjan,Ivory Coast,True,4,-4,Togo
10784,11887,12774,1983,Ghana,Togo,3,1,West African Cup,Abidjan,Ivory Coast,True,4,2,Ghana
10785,11888,12775,1983,Ivory Coast,Liberia,2,1,West African Cup,Abidjan,Ivory Coast,False,3,1,Ivory Coast
10786,11889,12776,1983,France,Spain,1,1,Friendly,Paris,France,False,2,0,Draw
10787,11890,12777,1983,Germany,Austria,3,0,UEFA Euro qualification,Gelsenkirchen,Germany,False,3,3,Germany
10788,11891,12778,1983,Italy,Greece,3,0,Friendly,Bari,Italy,False,3,3,Italy
10789,11892,12779,1983,Peru,Paraguay,0,2,Friendly,Lima,Peru,False,2,-2,Paraguay
10790,11893,12780,1983,Paraguay,Peru,4,1,Friendly,Asunción,Paraguay,False,5,3,Paraguay
10791,11894,12781,1983,Sierra Leone,Mali,1,0,Friendly,Freetown,Sierra Leone,False,1,1,Sierra Leone
10792,11895,12782,1983,Libya,Malta,4,0,Friendly,Tripoli,Libya,False,4,4,Libya
10793,11896,12783,1983,Russia,Poland,2,0,UEFA Euro qualification,Moscow,Soviet Union,False,2,2,Russia
10794,11897,12784,1983,Denmark,Luxembourg,6,0,UEFA Euro qualification,Copenhagen,Denmark,False,6,6,Denmark
10795,11898,12786,1983,Hungary,England,0,3,UEFA Euro qualification,Budapest,Hungary,False,3,-3,England
10796,11899,12787,1983,Republic of Ireland,Netherlands,2,3,UEFA Euro qualification,Dublin,Republic of Ireland,False,5,-1,Netherlands
10797,11900,12788,1983,Scotland,Belgium,1,1,UEFA Euro qualification,Glasgow,Scotland,False,2,0,Draw
10798,11901,12789,1983,Turkey,Northern Ireland,1,0,UEFA Euro qualification,Ankara,Turkey,False,1,1,Turkey
10799,11902,12790,1983,Wales,Romania,5,0,Friendly,Wrexham,Wales,False,5,5,Wales
10800,11903,12792,1983,Paraguay,Brazil,1,1,Copa América,Asunción,Paraguay,False,2,0,Draw
10801,11904,12793,1983,Peru,Uruguay,0,1,Copa América,Lima,Peru,False,1,-1,Uruguay
10802,11905,12794,1983,Italy,Sweden,0,3,UEFA Euro qualification,Naples,Italy,False,3,-3,Sweden
10803,11906,12795,1983,Brazil,Paraguay,0,0,Copa América,Uberlândia,Brazil,False,0,0,Draw
10804,11907,12796,1983,Uruguay,Peru,1,1,Copa América,Montevideo,Uruguay,False,2,0,Draw
10805,11908,12797,1983,Tanzania,Malawi,1,1,Friendly,Dodoma,Tanzania,False,2,0,Draw
10806,11909,12798,1983,Tanzania,Malawi,0,0,Friendly,Dar es Salaam,Tanzania,False,0,0,Draw
10807,11910,12799,1983,El Salvador,Mexico,0,5,Friendly,Los Angeles,United States,True,5,-5,Mexico
10808,11911,12801,1983,Germany,Turkey,5,1,UEFA Euro qualification,Berlin,Germany,False,6,4,Germany
10809,11912,12802,1983,Hungary,Denmark,1,0,UEFA Euro qualification,Budapest,Hungary,False,1,1,Hungary
10810,11914,12805,1983,Uruguay,Brazil,2,0,Copa América,Montevideo,Uruguay,False,2,2,Uruguay
10811,11915,12806,1983,Poland,Portugal,0,1,UEFA Euro qualification,Wrocław,Poland,False,1,-1,Portugal
10812,11916,12807,1983,Tanzania,Malawi,1,0,Friendly,Dodoma,Tanzania,False,1,1,Tanzania
10813,11917,12808,1983,Brazil,Uruguay,1,1,Copa América,Salvador,Brazil,False,2,0,Draw
10814,11918,12809,1983,Israel,Romania,1,1,Friendly,Jaffa,Israel,False,2,0,Draw
10815,11919,12810,1983,Switzerland,Belgium,3,1,UEFA Euro qualification,Berne,Switzerland,False,4,2,Switzerland
10816,11920,12811,1983,Cyprus,Romania,0,1,UEFA Euro qualification,Limassol,Cyprus,False,1,-1,Romania
10817,11921,12812,1983,Kenya,Uganda,2,1,CECAFA Cup,Nairobi,Kenya,False,3,1,Kenya
10818,11922,12814,1983,Ethiopia,Tanzania,1,1,CECAFA Cup,Nairobi,Kenya,True,2,0,Draw
10819,11923,12815,1983,Malawi,Zimbabwe,0,1,CECAFA Cup,Mombasa,Kenya,True,1,-1,Zimbabwe
10820,11924,12816,1983,Niger,Mali,1,1,Friendly,Niamey,Niger,False,2,0,Draw
10821,11925,12817,1983,Portugal,Russia,1,0,UEFA Euro qualification,Lisbon,Portugal,False,1,1,Portugal
10822,11926,12818,1983,Niger,Mali,1,1,Friendly,Niamey,Niger,False,2,0,Draw
10823,11928,12820,1983,Sudan,Uganda,1,2,CECAFA Cup,Nairobi,Kenya,True,3,-1,Uganda
10824,11929,12821,1983,Kenya,Ethiopia,2,0,CECAFA Cup,Nairobi,Kenya,False,2,2,Kenya
10825,11930,12822,1983,Nigeria,Senegal,1,0,Friendly,Lagos,Nigeria,False,1,1,Nigeria
10826,11931,12823,1983,Bulgaria,Wales,1,0,UEFA Euro qualification,Sofia,Bulgaria,False,1,1,Bulgaria
10827,11932,12826,1983,Germany,Northern Ireland,0,1,UEFA Euro qualification,Hamburg,Germany,False,1,-1,Northern Ireland
10828,11933,12827,1983,Greece,Denmark,0,2,UEFA Euro qualification,Athens,Greece,False,2,-2,Denmark
10829,11934,12828,1983,Republic of Ireland,Malta,8,0,UEFA Euro qualification,Dublin,Republic of Ireland,False,8,8,Republic of Ireland
10830,11935,12829,1983,Luxembourg,England,0,4,UEFA Euro qualification,Luxembourg,Luxembourg,False,4,-4,England
10831,11936,12830,1983,Netherlands,Spain,2,1,UEFA Euro qualification,Rotterdam,Netherlands,False,3,1,Netherlands
10832,11937,12831,1983,Sudan,Tanzania,1,0,CECAFA Cup,Nairobi,Kenya,True,1,1,Sudan
10833,11938,12832,1983,Trinidad and Tobago,Sweden,0,5,Friendly,Port of Spain,Trinidad and Tobago,False,5,-5,Sweden
10834,11939,12833,1983,Turkey,Austria,3,1,UEFA Euro qualification,Istanbul,Turkey,False,4,2,Turkey
10835,11940,12835,1983,Ethiopia,Uganda,1,2,CECAFA Cup,Nairobi,Kenya,True,3,-1,Uganda
10836,11941,12836,1983,Malawi,Somalia,2,1,CECAFA Cup,Mombasa,Kenya,True,3,1,Malawi
10837,11942,12837,1983,Kenya,Tanzania,0,0,CECAFA Cup,Nairobi,Kenya,False,0,0,Draw
10838,11943,12838,1983,Barbados,Sweden,0,4,Friendly,Bridgetown,Barbados,False,4,-4,Sweden
10839,11944,12839,1983,Ethiopia,Sudan,0,2,CECAFA Cup,Nairobi,Kenya,True,2,-2,Sudan
10840,11945,12840,1983,Senegal,Nigeria,0,1,Friendly,Dakar,Senegal,False,1,-1,Nigeria
10841,11946,12841,1983,Somalia,Zimbabwe,1,2,CECAFA Cup,Mombasa,Kenya,True,3,-1,Zimbabwe
10842,11947,12842,1983,Germany,Albania,2,1,UEFA Euro qualification,Saarbrücken,Germany,False,3,1,Germany
10843,11949,12844,1983,Sri Lanka,Singapore,0,4,Friendly,Colombo,Sri Lanka,False,4,-4,Singapore
10844,11950,12845,1983,Tanzania,Uganda,1,1,CECAFA Cup,Nairobi,Kenya,True,2,0,Draw
10845,11951,12846,1983,Kenya,Sudan,1,0,CECAFA Cup,Nairobi,Kenya,False,1,1,Kenya
10846,11952,12847,1983,Mexico,Sweden,2,0,Friendly,Morelia,Mexico,False,2,2,Mexico
10847,11953,12848,1983,Kenya,Malawi,2,0,CECAFA Cup,Nairobi,Kenya,False,2,2,Kenya
10848,11954,12849,1983,Uganda,Zimbabwe,0,1,CECAFA Cup,Mombasa,Kenya,True,1,-1,Zimbabwe
10849,11955,12850,1983,Malawi,Uganda,1,2,CECAFA Cup,Nairobi,Kenya,True,3,-1,Uganda
10850,11956,12851,1983,Kenya,Zimbabwe,1,0,CECAFA Cup,Nairobi,Kenya,False,1,1,Kenya
10851,11957,12852,1983,Martinique,Mexico,4,4,Friendly,Fort-de-France,Martinique,False,8,0,Draw
10852,11958,12853,1983,Algeria,Switzerland,1,2,Friendly,Algiers,Algeria,False,3,-1,Switzerland
10853,11959,12855,1983,Ivory Coast,Switzerland,1,0,Friendly,Abidjan,Ivory Coast,False,1,1,Ivory Coast
10854,11960,12856,1983,Greece,Hungary,2,2,UEFA Euro qualification,Salonica,Greece,False,4,0,Draw
10855,11962,12858,1983,Zimbabwe,Switzerland,3,2,Friendly,Harare,Zimbabwe,False,5,1,Zimbabwe
10856,11963,12859,1983,Kenya,Switzerland,0,0,Friendly,Mombasa,Kenya,False,0,0,Draw
10857,11964,12860,1983,Mexico,Canada,5,0,Friendly,Irapuato,Mexico,False,5,5,Mexico
10858,11965,12861,1983,Belize,Canada,0,2,Friendly,Belmopan,Belize,False,2,-2,Canada
10859,11966,12862,1983,Kenya,Ethiopia,2,2,Friendly,Nairobi,Kenya,False,4,0,Draw
10860,11967,12863,1983,Kenya,Ethiopia,1,0,Friendly,Nairobi,Kenya,False,1,1,Kenya
10861,11968,12864,1983,Honduras,Canada,3,1,Friendly,San Pedro Sula,Honduras,False,4,2,Honduras
10862,11969,12865,1983,Singapore,Brunei,4,0,Merlion Cup,Kallang,Singapore,False,4,4,Singapore
10863,11970,12866,1983,Kenya,Ethiopia,2,1,Friendly,Nairobi,Kenya,False,3,1,Kenya
10864,11971,12867,1983,Northern Ireland,Scotland,2,0,British Championship,Belfast,Northern Ireland,False,2,2,Northern Ireland
10865,11972,12868,1983,Greece,Luxembourg,1,0,UEFA Euro qualification,Piraeus,Greece,False,1,1,Greece
10866,11973,12869,1983,Honduras,Canada,1,0,Friendly,Tegucigalpa,Honduras,False,1,1,Honduras
10867,11976,12872,1983,Ivory Coast,Mali,1,1,Friendly,Abidjan,Ivory Coast,False,2,0,Draw
10868,11977,12873,1983,Nigeria,Togo,2,5,Friendly,Abidjan,Ivory Coast,True,7,-3,Togo
10869,11978,12874,1983,Netherlands,Malta,5,0,UEFA Euro qualification,Rotterdam,Netherlands,False,5,5,Netherlands
10870,11979,12875,1983,Singapore,Australia,2,4,Merlion Cup,Kallang,Singapore,False,6,-2,Australia
10871,11980,12876,1983,Ivory Coast,Togo,2,1,Friendly,Abidjan,Ivory Coast,False,3,1,Ivory Coast
10872,11981,12877,1983,Mali,Nigeria,0,0,Friendly,Abidjan,Ivory Coast,True,0,0,Draw
10873,11982,12878,1983,Ivory Coast,Togo,1,0,Friendly,Abidjan,Ivory Coast,False,1,1,Ivory Coast
10874,11983,12879,1983,Spain,Malta,12,1,UEFA Euro qualification,Seville,Spain,False,13,11,Spain
10875,11984,12881,1983,Italy,Cyprus,3,1,UEFA Euro qualification,Perugia,Italy,False,4,2,Italy
10876,11985,12882,1984,Gambia,Senegal,2,2,Friendly,Banjul,Gambia,False,4,0,Draw
10877,11986,12883,1984,Mauritania,Sierra Leone,0,1,Friendly,Banjul,Gambia,True,1,-1,Sierra Leone
10878,11987,12884,1984,Gambia,Sierra Leone,1,0,Friendly,Bakau,Gambia,False,1,1,Gambia
10879,11988,12885,1984,Mauritania,Senegal,0,2,Friendly,Banjul,Gambia,True,2,-2,Senegal
10880,11989,12886,1984,Ivory Coast,Sierra Leone,1,0,Friendly,Yamoussoukro,Ivory Coast,False,1,1,Ivory Coast
10881,11990,12887,1984,India,Poland,1,2,Nehru Cup,Calcutta,India,False,3,-1,Poland
10882,11991,12888,1984,India,Argentina,0,1,Nehru Cup,Calcutta,India,False,1,-1,Argentina
10883,11992,12890,1984,Ivory Coast,Morocco,3,3,Friendly,Abidjan,Ivory Coast,False,6,0,Draw
10884,11993,12891,1984,Argentina,Poland,1,1,Nehru Cup,Calcutta,India,True,2,0,Draw
10885,11994,12892,1984,Gambia,Guinea,1,0,Friendly,Banjul,Gambia,False,1,1,Gambia
10886,11995,12893,1984,Senegal,Guinea,1,0,Friendly,Dakar,Senegal,False,1,1,Senegal
10887,11996,12894,1984,Spain,Hungary,0,1,Friendly,Cádiz,Spain,False,1,-1,Hungary
10888,11998,12896,1984,Egypt,Turkey,1,0,Friendly,Cairo,Egypt,False,1,1,Egypt
10889,11999,12897,1984,Egypt,Turkey,0,1,Friendly,Port Said,Egypt,False,1,-1,Turkey
10890,12000,12898,1984,Ivory Coast,Guinea,3,0,Friendly,Abidjan,Ivory Coast,False,3,3,Ivory Coast
10891,12002,12901,1984,Gambia,Ghana,0,1,Friendly,Banjul,Gambia,False,1,-1,Ghana
10892,12003,12902,1984,Ivory Coast,Mali,4,1,Friendly,Abidjan,Ivory Coast,False,5,3,Ivory Coast
10893,12004,12903,1984,Liberia,Senegal,0,0,Friendly,Abidjan,Ivory Coast,True,0,0,Draw
10894,12005,12904,1984,Guinea,Ghana,1,2,Friendly,Conakry,Guinea,False,3,-1,Ghana
10895,12006,12905,1984,Ivory Coast,Senegal,1,0,Friendly,Abidjan,Ivory Coast,False,1,1,Ivory Coast
10896,12007,12906,1984,Liberia,Mali,2,2,Friendly,Abidjan,Ivory Coast,True,4,0,Draw
10897,12008,12907,1984,Ivory Coast,Liberia,4,1,Friendly,Abidjan,Ivory Coast,False,5,3,Ivory Coast
10898,12009,12908,1984,Mali,Senegal,1,1,Friendly,Abidjan,Ivory Coast,True,2,0,Draw
10899,12010,12909,1984,Italy,Mexico,5,0,Friendly,Rome,Italy,False,5,5,Italy
10900,12011,12910,1984,Ivory Coast,Senegal,4,3,Friendly,Abidjan,Ivory Coast,False,7,1,Ivory Coast
10901,12012,12911,1984,Liberia,Mali,0,1,Friendly,Abidjan,Ivory Coast,True,1,-1,Mali
10902,12013,12912,1984,Morocco,Bulgaria,1,1,Friendly,Casablanca,Morocco,False,2,0,Draw
10903,12014,12913,1984,Algeria,Romania,1,1,Friendly,Algiers,Algeria,False,2,0,Draw
10904,12015,12914,1984,Congo,Ivory Coast,2,3,Friendly,Brazzaville,Congo,False,5,-1,Ivory Coast
10905,12016,12915,1984,Gambia,Guinea,2,2,Amílcar Cabral Cup,Freetown,Sierra Leone,True,4,0,Draw
10906,12018,12917,1984,Guinea-Bissau,Senegal,2,3,Amílcar Cabral Cup,Freetown,Sierra Leone,True,5,-1,Senegal
10907,12019,12918,1984,Mali,Mauritania,1,0,Amílcar Cabral Cup,Freetown,Sierra Leone,True,1,1,Mali
10908,12020,12920,1984,Sierra Leone,Gambia,1,0,Amílcar Cabral Cup,Freetown,Sierra Leone,False,1,1,Sierra Leone
10909,12021,12921,1984,Guinea-Bissau,Mauritania,2,1,Amílcar Cabral Cup,Freetown,Sierra Leone,True,3,1,Guinea-Bissau
10910,12022,12922,1984,Mali,Senegal,1,0,Amílcar Cabral Cup,Freetown,Sierra Leone,True,1,1,Mali
10911,12023,12924,1984,Malawi,Zambia,1,0,Friendly,Blantyre,Malawi,False,1,1,Malawi
10912,12024,12925,1984,Sierra Leone,Guinea,0,0,Amílcar Cabral Cup,Freetown,Sierra Leone,False,0,0,Draw
10913,12025,12926,1984,Guinea-Bissau,Mali,1,0,Amílcar Cabral Cup,Freetown,Sierra Leone,True,1,1,Guinea-Bissau
10914,12026,12927,1984,Mauritania,Senegal,0,6,Amílcar Cabral Cup,Freetown,Sierra Leone,True,6,-6,Senegal
10915,12027,12928,1984,Bulgaria,Germany,2,3,Friendly,Varna,Bulgaria,False,5,-1,Germany
10916,12028,12929,1984,Gambia,Senegal,0,1,Amílcar Cabral Cup,Freetown,Sierra Leone,True,1,-1,Senegal
10917,12030,12931,1984,Malawi,Zambia,0,0,Friendly,Blantyre,Malawi,False,0,0,Draw
10918,12031,12932,1984,Togo,Ghana,2,1,Friendly,Lomé,Togo,False,3,1,Togo
10919,12032,12933,1984,Sierra Leone,Mali,0,0,Amílcar Cabral Cup,Freetown,Sierra Leone,False,0,0,Draw
10920,12033,12934,1984,Gambia,Mali,0,2,Amílcar Cabral Cup,Freetown,Sierra Leone,True,2,-2,Mali
10921,12034,12935,1984,Gabon,Togo,1,1,Friendly,Libreville,Gabon,False,2,0,Draw
10922,12035,12936,1984,Sierra Leone,Senegal,0,0,Amílcar Cabral Cup,Freetown,Sierra Leone,False,0,0,Draw
10923,12036,12937,1984,Saudi Arabia,Algeria,4,2,Friendly,Riyadh,Saudi Arabia,False,6,2,Saudi Arabia
10924,12037,12938,1984,Peru,Honduras,1,3,Friendly,Lima,Peru,False,4,-2,Honduras
10925,12038,12939,1984,Egypt,Iraq,1,2,Friendly,Cairo,Egypt,False,3,-1,Iraq
10926,12039,12940,1984,Scotland,Wales,2,1,British Championship,Glasgow,Scotland,False,3,1,Scotland
10927,12040,12941,1984,Belgium,Germany,0,1,Friendly,Brussels,Belgium,False,1,-1,Germany
10928,12041,12942,1984,Egypt,Iraq,0,0,Friendly,Cairo,Egypt,False,0,0,Draw
10929,12042,12943,1984,France,England,2,0,Friendly,Paris,France,False,2,2,France
10930,12043,12944,1984,Luxembourg,Spain,0,1,Friendly,Luxembourg,Luxembourg,False,1,-1,Spain
10931,12044,12945,1984,Turkey,Italy,1,2,Friendly,Istanbul,Turkey,False,3,-1,Italy
10932,12045,12946,1984,Cameroon,Egypt,0,1,African Cup of Nations,Abidjan,Ivory Coast,True,1,-1,Egypt
10933,12046,12947,1984,Ivory Coast,Togo,3,0,African Cup of Nations,Abidjan,Ivory Coast,False,3,3,Ivory Coast
10934,12047,12948,1984,Algeria,Malawi,3,0,African Cup of Nations,Bouaké,Ivory Coast,True,3,3,Algeria
10935,12048,12949,1984,Ghana,Nigeria,1,2,African Cup of Nations,Bouaké,Ivory Coast,True,3,-1,Nigeria
10936,12049,12950,1984,Brunei,Japan,1,7,Friendly,Bandar Seri Begawan,Brunei,False,8,-6,Japan
10937,12050,12951,1984,Cameroon,Togo,4,1,African Cup of Nations,Abidjan,Ivory Coast,True,5,3,Cameroon
10938,12051,12952,1984,Ivory Coast,Egypt,1,2,African Cup of Nations,Abidjan,Ivory Coast,False,3,-1,Egypt
10939,12052,12953,1984,Romania,Greece,2,0,Friendly,Craiova,Romania,False,2,2,Romania
10940,12053,12954,1984,Algeria,Ghana,2,0,African Cup of Nations,Bouaké,Ivory Coast,True,2,2,Algeria
10941,12054,12955,1984,Malawi,Nigeria,2,2,African Cup of Nations,Bouaké,Ivory Coast,True,4,0,Draw
10942,12055,12956,1984,Kuwait,Finland,1,0,Friendly,Kuwait City,Kuwait,False,1,1,Kuwait
10943,12056,12957,1984,Oman,Bahrain,0,1,Gulf Cup,Muscat,Oman,False,1,-1,Bahrain
10944,12057,12958,1984,Egypt,Togo,0,0,African Cup of Nations,Abidjan,Ivory Coast,True,0,0,Draw
10945,12058,12959,1984,Ivory Coast,Cameroon,0,2,African Cup of Nations,Abidjan,Ivory Coast,False,2,-2,Cameroon
10946,12059,12960,1984,Kuwait,United Arab Emirates,0,2,Gulf Cup,Muscat,Oman,True,2,-2,United Arab Emirates
10947,12060,12961,1984,Saudi Arabia,Qatar,1,2,Gulf Cup,Muscat,Oman,True,3,-1,Qatar
10948,12061,12962,1984,Algeria,Nigeria,0,0,African Cup of Nations,Bouaké,Ivory Coast,True,0,0,Draw
10949,12062,12963,1984,Ghana,Malawi,1,0,African Cup of Nations,Bouaké,Ivory Coast,True,1,1,Ghana
10950,12063,12964,1984,Luxembourg,Turkey,1,3,Friendly,Esch-sur-Alzette,Luxembourg,False,4,-2,Turkey
10951,12064,12965,1984,Oman,Iraq,1,2,Gulf Cup,Muscat,Oman,False,3,-1,Iraq
10952,12065,12966,1984,Bahrain,Kuwait,0,1,Gulf Cup,Muscat,Oman,True,1,-1,Kuwait
10953,12066,12967,1984,Panama,Cuba,1,1,Friendly,Panama City,Panama,False,2,0,Draw
10954,12067,12968,1984,Qatar,United Arab Emirates,0,1,Gulf Cup,Muscat,Oman,True,1,-1,United Arab Emirates
10955,12068,12969,1984,Algeria,Cameroon,0,0,African Cup of Nations,Bouaké,Ivory Coast,True,0,0,Draw
10956,12069,12970,1984,Egypt,Nigeria,2,2,African Cup of Nations,Abidjan,Ivory Coast,True,4,0,Draw
10957,12070,12971,1984,Netherlands,Denmark,6,0,Friendly,Amsterdam,Netherlands,False,6,6,Netherlands
10958,12071,12972,1984,Iraq,United Arab Emirates,0,0,Gulf Cup,Muscat,Oman,True,0,0,Draw
10959,12072,12973,1984,Oman,Saudi Arabia,1,3,Gulf Cup,Muscat,Oman,False,4,-2,Saudi Arabia
10960,12073,12974,1984,Kuwait,Qatar,1,2,Gulf Cup,Muscat,Oman,True,3,-1,Qatar
10961,12074,12975,1984,Algeria,Egypt,3,1,African Cup of Nations,Abidjan,Ivory Coast,True,4,2,Algeria
10962,12075,12976,1984,Iraq,Saudi Arabia,4,0,Gulf Cup,Muscat,Oman,True,4,4,Iraq
10963,12076,12977,1984,Bahrain,United Arab Emirates,1,1,Gulf Cup,Muscat,Oman,True,2,0,Draw
10964,12077,12978,1984,Cameroon,Nigeria,3,1,African Cup of Nations,Abidjan,Ivory Coast,True,4,2,Cameroon
10965,12078,12979,1984,Oman,Qatar,0,2,Gulf Cup,Muscat,Oman,False,2,-2,Qatar
10966,12079,12980,1984,Panama,Cuba,0,1,Friendly,Panama City,Panama,False,1,-1,Cuba
10967,12080,12981,1984,Bahrain,Iraq,0,1,Gulf Cup,Muscat,Oman,True,1,-1,Iraq
10968,12081,12982,1984,Saudi Arabia,Kuwait,1,1,Gulf Cup,Muscat,Oman,True,2,0,Draw
10969,12082,12983,1984,Oman,United Arab Emirates,1,1,Gulf Cup,Muscat,Oman,False,2,0,Draw
10970,12083,12984,1984,Bahrain,Qatar,1,1,Gulf Cup,Muscat,Oman,True,2,0,Draw
10971,12084,12985,1984,Iraq,Kuwait,3,1,Gulf Cup,Muscat,Oman,True,4,2,Iraq
10972,12085,12986,1984,Djibouti,Ethiopia,0,2,Friendly,Djibouti,Djibouti,False,2,-2,Ethiopia
10973,12086,12987,1984,Saudi Arabia,United Arab Emirates,2,0,Gulf Cup,Muscat,Oman,True,2,2,Saudi Arabia
10974,12087,12988,1984,Panama,Costa Rica,1,1,Friendly,Panama City,Panama,False,2,0,Draw
10975,12088,12989,1984,Iraq,Qatar,1,2,Gulf Cup,Muscat,Oman,True,3,-1,Qatar
10976,12089,12990,1984,Oman,Kuwait,0,0,Gulf Cup,Muscat,Oman,False,0,0,Draw
10977,12090,12991,1984,Bahrain,Saudi Arabia,0,2,Gulf Cup,Muscat,Oman,True,2,-2,Saudi Arabia
10978,12091,12992,1984,Switzerland,Poland,1,1,Friendly,Zürich,Switzerland,False,2,0,Draw
10979,12092,12993,1984,France,Austria,1,0,Friendly,Bordeaux,France,False,1,1,France
10980,12093,12995,1984,Germany,Russia,2,1,Friendly,Hanover,Germany,False,3,1,Germany
10981,12094,12996,1984,Haiti,Canada,0,1,Friendly,Port-au-Prince,Haiti,False,1,-1,Canada
10982,12095,12997,1984,Iraq,Qatar,1,1,Gulf Cup,Muscat,Oman,True,2,0,Draw
10983,12096,12998,1984,New Zealand,Malaysia,2,0,Friendly,Wellington,New Zealand,False,2,2,New Zealand
10984,12097,13000,1984,Kuwait,Bulgaria,1,1,Friendly,Kuwait City,Kuwait,False,2,0,Draw
10985,12098,13001,1984,New Zealand,Malaysia,6,1,Friendly,Christchurch,New Zealand,False,7,5,New Zealand
10986,12099,13002,1984,England,Northern Ireland,1,0,British Championship,London,England,False,1,1,England
10987,12100,13003,1984,Israel,Republic of Ireland,3,0,Friendly,Jaffa,Israel,False,3,3,Israel
10988,12101,13004,1984,Turkey,Hungary,0,6,Friendly,Istanbul,Turkey,False,6,-6,Hungary
10989,12103,13006,1984,New Zealand,Malaysia,0,0,Friendly,Auckland,New Zealand,False,0,0,Draw
10990,12104,13007,1984,Greece,Cyprus,1,1,Friendly,Athens,Greece,False,2,0,Draw
10991,12105,13008,1984,Romania,Israel,0,0,Friendly,Oradea,Romania,False,0,0,Draw
10992,12106,13009,1984,Spain,Denmark,2,1,Friendly,Valencia,Spain,False,3,1,Spain
10993,12108,13011,1984,Poland,Belgium,0,1,Friendly,Warsaw,Poland,False,1,-1,Belgium
10994,12109,13012,1984,Austria,Greece,0,0,Friendly,Vienna,Austria,False,0,0,Draw
10995,12110,13013,1984,France,Germany,1,0,Friendly,Strasbourg,France,False,1,1,France
10996,12111,13014,1984,Panama,Nicaragua,2,0,Friendly,Panama City,Panama,False,2,2,Panama
10997,12112,13015,1984,Jamaica,Haiti,0,1,Friendly,Kingston,Jamaica,False,1,-1,Haiti
10998,12113,13016,1984,Luxembourg,Norway,0,2,Friendly,Ettelbruck,Luxembourg,False,2,-2,Norway
10999,12114,13017,1984,Cyprus,Austria,1,2,FIFA World Cup qualification,Nicosia,Cyprus,False,3,-1,Austria
11000,12115,13018,1984,Switzerland,Sweden,0,0,Friendly,Berne,Switzerland,False,0,0,Draw
11001,12116,13019,1984,Wales,England,1,0,British Championship,Wrexham,Wales,False,1,1,Wales
11002,12117,13020,1984,Finland,Russia,1,3,Friendly,Kouvola,Finland,False,4,-2,Russia
11003,12118,13022,1984,Réunion,Tanzania,1,1,Friendly,Saint-Pierre,Réunion,False,2,0,Draw
11004,12119,13023,1984,Germany,Italy,1,0,Friendly,Zürich,Switzerland,True,1,1,Germany
11005,12120,13024,1984,Wales,Northern Ireland,1,1,British Championship,Swansea,Wales,False,2,0,Draw
11006,12121,13025,1984,Hungary,Norway,0,0,Friendly,Székesfehérvár,Hungary,False,0,0,Draw
11007,12122,13026,1984,Republic of Ireland,Poland,0,0,Friendly,Dublin,Republic of Ireland,False,0,0,Draw
11008,12123,13027,1984,Sweden,Malta,4,0,FIFA World Cup qualification,Norrköping,Sweden,False,4,4,Sweden
11009,12124,13028,1984,Canada,Italy,0,2,Friendly,Toronto,Canada,False,2,-2,Italy
11010,12125,13029,1984,Scotland,England,1,1,British Championship,Glasgow,Scotland,False,2,0,Draw
11011,12126,13030,1984,Switzerland,Spain,0,4,Friendly,Geneva,Switzerland,False,4,-4,Spain
11012,12127,13031,1984,Finland,Northern Ireland,1,0,FIFA World Cup qualification,Pori,Finland,False,1,1,Finland
11013,12128,13032,1984,El Salvador,Panama,2,1,Friendly,San Salvador,El Salvador,False,3,1,El Salvador
11014,12129,13033,1984,United States,Italy,0,0,Friendly,East Rutherford,United States,False,0,0,Draw
11015,12130,13034,1984,Hungary,Spain,1,1,Friendly,Budapest,Hungary,False,2,0,Draw
11016,12132,13036,1984,France,Scotland,2,0,Friendly,Marseille,France,False,2,2,France
11017,12133,13037,1984,England,Russia,0,2,Friendly,London,England,False,2,-2,Russia
11018,12135,13040,1984,Ethiopia,Djibouti,2,0,Friendly,Addis Abeba,Ethiopia,False,2,2,Ethiopia
11019,12136,13042,1984,Belgium,Hungary,2,2,Friendly,Brussels,Belgium,False,4,0,Draw
11020,12137,13043,1984,Norway,Wales,1,0,Friendly,Trondheim,Norway,False,1,1,Norway
11021,12138,13044,1984,Sweden,Denmark,0,1,Friendly,Gothenburg,Sweden,False,1,-1,Denmark
11022,12139,13045,1984,Djibouti,Zimbabwe,1,3,Friendly,Addis Abeba,Ethiopia,True,4,-2,Zimbabwe
11023,12140,13046,1984,Liechtenstein,Austria,0,6,Friendly,Vaduz,Liechtenstein,False,6,-6,Austria
11024,12142,13048,1984,Denmark,Bulgaria,1,1,Friendly,Copenhagen,Denmark,False,2,0,Draw
11025,12143,13049,1984,Luxembourg,Portugal,1,2,Friendly,Luxembourg,Luxembourg,False,3,-1,Portugal
11026,12144,13050,1984,Trinidad and Tobago,India,1,2,Friendly,Port of Spain,Trinidad and Tobago,False,3,-1,India
11027,12145,13051,1984,Brazil,England,0,2,Friendly,Rio de Janeiro,Brazil,False,2,-2,England
11028,12146,13052,1984,Israel,Wales,0,0,Friendly,Ramat-Gan,Israel,False,0,0,Draw
11029,12147,13053,1984,Zambia,Zimbabwe,1,1,Friendly,Lusaka,Zambia,False,2,0,Draw
11030,12148,13054,1984,Ethiopia,Zimbabwe,2,0,Friendly,Addis Abeba,Ethiopia,False,2,2,Ethiopia
11031,12149,13055,1984,Trinidad and Tobago,India,3,0,Friendly,San Fernando,Trinidad and Tobago,False,3,3,Trinidad and Tobago
11032,12150,13056,1984,France,Denmark,1,0,UEFA Euro,Paris,France,False,1,1,France
11033,12152,13058,1984,Uruguay,England,2,0,Friendly,Montevideo,Uruguay,False,2,2,Uruguay
11034,12153,13059,1984,Germany,Portugal,0,0,UEFA Euro,Strasbourg,France,True,0,0,Draw
11035,12154,13060,1984,Romania,Spain,1,1,UEFA Euro,Saint-Étienne,France,True,2,0,Draw
11036,12155,13061,1984,Panama,Honduras,0,3,FIFA World Cup qualification,Colón,Panama,False,3,-3,Honduras
11037,12156,13062,1984,Suriname,India,6,2,Friendly,Paramaribo,Suriname,False,8,4,Suriname
11038,12158,13064,1984,France,Belgium,5,0,UEFA Euro,Nantes,France,False,5,5,France
11039,12159,13065,1984,Brazil,Argentina,0,0,Friendly,São Paulo,Brazil,False,0,0,Draw
11040,12160,13066,1984,Chile,England,0,0,Friendly,Santiago,Chile,False,0,0,Draw
11041,12161,13067,1984,Germany,Romania,2,1,UEFA Euro,Lens,France,True,3,1,Germany
11042,12162,13068,1984,Macau,Hong Kong,0,3,Friendly,Macau,Macau,False,3,-3,Hong Kong
11043,12163,13069,1984,Portugal,Spain,1,1,UEFA Euro,Marseille,France,True,2,0,Draw
11044,12164,13070,1984,Suriname,India,4,1,Friendly,Paramaribo,Suriname,False,5,3,Suriname
11045,12165,13071,1984,Guyana,India,3,0,Friendly,Georgetown,Guyana,False,3,3,Guyana
11046,12166,13072,1984,Denmark,Belgium,3,2,UEFA Euro,Strasbourg,France,True,5,1,Denmark
11047,12168,13074,1984,Germany,Spain,0,1,UEFA Euro,Paris,France,True,1,-1,Spain
11048,12169,13075,1984,Iceland,Norway,0,1,Friendly,Reykjavík,Iceland,False,1,-1,Norway
11049,12170,13076,1984,Portugal,Romania,1,0,UEFA Euro,Nantes,France,True,1,1,Portugal
11050,12171,13077,1984,Brazil,Uruguay,1,0,Friendly,Curitiba,Brazil,False,1,1,Brazil
11051,12172,13079,1984,Trinidad and Tobago,India,3,0,Friendly,Arima,Trinidad and Tobago,False,3,3,Trinidad and Tobago
11052,12173,13080,1984,France,Portugal,3,2,UEFA Euro,Marseille,France,False,5,1,France
11053,12174,13081,1984,Morocco,Senegal,2,1,Friendly,Casablanca,Morocco,False,3,1,Morocco
11054,12175,13082,1984,Denmark,Spain,1,1,UEFA Euro,Lyon,France,True,2,0,Draw
11055,12176,13083,1984,Honduras,Panama,1,0,FIFA World Cup qualification,Tegucigalpa,Honduras,False,1,1,Honduras
11056,12177,13085,1984,El Salvador,Guatemala,3,1,Friendly,San Salvador,El Salvador,False,4,2,El Salvador
11057,12178,13086,1984,France,Spain,2,0,UEFA Euro,Paris,France,False,2,2,France
11058,12179,13087,1984,Kenya,Cameroon,1,3,Friendly,Nairobi,Kenya,False,4,-2,Cameroon
11059,12180,13088,1984,Sierra Leone,Morocco,0,1,FIFA World Cup qualification,Freetown,Sierra Leone,False,1,-1,Morocco
11060,12181,13089,1984,Angola,Senegal,1,0,FIFA World Cup qualification,Luanda,Angola,False,1,1,Angola
11061,12182,13090,1984,Eswatini,Lesotho,3,1,Friendly,Lobamba,Eswatini,False,4,2,Eswatini
11062,12183,13091,1984,Zimbabwe,Zambia,2,1,Friendly,Harare,Zimbabwe,False,3,1,Zimbabwe
11063,12184,13092,1984,Egypt,Cameroon,2,1,Friendly,Cairo,Egypt,False,3,1,Egypt
11064,12185,13093,1984,Malawi,Kenya,2,1,Friendly,Blantyre,Malawi,False,3,1,Malawi
11065,12186,13094,1984,Malawi,Kenya,1,1,Friendly,Lilongwe,Malawi,False,2,0,Draw
11066,12187,13095,1984,Malawi,Kenya,2,1,Friendly,Mzuzu,Malawi,False,3,1,Malawi
11067,12188,13096,1984,Mauritius,Malawi,0,1,FIFA World Cup qualification,Curepipe,Mauritius,False,1,-1,Malawi
11068,12189,13097,1984,Morocco,Sierra Leone,4,0,FIFA World Cup qualification,Rabat,Morocco,False,4,4,Morocco
11069,12190,13098,1984,Senegal,Angola,1,0,FIFA World Cup qualification,Dakar,Senegal,False,1,1,Senegal
11070,12191,13099,1984,Zambia,Congo,2,1,Friendly,Lusaka,Zambia,False,3,1,Zambia
11071,12192,13100,1984,Uruguay,Argentina,1,0,Friendly,Montevideo,Uruguay,False,1,1,Uruguay
11072,12194,13102,1984,Guyana,Trinidad and Tobago,0,2,Friendly,Georgetown,Guyana,False,2,-2,Trinidad and Tobago
11073,12195,13103,1984,Zimbabwe,Uganda,1,0,Friendly,Harare,Zimbabwe,False,1,1,Zimbabwe
11074,12196,13104,1984,Mauritania,Gambia,0,0,Friendly,Nouakchott,Mauritania,False,0,0,Draw
11075,12197,13105,1984,Gambia,Guinea,1,1,Friendly,Nouakchott,Mauritania,True,2,0,Draw
11076,12198,13106,1984,Mauritania,Guinea,1,1,Friendly,Nouakchott,Mauritania,False,2,0,Draw
11077,12199,13107,1984,Benin,Congo,2,0,Friendly,Ouagadougou,Upper Volta,True,2,2,Benin
11078,12200,13108,1984,Malawi,Mauritius,4,0,FIFA World Cup qualification,Lilongwe,Malawi,False,4,4,Malawi
11079,12201,13109,1984,Trinidad and Tobago,Guyana,3,1,Friendly,San Fernando,Trinidad and Tobago,False,4,2,Trinidad and Tobago
11080,12202,13110,1984,El Salvador,Puerto Rico,5,0,FIFA World Cup qualification,San Salvador,El Salvador,False,5,5,El Salvador
11081,12203,13111,1984,Gambia,Guinea,0,1,Friendly,Nouakchott,Mauritania,True,1,-1,Guinea
11082,12205,13113,1984,Zambia,Uganda,3,0,FIFA World Cup qualification,Ndola,Zambia,False,3,3,Zambia
11083,12206,13114,1984,Ghana,Niger,1,0,Friendly,Bobo Dioulasso,Upper Volta,True,1,1,Ghana
11084,12207,13115,1984,Mauritania,Gambia,1,1,Friendly,Nouakchott,Mauritania,False,2,0,Draw
11085,12208,13116,1984,Mauritania,Guinea,0,2,Friendly,Nouakchott,Mauritania,False,2,-2,Guinea
11086,12210,13118,1984,Burkina Faso,Benin,3,1,Friendly,Ouagadougou,Upper Volta,False,4,2,Burkina Faso
11087,12211,13119,1984,Faroe Islands,Iceland,0,0,Friendly,Tórshavn,Faroe Islands,False,0,0,Draw
11088,12212,13120,1984,Argentina,Uruguay,0,0,Friendly,Buenos Aires,Argentina,False,0,0,Draw
11089,12213,13121,1984,Mauritania,Guinea,0,0,Friendly,Nouakchott,Mauritania,False,0,0,Draw
11090,12214,13122,1984,Burkina Faso,Ghana,0,2,Friendly,Ouagadougou,Upper Volta,False,2,-2,Ghana
11091,12215,13123,1984,Greenland,Iceland,0,1,Friendly,Fuglafjørður,Faroe Islands,True,1,-1,Iceland
11092,12216,13124,1984,Haiti,Antigua and Barbuda,4,0,FIFA World Cup qualification,Port-au-Prince,Haiti,False,4,4,Haiti
11093,12217,13125,1984,Tanzania,Uganda,0,1,African Cup of Nations qualification,Dar es Salaam,Tanzania,False,1,-1,Uganda
11094,12218,13126,1984,Faroe Islands,Greenland,1,0,Friendly,Klaksvík,Faroe Islands,False,1,1,Faroe Islands
11095,12219,13127,1984,Puerto Rico,El Salvador,0,3,FIFA World Cup qualification,San Juan,Puerto Rico,False,3,-3,El Salvador
11096,12220,13128,1984,Indonesia,Thailand,2,1,AFC Asian Cup qualification,Jakarta,Indonesia,False,3,1,Indonesia
11097,12221,13129,1984,Faroe Islands,Greenland,4,2,Friendly,Tórshavn,Faroe Islands,False,6,2,Faroe Islands
11098,12222,13130,1984,Haiti,Antigua and Barbuda,1,2,FIFA World Cup qualification,Port-au-Prince,Haiti,False,3,-1,Antigua and Barbuda
11099,12223,13131,1984,Iran,Bangladesh,5,0,AFC Asian Cup qualification,Jakarta,Indonesia,True,5,5,Iran
11100,12224,13132,1984,Syria,Philippines,2,0,AFC Asian Cup qualification,Jakarta,Indonesia,True,2,2,Syria
11101,12225,13133,1984,Republic of Ireland,Mexico,0,0,Friendly,Dublin,Republic of Ireland,False,0,0,Draw
11102,12226,13134,1984,Indonesia,Bangladesh,2,1,AFC Asian Cup qualification,Jakarta,Indonesia,False,3,1,Indonesia
11103,12227,13135,1984,Iran,Syria,3,1,AFC Asian Cup qualification,Solo,Indonesia,True,4,2,Iran
11104,12228,13136,1984,Peru,Colombia,0,0,Friendly,Lima,Peru,False,0,0,Draw
11105,12229,13137,1984,Thailand,Philippines,3,0,AFC Asian Cup qualification,Jakarta,Indonesia,True,3,3,Thailand
11106,12230,13139,1984,Indonesia,Philippines,1,0,AFC Asian Cup qualification,Solo,Indonesia,False,1,1,Indonesia
11107,12231,13140,1984,Iran,Thailand,5,0,AFC Asian Cup qualification,Jakarta,Indonesia,True,5,5,Iran
11108,12232,13141,1984,Syria,Bangladesh,2,1,AFC Asian Cup qualification,Jakarta,Indonesia,True,3,1,Syria
11109,12233,13142,1984,Malaysia,Singapore,1,0,Friendly,Kuala Lumpur,Malaysia,False,1,1,Malaysia
11110,12234,13143,1984,Bangladesh,Philippines,3,2,AFC Asian Cup qualification,Solo,Indonesia,True,5,1,Bangladesh
11111,12235,13144,1984,Indonesia,Iran,0,1,AFC Asian Cup qualification,Jakarta,Indonesia,False,1,-1,Iran
11112,12236,13145,1984,Syria,Thailand,2,3,AFC Asian Cup qualification,Jakarta,Indonesia,True,5,-1,Thailand
11113,12237,13146,1984,Indonesia,Syria,1,2,AFC Asian Cup qualification,Jakarta,Indonesia,False,3,-1,Syria
11114,12238,13147,1984,Iran,Philippines,7,1,AFC Asian Cup qualification,Jakarta,Indonesia,True,8,6,Iran
11115,12239,13148,1984,Suriname,Guyana,1,0,FIFA World Cup qualification,Paramaribo,Suriname,False,1,1,Suriname
11116,12240,13149,1984,Thailand,Bangladesh,2,1,AFC Asian Cup qualification,Solo,Indonesia,True,3,1,Thailand
11117,12241,13150,1984,Finland,Mexico,0,3,Friendly,Helsinki,Finland,False,3,-3,Mexico
11118,12242,13151,1984,Iran,Syria,1,0,Friendly,Jakarta,Indonesia,True,1,1,Iran
11119,12243,13152,1984,Singapore,Malaysia,1,1,Friendly,Kallang,Singapore,False,2,0,Draw
11120,12244,13153,1984,Uganda,Tanzania,1,3,African Cup of Nations qualification,Kampala,Uganda,False,4,-2,Tanzania
11121,12245,13154,1984,Russia,Mexico,3,0,Friendly,Leningrad,Soviet Union,False,3,3,Russia
11122,12246,13155,1984,Hungary,Switzerland,3,0,Friendly,Budapest,Hungary,False,3,3,Hungary
11123,12247,13156,1984,Indonesia,Thailand,5,1,Merdeka Tournament,Kuala Lumpur,Malaysia,True,6,4,Indonesia
11124,12248,13157,1984,Sweden,Mexico,1,1,Friendly,Malmö,Sweden,False,2,0,Draw
11125,12249,13158,1984,Colombia,Argentina,1,0,Friendly,Bogotá,Colombia,False,1,1,Colombia
11126,12250,13159,1984,Malaysia,Thailand,1,0,Merdeka Tournament,Kuala Lumpur,Malaysia,False,1,1,Malaysia
11127,12251,13160,1984,Hungary,Mexico,0,2,Friendly,Budapest,Hungary,False,2,-2,Mexico
11128,12252,13161,1984,Liberia,Papua New Guinea,1,2,Merdeka Tournament,Kuala Lumpur,Malaysia,True,3,-1,Papua New Guinea
11129,12253,13162,1984,Uganda,Zambia,1,0,FIFA World Cup qualification,Kampala,Uganda,False,1,1,Uganda
11130,12254,13163,1984,Malaysia,Indonesia,2,2,Merdeka Tournament,Kuala Lumpur,Malaysia,False,4,0,Draw
11131,12255,13164,1984,Egypt,Zimbabwe,1,0,FIFA World Cup qualification,Cairo,Egypt,False,1,1,Egypt
11132,12256,13166,1984,Guyana,Suriname,1,1,FIFA World Cup qualification,Georgetown,Guyana,False,2,0,Draw
11133,12257,13167,1984,Malaysia,Liberia,3,1,Merdeka Tournament,Kota Bharu,Malaysia,False,4,2,Malaysia
11134,12258,13168,1984,Norway,Poland,1,1,Friendly,Drammen,Norway,False,2,0,Draw
11135,12259,13169,1984,Thailand,Papua New Guinea,1,4,Merdeka Tournament,Kuala Lumpur,Malaysia,True,5,-3,Papua New Guinea
11136,12260,13170,1984,Cyprus,Greece,0,2,Friendly,Limassol,Cyprus,False,2,-2,Greece
11137,12261,13171,1984,Indonesia,Papua New Guinea,0,1,Merdeka Tournament,Kuala Lumpur,Malaysia,True,1,-1,Papua New Guinea
11138,12262,13172,1984,Liberia,Thailand,2,1,Merdeka Tournament,Kuala Lumpur,Malaysia,True,3,1,Liberia
11139,12263,13173,1984,Switzerland,Argentina,0,2,Friendly,Berne,Switzerland,False,2,-2,Argentina
11140,12264,13174,1984,Indonesia,Liberia,1,2,Merdeka Tournament,Johor Baharu,Malaysia,True,3,-1,Liberia
11141,12265,13175,1984,Malaysia,Papua New Guinea,5,1,Merdeka Tournament,Kuala Lumpur,Malaysia,False,6,4,Malaysia
11142,12266,13176,1984,Singapore,Qatar,0,1,Friendly,Kallang,Singapore,False,1,-1,Qatar
11143,12267,13177,1984,Belgium,Argentina,0,2,Friendly,Brussels,Belgium,False,2,-2,Argentina
11144,12269,13179,1984,Israel,Malta,2,1,Friendly,Jerusalem,Israel,False,3,1,Israel
11145,12270,13180,1984,Jordan,Hong Kong,1,1,AFC Asian Cup qualification,Guangzhou,China PR,True,2,0,Draw
11146,12271,13181,1984,Qatar,Afghanistan,8,0,AFC Asian Cup qualification,Guangzhou,China PR,True,8,8,Qatar
11147,12272,13183,1984,Denmark,Austria,3,1,Friendly,Copenhagen,Denmark,False,4,2,Denmark
11148,12274,13185,1984,Finland,Poland,0,2,Friendly,Helsinki,Finland,False,2,-2,Poland
11149,12275,13187,1984,Germany,Argentina,1,3,Friendly,Düsseldorf,Germany,False,4,-2,Argentina
11150,12276,13188,1984,Iceland,Wales,1,0,FIFA World Cup qualification,Reykjavík,Iceland,False,1,1,Iceland
11151,12277,13189,1984,Republic of Ireland,Russia,1,0,FIFA World Cup qualification,Dublin,Republic of Ireland,False,1,1,Republic of Ireland
11152,12278,13190,1984,Northern Ireland,Romania,3,2,FIFA World Cup qualification,Belfast,Northern Ireland,False,5,1,Northern Ireland
11153,12279,13191,1984,Norway,Switzerland,0,1,FIFA World Cup qualification,Oslo,Norway,False,1,-1,Switzerland
11154,12280,13192,1984,Qatar,Hong Kong,1,0,AFC Asian Cup qualification,Guangzhou,China PR,True,1,1,Qatar
11155,12282,13194,1984,Sweden,Portugal,0,1,FIFA World Cup qualification,Solna,Sweden,False,1,-1,Portugal
11156,12283,13196,1984,Hong Kong,Afghanistan,0,0,AFC Asian Cup qualification,Guangzhou,China PR,True,0,0,Draw
11157,12284,13197,1984,Mauritius,Mozambique,0,0,African Cup of Nations qualification,Curepipe,Mauritius,False,0,0,Draw
11158,12285,13199,1984,Qatar,Jordan,2,0,AFC Asian Cup qualification,Guangzhou,China PR,True,2,2,Qatar
11159,12286,13200,1984,Mexico,Argentina,1,1,Friendly,Monterrey,Mexico,False,2,0,Draw
11160,12287,13201,1984,Uruguay,Peru,2,0,Friendly,Montevideo,Uruguay,False,2,2,Uruguay
11161,12288,13203,1984,Jordan,Afghanistan,6,1,AFC Asian Cup qualification,Guangzhou,China PR,True,7,5,Jordan
11162,12289,13204,1984,Ghana,Gambia,3,1,Friendly,Accra,Ghana,False,4,2,Ghana
11163,12290,13205,1984,Niger,Ivory Coast,1,3,Friendly,Niamey,Niger,False,4,-2,Ivory Coast
11164,12291,13206,1984,Saudi Arabia,Iceland,1,2,Friendly,Khobar,Saudi Arabia,False,3,-1,Iceland
11165,12292,13207,1984,Denmark,Norway,1,0,FIFA World Cup qualification,Copenhagen,Denmark,False,1,1,Denmark
11166,12293,13208,1984,Hungary,Austria,3,1,FIFA World Cup qualification,Budapest,Hungary,False,4,2,Hungary
11167,12294,13209,1984,Italy,Sweden,1,0,Friendly,Milan,Italy,False,1,1,Italy
11168,12295,13210,1984,Poland,Turkey,2,0,Friendly,Słupsk,Poland,False,2,2,Poland
11169,12296,13211,1984,Tunisia,Nigeria,5,0,Friendly,Tunis,Tunisia,False,5,5,Tunisia
11170,12297,13212,1984,Curaçao,United States,0,0,FIFA World Cup qualification,Willemstad,Netherlands Antilles,True,0,0,Draw
11171,12298,13214,1984,Botswana,Angola,1,3,Friendly,Gaborone,Botswana,False,4,-2,Angola
11172,12299,13216,1984,Mozambique,Mauritius,3,0,African Cup of Nations qualification,Maputo,Mozambique,False,3,3,Mozambique
11173,12300,13217,1984,Zimbabwe,Egypt,1,1,FIFA World Cup qualification,Harare,Zimbabwe,False,2,0,Draw
11174,12301,13218,1984,Honduras,Guatemala,1,0,Friendly,Tegucigalpa,Honduras,False,1,1,Honduras
11175,12302,13219,1984,Peru,Uruguay,1,3,Friendly,Lima,Peru,False,4,-2,Uruguay
11176,12303,13221,1984,United States,Curaçao,4,0,FIFA World Cup qualification,St. Louis,United States,False,4,4,United States
11177,12304,13222,1984,Saudi Arabia,Thailand,2,1,Friendly,Jeddah,Saudi Arabia,False,3,1,Saudi Arabia
11178,12305,13223,1984,Greece,Israel,2,2,Friendly,Athens,Greece,False,4,0,Draw
11179,12306,13224,1984,Mexico,Colombia,1,0,Friendly,Los Angeles,United States,True,1,1,Mexico
11180,12307,13225,1984,United States,El Salvador,3,1,Friendly,Los Angeles,United States,False,4,2,United States
11181,12308,13228,1984,Norway,Russia,1,1,FIFA World Cup qualification,Oslo,Norway,False,2,0,Draw
11182,12309,13229,1984,Saudi Arabia,Thailand,1,3,Friendly,Jeddah,Saudi Arabia,False,4,-2,Thailand
11183,12310,13230,1984,El Salvador,Mexico,0,1,Friendly,Los Angeles,United States,True,1,-1,Mexico
11184,12311,13231,1984,Ivory Coast,Liberia,3,0,Friendly,Abidjan,Ivory Coast,False,3,3,Ivory Coast
11185,12312,13232,1984,Malaysia,Pakistan,5,0,AFC Asian Cup qualification,Calcutta,India,True,5,5,Malaysia
11186,12313,13233,1984,United States,Colombia,1,0,Friendly,Los Angeles,United States,False,1,1,United States
11187,12314,13234,1984,India,Yemen,4,0,AFC Asian Cup qualification,Calcutta,India,False,4,4,India
11188,12315,13235,1984,Kenya,Ethiopia,2,1,FIFA World Cup qualification,Nairobi,Kenya,False,3,1,Kenya
11189,12316,13237,1984,Luxembourg,France,0,4,FIFA World Cup qualification,Luxembourg,Luxembourg,False,4,-4,France
11190,12317,13238,1984,Tanzania,Sudan,1,1,FIFA World Cup qualification,Mwanza,Tanzania,False,2,0,Draw
11191,12318,13239,1984,Guatemala,United States,4,0,Friendly,Guatemala,Guatemala,False,4,4,Guatemala
11192,12319,13240,1984,India,Malaysia,2,1,AFC Asian Cup qualification,Calcutta,India,False,3,1,India
11193,12321,13242,1984,Zimbabwe,Eswatini,3,0,African Cup of Nations qualification,Bulawayo,Zimbabwe,False,3,3,Zimbabwe
11194,12322,13243,1984,Congo,Benin,0,2,Friendly,Brazzaville,Congo,False,2,-2,Benin
11195,12323,13244,1984,Pakistan,Yemen,4,1,AFC Asian Cup qualification,Calcutta,India,True,5,3,Pakistan
11196,12324,13245,1984,Algeria,Canada,1,0,Friendly,Algiers,Algeria,False,1,1,Algeria
11197,12325,13247,1984,Northern Ireland,Israel,3,0,Friendly,Belfast,Northern Ireland,False,3,3,Northern Ireland
11198,12326,13248,1984,Turkey,Bulgaria,0,0,Friendly,Istanbul,Turkey,False,0,0,Draw
11199,12327,13249,1984,Belgium,Albania,3,1,FIFA World Cup qualification,Brussels,Belgium,False,4,2,Belgium
11200,12328,13250,1984,England,Finland,5,0,FIFA World Cup qualification,London,England,False,5,5,England
11201,12329,13251,1984,Germany,Sweden,2,0,FIFA World Cup qualification,Cologne,Germany,False,2,2,Germany
11202,12330,13252,1984,India,Pakistan,2,0,AFC Asian Cup qualification,Calcutta,India,False,2,2,India
11203,12331,13253,1984,Mexico,United States,2,1,Friendly,Nezahualcóyotl,Mexico,False,3,1,Mexico
11204,12332,13254,1984,Netherlands,Hungary,1,2,FIFA World Cup qualification,Rotterdam,Netherlands,False,3,-1,Hungary
11205,12333,13255,1984,Norway,Republic of Ireland,1,0,FIFA World Cup qualification,Oslo,Norway,False,1,1,Norway
11206,12334,13256,1984,Poland,Greece,3,1,FIFA World Cup qualification,Zabrze,Poland,False,4,2,Poland
11207,12335,13257,1984,Scotland,Iceland,3,0,FIFA World Cup qualification,Glasgow,Scotland,False,3,3,Scotland
11208,12336,13258,1984,Spain,Wales,3,0,FIFA World Cup qualification,Seville,Spain,False,3,3,Spain
11209,12337,13259,1984,Switzerland,Denmark,1,0,FIFA World Cup qualification,Berne,Switzerland,False,1,1,Switzerland
11210,12338,13260,1984,Fiji,New Zealand,1,2,Friendly,Lautoka,Fiji,False,3,-1,New Zealand
11211,12339,13261,1984,Malaysia,Yemen,4,1,AFC Asian Cup qualification,Calcutta,India,True,5,3,Malaysia
11212,12341,13263,1984,Saudi Arabia,Nepal,7,0,AFC Asian Cup qualification,Jeddah,Saudi Arabia,False,7,7,Saudi Arabia
11213,12342,13264,1984,Fiji,New Zealand,1,1,Friendly,Suva,Fiji,False,2,0,Draw
11214,12343,13266,1984,Nigeria,Liberia,3,0,FIFA World Cup qualification,Lagos,Nigeria,False,3,3,Nigeria
11215,12344,13267,1984,Oman,Sri Lanka,1,1,AFC Asian Cup qualification,Jeddah,Saudi Arabia,True,2,0,Draw
11216,12345,13268,1984,Ivory Coast,Gambia,4,0,FIFA World Cup qualification,Abidjan,Ivory Coast,False,4,4,Ivory Coast
11217,12346,13269,1984,Tunisia,Canada,2,0,Friendly,Tunis,Tunisia,False,2,2,Tunisia
11218,12347,13270,1984,Saudi Arabia,United Arab Emirates,1,0,AFC Asian Cup qualification,Jeddah,Saudi Arabia,False,1,1,Saudi Arabia
11219,12348,13271,1984,Sri Lanka,Nepal,4,0,AFC Asian Cup qualification,Jeddah,Saudi Arabia,True,4,4,Sri Lanka
11220,12349,13272,1984,Morocco,Canada,3,2,Friendly,Rabat,Morocco,False,5,1,Morocco
11221,12350,13273,1984,Saudi Arabia,Sri Lanka,5,0,AFC Asian Cup qualification,Jeddah,Saudi Arabia,False,5,5,Saudi Arabia
11222,12351,13274,1984,United Arab Emirates,Oman,8,0,AFC Asian Cup qualification,Jeddah,Saudi Arabia,True,8,8,United Arab Emirates
11223,12352,13275,1984,Argentina,Mexico,1,1,Friendly,Buenos Aires,Argentina,False,2,0,Draw
11224,12353,13276,1984,Saudi Arabia,Oman,6,0,AFC Asian Cup qualification,Jeddah,Saudi Arabia,False,6,6,Saudi Arabia
11225,12354,13277,1984,United Arab Emirates,Nepal,11,0,AFC Asian Cup qualification,Jeddah,Saudi Arabia,True,11,11,United Arab Emirates
11226,12355,13278,1984,Sudan,Tanzania,0,0,FIFA World Cup qualification,Khartoum,Sudan,False,0,0,Draw
11227,12356,13279,1984,Benin,Tunisia,0,2,FIFA World Cup qualification,Cotonou,Benin,False,2,-2,Tunisia
11228,12357,13280,1984,Chile,Mexico,1,0,Friendly,Santiago,Chile,False,1,1,Chile
11229,12358,13281,1984,Ethiopia,Kenya,3,3,FIFA World Cup qualification,Addis Abeba,Ethiopia,False,6,0,Draw
11230,12359,13282,1984,Oman,Nepal,8,0,AFC Asian Cup qualification,Jeddah,Saudi Arabia,True,8,8,Oman
11231,12360,13283,1984,United Arab Emirates,Sri Lanka,5,1,AFC Asian Cup qualification,Jeddah,Saudi Arabia,True,6,4,United Arab Emirates
11232,12361,13285,1984,Poland,Albania,2,2,FIFA World Cup qualification,Mielec,Poland,False,4,0,Draw
11233,12362,13286,1984,Turkey,Finland,1,2,FIFA World Cup qualification,Antalya,Turkey,False,3,-1,Finland
11234,12363,13287,1984,Uruguay,Mexico,1,1,Friendly,Montevideo,Uruguay,False,2,0,Draw
11235,12364,13288,1984,Egypt,Canada,1,0,Friendly,Cairo,Egypt,False,1,1,Egypt
11236,12365,13290,1984,Switzerland,Italy,1,1,Friendly,Lausanne,Switzerland,False,2,0,Draw
11237,12366,13291,1984,Gambia,Ivory Coast,3,2,FIFA World Cup qualification,Bakau,Gambia,False,5,1,Gambia
11238,12367,13292,1984,Liberia,Nigeria,0,1,FIFA World Cup qualification,Monrovia,Liberia,False,1,-1,Nigeria
11239,12368,13293,1984,Eswatini,Zimbabwe,1,5,African Cup of Nations qualification,Mbabane,Eswatini,False,6,-4,Zimbabwe
11240,12369,13294,1984,Guyana,Suriname,1,1,Friendly,Georgetown,Guyana,False,2,0,Draw
11241,12370,13295,1984,Somalia,Kenya,1,0,African Cup of Nations qualification,Mogadishu,Somalia,False,1,1,Somalia
11242,12371,13296,1984,Angola,Congo,1,0,Friendly,Luanda,Angola,False,1,1,Angola
11243,12372,13297,1984,Burkina Faso,Mali,1,0,Friendly,Ouagadougou,Burkina Faso,False,1,1,Burkina Faso
11244,12373,13298,1984,DR Congo,Gabon,2,0,African Cup of Nations qualification,Kinshasa,Zaïre,False,2,2,DR Congo
11245,12374,13299,1984,Guyana,Suriname,1,1,Friendly,Georgetown,Guyana,False,2,0,Draw
11246,12375,13300,1984,Liberia,Mauritania,3,1,African Cup of Nations qualification,Monrovia,Liberia,False,4,2,Liberia
11247,12376,13301,1984,Trinidad and Tobago,Mexico,0,2,Friendly,Port of Spain,Trinidad and Tobago,False,2,-2,Mexico
11248,12377,13302,1984,Tunisia,Benin,4,0,FIFA World Cup qualification,Tunis,Tunisia,False,4,4,Tunisia
11249,12378,13303,1984,Austria,Netherlands,1,0,FIFA World Cup qualification,Vienna,Austria,False,1,1,Austria
11250,12379,13304,1984,Denmark,Republic of Ireland,3,0,FIFA World Cup qualification,Copenhagen,Denmark,False,3,3,Denmark
11251,12380,13305,1984,Northern Ireland,Finland,2,1,FIFA World Cup qualification,Belfast,Northern Ireland,False,3,1,Northern Ireland
11252,12381,13306,1984,Portugal,Sweden,1,3,FIFA World Cup qualification,Lisbon,Portugal,False,4,-2,Sweden
11253,12382,13307,1984,Scotland,Spain,3,1,FIFA World Cup qualification,Glasgow,Scotland,False,4,2,Scotland
11254,12383,13308,1984,Turkey,England,0,8,FIFA World Cup qualification,Istanbul,Turkey,False,8,-8,England
11255,12384,13309,1984,Wales,Iceland,2,1,FIFA World Cup qualification,Cardiff,Wales,False,3,1,Wales
11256,12385,13310,1984,Burkina Faso,Togo,1,1,West African Cup,Ouagadougou,Burkina Faso,False,2,0,Draw
11257,12386,13311,1984,Cyprus,Hungary,1,2,FIFA World Cup qualification,Limassol,Cyprus,False,3,-1,Hungary
11258,12388,13313,1984,Malawi,Zimbabwe,3,0,Friendly,Lilongwe,Malawi,False,3,3,Malawi
11259,12389,13314,1984,Gambia,Sierra Leone,3,2,African Cup of Nations qualification,Banjul,Gambia,False,5,1,Gambia
11260,12390,13315,1984,Ghana,Ivory Coast,2,0,West African Cup,Ouagadougou,Burkina Faso,True,2,2,Ghana
11261,12391,13316,1984,Mali,Benin,1,0,African Cup of Nations qualification,Bamako,Mali,False,1,1,Mali
11262,12392,13317,1984,Malawi,Zimbabwe,1,0,Friendly,Blantyre,Malawi,False,1,1,Malawi
11263,12393,13318,1984,Burkina Faso,Ivory Coast,2,2,West African Cup,Ouagadougou,Burkina Faso,False,4,0,Draw
11264,12394,13319,1984,Saudi Arabia,Finland,2,1,Friendly,Jubail,Saudi Arabia,False,3,1,Saudi Arabia
11265,12395,13320,1984,France,Bulgaria,1,0,FIFA World Cup qualification,Paris,France,False,1,1,France
11266,12396,13321,1984,Ghana,Togo,2,2,West African Cup,Ouagadougou,Burkina Faso,True,4,0,Draw
11267,12397,13322,1984,Israel,Romania,1,1,Friendly,Petah Tikva,Israel,False,2,0,Draw
11268,12398,13323,1984,Burkina Faso,Benin,2,1,West African Cup,Ouagadougou,Burkina Faso,False,3,1,Burkina Faso
11269,12399,13324,1984,Qatar,Finland,2,2,Friendly,Doha,Qatar,False,4,0,Draw
11270,12400,13325,1984,Ivory Coast,Togo,1,1,West African Cup,Ouagadougou,Burkina Faso,True,2,0,Draw
11271,12401,13326,1984,Kenya,Somalia,1,0,African Cup of Nations qualification,Nairobi,Kenya,False,1,1,Kenya
11272,12402,13327,1984,Benin,Ivory Coast,1,2,West African Cup,Ouagadougou,Burkina Faso,True,3,-1,Ivory Coast
11273,12403,13328,1984,Burkina Faso,Ghana,1,1,West African Cup,Ouagadougou,Burkina Faso,False,2,0,Draw
11274,12404,13329,1984,Qatar,Finland,1,1,Friendly,Doha,Qatar,False,2,0,Draw
11275,12405,13330,1984,Benin,Togo,0,2,West African Cup,Ouagadougou,Burkina Faso,True,2,-2,Togo
11276,12406,13331,1984,Gabon,DR Congo,1,1,African Cup of Nations qualification,Libreville,Gabon,False,2,0,Draw
11277,12407,13332,1984,United Arab Emirates,Syria,2,1,Friendly,Abu Dhabi,United Arab Emirates,False,3,1,United Arab Emirates
11278,12408,13333,1984,Benin,Ghana,1,3,West African Cup,Ouagadougou,Burkina Faso,True,4,-2,Ghana
11279,12409,13334,1984,Burkina Faso,Ivory Coast,0,2,West African Cup,Ouagadougou,Burkina Faso,False,2,-2,Ivory Coast
11280,12410,13335,1984,Ghana,Togo,1,1,West African Cup,Ouagadougou,Burkina Faso,True,2,0,Draw
11281,12411,13336,1984,United States,Ecuador,0,0,Friendly,Hempstead,United States,False,0,0,Draw
11282,12412,13337,1984,Iran,United Arab Emirates,3,0,AFC Asian Cup,Kallang,Singapore,True,3,3,Iran
11283,12413,13338,1984,Qatar,Syria,1,1,AFC Asian Cup,Kallang,Singapore,True,2,0,Draw
11284,12414,13339,1984,Uganda,Tanzania,1,1,CECAFA Cup,Kampala,Uganda,False,2,0,Draw
11285,12415,13340,1984,Benin,Mali,2,2,African Cup of Nations qualification,Cotonou,Benin,False,4,0,Draw
11286,12416,13341,1984,Dominica,Grenada,0,4,Windward Islands Tournament,Castries,Saint Lucia,True,4,-4,Grenada
11287,12417,13342,1984,Kenya,Malawi,1,2,CECAFA Cup,Mbale,Uganda,True,3,-1,Malawi
11288,12419,13344,1984,Sierra Leone,Gambia,2,0,African Cup of Nations qualification,Freetown,Sierra Leone,False,2,2,Sierra Leone
11289,12420,13345,1984,Singapore,India,2,0,AFC Asian Cup,Kallang,Singapore,False,2,2,Singapore
11290,12421,13346,1984,Saint Lucia,Saint Vincent and the Grenadines,2,0,Windward Islands Tournament,Castries,Saint Lucia,False,2,2,Saint Lucia
11291,12422,13347,1984,United States,Ecuador,2,2,Friendly,Miami,United States,False,4,0,Draw
11292,12423,13348,1984,Zambia,Zimbabwe,2,0,CECAFA Cup,Kampala,Uganda,True,2,2,Zambia
11293,12424,13350,1984,Kuwait,Qatar,1,0,AFC Asian Cup,Kallang,Singapore,True,1,1,Kuwait
11294,12426,13352,1984,El Salvador,Guatemala,2,1,Friendly,Los Angeles,United States,True,3,1,El Salvador
11295,12427,13353,1984,Mexico,Ecuador,3,2,Friendly,Los Angeles,United States,True,5,1,Mexico
11296,12428,13354,1984,Syria,Saudi Arabia,0,1,AFC Asian Cup,Kallang,Singapore,True,1,-1,Saudi Arabia
11297,12429,13355,1984,Uganda,Zimbabwe,4,1,CECAFA Cup,Kampala,Uganda,False,5,3,Uganda
11298,12430,13356,1984,United Arab Emirates,India,2,0,AFC Asian Cup,Kallang,Singapore,True,2,2,United Arab Emirates
11299,12431,13357,1984,Bulgaria,Luxembourg,4,0,FIFA World Cup qualification,Sofia,Bulgaria,False,4,4,Bulgaria
11300,12432,13358,1984,Greece,Romania,2,1,Friendly,Athens,Greece,False,3,1,Greece
11301,12433,13360,1984,Malawi,Somalia,1,0,CECAFA Cup,Mbale,Uganda,True,1,1,Malawi
11302,12435,13362,1984,Tanzania,Zambia,1,2,CECAFA Cup,Kampala,Uganda,True,3,-1,Zambia
11303,12437,13364,1984,Honduras,Ecuador,0,0,Friendly,Tegucigalpa,Honduras,False,0,0,Draw
11304,12438,13365,1984,Iran,India,0,0,AFC Asian Cup,Kallang,Singapore,True,0,0,Draw
11305,12440,13367,1984,Uganda,Zambia,1,1,CECAFA Cup,Kampala,Uganda,False,2,0,Draw
11306,12442,13369,1984,Italy,Poland,2,0,Friendly,Pescara,Italy,False,2,2,Italy
11307,12443,13370,1984,Kenya,Somalia,1,1,CECAFA Cup,Mbale,Uganda,True,2,0,Draw
11308,12444,13371,1984,Qatar,Saudi Arabia,1,1,AFC Asian Cup,Kallang,Singapore,True,2,0,Draw
11309,12445,13372,1984,Singapore,United Arab Emirates,0,1,AFC Asian Cup,Kallang,Singapore,False,1,-1,United Arab Emirates
11310,12446,13373,1984,Tanzania,Zimbabwe,2,2,CECAFA Cup,Kampala,Uganda,True,4,0,Draw
11311,12447,13374,1984,Congo,Equatorial Guinea,5,0,UDEAC Cup,Brazzaville,Congo,False,5,5,Congo
11312,12448,13375,1984,Guatemala,Ecuador,1,0,Friendly,Guatemala,Guatemala,False,1,1,Guatemala
11313,12450,13377,1984,Ivory Coast,Guinea,2,2,Friendly,Abidjan,Ivory Coast,False,4,0,Draw
11314,12451,13378,1984,Kuwait,Syria,3,1,AFC Asian Cup,Kallang,Singapore,True,4,2,Kuwait
11315,12453,13380,1984,Chad,Cameroon,0,2,UDEAC Cup,Brazzaville,Congo,True,2,-2,Cameroon
11316,12454,13382,1984,Singapore,Iran,1,1,AFC Asian Cup,Kallang,Singapore,False,2,0,Draw
11317,12455,13384,1984,Saudi Arabia,Kuwait,1,0,AFC Asian Cup,Kallang,Singapore,True,1,1,Saudi Arabia
11318,12456,13385,1984,Chad,Gabon,3,3,UDEAC Cup,Brazzaville,Congo,True,6,0,Draw
11319,12457,13386,1984,Congo,Central African Republic,2,1,UDEAC Cup,Brazzaville,Congo,False,3,1,Congo
11320,12458,13387,1984,El Salvador,Ecuador,0,0,Friendly,San Salvador,El Salvador,False,0,0,Draw
11321,12459,13388,1984,Kenya,Zambia,0,2,CECAFA Cup,Kampala,Uganda,True,2,-2,Zambia
11322,12460,13389,1984,Uganda,Malawi,0,2,CECAFA Cup,Mbale,Uganda,False,2,-2,Malawi
11323,12461,13390,1984,Saudi Arabia,Iran,1,1,AFC Asian Cup,Kallang,Singapore,True,2,0,Draw
11324,12462,13391,1984,Cameroon,Gabon,0,0,UDEAC Cup,Brazzaville,Congo,True,0,0,Draw
11325,12463,13392,1984,Central African Republic,Equatorial Guinea,1,1,UDEAC Cup,Brazzaville,Congo,True,2,0,Draw
11326,12465,13394,1984,Malawi,Zambia,0,0,CECAFA Cup,Kampala,Uganda,True,0,0,Draw
11327,12466,13395,1984,Uganda,Kenya,3,1,CECAFA Cup,Kampala,Uganda,False,4,2,Uganda
11328,12467,13396,1984,Chad,Equatorial Guinea,1,1,UDEAC Cup,Brazzaville,Congo,True,2,0,Draw
11329,12468,13397,1984,Guatemala,Honduras,1,0,Friendly,Guatemala,Guatemala,False,1,1,Guatemala
11330,12469,13398,1984,Iran,Kuwait,1,1,AFC Asian Cup,Kallang,Singapore,True,2,0,Draw
11331,12470,13399,1984,Malta,Germany,2,3,FIFA World Cup qualification,Attard,Malta,False,5,-1,Germany
11332,12472,13401,1984,Central African Republic,Cameroon,1,7,UDEAC Cup,Brazzaville,Congo,True,8,-6,Cameroon
11333,12473,13402,1984,Congo,Gabon,3,0,UDEAC Cup,Brazzaville,Congo,False,3,3,Congo
11334,12474,13403,1984,Cyprus,Luxembourg,1,0,Friendly,Nicosia,Cyprus,False,1,1,Cyprus
11335,12475,13404,1984,Egypt,Norway,0,1,Friendly,Cairo,Egypt,False,1,-1,Norway
11336,12476,13405,1984,Central African Republic,Gabon,2,2,UDEAC Cup,Brazzaville,Congo,True,4,0,Draw
11337,12477,13406,1984,Greece,Belgium,0,0,FIFA World Cup qualification,Athens,Greece,False,0,0,Draw
11338,12478,13407,1984,Israel,Luxembourg,2,0,Friendly,Petah Tikva,Israel,False,2,2,Israel
11339,12479,13408,1984,Congo,Cameroon,2,2,UDEAC Cup,Brazzaville,Congo,False,4,0,Draw
11340,12480,13409,1984,Egypt,Norway,0,1,Friendly,Ismailia,Egypt,False,1,-1,Norway
11341,12481,13410,1984,Albania,Belgium,2,0,FIFA World Cup qualification,Tirana,Albania,False,2,2,Albania
11342,12482,13411,1984,Turkey,Luxembourg,1,0,Friendly,Istanbul,Turkey,False,1,1,Turkey
11343,12483,13412,1984,Cyprus,Netherlands,0,1,FIFA World Cup qualification,Nicosia,Cyprus,False,1,-1,Netherlands
11344,12484,13413,1984,Guatemala,El Salvador,2,0,Friendly,Guatemala,Guatemala,False,2,2,Guatemala
11345,12485,13414,1984,Algeria,Ghana,1,2,Friendly,Abidjan,Ivory Coast,True,3,-1,Ghana
11346,12486,13415,1984,Ivory Coast,Tunisia,3,1,Friendly,Abidjan,Ivory Coast,False,4,2,Ivory Coast
11347,12487,13416,1984,Algeria,Tunisia,3,1,Friendly,Abidjan,Ivory Coast,True,4,2,Algeria
11348,12488,13417,1984,Ivory Coast,Ghana,2,0,Friendly,Abidjan,Ivory Coast,False,2,2,Ivory Coast
11349,12489,13418,1985,Ghana,Tunisia,0,2,Friendly,Abidjan,Ivory Coast,True,2,-2,Tunisia
11350,12490,13419,1985,Ivory Coast,Algeria,1,1,Friendly,Abidjan,Ivory Coast,False,2,0,Draw
11351,12491,13420,1985,Libya,Morocco,0,0,Friendly,Tripoli,Libya,False,0,0,Draw
11352,12492,13421,1985,Israel,Greece,0,2,Friendly,Jaffa,Israel,False,2,-2,Greece
11353,12493,13422,1985,Barbados,Saint Lucia,4,1,Friendly,Bridgetown,Barbados,False,5,3,Barbados
11354,12495,13424,1985,Guyana,Cuba,2,1,Friendly,Georgetown,Guyana,False,3,1,Guyana
11355,12497,13427,1985,Spain,Finland,3,1,Friendly,Alicante,Spain,False,4,2,Spain
11356,12499,13429,1985,Guyana,Cuba,1,1,Friendly,Georgetown,Guyana,False,2,0,Draw
11357,12500,13430,1985,Honduras,Denmark,1,0,Friendly,Tegucigalpa,Honduras,False,1,1,Honduras
11358,12501,13431,1985,Iran,Russia,0,2,Nehru Cup,Ernakulam,India,True,2,-2,Russia
11359,12502,13433,1985,Germany,Hungary,0,1,Friendly,Hamburg,Germany,False,1,-1,Hungary
11360,12504,13435,1985,Portugal,Romania,2,3,Friendly,Lisbon,Portugal,False,5,-1,Romania
11361,12505,13436,1985,India,Morocco,0,1,Nehru Cup,Ernakulam,India,False,1,-1,Morocco
11362,12506,13437,1985,Ivory Coast,Egypt,0,1,Friendly,Abidjan,Ivory Coast,False,1,-1,Egypt
11363,12507,13438,1985,Colombia,Switzerland,2,2,Friendly,Bogotá,Colombia,False,4,0,Draw
11364,12508,13439,1985,Morocco,Russia,0,1,Nehru Cup,Ernakulam,India,True,1,-1,Russia
11365,12509,13440,1985,Zimbabwe,Zambia,1,1,Friendly,Gweru,Zimbabwe,False,2,0,Draw
11366,12511,13442,1985,Cameroon,Egypt,1,0,Friendly,Douala,Cameroon,False,1,1,Cameroon
11367,12512,13443,1985,Uruguay,Paraguay,1,0,Copa Artigas,Montevideo,Uruguay,False,1,1,Uruguay
11368,12513,13444,1985,Zimbabwe,Zambia,2,3,Friendly,Bulawayo,Zimbabwe,False,5,-1,Zambia
11369,12514,13446,1985,Bulgaria,Switzerland,1,0,Friendly,Querétaro,Mexico,True,1,1,Bulgaria
11370,12516,13448,1985,Republic of Ireland,Italy,1,2,Friendly,Dublin,Republic of Ireland,False,3,-1,Italy
11371,12517,13449,1985,Mexico,Poland,5,0,Friendly,Querétaro,Mexico,False,5,5,Mexico
11372,12518,13450,1985,Bolivia,Uruguay,0,1,Friendly,Cochabamba,Bolivia,False,1,-1,Uruguay
11373,12519,13451,1985,Bulgaria,Poland,2,2,Friendly,Querétaro,Mexico,True,4,0,Draw
11374,12520,13452,1985,Cameroon,Egypt,0,0,Friendly,Yaoundé,Cameroon,False,0,0,Draw
11375,12521,13453,1985,Chile,Paraguay,1,0,Friendly,Viña del Mar,Chile,False,1,1,Chile
11376,12522,13454,1985,Costa Rica,El Salvador,2,1,Friendly,San José,Costa Rica,False,3,1,Costa Rica
11377,12524,13456,1985,Mexico,Switzerland,1,2,Friendly,Querétaro,Mexico,False,3,-1,Switzerland
11378,12525,13457,1985,Chile,Finland,2,0,Friendly,Viña del Mar,Chile,False,2,2,Chile
11379,12526,13458,1985,United States,Switzerland,1,1,Friendly,Tampa,United States,False,2,0,Draw
11380,12527,13459,1985,Colombia,Poland,1,2,Friendly,Bogotá,Colombia,False,3,-1,Poland
11381,12529,13461,1985,Guinea,Tunisia,1,0,FIFA World Cup qualification,Conakry,Guinea,False,1,1,Guinea
11382,12530,13462,1985,Malta,Portugal,1,3,FIFA World Cup qualification,Attard,Malta,False,4,-2,Portugal
11383,12531,13463,1985,Paraguay,Uruguay,1,3,Copa Artigas,Asunción,Paraguay,False,4,-2,Uruguay
11384,12533,13465,1985,Guinea-Bissau,Sierra Leone,0,0,Amílcar Cabral Cup,Banjul,Gambia,True,0,0,Draw
11385,12534,13466,1985,Guinea,Senegal,0,2,Amílcar Cabral Cup,Bakau,Gambia,True,2,-2,Senegal
11386,12535,13467,1985,Mali,Mauritania,3,0,Amílcar Cabral Cup,Bakau,Gambia,True,3,3,Mali
11387,12536,13469,1985,El Salvador,Costa Rica,1,0,Friendly,San Salvador,El Salvador,False,1,1,El Salvador
11388,12537,13470,1985,Gambia,Guinea-Bissau,1,0,Amílcar Cabral Cup,Banjul,Gambia,False,1,1,Gambia
11389,12538,13471,1985,Colombia,Poland,1,0,Friendly,Cali,Colombia,False,1,1,Colombia
11390,12539,13472,1985,Guinea,Mali,1,3,Amílcar Cabral Cup,Bakau,Gambia,True,4,-2,Mali
11391,12540,13473,1985,Mauritania,Senegal,0,2,Amílcar Cabral Cup,Bakau,Gambia,True,2,-2,Senegal
11392,12541,13474,1985,Uruguay,Finland,2,1,Friendly,Montevideo,Uruguay,False,3,1,Uruguay
11393,12542,13476,1985,Gambia,Sierra Leone,1,1,Amílcar Cabral Cup,Banjul,Gambia,False,2,0,Draw
11394,12543,13477,1985,Guinea,Mauritania,1,0,Amílcar Cabral Cup,Banjul,Gambia,True,1,1,Guinea
11395,12544,13478,1985,Mali,Senegal,2,2,Amílcar Cabral Cup,Bakau,Gambia,True,4,0,Draw
11396,12545,13479,1985,Ecuador,Finland,3,1,Friendly,Ambato,Ecuador,False,4,2,Ecuador
11397,12546,13480,1985,Guatemala,Costa Rica,1,0,Friendly,Guatemala,Guatemala,False,1,1,Guatemala
11398,12548,13482,1985,Macau,Brunei,2,0,FIFA World Cup qualification,Macau,Macau,False,2,2,Macau
11399,12549,13483,1985,Peru,Bolivia,3,0,Friendly,Lima,Peru,False,3,3,Peru
11400,12550,13485,1985,Gambia,Mali,1,0,Amílcar Cabral Cup,Bakau,Gambia,False,1,1,Gambia
11401,12551,13486,1985,Ivory Coast,Congo,2,1,Friendly,Abidjan,Ivory Coast,False,3,1,Ivory Coast
11402,12553,13489,1985,Chile,Colombia,1,1,Friendly,Santiago,Chile,False,2,0,Draw
11403,12554,13490,1985,Ecuador,Bolivia,3,0,Friendly,Quito,Ecuador,False,3,3,Ecuador
11404,12555,13491,1985,Gambia,Senegal,0,1,Amílcar Cabral Cup,Bakau,Gambia,False,1,-1,Senegal
11405,12556,13492,1985,Sudan,Libya,0,0,FIFA World Cup qualification,Khartoum,Sudan,False,0,0,Draw
11406,12557,13493,1985,Hong Kong,Brunei,8,0,FIFA World Cup qualification,Siu Sai Wan,Hong Kong,False,8,8,Hong Kong
11407,12558,13494,1985,Singapore,Japan,1,3,FIFA World Cup qualification,Kallang,Singapore,False,4,-2,Japan
11408,12559,13495,1985,Antigua and Barbuda,Dominica,2,1,CFU Caribbean Cup qualification,St. John's,Antigua and Barbuda,False,3,1,Antigua and Barbuda
11409,12560,13496,1985,Chile,Peru,1,2,Friendly,Santiago,Chile,False,3,-1,Peru
11410,12561,13497,1985,El Salvador,Suriname,3,0,FIFA World Cup qualification,San Salvador,El Salvador,False,3,3,El Salvador
11411,12562,13498,1985,Portugal,Germany,1,2,FIFA World Cup qualification,Oeiras,Portugal,False,3,-1,Germany
11412,12563,13499,1985,Saint Vincent and the Grenadines,Trinidad and Tobago,1,1,CFU Caribbean Cup qualification,Kingstown,Saint Vincent and the Grenadines,False,2,0,Draw
11413,12564,13500,1985,Tunisia,Guinea,2,0,FIFA World Cup qualification,Tunis,Tunisia,False,2,2,Tunisia
11414,12565,13501,1985,Uruguay,Colombia,3,0,Friendly,Montevideo,Uruguay,False,3,3,Uruguay
11415,12566,13503,1985,Mexico,Finland,2,1,Friendly,Acapulco,Mexico,False,3,1,Mexico
11416,12567,13504,1985,Wales,Norway,1,1,Friendly,Wrexham,Wales,False,2,0,Draw
11417,12568,13505,1985,El Salvador,Suriname,3,0,FIFA World Cup qualification,San Salvador,El Salvador,False,3,3,El Salvador
11418,12569,13506,1985,Greece,Albania,2,0,FIFA World Cup qualification,Athens,Greece,False,2,2,Greece
11419,12570,13507,1985,Israel,Republic of Ireland,0,0,Friendly,Ramat-Gan,Israel,False,0,0,Draw
11420,12571,13508,1985,Netherlands,Cyprus,7,1,FIFA World Cup qualification,Amsterdam,Netherlands,False,8,6,Netherlands
11421,12572,13509,1985,Northern Ireland,England,0,1,FIFA World Cup qualification,Belfast,Northern Ireland,False,1,-1,England
11422,12573,13510,1985,Spain,Scotland,1,0,FIFA World Cup qualification,Seville,Spain,False,1,1,Spain
11423,12574,13511,1985,Uruguay,Peru,2,2,Friendly,Montevideo,Uruguay,False,4,0,Draw
11424,12575,13512,1985,Paraguay,Colombia,0,3,Friendly,Asunción,Paraguay,False,3,-3,Colombia
11425,12578,13515,1985,Antigua and Barbuda,Guadeloupe,0,1,CFU Caribbean Cup qualification,St. John's,Antigua and Barbuda,False,1,-1,Guadeloupe
11426,12579,13516,1985,Dominica,Cayman Islands,2,1,CFU Caribbean Cup qualification,Roseau,Dominica,False,3,1,Dominica
11427,12580,13517,1985,Ecuador,Chile,1,1,FIFA World Cup qualification,Quito,Ecuador,False,2,0,Draw
11428,12581,13518,1985,Grenada,Trinidad and Tobago,1,5,CFU Caribbean Cup qualification,St. George's,Grenada,False,6,-4,Trinidad and Tobago
11429,12582,13519,1985,Honduras,Suriname,1,1,FIFA World Cup qualification,Tegucigalpa,Honduras,False,2,0,Draw
11430,12583,13520,1985,Madagascar,Zimbabwe,0,1,African Cup of Nations qualification,Antananarivo,Madagascar,False,1,-1,Zimbabwe
11431,12584,13521,1985,Ivory Coast,DR Congo,2,1,Friendly,Abidjan,Ivory Coast,False,3,1,Ivory Coast
11432,12585,13522,1985,Costa Rica,Guatemala,2,0,Friendly,San José,Costa Rica,False,2,2,Costa Rica
11433,12586,13523,1985,Honduras,Suriname,2,1,FIFA World Cup qualification,Tegucigalpa,Honduras,False,3,1,Honduras
11434,12587,13524,1985,Algeria,Mauritania,4,0,African Cup of Nations qualification,Algiers,Algeria,False,4,4,Algeria
11435,12588,13525,1985,Libya,Sudan,4,0,FIFA World Cup qualification,Tripoli,Libya,False,4,4,Libya
11436,12589,13526,1985,Saint Vincent and the Grenadines,Canada,1,2,Friendly,Kingstown,Saint Vincent and the Grenadines,False,3,-1,Canada
11437,12590,13527,1985,Peru,Chile,1,1,Friendly,Lima,Peru,False,2,0,Draw
11438,12591,13528,1985,El Salvador,Honduras,1,2,FIFA World Cup qualification,San Salvador,El Salvador,False,3,-1,Honduras
11439,12592,13529,1985,French Guiana,Guyana,0,1,CFU Caribbean Cup qualification,Cayenne,French Guiana,False,1,-1,Guyana
11440,12594,13531,1985,Trinidad and Tobago,Canada,1,2,Friendly,Port of Spain,Trinidad and Tobago,False,3,-1,Canada
11441,12595,13532,1985,Uruguay,Ecuador,2,1,FIFA World Cup qualification,Montevideo,Uruguay,False,3,1,Uruguay
11442,12597,13534,1985,Greece,Italy,0,0,Friendly,Athens,Greece,False,0,0,Draw
11443,12598,13535,1985,Jamaica,Canada,1,1,Friendly,Montego Bay,Jamaica,False,2,0,Draw
11444,12599,13536,1985,Honduras,El Salvador,0,0,FIFA World Cup qualification,Tegucigalpa,Honduras,False,0,0,Draw
11445,12600,13537,1985,Indonesia,Thailand,1,0,FIFA World Cup qualification,Jakarta,Indonesia,False,1,1,Indonesia
11446,12601,13538,1985,Iraq,Lebanon,6,0,FIFA World Cup qualification,Kuwait City,Kuwait,True,6,6,Iraq
11447,12602,13539,1985,Jordan,Qatar,1,0,FIFA World Cup qualification,Amman,Jordan,False,1,1,Jordan
11448,12603,13540,1985,Nepal,Malaysia,0,0,FIFA World Cup qualification,Kathmandu,Nepal,False,0,0,Draw
11449,12604,13541,1985,Chile,Ecuador,6,2,FIFA World Cup qualification,Santiago,Chile,False,8,4,Chile
11450,12605,13542,1985,French Guiana,Suriname,0,1,CFU Caribbean Cup qualification,Cayenne,French Guiana,False,1,-1,Suriname
11451,12606,13543,1985,Jamaica,Canada,0,0,Friendly,Kingston,Jamaica,False,0,0,Draw
11452,12607,13544,1985,Indonesia,Bangladesh,2,0,FIFA World Cup qualification,Jakarta,Indonesia,False,2,2,Indonesia
11453,12608,13545,1985,Iraq,Lebanon,6,0,FIFA World Cup qualification,Kuwait City,Kuwait,True,6,6,Iraq
11454,12609,13546,1985,Costa Rica,Canada,1,0,Friendly,San José,Costa Rica,False,1,1,Costa Rica
11455,12610,13547,1985,Indonesia,India,2,1,FIFA World Cup qualification,Jakarta,Indonesia,False,3,1,Indonesia
11456,12612,13549,1985,Peru,Ecuador,1,0,Friendly,Lima,Peru,False,1,1,Peru
11457,12613,13550,1985,Mauritania,Algeria,1,1,African Cup of Nations qualification,Nouakchott,Mauritania,False,2,0,Draw
11458,12614,13551,1985,Qatar,Lebanon,7,0,FIFA World Cup qualification,Doha,Qatar,False,7,7,Qatar
11459,12615,13552,1985,Syria,Kuwait,1,0,FIFA World Cup qualification,Damascus,Syria,False,1,1,Syria
11460,12616,13553,1985,Thailand,Bangladesh,3,0,FIFA World Cup qualification,Bangkok,Thailand,False,3,3,Thailand
11461,12617,13554,1985,Zambia,Malawi,1,1,Friendly,Ndola,Zambia,False,2,0,Draw
11462,12618,13555,1985,Brunei,Philippines,4,1,Friendly,Bandar Seri Begawan,Brunei,False,5,3,Brunei
11463,12619,13556,1985,Chile,Uruguay,2,0,FIFA World Cup qualification,Santiago,Chile,False,2,2,Chile
11464,12620,13557,1985,Costa Rica,Canada,0,0,Friendly,San José,Costa Rica,False,0,0,Draw
11465,12621,13558,1985,Guyana,Suriname,0,1,CFU Caribbean Cup qualification,Georgetown,Guyana,False,1,-1,Suriname
11466,12622,13559,1985,Saint Vincent and the Grenadines,Grenada,3,0,CFU Caribbean Cup qualification,Kingstown,Saint Vincent and the Grenadines,False,3,3,Saint Vincent and the Grenadines
11467,12623,13560,1985,Zambia,Malawi,2,2,Friendly,Lusaka,Zambia,False,4,0,Draw
11468,12624,13561,1985,England,Republic of Ireland,2,1,Friendly,London,England,False,3,1,England
11469,12625,13562,1985,Thailand,India,0,0,FIFA World Cup qualification,Bangkok,Thailand,False,0,0,Draw
11470,12626,13563,1985,Belgium,Greece,2,0,FIFA World Cup qualification,Brussels,Belgium,False,2,2,Belgium
11471,12627,13564,1985,Germany,Malta,6,0,FIFA World Cup qualification,Saarbrücken,Germany,False,6,6,Germany
11472,12628,13565,1985,Qatar,Lebanon,8,0,FIFA World Cup qualification,Doha,Qatar,False,8,8,Qatar
11473,12629,13566,1985,Romania,Poland,0,0,Friendly,Sibiu,Romania,False,0,0,Draw
11474,12630,13567,1985,Russia,Austria,2,0,Friendly,Tbilisi,Soviet Union,False,2,2,Russia
11475,12631,13568,1985,Scotland,Wales,0,1,FIFA World Cup qualification,Glasgow,Scotland,False,1,-1,Wales
11476,12632,13569,1985,Spain,Northern Ireland,0,0,Friendly,Palma de Mallorca,Spain,False,0,0,Draw
11477,12634,13572,1985,Albania,Turkey,0,0,Friendly,Tirana,Albania,False,0,0,Draw
11478,12635,13573,1985,Egypt,Cameroon,2,0,Friendly,Cairo,Egypt,False,2,2,Egypt
11479,12636,13574,1985,Jordan,Iraq,2,3,FIFA World Cup qualification,Amman,Jordan,False,5,-1,Iraq
11480,12637,13575,1985,Libya,Tunisia,2,0,African Cup of Nations qualification,Tripoli,Libya,False,2,2,Libya
11481,12638,13576,1985,Panama,Guatemala,0,0,Friendly,Panama City,Panama,False,0,0,Draw
11482,12639,13577,1985,Thailand,Indonesia,0,1,FIFA World Cup qualification,Bangkok,Thailand,False,1,-1,Indonesia
11483,12640,13578,1985,Yemen,Syria,0,1,FIFA World Cup qualification,Sana'a,Yemen AR,True,1,-1,Syria
11484,12641,13580,1985,Bangladesh,India,1,2,FIFA World Cup qualification,Dhaka,Bangladesh,False,3,-1,India
11485,12642,13581,1985,Angola,Algeria,0,0,FIFA World Cup qualification,Luanda,Angola,False,0,0,Draw
11486,12643,13582,1985,Congo,DR Congo,2,5,African Cup of Nations qualification,Brazzaville,Congo,False,7,-3,DR Congo
11487,12644,13583,1985,Ecuador,Uruguay,0,2,FIFA World Cup qualification,Quito,Ecuador,False,2,-2,Uruguay
11488,12645,13584,1985,Egypt,Cameroon,2,1,Friendly,Cairo,Egypt,False,3,1,Egypt
11489,12646,13585,1985,Ghana,Guinea,1,1,African Cup of Nations qualification,Accra,Ghana,False,2,0,Draw
11490,12647,13586,1985,Ivory Coast,Mali,6,0,African Cup of Nations qualification,Abidjan,Ivory Coast,False,6,6,Ivory Coast
11491,12648,13587,1985,Kuwait,Iceland,1,1,Friendly,Kuwait City,Kuwait,False,2,0,Draw
11492,12649,13588,1985,Malaysia,Nepal,5,0,FIFA World Cup qualification,Kuala Lumpur,Malaysia,False,5,5,Malaysia
11493,12650,13589,1985,Togo,Senegal,0,1,African Cup of Nations qualification,Tsévié,Togo,False,1,-1,Senegal
11494,12651,13590,1985,Bangladesh,Indonesia,2,1,FIFA World Cup qualification,Dhaka,Bangladesh,False,3,1,Bangladesh
11495,12652,13591,1985,Canada,United States,2,0,Friendly,Vancouver,Canada,False,2,2,Canada
11496,12653,13592,1985,Syria,United Arab Emirates,2,1,Friendly,Manama,Bahrain,True,3,1,Syria
11497,12654,13593,1985,Guadeloupe,Trinidad and Tobago,1,1,CFU Caribbean Cup qualification,Basse-Terre,Guadeloupe,False,2,0,Draw
11498,12655,13594,1985,Hungary,Cyprus,2,0,FIFA World Cup qualification,Budapest,Hungary,False,2,2,Hungary
11499,12656,13595,1985,Italy,Portugal,2,0,Friendly,Ascoli Piceno,Italy,False,2,2,Italy
11500,12657,13596,1985,Malta,Jordan,3,1,Friendly,Attard,Malta,False,4,2,Malta
11501,12658,13597,1985,Romania,Turkey,3,0,FIFA World Cup qualification,Craiova,Romania,False,3,3,Romania
11502,12659,13599,1985,United States,Canada,1,1,Friendly,Portland,United States,False,2,0,Draw
11503,12660,13600,1985,Bahrain,United Arab Emirates,3,2,Friendly,Manama,Bahrain,False,5,1,Bahrain
11504,12661,13601,1985,Bangladesh,Thailand,1,0,FIFA World Cup qualification,Dhaka,Bangladesh,False,1,1,Bangladesh
11505,12662,13602,1985,Egypt,Madagascar,1,0,FIFA World Cup qualification,Cairo,Egypt,False,1,1,Egypt
11506,12663,13603,1985,Kuwait,Yemen,5,0,FIFA World Cup qualification,Kuwait City,Kuwait,False,5,5,Kuwait
11507,12664,13604,1985,Qatar,Iraq,3,0,FIFA World Cup qualification,Doha,Qatar,False,3,3,Qatar
11508,12665,13605,1985,Brunei,Hong Kong,1,5,FIFA World Cup qualification,Bandar Seri Begawan,Brunei,False,6,-4,Hong Kong
11509,12667,13607,1985,India,Indonesia,1,1,FIFA World Cup qualification,Calcutta,India,False,2,0,Draw
11510,12668,13608,1985,Kenya,Nigeria,0,3,FIFA World Cup qualification,Nairobi,Kenya,False,3,-3,Nigeria
11511,12669,13610,1985,Ivory Coast,Ghana,0,0,FIFA World Cup qualification,Abidjan,Ivory Coast,False,0,0,Draw
11512,12670,13611,1985,Mali,Togo,4,0,Friendly,Bamako,Mali,False,4,4,Mali
11513,12671,13612,1985,Morocco,Malawi,2,0,FIFA World Cup qualification,Rabat,Morocco,False,2,2,Morocco
11514,12672,13613,1985,Syria,United Arab Emirates,0,4,Friendly,Manama,Bahrain,True,4,-4,United Arab Emirates
11515,12673,13614,1985,Uruguay,Chile,2,1,FIFA World Cup qualification,Montevideo,Uruguay,False,3,1,Uruguay
11516,12674,13615,1985,Zambia,Cameroon,4,1,FIFA World Cup qualification,Lusaka,Zambia,False,5,3,Zambia
11517,12675,13616,1985,India,Thailand,1,1,FIFA World Cup qualification,Calcutta,India,False,2,0,Draw
11518,12677,13618,1985,India,Bangladesh,2,1,FIFA World Cup qualification,Calcutta,India,False,3,1,India
11519,12678,13619,1985,Kuwait,Syria,0,0,FIFA World Cup qualification,Kuwait City,Kuwait,False,0,0,Draw
11520,12679,13620,1985,Qatar,Jordan,2,0,FIFA World Cup qualification,Doha,Qatar,False,2,2,Qatar
11521,12680,13621,1985,Saudi Arabia,United Arab Emirates,0,0,FIFA World Cup qualification,Riyadh,Saudi Arabia,False,0,0,Draw
11522,12681,13622,1985,Brunei,Macau,1,2,FIFA World Cup qualification,Bandar Seri Begawan,Brunei,False,3,-1,Macau
11523,12682,13623,1985,Canada,Haiti,2,0,FIFA World Cup qualification,Victoria,Canada,False,2,2,Canada
11524,12683,13624,1985,DR Congo,Congo,0,0,African Cup of Nations qualification,Kinshasa,Zaïre,False,0,0,Draw
11525,12684,13625,1985,Guinea,Ghana,1,4,African Cup of Nations qualification,Conakry,Guinea,False,5,-3,Ghana
11526,12685,13626,1985,Mali,Ivory Coast,1,1,African Cup of Nations qualification,Bamako,Mali,False,2,0,Draw
11527,12686,13627,1985,Panama,Trinidad and Tobago,0,0,Friendly,Panama City,Panama,False,0,0,Draw
11528,12687,13628,1985,Senegal,Togo,1,1,African Cup of Nations qualification,Dakar,Senegal,False,2,0,Draw
11529,12688,13629,1985,Tunisia,Libya,1,0,African Cup of Nations qualification,Tunis,Tunisia,False,1,1,Tunisia
11530,12689,13630,1985,Mozambique,Malawi,1,1,African Cup of Nations qualification,Maputo,Mozambique,False,2,0,Draw
11531,12690,13631,1985,Austria,Hungary,0,3,FIFA World Cup qualification,Vienna,Austria,False,3,-3,Hungary
11532,12691,13632,1985,Colombia,Paraguay,2,0,Friendly,Pereira,Colombia,False,2,2,Colombia
11533,12692,13634,1985,Germany,Bulgaria,4,1,Friendly,Augsburg,Germany,False,5,3,Germany
11534,12693,13635,1985,Panama,Trinidad and Tobago,1,1,Friendly,David,Panama,False,2,0,Draw
11535,12694,13636,1985,Poland,Finland,2,1,Friendly,Opole,Poland,False,3,1,Poland
11536,12695,13637,1985,Switzerland,Russia,2,2,FIFA World Cup qualification,Berne,Switzerland,False,4,0,Draw
11537,12696,13638,1985,Algeria,Angola,3,2,FIFA World Cup qualification,Algiers,Algeria,False,5,1,Algeria
11538,12697,13639,1985,Colombia,Paraguay,2,2,Friendly,Bogotá,Colombia,False,4,0,Draw
11539,12698,13640,1985,Iraq,Jordan,2,0,FIFA World Cup qualification,Kuwait City,Kuwait,True,2,2,Iraq
11540,12699,13641,1985,Syria,Yemen,3,0,FIFA World Cup qualification,Damascus,Syria,False,3,3,Syria
11541,12700,13642,1985,United Arab Emirates,Saudi Arabia,1,0,FIFA World Cup qualification,Dubai,United Arab Emirates,False,1,1,United Arab Emirates
11542,12701,13643,1985,Barbados,Jamaica,2,2,Friendly,Bridgetown,Barbados,False,4,0,Draw
11543,12702,13644,1985,Canada,Guatemala,2,1,FIFA World Cup qualification,Victoria,Canada,False,3,1,Canada
11544,12703,13645,1985,Nigeria,Kenya,3,1,FIFA World Cup qualification,Lagos,Nigeria,False,4,2,Nigeria
11545,12704,13646,1985,Bolivia,Venezuela,4,0,Friendly,Santa Cruz,Bolivia,False,4,4,Bolivia
11546,12705,13647,1985,Cameroon,Zambia,1,1,FIFA World Cup qualification,Yaoundé,Cameroon,False,2,0,Draw
11547,12706,13648,1985,Ghana,Ivory Coast,2,0,FIFA World Cup qualification,Kumasi,Ghana,False,2,2,Ghana
11548,12707,13649,1985,Madagascar,Egypt,1,0,FIFA World Cup qualification,Antananarivo,Madagascar,False,1,1,Madagascar
11549,12708,13650,1985,Malawi,Morocco,0,0,FIFA World Cup qualification,Blantyre,Malawi,False,0,0,Draw
11550,12710,13652,1985,Togo,Mali,3,0,Friendly,Lomé,Togo,False,3,3,Togo
11551,12711,13653,1985,Peru,Uruguay,2,1,Friendly,Lima,Peru,False,3,1,Peru
11552,12712,13654,1985,Costa Rica,Trinidad and Tobago,3,0,FIFA World Cup qualification,San José,Costa Rica,False,3,3,Costa Rica
11553,12713,13655,1985,Luxembourg,Iceland,0,0,Friendly,Ettelbruck,Luxembourg,False,0,0,Draw
11554,12714,13656,1985,Brazil,Colombia,2,1,Friendly,Belo Horizonte,Brazil,False,3,1,Brazil
11555,12715,13657,1985,Haiti,Guatemala,0,1,FIFA World Cup qualification,Port-au-Prince,Haiti,False,1,-1,Guatemala
11556,12716,13658,1985,Yemen,Kuwait,1,3,FIFA World Cup qualification,Sana'a,Yemen AR,True,4,-2,Kuwait
11557,12717,13659,1985,Suriname,Guadeloupe,0,1,CFU Caribbean Cup qualification,Cayenne,French Guiana,True,1,-1,Guadeloupe
11558,12718,13660,1985,Bangladesh,Indonesia,1,1,Friendly,Peshawar,Pakistan,True,2,0,Draw
11559,12719,13661,1985,Brazil,Peru,0,1,Friendly,Brasília,Brazil,False,1,-1,Peru
11560,12720,13662,1985,Colombia,Uruguay,2,1,Friendly,Bogotá,Colombia,False,3,1,Colombia
11561,12721,13663,1985,Costa Rica,Trinidad and Tobago,1,1,FIFA World Cup qualification,San José,Costa Rica,False,2,0,Draw
11562,12722,13664,1985,Macau,Hong Kong,0,2,FIFA World Cup qualification,Macau,Macau,False,2,-2,Hong Kong
11563,12724,13666,1985,Paraguay,Argentina,1,0,Friendly,Asunción,Paraguay,False,1,1,Paraguay
11564,12725,13670,1985,Pakistan,Nepal,1,0,Friendly,Peshawar,Pakistan,False,1,1,Pakistan
11565,12726,13671,1985,Wales,Spain,3,0,FIFA World Cup qualification,Wrexham,Wales,False,3,3,Wales
11566,12727,13672,1985,Belgium,Poland,2,0,FIFA World Cup qualification,Brussels,Belgium,False,2,2,Belgium
11567,12728,13673,1985,Bolivia,Peru,0,0,Friendly,Santa Cruz,Bolivia,False,0,0,Draw
11568,12729,13674,1985,Republic of Ireland,Norway,0,0,FIFA World Cup qualification,Dublin,Republic of Ireland,False,0,0,Draw
11569,12730,13675,1985,Israel,Sweden,1,1,Friendly,Ramat-Gan,Israel,False,2,0,Draw
11570,12732,13677,1985,Netherlands,Austria,1,1,FIFA World Cup qualification,Rotterdam,Netherlands,False,2,0,Draw
11571,12733,13678,1985,Northern Ireland,Turkey,2,0,FIFA World Cup qualification,Belfast,Northern Ireland,False,2,2,Northern Ireland
11572,12734,13679,1985,Romania,England,0,0,FIFA World Cup qualification,Bucharest,Romania,False,0,0,Draw
11573,12735,13680,1985,Tunisia,Algeria,1,0,Friendly,Tunis,Tunisia,False,1,1,Tunisia
11574,12736,13681,1985,Brazil,Uruguay,2,0,Friendly,Recife,Brazil,False,2,2,Brazil
11575,12737,13682,1985,Bulgaria,France,2,0,FIFA World Cup qualification,Sofia,Bulgaria,False,2,2,Bulgaria
11576,12739,13684,1985,Pakistan,Bangladesh,1,3,Friendly,Peshawar,Pakistan,False,4,-2,Bangladesh
11577,12740,13685,1985,Russia,Switzerland,4,0,FIFA World Cup qualification,Moscow,Soviet Union,True,4,4,Russia
11578,12741,13686,1985,Zimbabwe,Malawi,1,3,Friendly,Harare,Zimbabwe,False,4,-2,Malawi
11579,12743,13688,1985,Hong Kong,Macau,2,0,FIFA World Cup qualification,Siu Sai Wan,Hong Kong,False,2,2,Hong Kong
11580,12744,13689,1985,Pakistan,Indonesia,1,3,Friendly,Peshawar,Pakistan,False,4,-2,Indonesia
11581,12745,13690,1985,Brazil,Argentina,2,1,Friendly,Salvador,Brazil,False,3,1,Brazil
11582,12746,13691,1985,Guatemala,Canada,1,1,FIFA World Cup qualification,Guatemala,Guatemala,False,2,0,Draw
11583,12747,13692,1985,Iraq,Qatar,2,1,FIFA World Cup qualification,Calcutta,India,True,3,1,Iraq
11584,12748,13693,1985,Trinidad and Tobago,Suriname,0,1,CFU Caribbean Cup qualification,San Fernando,Trinidad and Tobago,False,1,-1,Suriname
11585,12749,13694,1985,Austria,Cyprus,4,0,FIFA World Cup qualification,Graz,Austria,False,4,4,Austria
11586,12751,13696,1985,Haiti,Canada,0,2,FIFA World Cup qualification,Port-au-Prince,Haiti,False,2,-2,Canada
11587,12752,13697,1985,Argentina,Paraguay,1,1,Friendly,Buenos Aires,Argentina,False,2,0,Draw
11588,12753,13698,1985,Mauritania,Senegal,0,0,Friendly,Nouakchott,Mauritania,False,0,0,Draw
11589,12754,13700,1985,Argentina,Chile,2,0,Friendly,Buenos Aires,Argentina,False,2,2,Argentina
11590,12755,13701,1985,Hungary,Netherlands,0,1,FIFA World Cup qualification,Budapest,Hungary,False,1,-1,Netherlands
11591,12756,13702,1985,Colombia,Brazil,1,0,Friendly,Bogotá,Colombia,False,1,1,Colombia
11592,12757,13703,1985,Guatemala,Haiti,4,0,FIFA World Cup qualification,Guatemala,Guatemala,False,4,4,Guatemala
11593,12758,13704,1985,United States,Trinidad and Tobago,2,1,FIFA World Cup qualification,St. Louis,United States,False,3,1,United States
11594,12759,13706,1985,Japan,Singapore,5,0,FIFA World Cup qualification,Tokyo,Japan,False,5,5,Japan
11595,12760,13708,1985,Greece,Poland,1,4,FIFA World Cup qualification,Athens,Greece,False,5,-3,Poland
11596,12761,13710,1985,United States,Trinidad and Tobago,1,0,FIFA World Cup qualification,Torrance,United States,False,1,1,United States
11597,12762,13711,1985,Chile,Brazil,2,1,Friendly,Santiago,Chile,False,3,1,Chile
11598,12763,13712,1985,Finland,England,1,1,FIFA World Cup qualification,Helsinki,Finland,False,2,0,Draw
11599,12764,13713,1985,Sweden,Norway,1,0,Friendly,Gothenburg,Sweden,False,1,1,Sweden
11600,12765,13715,1985,Scotland,England,1,0,Rous Cup,Glasgow,Scotland,False,1,1,Scotland
11601,12766,13716,1985,Bolivia,Paraguay,1,1,FIFA World Cup qualification,Santa Cruz,Bolivia,False,2,0,Draw
11602,12767,13717,1985,Colombia,Peru,1,0,FIFA World Cup qualification,Bogotá,Colombia,False,1,1,Colombia
11603,12768,13718,1985,Costa Rica,United States,1,1,FIFA World Cup qualification,Alajuela,Costa Rica,False,2,0,Draw
11604,12769,13719,1985,Republic of Ireland,Spain,0,0,Friendly,Cork,Republic of Ireland,False,0,0,Draw
11605,12770,13720,1985,Venezuela,Argentina,2,3,FIFA World Cup qualification,San Cristóbal,Venezuela,False,5,-1,Argentina
11606,12771,13721,1985,Iceland,Scotland,0,1,FIFA World Cup qualification,Reykjavík,Iceland,False,1,-1,Scotland
11607,12772,13722,1985,Albania,Poland,0,1,FIFA World Cup qualification,Tirana,Albania,False,1,-1,Poland
11608,12773,13723,1985,United States,Costa Rica,0,1,FIFA World Cup qualification,Torrance,United States,False,1,-1,Costa Rica
11609,12775,13725,1985,Hong Kong,Macau,2,0,Friendly,Siu Sai Wan,Hong Kong,False,2,2,Hong Kong
11610,12776,13726,1985,Bolivia,Brazil,0,2,FIFA World Cup qualification,Santa Cruz,Bolivia,False,2,-2,Brazil
11611,12777,13727,1985,Canada,Ghana,2,1,Korea Cup,Seoul,South Korea,True,3,1,Canada
11612,12778,13728,1985,Colombia,Argentina,1,3,FIFA World Cup qualification,Bogotá,Colombia,False,4,-2,Argentina
11613,12779,13729,1985,Republic of Ireland,Switzerland,3,0,FIFA World Cup qualification,Dublin,Republic of Ireland,False,3,3,Republic of Ireland
11614,12780,13730,1985,Mexico,Italy,1,1,Friendly,Mexico City,Mexico,False,2,0,Draw
11615,12781,13731,1985,Venezuela,Peru,0,1,FIFA World Cup qualification,San Cristóbal,Venezuela,False,1,-1,Peru
11616,12782,13732,1985,Bahrain,Malaysia,3,1,Korea Cup,Seoul,South Korea,True,4,2,Bahrain
11617,12783,13733,1985,New Zealand,Fiji,5,0,Friendly,Mount Maunganui,New Zealand,False,5,5,New Zealand
11618,12784,13734,1985,Denmark,Russia,4,2,FIFA World Cup qualification,Copenhagen,Denmark,False,6,2,Denmark
11619,12785,13735,1985,New Zealand,Fiji,3,0,Friendly,Gisborne,New Zealand,False,3,3,New Zealand
11620,12786,13736,1985,Norway,Wales,4,2,Friendly,Bergen,Norway,False,6,2,Norway
11621,12788,13738,1985,England,Italy,1,2,Friendly,Mexico City,Mexico,True,3,-1,Italy
11622,12789,13739,1985,Finland,Romania,1,1,FIFA World Cup qualification,Helsinki,Finland,False,2,0,Draw
11623,12790,13741,1985,New Zealand,Fiji,2,0,Friendly,Auckland,New Zealand,False,2,2,New Zealand
11624,12791,13742,1985,Brazil,Chile,3,1,Friendly,Porto Alegre,Brazil,False,4,2,Brazil
11625,12792,13744,1985,Argentina,Venezuela,3,0,FIFA World Cup qualification,Buenos Aires,Argentina,False,3,3,Argentina
11626,12793,13745,1985,Canada,Iraq,1,6,Korea Cup,Gwangju,South Korea,True,7,-5,Iraq
11627,12794,13746,1985,Mexico,England,1,0,Friendly,Mexico City,Mexico,False,1,1,Mexico
11628,12795,13747,1985,Paraguay,Bolivia,3,0,FIFA World Cup qualification,Asunción,Paraguay,False,3,3,Paraguay
11629,12796,13748,1985,Peru,Colombia,0,0,FIFA World Cup qualification,Lima,Peru,False,0,0,Draw
11630,12797,13749,1985,England,Germany,3,0,Friendly,Mexico City,Mexico,True,3,3,England
11631,12798,13750,1985,Iceland,Spain,1,2,FIFA World Cup qualification,Reykjavík,Iceland,False,3,-1,Spain
11632,12799,13752,1985,Mexico,Germany,2,0,Friendly,Mexico City,Mexico,False,2,2,Mexico
11633,12800,13753,1985,Nigeria,Ivory Coast,0,0,Friendly,Lagos,Nigeria,False,0,0,Draw
11634,12801,13754,1985,Argentina,Colombia,1,0,FIFA World Cup qualification,Buenos Aires,Argentina,False,1,1,Argentina
11635,12802,13755,1985,Paraguay,Brazil,0,2,FIFA World Cup qualification,Asunción,Paraguay,False,2,-2,Brazil
11636,12803,13756,1985,Peru,Venezuela,4,1,FIFA World Cup qualification,Lima,Peru,False,5,3,Peru
11637,12804,13757,1985,United States,England,0,5,Friendly,Los Angeles,United States,False,5,-5,England
11638,12805,13758,1985,Nigeria,Ivory Coast,2,0,Friendly,Lagos,Nigeria,False,2,2,Nigeria
11639,12806,13759,1985,Brazil,Paraguay,1,1,FIFA World Cup qualification,Rio de Janeiro,Brazil,False,2,0,Draw
11640,12807,13760,1985,Ivory Coast,Nigeria,1,1,Friendly,Abidjan,Ivory Coast,False,2,0,Draw
11641,12808,13761,1985,Peru,Argentina,1,0,FIFA World Cup qualification,Lima,Peru,False,1,1,Peru
11642,12809,13762,1985,Venezuela,Colombia,2,2,FIFA World Cup qualification,San Cristóbal,Venezuela,False,4,0,Draw
11643,12810,13763,1985,Guinea,Gambia,1,0,Friendly,Conakry,Guinea,False,1,1,Guinea
11644,12811,13764,1985,Barbados,Suriname,0,0,CFU Caribbean Cup,Bridgetown,Barbados,False,0,0,Draw
11645,12812,13765,1985,Guadeloupe,Martinique,1,2,CFU Caribbean Cup,Bridgetown,Barbados,True,3,-1,Martinique
11646,12813,13766,1985,Ivory Coast,Nigeria,1,1,Friendly,Abidjan,Ivory Coast,False,2,0,Draw
11647,12814,13767,1985,Barbados,Guadeloupe,1,1,CFU Caribbean Cup,Bridgetown,Barbados,False,2,0,Draw
11648,12815,13768,1985,Martinique,Suriname,2,0,CFU Caribbean Cup,Bridgetown,Barbados,True,2,2,Martinique
11649,12816,13769,1985,Angola,São Tomé and Príncipe,3,2,Friendly,Praia,Cape Verde,True,5,1,Angola
11650,12817,13770,1985,Argentina,Peru,2,2,FIFA World Cup qualification,Buenos Aires,Argentina,False,4,0,Draw
11651,12818,13771,1985,Barbados,Martinique,1,1,CFU Caribbean Cup,Bridgetown,Barbados,False,2,0,Draw
11652,12819,13772,1985,Brazil,Bolivia,1,1,FIFA World Cup qualification,São Paulo,Brazil,False,2,0,Draw
11653,12820,13773,1985,Colombia,Venezuela,2,0,FIFA World Cup qualification,Bogotá,Colombia,False,2,2,Colombia
11654,12821,13774,1985,Guadeloupe,Suriname,2,2,CFU Caribbean Cup,Bridgetown,Barbados,True,4,0,Draw
11655,12822,13775,1985,Réunion,DR Congo,1,2,Friendly,Saint-Paul,Réunion,False,3,-1,DR Congo
11656,12823,13776,1985,Saudi Arabia,Jordan,4,0,UAFA Cup,Ta'if,Saudi Arabia,False,4,4,Saudi Arabia
11657,12824,13777,1985,Bahrain,Iraq,1,1,UAFA Cup,Ta'if,Saudi Arabia,True,2,0,Draw
11658,12826,13779,1985,Malawi,DR Congo,0,1,Friendly,Saint-Paul,Réunion,True,1,-1,DR Congo
11659,12827,13780,1985,Jordan,Qatar,0,2,UAFA Cup,Ta'if,Saudi Arabia,True,2,-2,Qatar
11660,12828,13781,1985,Bahrain,Mauritania,2,0,UAFA Cup,Ta'if,Saudi Arabia,True,2,2,Bahrain
11661,12829,13782,1985,Malawi,Tanzania,0,0,Friendly,Blantyre,Malawi,False,0,0,Draw
11662,12830,13783,1985,Nigeria,Tunisia,1,0,FIFA World Cup qualification,Lagos,Nigeria,False,1,1,Nigeria
11663,12831,13784,1985,Réunion,Malawi,2,8,Friendly,Saint-Paul,Réunion,False,10,-6,Malawi
11664,12832,13785,1985,Saudi Arabia,Qatar,1,0,UAFA Cup,Ta'if,Saudi Arabia,False,1,1,Saudi Arabia
11665,12833,13786,1985,Iraq,Mauritania,2,0,UAFA Cup,Ta'if,Saudi Arabia,True,2,2,Iraq
11666,12834,13787,1985,Malawi,Tanzania,2,0,Friendly,Lilongwe,Malawi,False,2,2,Malawi
11667,12835,13789,1985,Kenya,DR Congo,0,1,Friendly,Nairobi,Kenya,False,1,-1,DR Congo
11668,12836,13790,1985,Angola,Guinea-Bissau,3,1,Friendly,Praia,Cape Verde,True,4,2,Angola
11669,12837,13791,1985,Bahrain,Qatar,1,1,UAFA Cup,Ta'if,Saudi Arabia,True,2,0,Draw
11670,12838,13792,1985,Iceland,Faroe Islands,9,0,Friendly,Keflavík,Iceland,False,9,9,Iceland
11671,12839,13793,1985,Malawi,Tanzania,0,0,Friendly,Mzuzu,Malawi,False,0,0,Draw
11672,12840,13794,1985,Saudi Arabia,Iraq,2,3,UAFA Cup,Ta'if,Saudi Arabia,False,5,-1,Iraq
11673,12842,13796,1985,Bahrain,Iraq,0,1,UAFA Cup,Ta'if,Saudi Arabia,True,1,-1,Iraq
11674,12843,13797,1985,Egypt,Morocco,0,0,FIFA World Cup qualification,Cairo,Egypt,False,0,0,Draw
11675,12844,13798,1985,Iceland,Faroe Islands,1,0,Friendly,Akranes,Iceland,False,1,1,Iceland
11676,12845,13799,1985,Saudi Arabia,Qatar,0,0,UAFA Cup,Ta'if,Saudi Arabia,False,0,0,Draw
11677,12846,13800,1985,Algeria,Zambia,2,0,FIFA World Cup qualification,Algiers,Algeria,False,2,2,Algeria
11678,12848,13802,1985,Ghana,Libya,0,0,FIFA World Cup qualification,Accra,Ghana,False,0,0,Draw
11679,12849,13803,1985,Costa Rica,Trinidad and Tobago,3,1,Friendly,San José,Costa Rica,False,4,2,Costa Rica
11680,12850,13804,1985,Tunisia,Nigeria,2,0,FIFA World Cup qualification,Tunis,Tunisia,False,2,2,Tunisia
11681,12851,13806,1985,Libya,Ghana,2,0,FIFA World Cup qualification,Bin Ghashir,Libya,False,2,2,Libya
11682,12852,13807,1985,Kenya,Uganda,0,1,Friendly,Nairobi,Kenya,False,1,-1,Uganda
11683,12853,13808,1985,Morocco,Egypt,2,0,FIFA World Cup qualification,Casablanca,Morocco,False,2,2,Morocco
11684,12854,13809,1985,Tunisia,Saudi Arabia,1,0,Friendly,Tunis,Tunisia,False,1,1,Tunisia
11685,12855,13810,1985,Zambia,Algeria,0,1,FIFA World Cup qualification,Lusaka,Zambia,False,1,-1,Algeria
11686,12857,13812,1985,Kenya,Algeria,0,0,African Cup of Nations qualification,Nairobi,Kenya,False,0,0,Draw
11687,12858,13813,1985,Thailand,Hong Kong,1,2,Friendly,Bangkok,Thailand,False,3,-1,Hong Kong
11688,12859,13814,1985,Russia,Romania,2,0,Friendly,Moscow,Soviet Union,False,2,2,Russia
11689,12860,13815,1985,Nigeria,Zambia,0,0,African Cup of Nations qualification,Lagos,Nigeria,False,0,0,Draw
11690,12861,13816,1985,Costa Rica,Honduras,2,2,FIFA World Cup qualification,San José,Costa Rica,False,4,0,Draw
11691,12862,13817,1985,Guinea,Mali,1,1,Friendly,Conakry,Guinea,False,2,0,Draw
11692,12863,13818,1985,Japan,Hong Kong,3,0,FIFA World Cup qualification,Kobe,Japan,False,3,3,Japan
11693,12864,13819,1985,Indonesia,Thailand,1,2,Indonesia Tournament,Jakarta,Indonesia,False,3,-1,Thailand
11694,12866,13821,1985,Canada,Costa Rica,1,1,FIFA World Cup qualification,Toronto,Canada,False,2,0,Draw
11695,12867,13822,1985,Ivory Coast,Ghana,2,0,African Cup of Nations qualification,Abidjan,Ivory Coast,False,2,2,Ivory Coast
11696,12868,13823,1985,Zambia,Nigeria,1,0,African Cup of Nations qualification,Lusaka,Zambia,False,1,1,Zambia
11697,12869,13824,1985,Zimbabwe,Senegal,1,0,African Cup of Nations qualification,Harare,Zimbabwe,False,1,1,Zimbabwe
11698,12870,13825,1985,France,Uruguay,2,0,Friendly,Paris,France,False,2,2,France
11699,12871,13826,1985,Sweden,Poland,1,0,Friendly,Malmö,Sweden,False,1,1,Sweden
11700,12872,13827,1985,Libya,Mozambique,2,1,African Cup of Nations qualification,Benghazi,Libya,False,3,1,Libya
11701,12873,13828,1985,Honduras,Canada,0,1,FIFA World Cup qualification,Tegucigalpa,Honduras,False,1,-1,Canada
11702,12874,13829,1985,Mali,Guinea,1,1,Friendly,Bamako,Mali,False,2,0,Draw
11703,12875,13830,1985,Morocco,DR Congo,1,0,African Cup of Nations qualification,Casablanca,Morocco,False,1,1,Morocco
11704,12876,13831,1985,Mexico,Bulgaria,1,1,Friendly,Los Angeles,United States,True,2,0,Draw
11705,12877,13832,1985,Romania,Finland,2,0,FIFA World Cup qualification,Timişoara,Romania,False,2,2,Romania
11706,12878,13833,1985,Russia,Germany,1,0,Friendly,Moscow,Soviet Union,False,1,1,Russia
11707,12879,13834,1985,Switzerland,Turkey,0,0,Friendly,St. Gallen,Switzerland,False,0,0,Draw
11708,12880,13835,1985,Costa Rica,Canada,0,0,FIFA World Cup qualification,San José,Costa Rica,False,0,0,Draw
11709,12881,13836,1985,Ghana,Ivory Coast,0,0,African Cup of Nations qualification,Kumasi,Ghana,False,0,0,Draw
11710,12882,13837,1985,Senegal,Zimbabwe,3,0,African Cup of Nations qualification,Dakar,Senegal,False,3,3,Senegal
11711,12884,13840,1985,Netherlands,Bulgaria,1,0,Friendly,Heerenveen,Netherlands,False,1,1,Netherlands
11712,12885,13841,1985,Bahrain,Syria,1,1,FIFA World Cup qualification,Riffa,Bahrain,False,2,0,Draw
11713,12886,13842,1985,DR Congo,Morocco,0,0,African Cup of Nations qualification,Lubumbashi,Zaïre,False,0,0,Draw
11714,12887,13843,1985,Honduras,Costa Rica,3,1,FIFA World Cup qualification,Tegucigalpa,Honduras,False,4,2,Honduras
11715,12888,13844,1985,Norway,Egypt,3,0,Friendly,Oslo,Norway,False,3,3,Norway
11716,12889,13845,1985,Wales,Scotland,1,1,FIFA World Cup qualification,Cardiff,Wales,False,2,0,Draw
11717,12890,13846,1985,Denmark,Sweden,0,3,Friendly,Copenhagen,Denmark,False,3,-3,Sweden
11718,12891,13847,1985,England,Romania,1,1,FIFA World Cup qualification,London,England,False,2,0,Draw
11719,12892,13849,1985,Poland,Belgium,0,0,FIFA World Cup qualification,Chorzów,Poland,False,0,0,Draw
11720,12893,13850,1985,Switzerland,Republic of Ireland,0,0,FIFA World Cup qualification,Berne,Switzerland,False,0,0,Draw
11721,12894,13851,1985,Turkey,Northern Ireland,0,0,FIFA World Cup qualification,Izmir,Turkey,False,0,0,Draw
11722,12895,13852,1985,Canada,Honduras,2,1,FIFA World Cup qualification,St. John's,Canada,False,3,1,Canada
11723,12896,13853,1985,Cameroon,Saudi Arabia,4,1,Friendly,Yaoundé,Cameroon,False,5,3,Cameroon
11724,12897,13854,1985,Mozambique,Libya,2,1,African Cup of Nations qualification,Maputo,Mozambique,False,3,1,Mozambique
11725,12900,13857,1985,Mexico,Peru,0,0,Friendly,Los Angeles,United States,True,0,0,Draw
11726,12901,13858,1985,Syria,Bahrain,1,0,FIFA World Cup qualification,Damascus,Syria,False,1,1,Syria
11727,12902,13859,1985,United Arab Emirates,Iraq,2,3,FIFA World Cup qualification,Dubai,United Arab Emirates,False,5,-1,Iraq
11728,12903,13860,1985,New Zealand,Australia,0,0,FIFA World Cup qualification,Auckland,New Zealand,False,0,0,Draw
11729,12904,13861,1985,Hong Kong,Japan,1,2,FIFA World Cup qualification,Siu Sai Wan,Hong Kong,False,3,-1,Japan
11730,12905,13862,1985,Mexico,Peru,1,0,Friendly,San Jose,United States,True,1,1,Mexico
11731,12906,13864,1985,Finland,Turkey,1,0,FIFA World Cup qualification,Tampere,Finland,False,1,1,Finland
11732,12907,13865,1985,Italy,Norway,1,2,Friendly,Lecce,Italy,False,3,-1,Norway
11733,12908,13866,1985,Luxembourg,Bulgaria,1,3,FIFA World Cup qualification,Luxembourg,Luxembourg,False,4,-2,Bulgaria
11734,12909,13867,1985,Russia,Denmark,1,0,FIFA World Cup qualification,Moscow,Soviet Union,True,1,1,Russia
11735,12910,13868,1985,Spain,Iceland,2,1,FIFA World Cup qualification,Seville,Spain,False,3,1,Spain
11736,12911,13869,1985,Sweden,Germany,2,2,FIFA World Cup qualification,Solna,Sweden,False,4,0,Draw
11737,12913,13871,1985,Iraq,United Arab Emirates,1,2,FIFA World Cup qualification,Ta'if,Saudi Arabia,True,3,-1,United Arab Emirates
11738,12914,13873,1985,Malawi,Uganda,1,0,CECAFA Cup,Bulawayo,Zimbabwe,True,1,1,Malawi
11739,12915,13874,1985,Saudi Arabia,Cameroon,2,1,Friendly,Ta'if,Saudi Arabia,False,3,1,Saudi Arabia
11740,12916,13875,1985,Zimbabwe,Tanzania,1,0,CECAFA Cup,Harare,Zimbabwe,False,1,1,Zimbabwe
11741,12918,13877,1985,Malawi,Zambia,2,2,CECAFA Cup,Bulawayo,Zimbabwe,True,4,0,Draw
11742,12919,13878,1985,Morocco,Libya,3,0,FIFA World Cup qualification,Rabat,Morocco,False,3,3,Morocco
11743,12920,13879,1985,Tunisia,Algeria,1,4,FIFA World Cup qualification,Tunis,Tunisia,False,5,-3,Algeria
11744,12921,13880,1985,Zimbabwe,Kenya,1,1,CECAFA Cup,Harare,Zimbabwe,False,2,0,Draw
11745,12922,13881,1985,Israel,Australia,1,2,FIFA World Cup qualification,Ramat-Gan,Israel,False,3,-1,Australia
11746,12923,13882,1985,Kenya,Tanzania,3,2,CECAFA Cup,Harare,Zimbabwe,True,5,1,Kenya
11747,12924,13883,1985,Uganda,Zambia,3,0,CECAFA Cup,Bulawayo,Zimbabwe,True,3,3,Uganda
11748,12925,13884,1985,Denmark,Switzerland,0,0,FIFA World Cup qualification,Copenhagen,Denmark,False,0,0,Draw
11749,12926,13885,1985,Paraguay,Chile,0,0,Friendly,Asunción,Paraguay,False,0,0,Draw
11750,12927,13886,1985,Kenya,Uganda,0,0,CECAFA Cup,Harare,Zimbabwe,True,0,0,Draw
11751,12928,13887,1985,Libya,Mexico,3,1,Friendly,Benghazi,Libya,False,4,2,Libya
11752,12929,13888,1985,Zimbabwe,Malawi,1,0,CECAFA Cup,Bulawayo,Zimbabwe,False,1,1,Zimbabwe
11753,12930,13889,1985,Malawi,Uganda,3,1,CECAFA Cup,Bulawayo,Zimbabwe,True,4,2,Malawi
11754,12931,13890,1985,Portugal,Malta,3,2,FIFA World Cup qualification,Lisbon,Portugal,False,5,1,Portugal
11755,12932,13891,1985,Brunei,Malaysia,0,4,Merlion Cup,Kallang,Singapore,True,4,-4,Malaysia
11756,12933,13892,1985,Zimbabwe,Kenya,2,0,CECAFA Cup,Harare,Zimbabwe,False,2,2,Zimbabwe
11757,12934,13893,1985,Yemen,Mexico,0,2,Friendly,Sana'a,Yemen AR,True,2,-2,Mexico
11758,12936,13895,1985,Belgium,Netherlands,1,0,FIFA World Cup qualification,Brussels,Belgium,False,1,1,Belgium
11759,12937,13897,1985,England,Turkey,5,0,FIFA World Cup qualification,London,England,False,5,5,England
11760,12938,13898,1985,Germany,Portugal,0,1,FIFA World Cup qualification,Stuttgart,Germany,False,1,-1,Portugal
11761,12939,13899,1985,Greece,Bulgaria,0,2,Friendly,Salonica,Greece,False,2,-2,Bulgaria
11762,12940,13900,1985,Norway,Denmark,1,5,FIFA World Cup qualification,Oslo,Norway,False,6,-4,Denmark
11763,12941,13901,1985,Peru,Paraguay,0,1,Friendly,Lima,Peru,False,1,-1,Paraguay
11764,12942,13902,1985,Romania,Northern Ireland,0,1,FIFA World Cup qualification,Bucharest,Romania,False,1,-1,Northern Ireland
11765,12943,13903,1985,Russia,Republic of Ireland,2,0,FIFA World Cup qualification,Moscow,Soviet Union,True,2,2,Russia
11766,12945,13905,1985,Singapore,Brunei,2,1,Merlion Cup,Kallang,Singapore,False,3,1,Singapore
11767,12946,13906,1985,Wales,Hungary,0,3,Friendly,Cardiff,Wales,False,3,-3,Hungary
11768,12947,13907,1985,Algeria,Tunisia,3,0,FIFA World Cup qualification,Algiers,Algeria,False,3,3,Algeria
11769,12948,13908,1985,Jordan,Mexico,0,0,Friendly,Amman,Jordan,False,0,0,Draw
11770,12949,13909,1985,Libya,Morocco,1,0,FIFA World Cup qualification,Bin Ghashir,Libya,False,1,1,Libya
11771,12950,13910,1985,Australia,Israel,1,1,FIFA World Cup qualification,Melbourne,Australia,False,2,0,Draw
11772,12951,13911,1985,Egypt,Mexico,2,1,Friendly,Cairo,Egypt,False,3,1,Egypt
11773,12952,13912,1985,Singapore,Malaysia,2,0,Merlion Cup,Kallang,Singapore,False,2,2,Singapore
11774,12954,13914,1985,Singapore,Malaysia,4,0,Merlion Cup,Kallang,Singapore,False,4,4,Singapore
11775,12955,13915,1985,Kuwait,Mexico,0,0,Friendly,Kuwait City,Kuwait,False,0,0,Draw
11776,12956,13916,1985,Burma,Indonesia,2,1,Friendly,Rangoon,Burma,False,3,1,Burma
11777,12958,13918,1985,New Zealand,Israel,3,1,FIFA World Cup qualification,Auckland,New Zealand,False,4,2,New Zealand
11778,12959,13919,1985,Chile,Peru,4,2,FIFA World Cup qualification,Santiago,Chile,False,6,2,Chile
11779,12960,13920,1985,Paraguay,Colombia,3,0,FIFA World Cup qualification,Asunción,Paraguay,False,3,3,Paraguay
11780,12961,13921,1985,Albania,Greece,1,1,FIFA World Cup qualification,Tirana,Albania,False,2,0,Draw
11781,12962,13922,1985,France,Luxembourg,6,0,FIFA World Cup qualification,Paris,France,False,6,6,France
11782,12963,13923,1985,Russia,Norway,1,0,FIFA World Cup qualification,Moscow,Soviet Union,True,1,1,Russia
11783,12964,13924,1985,Australia,New Zealand,2,0,FIFA World Cup qualification,Sydney,Australia,False,2,2,Australia
11784,12965,13925,1985,Colombia,Paraguay,2,1,FIFA World Cup qualification,Cali,Colombia,False,3,1,Colombia
11785,12966,13927,1985,Peru,Chile,0,1,FIFA World Cup qualification,Lima,Peru,False,1,-1,Chile
11786,12968,13929,1985,Angola,Mozambique,0,0,Friendly,Luanda,Angola,False,0,0,Draw
11787,12969,13930,1985,Angola,Zimbabwe,2,3,Friendly,Luanda,Angola,False,5,-1,Zimbabwe
11788,12970,13931,1985,Israel,New Zealand,3,0,FIFA World Cup qualification,Ramat-Gan,Israel,False,3,3,Israel
11789,12971,13932,1985,Paraguay,Chile,3,0,FIFA World Cup qualification,Asunción,Paraguay,False,3,3,Paraguay
11790,12972,13933,1985,Mozambique,Zimbabwe,1,2,Friendly,Luanda,Angola,True,3,-1,Zimbabwe
11791,12973,13934,1985,England,Northern Ireland,0,0,FIFA World Cup qualification,London,England,False,0,0,Draw
11792,12974,13935,1985,Republic of Ireland,Denmark,1,4,FIFA World Cup qualification,Dublin,Republic of Ireland,False,5,-3,Denmark
11793,12975,13936,1985,Switzerland,Norway,1,1,FIFA World Cup qualification,Lucerne,Switzerland,False,2,0,Draw
11794,12976,13937,1985,Turkey,Romania,1,3,FIFA World Cup qualification,Izmir,Turkey,False,4,-2,Romania
11795,12977,13938,1985,Mexico,Argentina,1,1,Friendly,Los Angeles,United States,True,2,0,Draw
11796,12978,13939,1985,Syria,Iraq,0,0,FIFA World Cup qualification,Damascus,Syria,False,0,0,Draw
11797,12980,13942,1985,Poland,Italy,1,0,Friendly,Chorzów,Poland,False,1,1,Poland
11798,12981,13943,1985,Chile,Paraguay,2,2,FIFA World Cup qualification,Santiago,Chile,False,4,0,Draw
11799,12983,13945,1985,Grenada,Dominica,0,0,Windward Islands Tournament,St. George's,Grenada,False,0,0,Draw
11800,12984,13946,1985,Malta,Sweden,1,2,FIFA World Cup qualification,Attard,Malta,False,3,-1,Sweden
11801,12985,13947,1985,Mexico,Argentina,1,1,Friendly,Puebla,Mexico,False,2,0,Draw
11802,12986,13948,1985,Saint Lucia,Saint Vincent and the Grenadines,0,0,Windward Islands Tournament,St. George's,Grenada,True,0,0,Draw
11803,12987,13949,1985,Dominica,Saint Vincent and the Grenadines,0,0,Windward Islands Tournament,St. George's,Grenada,True,0,0,Draw
11804,12988,13950,1985,DR Congo,Zambia,0,1,Friendly,Kinshasa,Zaïre,False,1,-1,Zambia
11805,12989,13951,1985,Egypt,Ivory Coast,0,1,Friendly,Kinshasa,Zaïre,True,1,-1,Ivory Coast
11806,12990,13952,1985,Netherlands,Belgium,2,1,FIFA World Cup qualification,Rotterdam,Netherlands,False,3,1,Netherlands
11807,12991,13953,1985,Scotland,Australia,2,0,FIFA World Cup qualification,Glasgow,Scotland,False,2,2,Scotland
11808,12992,13954,1985,Spain,Austria,0,0,Friendly,Zaragoza,Spain,False,0,0,Draw
11809,12993,13955,1985,DR Congo,Egypt,3,2,Friendly,Kinshasa,Zaïre,False,5,1,DR Congo
11810,12994,13956,1985,Ivory Coast,Zambia,0,1,Friendly,Kinshasa,Zaïre,True,1,-1,Zambia
11811,12995,13957,1985,Egypt,Zambia,1,0,Friendly,Kinshasa,Zaïre,True,1,1,Egypt
11812,12996,13958,1985,DR Congo,Ivory Coast,1,2,Friendly,Kinshasa,Zaïre,False,3,-1,Ivory Coast
11813,12997,13959,1985,Saint Kitts and Nevis,Dominica,2,1,Friendly,Basseterre,Saint Kitts and Nevis,False,3,1,Saint Kitts and Nevis
11814,12998,13960,1985,Congo,Ivory Coast,2,1,Friendly,Kinshasa,Zaïre,True,3,1,Congo
11815,12999,13961,1985,Congo,Ivory Coast,0,1,Friendly,Kinshasa,Zaïre,True,1,-1,Ivory Coast
11816,13000,13962,1985,Iraq,Syria,3,1,FIFA World Cup qualification,Ta'if,Saudi Arabia,True,4,2,Iraq
11817,13001,13963,1985,Dominica,Saint Kitts and Nevis,0,1,Friendly,Roseau,Dominica,False,1,-1,Saint Kitts and Nevis
11818,13003,13965,1985,Australia,Scotland,0,0,FIFA World Cup qualification,Melbourne,Australia,False,0,0,Draw
11819,13004,13966,1985,Gabon,Congo,1,0,UDEAC Cup,Libreville,Gabon,False,1,1,Gabon
11820,13005,13967,1985,Mexico,Algeria,2,0,Friendly,Mexico City,Mexico,False,2,2,Mexico
11821,13006,13968,1985,Cameroon,Equatorial Guinea,2,0,UDEAC Cup,Libreville,Gabon,True,2,2,Cameroon
11822,13007,13969,1985,Tunisia,Poland,1,0,Friendly,Tunis,Tunisia,False,1,1,Tunisia
11823,13008,13970,1985,Central African Republic,Congo,1,4,UDEAC Cup,Libreville,Gabon,True,5,-3,Congo
11824,13010,13972,1985,Chad,Equatorial Guinea,1,1,UDEAC Cup,Libreville,Gabon,True,2,0,Draw
11825,13012,13974,1985,Algeria,Hungary,1,3,Friendly,Monterrey,Mexico,True,4,-2,Hungary
11826,13013,13975,1985,Gabon,Central African Republic,4,0,UDEAC Cup,Libreville,Gabon,False,4,4,Gabon
11827,13014,13976,1985,Turkey,Poland,1,1,Friendly,Adana,Turkey,False,2,0,Draw
11828,13015,13977,1985,Chad,Cameroon,2,2,UDEAC Cup,Libreville,Gabon,True,4,0,Draw
11829,13017,13979,1985,Gabon,Chad,3,0,UDEAC Cup,Libreville,Gabon,False,3,3,Gabon
11830,13018,13980,1985,Mexico,Hungary,2,0,Friendly,Toluca,Mexico,False,2,2,Mexico
11831,13019,13981,1985,Congo,Cameroon,1,0,UDEAC Cup,Libreville,Gabon,True,1,1,Congo
11832,13020,13982,1985,Gambia,Guinea,0,0,Friendly,Bakau,Gambia,False,0,0,Draw
11833,13021,13983,1985,Chad,Cameroon,1,2,UDEAC Cup,Libreville,Gabon,True,3,-1,Cameroon
11834,13022,13984,1985,Spain,Bulgaria,2,0,Friendly,Valencia,Spain,False,2,2,Spain
11835,13023,13985,1985,Gabon,Congo,3,0,UDEAC Cup,Libreville,Gabon,False,3,3,Gabon
11836,13024,13986,1985,Senegal,Guinea,3,1,Friendly,Dakar,Senegal,False,4,2,Senegal
11837,13025,13987,1985,Ivory Coast,Guinea,1,0,Friendly,Dakar,Senegal,True,1,1,Ivory Coast
11838,13026,13988,1985,Senegal,Ivory Coast,2,0,Friendly,Dakar,Senegal,False,2,2,Senegal
11839,13028,13990,1986,Qatar,Greece,0,1,Friendly,Doha,Qatar,False,1,-1,Greece
11840,13029,13991,1986,Gabon,Senegal,0,1,Friendly,Libreville,Gabon,False,1,-1,Senegal
11841,13030,13992,1986,Portugal,Finland,1,1,Friendly,Leiria,Portugal,False,2,0,Draw
11842,13031,13993,1986,Spain,Russia,2,0,Friendly,Las Palmas,Spain,False,2,2,Spain
11843,13032,13994,1986,Qatar,Tunisia,2,1,Friendly,Doha,Qatar,False,3,1,Qatar
11844,13034,13996,1986,Oman,Tunisia,0,0,Friendly,Muscat,Oman,False,0,0,Draw
11845,13035,13998,1986,Israel,Scotland,0,1,Friendly,Ramat-Gan,Israel,False,1,-1,Scotland
11846,13036,13999,1986,Canada,Paraguay,0,0,Friendly,Vancouver,Canada,False,0,0,Draw
11847,13037,14000,1986,Egypt,England,0,4,Friendly,Cairo,Egypt,False,4,-4,England
11848,13038,14001,1986,India,Peru,0,1,Nehru Cup,Trivandrum,India,False,1,-1,Peru
11849,13039,14002,1986,Senegal,Guinea,2,1,Amílcar Cabral Cup,Dakar,Senegal,False,3,1,Senegal
11850,13040,14003,1986,Canada,Uruguay,1,3,Friendly,Miami,United States,True,4,-2,Uruguay
11851,13041,14004,1986,Gambia,Guinea-Bissau,3,0,Amílcar Cabral Cup,Dakar,Senegal,True,3,3,Gambia
11852,13042,14005,1986,Mauritania,Sierra Leone,0,1,Amílcar Cabral Cup,Dakar,Senegal,True,1,-1,Sierra Leone
11853,13043,14006,1986,Qatar,Hungary,0,3,Friendly,Doha,Qatar,False,3,-3,Hungary
11854,13044,14007,1986,Guinea,Mali,1,1,Amílcar Cabral Cup,Dakar,Senegal,True,2,0,Draw
11855,13045,14008,1986,Gambia,Sierra Leone,1,2,Amílcar Cabral Cup,Dakar,Senegal,True,3,-1,Sierra Leone
11856,13046,14009,1986,Guinea-Bissau,Mauritania,1,0,Amílcar Cabral Cup,Dakar,Senegal,True,1,1,Guinea-Bissau
11857,13047,14010,1986,Italy,Germany,1,2,Friendly,Avellino,Italy,False,3,-1,Germany
11858,13048,14011,1986,Jamaica,Paraguay,1,4,Friendly,Miami,United States,True,5,-3,Paraguay
11859,13049,14012,1986,Portugal,Luxembourg,2,0,Friendly,Portimão,Portugal,False,2,2,Portugal
11860,13050,14013,1986,Senegal,Mali,1,0,Amílcar Cabral Cup,Dakar,Senegal,False,1,1,Senegal
11861,13051,14014,1986,United States,Canada,0,0,Friendly,Miami,United States,False,0,0,Draw
11862,13052,14015,1986,Gambia,Mauritania,3,1,Amílcar Cabral Cup,Dakar,Senegal,True,4,2,Gambia
11863,13053,14016,1986,Guinea-Bissau,Sierra Leone,2,3,Amílcar Cabral Cup,Dakar,Senegal,True,5,-1,Sierra Leone
11864,13054,14017,1986,United States,Uruguay,1,1,Friendly,Miami,United States,False,2,0,Draw
11865,13055,14018,1986,Guinea,Sierra Leone,1,2,Amílcar Cabral Cup,Dakar,Senegal,True,3,-1,Sierra Leone
11866,13056,14019,1986,Senegal,Gambia,1,0,Amílcar Cabral Cup,Dakar,Senegal,False,1,1,Senegal
11867,13058,14021,1986,Senegal,Sierra Leone,3,1,Amílcar Cabral Cup,Dakar,Senegal,False,4,2,Senegal
11868,13060,14024,1986,Zambia,Botswana,6,0,Friendly,Ndola,Zambia,False,6,6,Zambia
11869,13061,14025,1986,Indonesia,Paraguay,2,3,Friendly,Jakarta,Indonesia,False,5,-1,Paraguay
11870,13062,14026,1986,Iran,Pakistan,2,0,Friendly,Teheran,Iran,False,2,2,Iran
11871,13063,14027,1986,Uruguay,Poland,2,2,Friendly,Montevideo,Uruguay,False,4,0,Draw
11872,13064,14028,1986,Zambia,Botswana,3,0,Friendly,Lusaka,Zambia,False,3,3,Zambia
11873,13065,14029,1986,Saudi Arabia,Algeria,0,0,Friendly,Khobar,Saudi Arabia,False,0,0,Draw
11874,13066,14030,1986,Greece,Cyprus,0,0,Friendly,Athens,Greece,False,0,0,Draw
11875,13067,14031,1986,Mexico,Russia,1,0,Friendly,Mexico City,Mexico,False,1,1,Mexico
11876,13068,14032,1986,Morocco,Bulgaria,0,0,Friendly,Rabat,Morocco,False,0,0,Draw
11877,13070,14034,1986,Spain,Belgium,3,0,Friendly,Elche,Spain,False,3,3,Spain
11878,13071,14035,1986,Iran,Ghana,2,0,Friendly,Teheran,Iran,False,2,2,Iran
11879,13072,14036,1986,Bahrain,Finland,0,0,Friendly,Manama,Bahrain,False,0,0,Draw
11880,13073,14037,1986,Saudi Arabia,Algeria,1,1,Friendly,Khobar,Saudi Arabia,False,2,0,Draw
11881,13074,14038,1986,Liberia,Burkina Faso,0,1,West African Cup,Accra,Ghana,True,1,-1,Burkina Faso
11882,13075,14039,1986,Bahrain,Finland,0,4,Friendly,Manama,Bahrain,False,4,-4,Finland
11883,13076,14040,1986,Burkina Faso,Togo,0,1,West African Cup,Accra,Ghana,True,1,-1,Togo
11884,13077,14041,1986,Ghana,Niger,2,0,West African Cup,Accra,Ghana,False,2,2,Ghana
11885,13078,14042,1986,Algeria,Mozambique,4,1,Friendly,Algiers,Algeria,False,5,3,Algeria
11886,13079,14043,1986,Ghana,Togo,2,2,West African Cup,Accra,Ghana,False,4,0,Draw
11887,13080,14044,1986,Liberia,Niger,3,0,West African Cup,Accra,Ghana,True,3,3,Liberia
11888,13081,14045,1986,Saudi Arabia,Wales,1,2,Friendly,Khobar,Saudi Arabia,False,3,-1,Wales
11889,13082,14046,1986,Burkina Faso,Niger,0,0,West African Cup,Accra,Ghana,True,0,0,Draw
11890,13083,14047,1986,France,Northern Ireland,0,0,Friendly,Paris,France,False,0,0,Draw
11891,13084,14048,1986,Ghana,Liberia,3,0,West African Cup,Accra,Ghana,False,3,3,Ghana
11892,13085,14049,1986,Grenada,Norway,1,2,Friendly,St. George's,Grenada,False,3,-1,Norway
11893,13086,14050,1986,Israel,England,1,2,Friendly,Ramat-Gan,Israel,False,3,-1,England
11894,13087,14051,1986,Qatar,Paraguay,1,1,Friendly,Doha,Qatar,False,2,0,Draw
11895,13088,14052,1986,Tunisia,Cameroon,1,1,Friendly,Tunis,Tunisia,False,2,0,Draw
11896,13089,14053,1986,Ghana,Burkina Faso,2,0,West African Cup,Accra,Ghana,False,2,2,Ghana
11897,13090,14054,1986,Togo,Liberia,1,0,West African Cup,Accra,Ghana,True,1,1,Togo
11898,13091,14055,1986,Egypt,Romania,2,2,Friendly,Alexandria,Egypt,False,4,0,Draw
11899,13092,14056,1986,Niger,Togo,3,1,West African Cup,Accra,Ghana,True,4,2,Niger
11900,13093,14057,1986,Saudi Arabia,Finland,0,1,Friendly,Khobar,Saudi Arabia,False,1,-1,Finland
11901,13094,14058,1986,Ghana,Burkina Faso,2,0,West African Cup,Accra,Ghana,False,2,2,Ghana
11902,13095,14059,1986,Qatar,Paraguay,0,3,Friendly,Doha,Qatar,False,3,-3,Paraguay
11903,13096,14060,1986,Saint Lucia,Norway,0,6,Friendly,Castries,Saint Lucia,False,6,-6,Norway
11904,13097,14061,1986,Togo,Niger,3,1,West African Cup,Accra,Ghana,True,4,2,Togo
11905,13098,14062,1986,Burkina Faso,Niger,1,2,West African Cup,Accra,Ghana,True,3,-1,Niger
11906,13099,14063,1986,Egypt,Romania,0,1,Friendly,Alexandria,Egypt,False,1,-1,Romania
11907,13100,14064,1986,Ghana,Togo,1,0,West African Cup,Accra,Ghana,False,1,1,Ghana
11908,13101,14065,1986,Guadeloupe,Norway,1,2,Friendly,Basse-Terre,Guadeloupe,False,3,-1,Norway
11909,13102,14066,1986,Martinique,Norway,0,1,Friendly,Fort-de-France,Martinique,False,1,-1,Norway
11910,13103,14067,1986,Thailand,Indonesia,1,1,King's Cup,Bangkok,Thailand,False,2,0,Draw
11911,13104,14068,1986,Mexico,Denmark,1,1,Friendly,Los Angeles,United States,True,2,0,Draw
11912,13105,14069,1986,Egypt,Senegal,0,1,African Cup of Nations,Cairo,Egypt,False,1,-1,Senegal
11913,13106,14070,1986,Ivory Coast,Mozambique,3,0,African Cup of Nations,Cairo,Egypt,True,3,3,Ivory Coast
11914,13107,14071,1986,Algeria,Morocco,0,0,African Cup of Nations,Alexandria,Egypt,True,0,0,Draw
11915,13108,14072,1986,Bahrain,Paraguay,1,2,Friendly,Manama,Bahrain,False,3,-1,Paraguay
11916,13109,14073,1986,Cameroon,Zambia,3,2,African Cup of Nations,Alexandria,Egypt,True,5,1,Cameroon
11917,13110,14074,1986,Egypt,Ivory Coast,2,0,African Cup of Nations,Cairo,Egypt,False,2,2,Egypt
11918,13111,14075,1986,Mozambique,Senegal,0,2,African Cup of Nations,Cairo,Egypt,True,2,-2,Senegal
11919,13112,14076,1986,Algeria,Zambia,0,0,African Cup of Nations,Alexandria,Egypt,True,0,0,Draw
11920,13113,14077,1986,Bahrain,Iceland,2,1,Friendly,Manama,Bahrain,False,3,1,Bahrain
11921,13114,14078,1986,Cameroon,Morocco,1,1,African Cup of Nations,Alexandria,Egypt,True,2,0,Draw
11922,13115,14080,1986,Germany,Brazil,2,0,Friendly,Frankfurt am Main,Germany,False,2,2,Germany
11923,13116,14081,1986,Saudi Arabia,Paraguay,0,0,Friendly,Khobar,Saudi Arabia,False,0,0,Draw
11924,13117,14082,1986,Turkey,Switzerland,1,0,Friendly,Adana,Turkey,False,1,1,Turkey
11925,13118,14083,1986,Egypt,Mozambique,2,0,African Cup of Nations,Cairo,Egypt,False,2,2,Egypt
11926,13119,14084,1986,Ivory Coast,Senegal,1,0,African Cup of Nations,Cairo,Egypt,True,1,1,Ivory Coast
11927,13120,14085,1986,Algeria,Cameroon,2,3,African Cup of Nations,Alexandria,Egypt,True,5,-1,Cameroon
11928,13121,14086,1986,Djibouti,Ethiopia,1,5,Friendly,Djibouti,Djibouti,False,6,-4,Ethiopia
11929,13122,14087,1986,Iraq,Romania,1,1,Friendly,Baghdad,Iraq,False,2,0,Draw
11930,13123,14088,1986,Morocco,Zambia,1,0,African Cup of Nations,Alexandria,Egypt,True,1,1,Morocco
11931,13124,14089,1986,Bahrain,Iceland,0,2,Friendly,Manama,Bahrain,False,2,-2,Iceland
11932,13125,14090,1986,Hungary,Brazil,3,0,Friendly,Budapest,Hungary,False,3,3,Hungary
11933,13126,14091,1986,Cameroon,Ivory Coast,1,0,African Cup of Nations,Alexandria,Egypt,True,1,1,Cameroon
11934,13127,14092,1986,Egypt,Morocco,1,0,African Cup of Nations,Cairo,Egypt,False,1,1,Egypt
11935,13128,14093,1986,Djibouti,Ethiopia,1,1,Friendly,Djibouti,Djibouti,False,2,0,Draw
11936,13129,14094,1986,Kuwait,Iceland,1,0,Friendly,Kuwait City,Kuwait,False,1,1,Kuwait
11937,13130,14095,1986,Ivory Coast,Morocco,3,2,African Cup of Nations,Cairo,Egypt,True,5,1,Ivory Coast
11938,13131,14096,1986,Egypt,Cameroon,0,0,African Cup of Nations,Cairo,Egypt,False,0,0,Draw
11939,13132,14097,1986,Bahrain,Iraq,0,0,Gulf Cup,Riffa,Bahrain,False,0,0,Draw
11940,13133,14098,1986,Qatar,Oman,2,1,Gulf Cup,Riffa,Bahrain,True,3,1,Qatar
11941,13134,14099,1986,Saudi Arabia,Kuwait,1,3,Gulf Cup,Riffa,Bahrain,True,4,-2,Kuwait
11942,13135,14100,1986,United Arab Emirates,Iraq,2,2,Gulf Cup,Riffa,Bahrain,True,4,0,Draw
11943,13136,14101,1986,Bahrain,Saudi Arabia,2,1,Gulf Cup,Riffa,Bahrain,False,3,1,Bahrain
11944,13137,14102,1986,Kuwait,Oman,2,0,Gulf Cup,Riffa,Bahrain,True,2,2,Kuwait
11945,13138,14103,1986,France,Argentina,2,0,Friendly,Paris,France,False,2,2,France
11946,13140,14105,1986,Republic of Ireland,Wales,0,1,Friendly,Dublin,Republic of Ireland,False,1,-1,Wales
11947,13141,14106,1986,Italy,Austria,2,1,Friendly,Udine,Italy,False,3,1,Italy
11948,13142,14107,1986,Northern Ireland,Denmark,1,1,Friendly,Belfast,Northern Ireland,False,2,0,Draw
11949,13143,14108,1986,Russia,England,0,1,Friendly,Tbilisi,Soviet Union,False,1,-1,England
11950,13144,14109,1986,Scotland,Romania,3,0,Friendly,Glasgow,Scotland,False,3,3,Scotland
11951,13145,14110,1986,Spain,Poland,3,0,Friendly,Cádiz,Spain,False,3,3,Spain
11952,13146,14111,1986,Qatar,Iraq,1,1,Gulf Cup,Riffa,Bahrain,True,2,0,Draw
11953,13147,14112,1986,Saudi Arabia,Oman,3,1,Gulf Cup,Riffa,Bahrain,True,4,2,Saudi Arabia
11954,13148,14113,1986,United Arab Emirates,Kuwait,0,1,Gulf Cup,Manama,Bahrain,True,1,-1,Kuwait
11955,13149,14114,1986,Bahrain,Qatar,0,0,Gulf Cup,Riffa,Bahrain,False,0,0,Draw
11956,13150,14115,1986,Iraq,Saudi Arabia,1,2,Gulf Cup,Riffa,Bahrain,True,3,-1,Saudi Arabia
11957,13151,14116,1986,Oman,United Arab Emirates,0,1,Gulf Cup,Riffa,Bahrain,True,1,-1,United Arab Emirates
11958,13152,14117,1986,Brazil,Peru,4,0,Friendly,São Luís,Brazil,False,4,4,Brazil
11959,13153,14118,1986,Kuwait,Qatar,2,1,Gulf Cup,Riffa,Bahrain,True,3,1,Kuwait
11960,13154,14119,1986,Bahrain,Oman,0,0,Gulf Cup,Riffa,Bahrain,False,0,0,Draw
11961,13155,14120,1986,Saudi Arabia,United Arab Emirates,0,2,Gulf Cup,Riffa,Bahrain,True,2,-2,United Arab Emirates
11962,13156,14121,1986,Iraq,Kuwait,1,2,Gulf Cup,Riffa,Bahrain,True,3,-1,Kuwait
11963,13157,14122,1986,Bahrain,United Arab Emirates,1,3,Gulf Cup,Riffa,Bahrain,False,4,-2,United Arab Emirates
11964,13158,14123,1986,Qatar,Saudi Arabia,0,2,Gulf Cup,Riffa,Bahrain,True,2,-2,Saudi Arabia
11965,13159,14124,1986,Oman,Iraq,2,3,Gulf Cup,Riffa,Bahrain,True,5,-1,Iraq
11966,13160,14125,1986,Bahrain,Kuwait,1,1,Gulf Cup,Riffa,Bahrain,False,2,0,Draw
11967,13161,14126,1986,Qatar,United Arab Emirates,3,2,Gulf Cup,Riffa,Bahrain,True,5,1,Qatar
11968,13163,14128,1986,Bulgaria,Denmark,3,0,Friendly,Sofia,Bulgaria,False,3,3,Bulgaria
11969,13164,14129,1986,Switzerland,Germany,0,1,Friendly,Basel,Switzerland,False,1,-1,Germany
11970,13165,14130,1986,Mexico,Uruguay,1,0,Friendly,Los Angeles,United States,True,1,1,Mexico
11971,13166,14131,1986,Brazil,Finland,3,0,Friendly,Brasília,Brazil,False,3,3,Brazil
11972,13167,14132,1986,Wales,Uruguay,0,0,Friendly,Wrexham,Wales,False,0,0,Draw
11973,13168,14133,1986,Belgium,Bulgaria,2,0,Friendly,Brussels,Belgium,False,2,2,Belgium
11974,13169,14135,1986,England,Scotland,2,1,Rous Cup,London,England,False,3,1,England
11975,13170,14136,1986,Republic of Ireland,Uruguay,1,1,Friendly,Dublin,Republic of Ireland,False,2,0,Draw
11976,13171,14137,1986,Northern Ireland,Morocco,2,1,Friendly,Belfast,Northern Ireland,False,3,1,Northern Ireland
11977,13172,14138,1986,Romania,Russia,2,1,Friendly,Timişoara,Romania,False,3,1,Romania
11978,13173,14140,1986,Pakistan,Sri Lanka,1,0,Friendly,Islamabad,Pakistan,False,1,1,Pakistan
11979,13175,14142,1986,Eswatini,Botswana,0,1,Friendly,Mbabane,Eswatini,False,1,-1,Botswana
11980,13176,14143,1986,Mexico,Canada,3,0,Friendly,Mexico City,Mexico,False,3,3,Mexico
11981,13177,14144,1986,Nepal,Sri Lanka,2,2,Friendly,Islamabad,Pakistan,True,4,0,Draw
11982,13179,14147,1986,Netherlands,Scotland,0,0,Friendly,Eindhoven,Netherlands,False,0,0,Draw
11983,13182,14151,1986,Norway,Argentina,1,0,Friendly,Oslo,Norway,False,1,1,Norway
11984,13183,14153,1986,Sweden,Greece,0,0,Friendly,Malmö,Sweden,False,0,0,Draw
11985,13184,14155,1986,Pakistan,Nepal,5,0,Friendly,Islamabad,Pakistan,False,5,5,Pakistan
11986,13185,14156,1986,Switzerland,Algeria,2,0,Friendly,Geneva,Switzerland,False,2,2,Switzerland
11987,13186,14157,1986,Brazil,Chile,1,1,Friendly,Curitiba,Brazil,False,2,0,Draw
11988,13187,14158,1986,Russia,Finland,0,0,Friendly,Moscow,Soviet Union,False,0,0,Draw
11989,13188,14159,1986,French Guiana,Réunion,0,0,Friendly,Gagny,France,True,0,0,Draw
11990,13189,14160,1986,Canada,Wales,2,0,Friendly,Toronto,Canada,False,2,2,Canada
11991,13192,14163,1986,Japan,Algeria,2,1,Kirin Cup,Matsuyama,Japan,False,3,1,Japan
11992,13193,14164,1986,Norway,Denmark,1,0,Friendly,Oslo,Norway,False,1,1,Norway
11993,13194,14165,1986,Austria,Sweden,1,0,Friendly,Salzburg,Austria,False,1,1,Austria
11994,13195,14166,1986,Germany,Netherlands,3,1,Friendly,Dortmund,Germany,False,4,2,Germany
11995,13196,14167,1986,Denmark,Poland,1,0,Friendly,Copenhagen,Denmark,False,1,1,Denmark
11996,13197,14168,1986,Mexico,England,0,3,Friendly,Los Angeles,United States,True,3,-3,England
11997,13199,14170,1986,Canada,Wales,0,3,Friendly,Vancouver,Canada,False,3,-3,Wales
11998,13200,14171,1986,Panama,Dominican Republic,2,1,Friendly,Panama City,Panama,False,3,1,Panama
11999,13201,14172,1986,Canada,England,0,1,Friendly,Burnaby,Canada,False,1,-1,England
12000,13202,14173,1986,Iceland,Republic of Ireland,1,2,Friendly,Reykjavík,Iceland,False,3,-1,Republic of Ireland
12001,13204,14177,1986,Bulgaria,Italy,1,1,FIFA World Cup,Mexico City,Mexico,True,2,0,Draw
12002,13205,14178,1986,Macau,Hong Kong,2,3,Friendly,Macau,Macau,False,5,-1,Hong Kong
12003,13206,14179,1986,Canada,France,0,1,FIFA World Cup,León,Mexico,True,1,-1,France
12004,13207,14180,1986,Spain,Brazil,0,1,FIFA World Cup,Guadalajara,Mexico,True,1,-1,Brazil
12005,13209,14182,1986,Morocco,Poland,0,0,FIFA World Cup,Monterrey,Mexico,True,0,0,Draw
12006,13210,14183,1986,Russia,Hungary,6,0,FIFA World Cup,Irapuato,Mexico,True,6,6,Russia
12007,13211,14184,1986,Algeria,Northern Ireland,1,1,FIFA World Cup,Guadalajara,Mexico,True,2,0,Draw
12008,13212,14185,1986,Djibouti,Ethiopia,0,2,Friendly,Djibouti,Djibouti,False,2,-2,Ethiopia
12009,13213,14186,1986,Mexico,Belgium,2,1,FIFA World Cup,Mexico City,Mexico,False,3,1,Mexico
12010,13214,14187,1986,Portugal,England,1,0,FIFA World Cup,Monterrey,Mexico,True,1,1,Portugal
12011,13215,14188,1986,Nepal,Hong Kong,4,2,Friendly,Kathmandu,Nepal,False,6,2,Nepal
12012,13216,14189,1986,Paraguay,Iraq,1,0,FIFA World Cup,Toluca,Mexico,True,1,1,Paraguay
12013,13217,14190,1986,Romania,Norway,3,1,Friendly,Bucharest,Romania,False,4,2,Romania
12014,13218,14191,1986,Scotland,Denmark,0,1,FIFA World Cup,Nezahualcóyotl,Mexico,True,1,-1,Denmark
12015,13219,14192,1986,Uruguay,Germany,1,1,FIFA World Cup,Querétaro,Mexico,True,2,0,Draw
12016,13220,14193,1986,France,Russia,1,1,FIFA World Cup,León,Mexico,True,2,0,Draw
12017,13221,14194,1986,Italy,Argentina,1,1,FIFA World Cup,Puebla,Mexico,True,2,0,Draw
12018,13222,14196,1986,Brazil,Algeria,1,0,FIFA World Cup,Guadalajara,Mexico,True,1,1,Brazil
12019,13223,14197,1986,England,Morocco,0,0,FIFA World Cup,Monterrey,Mexico,True,0,0,Draw
12020,13224,14198,1986,Hungary,Canada,2,0,FIFA World Cup,Irapuato,Mexico,True,2,2,Hungary
12021,13225,14199,1986,Mauritius,Réunion,0,1,Friendly,Curepipe,Mauritius,False,1,-1,Réunion
12022,13226,14200,1986,Mexico,Paraguay,1,1,FIFA World Cup,Mexico City,Mexico,False,2,0,Draw
12023,13227,14201,1986,Nepal,Bhutan,4,0,Friendly,Kathmandu,Nepal,False,4,4,Nepal
12024,13228,14202,1986,Northern Ireland,Spain,1,2,FIFA World Cup,Guadalajara,Mexico,True,3,-1,Spain
12025,13229,14203,1986,Poland,Portugal,1,0,FIFA World Cup,Monterrey,Mexico,True,1,1,Poland
12026,13230,14204,1986,Denmark,Uruguay,6,1,FIFA World Cup,Nezahualcóyotl,Mexico,True,7,5,Denmark
12027,13231,14205,1986,Germany,Scotland,2,1,FIFA World Cup,Querétaro,Mexico,True,3,1,Germany
12028,13232,14206,1986,Iraq,Belgium,1,2,FIFA World Cup,Toluca,Mexico,True,3,-1,Belgium
12029,13233,14207,1986,Hungary,France,0,3,FIFA World Cup,León,Mexico,True,3,-3,France
12030,13234,14208,1986,Russia,Canada,2,0,FIFA World Cup,Irapuato,Mexico,True,2,2,Russia
12031,13235,14209,1986,Argentina,Bulgaria,2,0,FIFA World Cup,Mexico City,Mexico,True,2,2,Argentina
12032,13236,14211,1986,England,Poland,3,0,FIFA World Cup,Monterrey,Mexico,True,3,3,England
12033,13237,14212,1986,Guyana,Barbados,2,1,Friendly,Georgetown,Guyana,False,3,1,Guyana
12034,13238,14213,1986,Mexico,Iraq,1,0,FIFA World Cup,Mexico City,Mexico,False,1,1,Mexico
12035,13239,14214,1986,Paraguay,Belgium,2,2,FIFA World Cup,Toluca,Mexico,True,4,0,Draw
12036,13240,14215,1986,Portugal,Morocco,1,3,FIFA World Cup,Guadalajara,Mexico,True,4,-2,Morocco
12037,13241,14216,1986,Algeria,Spain,0,3,FIFA World Cup,Monterrey,Mexico,True,3,-3,Spain
12038,13242,14217,1986,Northern Ireland,Brazil,0,3,FIFA World Cup,Guadalajara,Mexico,True,3,-3,Brazil
12039,13243,14218,1986,Denmark,Germany,2,0,FIFA World Cup,Querétaro,Mexico,True,2,2,Denmark
12040,13244,14219,1986,Réunion,Mauritius,0,0,Friendly,Saint-Pierre,Réunion,False,0,0,Draw
12041,13245,14220,1986,Scotland,Uruguay,0,0,FIFA World Cup,Nezahualcóyotl,Mexico,True,0,0,Draw
12042,13246,14221,1986,Mexico,Bulgaria,2,0,FIFA World Cup,Mexico City,Mexico,False,2,2,Mexico
12043,13247,14222,1986,Russia,Belgium,3,4,FIFA World Cup,León,Mexico,True,7,-1,Belgium
12044,13248,14223,1986,Argentina,Uruguay,1,0,FIFA World Cup,Puebla,Mexico,True,1,1,Argentina
12045,13249,14224,1986,Brazil,Poland,4,0,FIFA World Cup,Guadalajara,Mexico,True,4,4,Brazil
12046,13250,14225,1986,Italy,France,0,2,FIFA World Cup,Mexico City,Mexico,True,2,-2,France
12047,13251,14226,1986,Morocco,Germany,0,1,FIFA World Cup,Monterrey,Mexico,True,1,-1,Germany
12048,13252,14227,1986,Denmark,Spain,1,5,FIFA World Cup,Querétaro,Mexico,True,6,-4,Spain
12049,13253,14228,1986,England,Paraguay,3,0,FIFA World Cup,Mexico City,Mexico,True,3,3,England
12050,13254,14229,1986,Brazil,France,1,1,FIFA World Cup,Guadalajara,Mexico,True,2,0,Draw
12051,13255,14230,1986,Malawi,Zambia,0,2,Friendly,Blantyre,Malawi,False,2,-2,Zambia
12052,13256,14231,1986,Mexico,Germany,0,0,FIFA World Cup,Monterrey,Mexico,False,0,0,Draw
12053,13257,14232,1986,Argentina,England,2,1,FIFA World Cup,Mexico City,Mexico,True,3,1,Argentina
12054,13258,14233,1986,Malawi,Zambia,0,1,Friendly,Lilongwe,Malawi,False,1,-1,Zambia
12055,13259,14234,1986,Spain,Belgium,1,1,FIFA World Cup,Puebla,Mexico,True,2,0,Draw
12056,13260,14235,1986,Argentina,Belgium,2,0,FIFA World Cup,Mexico City,Mexico,True,2,2,Argentina
12057,13261,14236,1986,France,Germany,0,2,FIFA World Cup,Guadalajara,Mexico,True,2,-2,Germany
12058,13262,14237,1986,France,Belgium,4,2,FIFA World Cup,Puebla,Mexico,True,6,2,France
12059,13263,14238,1986,Argentina,Germany,3,2,FIFA World Cup,Mexico City,Mexico,True,5,1,Argentina
12060,13264,14239,1986,Burma,India,3,1,Friendly,Rangoon,Burma,False,4,2,Burma
12061,13265,14240,1986,Malawi,Uganda,2,1,Friendly,Blantyre,Malawi,False,3,1,Malawi
12062,13266,14241,1986,Malawi,Uganda,0,0,Friendly,Lilongwe,Malawi,False,0,0,Draw
12063,13267,14242,1986,Malawi,Uganda,0,0,Friendly,Mzuzu,Malawi,False,0,0,Draw
12064,13269,14244,1986,Malaysia,India,3,0,Merdeka Tournament,Kuala Lumpur,Malaysia,False,3,3,Malaysia
12065,13270,14245,1986,Japan,Syria,2,1,Merdeka Tournament,Kuala Lumpur,Malaysia,True,3,1,Japan
12066,13272,14247,1986,Liberia,Guinea,0,0,Friendly,Monrovia,Liberia,False,0,0,Draw
12067,13273,14248,1986,Malaysia,Thailand,2,0,Merdeka Tournament,Kuala Lumpur,Malaysia,False,2,2,Malaysia
12068,13274,14249,1986,Nigeria,Togo,2,2,Friendly,Monrovia,Liberia,True,4,0,Draw
12069,13275,14250,1986,Guinea,Ivory Coast,0,2,Friendly,Monrovia,Liberia,True,2,-2,Ivory Coast
12070,13276,14252,1986,Ghana,Nigeria,2,0,Friendly,Paynesville,Liberia,True,2,2,Ghana
12071,13277,14253,1986,India,Thailand,3,1,Merdeka Tournament,Kuala Lumpur,Malaysia,True,4,2,India
12072,13278,14254,1986,Liberia,Ivory Coast,0,2,Friendly,Monrovia,Liberia,False,2,-2,Ivory Coast
12073,13279,14256,1986,Ghana,Togo,1,1,Friendly,Monrovia,Liberia,True,2,0,Draw
12074,13280,14257,1986,Liberia,Guinea,2,1,Friendly,Monrovia,Liberia,False,3,1,Liberia
12075,13281,14258,1986,Malaysia,Japan,2,1,Merdeka Tournament,Kuala Lumpur,Malaysia,False,3,1,Malaysia
12076,13282,14259,1986,Ghana,Ivory Coast,0,1,Friendly,Monrovia,Liberia,True,1,-1,Ivory Coast
12077,13283,14260,1986,Liberia,Togo,1,0,Friendly,Monrovia,Liberia,False,1,1,Liberia
12078,13286,14263,1986,Finland,Sweden,1,3,Friendly,Helsinki,Finland,False,4,-2,Sweden
12079,13288,14265,1986,Bahrain,Oman,2,3,Friendly,Manama,Bahrain,False,5,-1,Oman
12080,13289,14266,1986,Senegal,Gabon,1,0,Friendly,Dakar,Senegal,False,1,1,Senegal
12081,13290,14267,1986,Bahrain,Oman,2,0,Friendly,Manama,Bahrain,False,2,2,Bahrain
12082,13291,14268,1986,Guinea,Gambia,2,1,African Cup of Nations qualification,Conakry,Guinea,False,3,1,Guinea
12083,13292,14269,1986,Switzerland,France,2,0,Friendly,Lausanne,Switzerland,False,2,2,Switzerland
12084,13294,14271,1986,Indonesia,Algeria,0,1,Indonesia Tournament,Jakarta,Indonesia,False,1,-1,Algeria
12085,13295,14272,1986,Norway,Romania,2,2,Friendly,Oslo,Norway,False,4,0,Draw
12086,13296,14273,1986,Sweden,Russia,0,0,Friendly,Gothenburg,Sweden,False,0,0,Draw
12087,13297,14274,1986,Malaysia,Algeria,2,2,Friendly,Kuala Lumpur,Malaysia,False,4,0,Draw
12088,13298,14276,1986,Oman,Bahrain,1,0,Friendly,Muscat,Oman,False,1,1,Oman
12089,13299,14277,1986,Singapore,Canada,0,1,Merlion Cup,Kallang,Singapore,False,1,-1,Canada
12090,13300,14278,1986,Oman,Bahrain,1,2,Friendly,Muscat,Oman,False,3,-1,Bahrain
12091,13301,14279,1986,Austria,Switzerland,1,1,Friendly,Innsbruck,Austria,False,2,0,Draw
12092,13303,14281,1986,Gambia,Guinea,0,1,African Cup of Nations qualification,Banjul,Gambia,False,1,-1,Guinea
12093,13308,14288,1986,Singapore,Canada,0,1,Merlion Cup,Kallang,Singapore,False,1,-1,Canada
12094,13309,14289,1986,Singapore,Saudi Arabia,0,4,Friendly,Kallang,Singapore,False,4,-4,Saudi Arabia
12095,13310,14290,1986,Norway,Hungary,0,0,Friendly,Oslo,Norway,False,0,0,Draw
12096,13311,14291,1986,Belgium,Republic of Ireland,2,2,UEFA Euro qualification,Brussels,Belgium,False,4,0,Draw
12097,13312,14293,1986,Finland,Wales,1,1,UEFA Euro qualification,Helsinki,Finland,False,2,0,Draw
12098,13313,14295,1986,Iceland,France,0,0,UEFA Euro qualification,Reykjavík,Iceland,False,0,0,Draw
12099,13314,14296,1986,Romania,Austria,4,0,UEFA Euro qualification,Bucharest,Romania,False,4,4,Romania
12100,13315,14297,1986,Scotland,Bulgaria,0,0,UEFA Euro qualification,Glasgow,Scotland,False,0,0,Draw
12101,13316,14298,1986,Sweden,England,1,0,Friendly,Solna,Sweden,False,1,1,Sweden
12102,13317,14299,1986,Fiji,New Zealand,2,4,Friendly,Lautoka,Fiji,False,6,-2,New Zealand
12103,13318,14300,1986,Fiji,New Zealand,1,2,Friendly,Suva,Fiji,False,3,-1,New Zealand
12104,13319,14301,1986,Iran,Thailand,4,0,Friendly,Seoul,South Korea,True,4,4,Iran
12105,13320,14302,1986,Uganda,Rwanda,1,0,Friendly,Kampala,Uganda,False,1,1,Uganda
12106,13321,14303,1986,Denmark,Germany,0,2,Friendly,Copenhagen,Denmark,False,2,-2,Germany
12107,13322,14304,1986,Iceland,Russia,1,1,UEFA Euro qualification,Reykjavík,Iceland,False,2,0,Draw
12108,13324,14306,1986,Spain,Greece,3,1,Friendly,Gijón,Spain,False,4,2,Spain
12109,13325,14307,1986,Sweden,Switzerland,2,0,UEFA Euro qualification,Solna,Sweden,False,2,2,Sweden
12110,13326,14308,1986,Zambia,DR Congo,2,2,Friendly,Ndola,Zambia,False,4,0,Draw
12111,13327,14309,1986,Zambia,DR Congo,0,1,Friendly,Lusaka,Zambia,False,1,-1,DR Congo
12112,13328,14310,1986,Botswana,Malawi,2,0,Friendly,Gaborone,Botswana,False,2,2,Botswana
12113,13329,14311,1986,Angola,Gabon,1,0,African Cup of Nations qualification,Luanda,Angola,False,1,1,Angola
12114,13330,14312,1986,Central African Republic,Congo,1,2,African Cup of Nations qualification,Bangui,Central African Republic,False,3,-1,Congo
12115,13331,14313,1986,Ethiopia,Tanzania,4,2,African Cup of Nations qualification,Addis Abeba,Ethiopia,False,6,2,Ethiopia
12116,13332,14314,1986,Kenya,Somalia,2,1,Friendly,Nairobi,Kenya,False,3,1,Kenya
12117,13334,14316,1986,Israel,Romania,2,4,Friendly,Ramat-Gan,Israel,False,6,-2,Romania
12118,13335,14317,1986,Italy,Greece,2,0,Friendly,Bologna,Italy,False,2,2,Italy
12119,13336,14318,1986,France,Russia,0,2,UEFA Euro qualification,Paris,France,False,2,-2,Russia
12120,13337,14319,1986,Uganda,Kenya,3,1,Friendly,Kampala,Uganda,False,4,2,Uganda
12121,13338,14320,1986,Portugal,Sweden,1,1,UEFA Euro qualification,Oeiras,Portugal,False,2,0,Draw
12122,13339,14321,1986,Luxembourg,Belgium,0,6,UEFA Euro qualification,Luxembourg,Luxembourg,False,6,-6,Belgium
12123,13340,14322,1986,Austria,Albania,3,0,UEFA Euro qualification,Graz,Austria,False,3,3,Austria
12124,13341,14324,1986,England,Northern Ireland,3,0,UEFA Euro qualification,London,England,False,3,3,England
12125,13342,14325,1986,Germany,Spain,2,2,Friendly,Hanover,Germany,False,4,0,Draw
12126,13343,14326,1986,Hungary,Netherlands,0,1,UEFA Euro qualification,Budapest,Hungary,False,1,-1,Netherlands
12127,13344,14327,1986,Republic of Ireland,Scotland,0,0,UEFA Euro qualification,Dublin,Republic of Ireland,False,0,0,Draw
12128,13345,14328,1986,Poland,Greece,2,1,UEFA Euro qualification,Poznań,Poland,False,3,1,Poland
12129,13346,14329,1986,Congo,Central African Republic,5,1,African Cup of Nations qualification,Brazzaville,Congo,False,6,4,Congo
12130,13347,14330,1986,Gabon,Angola,1,0,African Cup of Nations qualification,Libreville,Gabon,False,1,1,Gabon
12131,13348,14331,1986,Liberia,Sierra Leone,1,1,African Cup of Nations qualification,Monrovia,Liberia,False,2,0,Draw
12132,13349,14332,1986,Somalia,Uganda,0,0,African Cup of Nations qualification,Mogadishu,Somalia,False,0,0,Draw
12133,13350,14333,1986,New Zealand,Australia,1,1,Friendly,Auckland,New Zealand,False,2,0,Draw
12134,13351,14334,1986,Honduras,Panama,1,0,Friendly,Managua,Nicaragua,True,1,1,Honduras
12135,13352,14335,1986,Austria,Germany,4,1,Friendly,Vienna,Austria,False,5,3,Austria
12136,13353,14336,1986,Denmark,Finland,1,0,UEFA Euro qualification,Copenhagen,Denmark,False,1,1,Denmark
12137,13354,14338,1986,Russia,Norway,4,0,UEFA Euro qualification,Simferopol,Soviet Union,False,4,4,Russia
12138,13355,14339,1986,Switzerland,Portugal,1,1,UEFA Euro qualification,Berne,Switzerland,False,2,0,Draw
12139,13356,14340,1986,Tunisia,Bulgaria,3,3,Friendly,Tunis,Tunisia,False,6,0,Draw
12140,13357,14342,1986,Cuba,Panama,1,1,Friendly,Managua,Nicaragua,True,2,0,Draw
12141,13358,14343,1986,Australia,New Zealand,2,1,Friendly,Sydney,Australia,False,3,1,Australia
12142,13360,14346,1986,Greece,Hungary,2,1,UEFA Euro qualification,Athens,Greece,False,3,1,Greece
12143,13361,14347,1986,Poland,Republic of Ireland,1,0,Friendly,Warsaw,Poland,False,1,1,Poland
12144,13362,14348,1986,Scotland,Luxembourg,3,0,UEFA Euro qualification,Glasgow,Scotland,False,3,3,Scotland
12145,13363,14349,1986,Spain,Romania,1,0,UEFA Euro qualification,Seville,Spain,False,1,1,Spain
12146,13364,14350,1986,Turkey,Northern Ireland,0,0,UEFA Euro qualification,Izmir,Turkey,False,0,0,Draw
12147,13365,14351,1986,Italy,Switzerland,3,2,UEFA Euro qualification,Milan,Italy,False,5,1,Italy
12148,13366,14352,1986,Malta,Sweden,0,5,UEFA Euro qualification,Attard,Malta,False,5,-5,Sweden
12149,13367,14353,1986,Belgium,Bulgaria,1,1,UEFA Euro qualification,Brussels,Belgium,False,2,0,Draw
12150,13368,14355,1986,Netherlands,Poland,0,0,UEFA Euro qualification,Amsterdam,Netherlands,False,0,0,Draw
12151,13369,14357,1986,Kenya,Rwanda,2,3,Friendly,Nairobi,Kenya,False,5,-1,Rwanda
12152,13370,14358,1986,Albania,Spain,1,2,UEFA Euro qualification,Tirana,Albania,False,3,-1,Spain
12153,13371,14359,1986,Cyprus,Greece,2,4,UEFA Euro qualification,Nicosia,Cyprus,False,6,-2,Greece
12154,13372,14360,1986,Nepal,Bangladesh,1,0,Friendly,Kathmandu,Nepal,False,1,1,Nepal
12155,13373,14362,1986,Malta,Italy,0,2,UEFA Euro qualification,Attard,Malta,False,2,-2,Italy
12156,13374,14363,1986,Angola,Tanzania,1,0,Friendly,Luanda,Angola,False,1,1,Angola
12157,13375,14364,1986,Equatorial Guinea,Cameroon,0,2,UDEAC Cup,Malabo,Equatorial Guinea,False,2,-2,Cameroon
12158,13376,14365,1986,Angola,Zambia,0,1,Friendly,Luanda,Angola,False,1,-1,Zambia
12159,13377,14366,1986,Congo,Gabon,0,1,UDEAC Cup,Malabo,Equatorial Guinea,True,1,-1,Gabon
12160,13378,14367,1986,Algeria,Ivory Coast,2,1,Friendly,Algiers,Algeria,False,3,1,Algeria
12161,13379,14368,1986,Chad,Cameroon,1,3,UDEAC Cup,Malabo,Equatorial Guinea,True,4,-2,Cameroon
12162,13381,14370,1986,Saint Lucia,Saint Vincent and the Grenadines,5,1,Windward Islands Tournament,Castries,Saint Lucia,False,6,4,Saint Lucia
12163,13382,14371,1986,Central African Republic,Congo,1,3,UDEAC Cup,Malabo,Equatorial Guinea,True,4,-2,Congo
12164,13383,14372,1986,Equatorial Guinea,Chad,0,1,UDEAC Cup,Malabo,Equatorial Guinea,False,1,-1,Chad
12165,13384,14373,1986,Algeria,Ivory Coast,2,1,Friendly,Mascara,Algeria,False,3,1,Algeria
12166,13385,14374,1986,Central African Republic,Gabon,0,1,UDEAC Cup,Malabo,Equatorial Guinea,True,1,-1,Gabon
12167,13386,14375,1986,Congo,Cameroon,0,1,UDEAC Cup,Malabo,Equatorial Guinea,True,1,-1,Cameroon
12168,13387,14376,1986,Chad,Gabon,0,0,UDEAC Cup,Malabo,Equatorial Guinea,True,0,0,Draw
12169,13388,14377,1986,Chad,Cameroon,1,4,UDEAC Cup,Malabo,Equatorial Guinea,True,5,-3,Cameroon
12170,13389,14378,1986,Cyprus,Netherlands,0,2,UEFA Euro qualification,Limassol,Cyprus,False,2,-2,Netherlands
12171,13390,14379,1987,Barbados,Saint Vincent and the Grenadines,3,0,Friendly,Bridgetown,Barbados,False,3,3,Barbados
12172,13391,14380,1987,Portugal,Greece,1,1,Friendly,Portalegre,Portugal,False,2,0,Draw
12173,13392,14381,1987,El Salvador,Mexico,1,3,Friendly,Los Angeles,United States,True,4,-2,Mexico
12174,13393,14382,1987,Greece,Cyprus,3,1,UEFA Euro qualification,Athens,Greece,False,4,2,Greece
12175,13395,14384,1987,Mali,Burkina Faso,2,0,Friendly,Bamako,Mali,False,2,2,Mali
12176,13396,14385,1987,Guinea,Mali,1,0,Friendly,Conakry,Guinea,False,1,1,Guinea
12177,13397,14386,1987,Spain,Netherlands,1,1,Friendly,Barcelona,Spain,False,2,0,Draw
12178,13398,14387,1987,Italy,Malta,5,0,UEFA Euro qualification,Bergamo,Italy,False,5,5,Italy
12179,13399,14388,1987,Niger,Mali,1,0,Friendly,Niamey,Niger,False,1,1,Niger
12180,13400,14389,1987,Nigeria,Syria,1,0,Nehru Cup,Calicut,India,True,1,1,Nigeria
12181,13401,14390,1987,Saint Lucia,Guyana,1,3,Friendly,Castries,Saint Lucia,False,4,-2,Guyana
12182,13402,14391,1987,Ivory Coast,Ghana,0,2,West African Cup,Monrovia,Liberia,True,2,-2,Ghana
12183,13403,14392,1987,Liberia,Burkina Faso,2,0,West African Cup,Monrovia,Liberia,False,2,2,Liberia
12184,13404,14393,1987,Niger,Ghana,0,4,West African Cup,Monrovia,Liberia,True,4,-4,Ghana
12185,13405,14394,1987,Liberia,Benin,0,0,West African Cup,Monrovia,Liberia,False,0,0,Draw
12186,13406,14395,1987,Niger,Ivory Coast,0,1,West African Cup,Monrovia,Liberia,True,1,-1,Ivory Coast
12187,13407,14396,1987,Portugal,Belgium,1,0,Friendly,Braga,Portugal,False,1,1,Portugal
12188,13408,14397,1987,Burkina Faso,Benin,3,2,West African Cup,Monrovia,Liberia,True,5,1,Burkina Faso
12189,13409,14398,1987,Cayman Islands,Jamaica,1,3,Friendly,George Town,Cayman Islands,False,4,-2,Jamaica
12190,13410,14399,1987,Tunisia,Austria,1,3,Friendly,Tunis,Tunisia,False,4,-2,Austria
12191,13411,14400,1987,Cyprus,Hungary,0,1,UEFA Euro qualification,Nicosia,Cyprus,False,1,-1,Hungary
12192,13412,14401,1987,Liberia,Ghana,1,2,West African Cup,Monrovia,Liberia,False,3,-1,Ghana
12193,13413,14402,1987,Portugal,Italy,0,1,UEFA Euro qualification,Oeiras,Portugal,False,1,-1,Italy
12194,13414,14403,1987,Kuwait,Algeria,2,0,Friendly,Kuwait City,Kuwait,False,2,2,Kuwait
12195,13415,14404,1987,Israel,Northern Ireland,1,1,Friendly,Ramat-Gan,Israel,False,2,0,Draw
12196,13416,14405,1987,Scotland,Republic of Ireland,0,1,UEFA Euro qualification,Glasgow,Scotland,False,1,-1,Republic of Ireland
12197,13417,14406,1987,Spain,England,2,4,Friendly,Madrid,Spain,False,6,-2,England
12198,13418,14407,1987,Wales,Russia,0,0,Friendly,Swansea,Wales,False,0,0,Draw
12199,13419,14408,1987,Panama,Cuba,1,0,Friendly,Panama City,Panama,False,1,1,Panama
12200,13420,14409,1987,Thailand,Oman,2,0,King's Cup,Bangkok,Thailand,False,2,2,Thailand
12201,13421,14411,1987,Kuwait,Iraq,2,0,Friendly,Kuwait City,Kuwait,False,2,2,Kuwait
12202,13422,14412,1987,Guinea,Mauritania,1,0,Amílcar Cabral Cup,Conakry,Guinea,False,1,1,Guinea
12203,13423,14413,1987,Guinea-Bissau,Mali,0,0,Amílcar Cabral Cup,Conakry,Guinea,True,0,0,Draw
12204,13424,14414,1987,Panama,Cuba,1,3,Friendly,Panama City,Panama,False,4,-2,Cuba
12205,13425,14415,1987,Senegal,Sierra Leone,0,1,Amílcar Cabral Cup,Conakry,Guinea,True,1,-1,Sierra Leone
12206,13426,14416,1987,Guinea,Mali,0,0,Amílcar Cabral Cup,Conakry,Guinea,False,0,0,Draw
12207,13427,14417,1987,Guinea-Bissau,Mauritania,1,1,Amílcar Cabral Cup,Conakry,Guinea,True,2,0,Draw
12208,13428,14419,1987,Dominican Republic,Panama,0,2,Friendly,Santo Domingo,Dominican Republic,False,2,-2,Panama
12209,13429,14420,1987,Guinea,Guinea-Bissau,0,0,Amílcar Cabral Cup,Conakry,Guinea,False,0,0,Draw
12210,13430,14421,1987,Kuwait,Iceland,1,1,Friendly,Kuwait City,Kuwait,False,2,0,Draw
12211,13431,14422,1987,Mali,Mauritania,1,0,Amílcar Cabral Cup,Conakry,Guinea,True,1,1,Mali
12212,13432,14424,1987,Dominican Republic,Panama,1,2,Friendly,Santo Domingo,Dominican Republic,False,3,-1,Panama
12213,13433,14425,1987,Dominican Republic,Panama,1,1,Friendly,Santo Domingo,Dominican Republic,False,2,0,Draw
12214,13434,14426,1987,Kuwait,Iceland,0,1,Friendly,Kuwait City,Kuwait,False,1,-1,Iceland
12215,13435,14427,1987,Guinea,Senegal,1,0,Amílcar Cabral Cup,Conakry,Guinea,False,1,1,Guinea
12216,13436,14428,1987,Mali,Sierra Leone,0,0,Amílcar Cabral Cup,Conakry,Guinea,True,0,0,Draw
12217,13437,14429,1987,Senegal,Sierra Leone,0,0,Amílcar Cabral Cup,Conakry,Guinea,True,0,0,Draw
12218,13438,14430,1987,Dominican Republic,Panama,0,1,Friendly,Santo Domingo,Dominican Republic,False,1,-1,Panama
12219,13439,14431,1987,Guinea,Mali,1,0,Amílcar Cabral Cup,Conakry,Guinea,False,1,1,Guinea
12220,13440,14432,1987,Turkey,Romania,1,3,Friendly,Ankara,Turkey,False,4,-2,Romania
12221,13441,14433,1987,Palau,Vanuatu,2,6,Friendly,Adelaide,Australia,True,8,-4,Vanuatu
12222,13442,14434,1987,Greece,Romania,1,1,Friendly,Piraeus,Greece,False,2,0,Draw
12223,13443,14435,1987,Barbados,Guyana,2,2,Friendly,Bridgetown,Barbados,False,4,0,Draw
12224,13445,14437,1987,Ivory Coast,DR Congo,2,1,Friendly,Abidjan,Ivory Coast,False,3,1,Ivory Coast
12225,13446,14438,1987,Poland,Finland,3,1,Friendly,Rybnik,Poland,False,4,2,Poland
12226,13447,14439,1987,United Arab Emirates,Syria,1,1,Friendly,Abu Dhabi,United Arab Emirates,False,2,0,Draw
12227,13448,14440,1987,Guatemala,El Salvador,2,0,Friendly,Guatemala,Guatemala,False,2,2,Guatemala
12228,13449,14441,1987,Ivory Coast,DR Congo,1,3,Friendly,Abidjan,Ivory Coast,False,4,-2,DR Congo
12229,13450,14442,1987,United Arab Emirates,Syria,2,1,Friendly,Abu Dhabi,United Arab Emirates,False,3,1,United Arab Emirates
12230,13451,14443,1987,Poland,Norway,4,1,Friendly,Wrocław,Poland,False,5,3,Poland
12231,13452,14444,1987,Israel,Germany,0,2,Friendly,Ramat-Gan,Israel,False,2,-2,Germany
12232,13453,14445,1987,Jordan,Cyprus,2,1,Friendly,Amman,Jordan,False,3,1,Jordan
12233,13454,14446,1987,Netherlands,Greece,1,1,UEFA Euro qualification,Rotterdam,Netherlands,False,2,0,Draw
12234,13455,14447,1987,Panama,Cuba,0,0,Friendly,Panama City,Panama,False,0,0,Draw
12235,13456,14448,1987,Romania,Albania,5,1,UEFA Euro qualification,Bucharest,Romania,False,6,4,Romania
12236,13459,14452,1987,Algeria,Tunisia,1,0,African Cup of Nations qualification,Algiers,Algeria,False,1,1,Algeria
12237,13460,14453,1987,Botswana,Mauritius,0,0,Friendly,Gaborone,Botswana,False,0,0,Draw
12238,13461,14454,1987,Kenya,Madagascar,2,0,African Cup of Nations qualification,Mombasa,Kenya,False,2,2,Kenya
12239,13462,14455,1987,Nigeria,Togo,2,0,African Cup of Nations qualification,Lagos,Nigeria,False,2,2,Nigeria
12240,13463,14456,1987,Cameroon,Uganda,5,1,African Cup of Nations qualification,Yaoundé,Cameroon,False,6,4,Cameroon
12241,13464,14457,1987,DR Congo,Angola,3,0,African Cup of Nations qualification,Kinshasa,Zaïre,False,3,3,DR Congo
12242,13465,14458,1987,Ivory Coast,Congo,2,0,African Cup of Nations qualification,Abidjan,Ivory Coast,False,2,2,Ivory Coast
12243,13466,14459,1987,Mozambique,Zimbabwe,1,1,African Cup of Nations qualification,Maputo,Mozambique,False,2,0,Draw
12244,13467,14460,1987,Portugal,Malta,2,2,UEFA Euro qualification,Funchal,Portugal,False,4,0,Draw
12245,13468,14461,1987,Senegal,Guinea,4,0,African Cup of Nations qualification,Dakar,Senegal,False,4,4,Senegal
12246,13469,14462,1987,Sudan,Tanzania,1,0,African Cup of Nations qualification,Khartoum,Sudan,False,1,1,Sudan
12247,13470,14463,1987,Ghana,Sierra Leone,1,2,African Cup of Nations qualification,Accra,Ghana,False,3,-1,Sierra Leone
12248,13471,14464,1987,Ecuador,Cuba,0,1,Friendly,Machala,Ecuador,False,1,-1,Cuba
12249,13472,14465,1987,Austria,Spain,2,3,UEFA Euro qualification,Vienna,Austria,False,5,-1,Spain
12250,13473,14466,1987,Belgium,Scotland,4,1,UEFA Euro qualification,Brussels,Belgium,False,5,3,Belgium
12251,13474,14467,1987,Bulgaria,Republic of Ireland,2,1,UEFA Euro qualification,Sofia,Bulgaria,False,3,1,Bulgaria
12252,13475,14468,1987,Northern Ireland,England,0,2,UEFA Euro qualification,Belfast,Northern Ireland,False,2,-2,England
12253,13476,14469,1987,Wales,Finland,4,0,UEFA Euro qualification,Wrexham,Wales,False,4,4,Wales
12254,13477,14470,1987,Ecuador,Cuba,0,0,Friendly,Azogues,Ecuador,False,0,0,Draw
12255,13478,14471,1987,Congo,Ivory Coast,1,2,African Cup of Nations qualification,Brazzaville,Congo,False,3,-1,Ivory Coast
12256,13479,14472,1987,Bahrain,Iraq,1,3,Friendly,Manama,Bahrain,False,4,-2,Iraq
12257,13480,14473,1987,Gabon,Ivory Coast,1,0,Friendly,Libreville,Gabon,False,1,1,Gabon
12258,13481,14474,1987,Romania,Israel,3,2,Friendly,Braşov,Romania,False,5,1,Romania
12259,13482,14475,1987,Bahrain,Iraq,1,2,Friendly,Manama,Bahrain,False,3,-1,Iraq
12260,13483,14476,1987,Angola,DR Congo,1,0,African Cup of Nations qualification,Luanda,Angola,False,1,1,Angola
12261,13484,14477,1987,Sierra Leone,Ghana,0,0,African Cup of Nations qualification,Freetown,Sierra Leone,False,0,0,Draw
12262,13485,14478,1987,Tanzania,Sudan,1,1,African Cup of Nations qualification,Dar es Salaam,Tanzania,False,2,0,Draw
12263,13486,14479,1987,Guinea,Senegal,0,0,African Cup of Nations qualification,Conakry,Guinea,False,0,0,Draw
12264,13487,14480,1987,Madagascar,Kenya,2,1,African Cup of Nations qualification,Antananarivo,Madagascar,False,3,1,Madagascar
12265,13488,14481,1987,Poland,Cyprus,0,0,UEFA Euro qualification,Gdańsk,Poland,False,0,0,Draw
12266,13489,14482,1987,Togo,Nigeria,1,1,African Cup of Nations qualification,Lomé,Togo,False,2,0,Draw
12267,13491,14484,1987,Switzerland,Malta,4,1,UEFA Euro qualification,Neuchâtel,Switzerland,False,5,3,Switzerland
12268,13492,14485,1987,Germany,Italy,0,0,Friendly,Cologne,Germany,False,0,0,Draw
12269,13493,14486,1987,Russia,Sweden,1,3,Friendly,Tbilisi,Soviet Union,False,4,-2,Sweden
12270,13494,14487,1987,Zimbabwe,Zambia,0,1,Friendly,Harare,Zimbabwe,False,1,-1,Zambia
12271,13495,14488,1987,Albania,Austria,0,1,UEFA Euro qualification,Tirana,Albania,False,1,-1,Austria
12272,13496,14489,1987,Finland,Denmark,0,1,UEFA Euro qualification,Helsinki,Finland,False,1,-1,Denmark
12273,13497,14490,1987,France,Iceland,2,0,UEFA Euro qualification,Paris,France,False,2,2,France
12274,13498,14491,1987,Greece,Poland,1,0,UEFA Euro qualification,Athens,Greece,False,1,1,Greece
12275,13499,14492,1987,Honduras,El Salvador,1,0,Friendly,Tegucigalpa,Honduras,False,1,1,Honduras
12276,13500,14493,1987,Republic of Ireland,Belgium,0,0,UEFA Euro qualification,Dublin,Republic of Ireland,False,0,0,Draw
12277,13501,14494,1987,Jamaica,Cuba,2,0,Friendly,Kingston,Jamaica,False,2,2,Jamaica
12278,13502,14495,1987,Netherlands,Hungary,2,0,UEFA Euro qualification,Rotterdam,Netherlands,False,2,2,Netherlands
12279,13504,14497,1987,Romania,Spain,3,1,UEFA Euro qualification,Bucharest,Romania,False,4,2,Romania
12280,13506,14499,1987,Turkey,England,0,0,UEFA Euro qualification,Izmir,Turkey,False,0,0,Draw
12281,13508,14501,1987,Luxembourg,Bulgaria,1,4,UEFA Euro qualification,Luxembourg,Luxembourg,False,5,-3,Bulgaria
12282,13509,14502,1987,El Salvador,Honduras,1,2,Friendly,San Salvador,El Salvador,False,3,-1,Honduras
12283,13511,14505,1987,Hungary,Poland,5,3,UEFA Euro qualification,Budapest,Hungary,False,8,2,Hungary
12284,13512,14506,1987,England,Brazil,1,1,Rous Cup,London,England,False,2,0,Draw
12285,13513,14507,1987,Switzerland,Israel,1,0,Friendly,Aarau,Switzerland,False,1,1,Switzerland
12286,13514,14508,1987,Bulgaria,Luxembourg,3,0,UEFA Euro qualification,Sofia,Bulgaria,False,3,3,Bulgaria
12287,13515,14509,1987,Burkina Faso,Mauritania,2,1,Friendly,Ouagadougou,Burkina Faso,False,3,1,Burkina Faso
12288,13516,14510,1987,Republic of Ireland,Brazil,1,0,Friendly,Dublin,Republic of Ireland,False,1,1,Republic of Ireland
12289,13517,14511,1987,Scotland,England,0,0,Rous Cup,Glasgow,Scotland,False,0,0,Draw
12290,13518,14512,1987,Sweden,Malta,1,0,UEFA Euro qualification,Gothenburg,Sweden,False,1,1,Sweden
12291,13519,14513,1987,Scotland,Brazil,0,2,Rous Cup,Glasgow,Scotland,False,2,-2,Brazil
12292,13520,14514,1987,Japan,Senegal,2,2,Kirin Cup,Hiroshima,Japan,False,4,0,Draw
12293,13521,14515,1987,Finland,Brazil,2,3,Friendly,Helsinki,Finland,False,5,-1,Brazil
12294,13522,14516,1987,Guadeloupe,French Guiana,4,1,Friendly,Gagny,France,True,5,3,Guadeloupe
12295,13523,14517,1987,Luxembourg,Republic of Ireland,0,2,UEFA Euro qualification,Luxembourg,Luxembourg,False,2,-2,Republic of Ireland
12296,13524,14518,1987,Norway,Italy,0,0,Friendly,Oslo,Norway,False,0,0,Draw
12297,13525,14519,1987,Guadeloupe,Réunion,3,0,Friendly,Gagny,France,True,3,3,Guadeloupe
12298,13526,14520,1987,Hong Kong,Macau,5,0,Friendly,So Kon Po,Hong Kong,False,5,5,Hong Kong
12299,13527,14521,1987,Israel,Brazil,0,4,Friendly,Ramat-Gan,Israel,False,4,-4,Brazil
12300,13530,14524,1987,Norway,Russia,0,1,UEFA Euro qualification,Oslo,Norway,False,1,-1,Russia
12301,13531,14525,1987,Sweden,Italy,1,0,UEFA Euro qualification,Solna,Sweden,False,1,1,Sweden
12302,13532,14526,1987,Egypt,United States,3,1,Korea Cup,Seoul,South Korea,True,4,2,Egypt
12303,13533,14527,1987,Australia,Morocco,1,0,Korea Cup,Gangneung,South Korea,True,1,1,Australia
12304,13534,14528,1987,Argentina,Italy,1,3,Friendly,Zürich,Switzerland,True,4,-2,Italy
12305,13535,14530,1987,Colombia,Ecuador,1,0,Friendly,Medellín,Colombia,False,1,1,Colombia
12306,13536,14531,1987,Egypt,Thailand,1,1,Korea Cup,Busan,South Korea,True,2,0,Draw
12307,13537,14533,1987,Malawi,Zimbabwe,1,4,Friendly,Lilongwe,Malawi,False,5,-3,Zimbabwe
12308,13538,14534,1987,Bolivia,Paraguay,0,2,Friendly,Santa Cruz,Bolivia,False,2,-2,Paraguay
12309,13539,14535,1987,Congo,Seychelles,1,1,Friendly,Antananarivo,Madagascar,True,2,0,Draw
12310,13540,14536,1987,Ecuador,Colombia,3,0,Friendly,Guayaquil,Ecuador,False,3,3,Ecuador
12311,13541,14538,1987,Malawi,Zimbabwe,2,1,Friendly,Blantyre,Malawi,False,3,1,Malawi
12312,13542,14539,1987,Norway,France,2,0,UEFA Euro qualification,Oslo,Norway,False,2,2,Norway
12313,13543,14540,1987,Thailand,United States,0,1,Korea Cup,Cheongju,South Korea,True,1,-1,United States
12314,13544,14541,1987,Switzerland,Sweden,1,1,UEFA Euro qualification,Lausanne,Switzerland,False,2,0,Draw
12315,13545,14542,1987,Madagascar,Seychelles,2,0,Friendly,Antananarivo,Madagascar,False,2,2,Madagascar
12316,13546,14543,1987,Australia,Egypt,0,0,Korea Cup,Seoul,South Korea,True,0,0,Draw
12317,13547,14544,1987,Peru,Chile,1,3,Friendly,Lima,Peru,False,4,-2,Chile
12318,13548,14545,1987,Uruguay,Ecuador,2,1,Friendly,Montevideo,Uruguay,False,3,1,Uruguay
12319,13549,14546,1987,Argentina,Paraguay,0,1,Friendly,Buenos Aires,Argentina,False,1,-1,Paraguay
12320,13550,14547,1987,Brazil,Ecuador,4,1,Friendly,Florianópolis,Brazil,False,5,3,Brazil
12321,13551,14549,1987,Madagascar,Congo,3,2,Friendly,Antananarivo,Madagascar,False,5,1,Madagascar
12322,13552,14550,1987,Peru,Chile,2,0,Friendly,Lima,Peru,False,2,2,Peru
12323,13553,14551,1987,Uruguay,Bolivia,2,1,Friendly,Montevideo,Uruguay,False,3,1,Uruguay
12324,13554,14552,1987,Chile,Peru,1,0,Friendly,Santiago,Chile,False,1,1,Chile
12325,13555,14553,1987,Argentina,Peru,1,1,Copa América,Buenos Aires,Argentina,False,2,0,Draw
12326,13556,14554,1987,Brazil,Venezuela,5,0,Copa América,Córdoba,Argentina,True,5,5,Brazil
12327,13557,14555,1987,Paraguay,Bolivia,0,0,Copa América,Rosario,Argentina,True,0,0,Draw
12328,13558,14556,1987,Zambia,Ivory Coast,2,0,Friendly,Lusaka,Zambia,False,2,2,Zambia
12329,13559,14557,1987,Venezuela,Chile,1,3,Copa América,Córdoba,Argentina,True,4,-2,Chile
12330,13560,14558,1987,Bolivia,Colombia,0,2,Copa América,Rosario,Argentina,True,2,-2,Colombia
12331,13561,14559,1987,Argentina,Ecuador,3,0,Copa América,Buenos Aires,Argentina,False,3,3,Argentina
12332,13562,14560,1987,Chile,Brazil,4,0,Copa América,Córdoba,Argentina,True,4,4,Chile
12333,13563,14561,1987,Malawi,Ivory Coast,1,2,African Cup of Nations qualification,Lilongwe,Malawi,False,3,-1,Ivory Coast
12334,13564,14562,1987,Nigeria,Sierra Leone,3,0,African Cup of Nations qualification,Lagos,Nigeria,False,3,3,Nigeria
12335,13565,14563,1987,Peru,Ecuador,1,1,Copa América,Buenos Aires,Argentina,True,2,0,Draw
12336,13566,14564,1987,Cameroon,Sudan,2,0,African Cup of Nations qualification,Yaoundé,Cameroon,False,2,2,Cameroon
12337,13567,14565,1987,Colombia,Paraguay,3,0,Copa América,Rosario,Argentina,True,3,3,Colombia
12338,13568,14566,1987,Senegal,DR Congo,0,0,African Cup of Nations qualification,Dakar,Senegal,False,0,0,Draw
12339,13569,14567,1987,Zimbabwe,Kenya,1,1,African Cup of Nations qualification,Harare,Zimbabwe,False,2,0,Draw
12340,13570,14568,1987,Malawi,Burundi,1,1,Friendly,Blantyre,Malawi,False,2,0,Draw
12341,13571,14569,1987,Chile,Colombia,2,1,Copa América,Córdoba,Argentina,True,3,1,Chile
12342,13572,14570,1987,Malawi,Burundi,1,1,Friendly,Lilongwe,Malawi,False,2,0,Draw
12343,13573,14571,1987,Argentina,Uruguay,0,1,Copa América,Buenos Aires,Argentina,False,1,-1,Uruguay
12344,13574,14572,1987,Argentina,Colombia,1,2,Copa América,Buenos Aires,Argentina,False,3,-1,Colombia
12345,13575,14573,1987,Malawi,Burundi,2,4,Friendly,Mzuzu,Malawi,False,6,-2,Burundi
12346,13576,14574,1987,Chile,Uruguay,0,1,Copa América,Buenos Aires,Argentina,True,1,-1,Uruguay
12347,13577,14575,1987,Kenya,Zimbabwe,0,0,African Cup of Nations qualification,Nairobi,Kenya,False,0,0,Draw
12348,13578,14576,1987,Sierra Leone,Nigeria,2,0,African Cup of Nations qualification,Freetown,Sierra Leone,False,2,2,Sierra Leone
12349,13579,14577,1987,Sudan,Cameroon,1,0,African Cup of Nations qualification,Khartoum,Sudan,False,1,1,Sudan
12350,13580,14578,1987,DR Congo,Senegal,0,0,African Cup of Nations qualification,Kinshasa,Zaïre,False,0,0,Draw
12351,13581,14579,1987,Ivory Coast,Malawi,2,0,African Cup of Nations qualification,Abidjan,Ivory Coast,False,2,2,Ivory Coast
12352,13582,14580,1987,São Tomé and Príncipe,Guinea-Bissau,0,2,Friendly,São Tomé,São Tomé and Príncipe,False,2,-2,Guinea-Bissau
12353,13583,14581,1987,Angola,Guinea-Bissau,0,0,Friendly,São Tomé,São Tomé and Príncipe,True,0,0,Draw
12354,13584,14582,1987,Liberia,Morocco,2,1,Friendly,Monrovia,Liberia,False,3,1,Liberia
12355,13585,14583,1987,Liberia,Ghana,0,0,Friendly,Monrovia,Liberia,False,0,0,Draw
12356,13586,14584,1987,São Tomé and Príncipe,Angola,1,1,Friendly,São Tomé,São Tomé and Príncipe,False,2,0,Draw
12357,13587,14586,1987,Indonesia,Algeria,2,1,Indonesia Tournament,Jakarta,Indonesia,False,3,1,Indonesia
12358,13590,14589,1987,Indonesia,Algeria,2,1,Indonesia Tournament,Jakarta,Indonesia,False,3,1,Indonesia
12359,13591,14590,1987,Germany,France,2,1,Friendly,Berlin,Germany,False,3,1,Germany
12360,13592,14591,1987,Norway,Sweden,0,0,Friendly,Oslo,Norway,False,0,0,Draw
12361,13593,14592,1987,Switzerland,Austria,2,2,Friendly,St. Gallen,Switzerland,False,4,0,Draw
12362,13595,14594,1987,Sweden,Denmark,1,0,Friendly,Solna,Sweden,False,1,1,Sweden
12363,13596,14596,1987,Australia,New Zealand,1,1,Friendly,Melbourne,Australia,False,2,0,Draw
12364,13597,14597,1987,Poland,Romania,3,1,Friendly,Bydgoszcz,Poland,False,4,2,Poland
12365,13598,14598,1987,Guyana,Grenada,1,1,Friendly,Georgetown,Guyana,False,2,0,Draw
12366,13599,14599,1987,Guyana,Grenada,3,0,Friendly,Linden,Guyana,False,3,3,Guyana
12367,13601,14601,1987,Germany,England,3,1,Friendly,Düsseldorf,Germany,False,4,2,Germany
12368,13602,14602,1987,Iceland,Norway,2,1,UEFA Euro qualification,Reykjavík,Iceland,False,3,1,Iceland
12369,13603,14603,1987,Republic of Ireland,Luxembourg,2,1,UEFA Euro qualification,Dublin,Republic of Ireland,False,3,1,Republic of Ireland
12370,13604,14604,1987,Netherlands,Belgium,0,0,Friendly,Rotterdam,Netherlands,False,0,0,Draw
12371,13605,14605,1987,New Zealand,Australia,1,0,Friendly,Lower Hutt,New Zealand,False,1,1,New Zealand
12372,13606,14606,1987,Russia,France,1,1,UEFA Euro qualification,Moscow,Soviet Union,False,2,0,Draw
12373,13607,14607,1987,Scotland,Hungary,2,0,Friendly,Glasgow,Scotland,False,2,2,Scotland
12374,13608,14608,1987,Wales,Denmark,1,0,UEFA Euro qualification,Cardiff,Wales,False,1,1,Wales
12375,13609,14609,1987,Guyana,Trinidad and Tobago,1,2,Friendly,Georgetown,Guyana,False,3,-1,Trinidad and Tobago
12376,13610,14610,1987,Bulgaria,Belgium,2,0,UEFA Euro qualification,Sofia,Bulgaria,False,2,2,Bulgaria
12377,13611,14612,1987,Germany,Denmark,1,0,Friendly,Hamburg,Germany,False,1,1,Germany
12378,13613,14614,1987,Norway,Iceland,0,1,UEFA Euro qualification,Oslo,Norway,False,1,-1,Iceland
12379,13614,14615,1987,Poland,Hungary,3,2,UEFA Euro qualification,Warsaw,Poland,False,5,1,Poland
12380,13615,14616,1987,Russia,Greece,3,0,Friendly,Moscow,Soviet Union,False,3,3,Russia
12381,13616,14617,1987,Spain,Luxembourg,2,0,Friendly,Castellón de la Plana,Spain,False,2,2,Spain
12382,13617,14618,1987,Sweden,Portugal,0,1,UEFA Euro qualification,Solna,Sweden,False,1,-1,Portugal
12383,13618,14619,1987,El Salvador,Canada,2,1,Friendly,San Salvador,El Salvador,False,3,1,El Salvador
12384,13619,14620,1987,Honduras,Canada,1,1,Friendly,Tegucigalpa,Honduras,False,2,0,Draw
12385,13620,14621,1987,Mexico,Canada,4,0,Friendly,Toluca,Mexico,False,4,4,Mexico
12386,13621,14622,1987,El Salvador,Guatemala,1,0,Friendly,Los Angeles,United States,True,1,1,El Salvador
12387,13622,14623,1987,Romania,Greece,2,2,Friendly,Bucharest,Romania,False,4,0,Draw
12388,13623,14625,1987,Denmark,Wales,1,0,UEFA Euro qualification,Copenhagen,Denmark,False,1,1,Denmark
12389,13624,14626,1987,England,Turkey,8,0,UEFA Euro qualification,London,England,False,8,8,England
12390,13625,14627,1987,France,Norway,1,1,UEFA Euro qualification,Paris,France,False,2,0,Draw
12391,13626,14628,1987,Germany,Sweden,1,1,Friendly,Gelsenkirchen,Germany,False,2,0,Draw
12392,13627,14629,1987,Hungary,Greece,3,0,UEFA Euro qualification,Budapest,Hungary,False,3,3,Hungary
12393,13628,14630,1987,Republic of Ireland,Bulgaria,2,0,UEFA Euro qualification,Dublin,Republic of Ireland,False,2,2,Republic of Ireland
12394,13629,14631,1987,Poland,Netherlands,0,2,UEFA Euro qualification,Zabrze,Poland,False,2,-2,Netherlands
12395,13630,14632,1987,Scotland,Belgium,2,0,UEFA Euro qualification,Glasgow,Scotland,False,2,2,Scotland
12396,13631,14633,1987,Spain,Austria,2,0,UEFA Euro qualification,Seville,Spain,False,2,2,Spain
12397,13632,14635,1987,Switzerland,Italy,0,0,UEFA Euro qualification,Berne,Switzerland,False,0,0,Draw
12398,13633,14636,1987,Zambia,Angola,2,0,Friendly,Lusaka,Zambia,False,2,2,Zambia
12399,13634,14637,1987,Barbados,Martinique,1,1,Friendly,Bridgetown,Barbados,False,2,0,Draw
12400,13635,14639,1987,Albania,Romania,0,1,UEFA Euro qualification,Vlorë,Albania,False,1,-1,Romania
12401,13636,14641,1987,Netherlands,Cyprus,8,0,UEFA Euro qualification,Rotterdam,Netherlands,False,8,8,Netherlands
12402,13637,14642,1987,Russia,Iceland,2,0,UEFA Euro qualification,Simferopol,Soviet Union,False,2,2,Russia
12403,13638,14643,1987,Liberia,Ghana,0,2,Friendly,Monrovia,Liberia,False,2,-2,Ghana
12404,13639,14644,1987,Kuwait,Egypt,0,2,Friendly,Kuwait City,Kuwait,False,2,-2,Egypt
12405,13640,14645,1987,Mali,Central African Republic,3,1,Friendly,Bamako,Mali,False,4,2,Mali
12406,13641,14646,1987,Republic of Ireland,Israel,5,0,Friendly,Dublin,Republic of Ireland,False,5,5,Republic of Ireland
12407,13642,14647,1987,Belgium,Luxembourg,3,0,UEFA Euro qualification,Brussels,Belgium,False,3,3,Belgium
12408,13643,14648,1987,Bulgaria,Scotland,0,1,UEFA Euro qualification,Sofia,Bulgaria,False,1,-1,Scotland
12409,13644,14649,1987,Cyprus,Poland,0,1,UEFA Euro qualification,Limassol,Cyprus,False,1,-1,Poland
12410,13645,14651,1987,French Guiana,Suriname,1,1,CFU Caribbean Cup qualification,Cayenne,French Guiana,False,2,0,Draw
12411,13646,14652,1987,Northern Ireland,Turkey,1,0,UEFA Euro qualification,Belfast,Northern Ireland,False,1,1,Northern Ireland
12412,13647,14653,1987,Portugal,Switzerland,0,0,UEFA Euro qualification,Porto,Portugal,False,0,0,Draw
12413,13648,14655,1987,Italy,Sweden,2,1,UEFA Euro qualification,Naples,Italy,False,3,1,Italy
12414,13649,14656,1987,Malta,Switzerland,1,1,UEFA Euro qualification,Attard,Malta,False,2,0,Draw
12415,13650,14657,1987,Austria,Romania,0,0,UEFA Euro qualification,Vienna,Austria,False,0,0,Draw
12416,13652,14659,1987,Hungary,Germany,0,0,Friendly,Budapest,Hungary,False,0,0,Draw
12417,13653,14660,1987,Spain,Albania,5,0,UEFA Euro qualification,Seville,Spain,False,5,5,Spain
12418,13654,14661,1987,Togo,Central African Republic,1,0,Friendly,Lomé,Togo,False,1,1,Togo
12419,13655,14662,1987,Burkina Faso,Nigeria,0,0,Friendly,Ouagadougou,Burkina Faso,False,0,0,Draw
12420,13656,14663,1987,Ivory Coast,Togo,3,0,Friendly,Abidjan,Ivory Coast,False,3,3,Ivory Coast
12421,13657,14664,1987,Barbados,Trinidad and Tobago,0,4,CFU Caribbean Cup qualification,Bridgetown,Barbados,False,4,-4,Trinidad and Tobago
12422,13658,14665,1987,Gabon,Angola,0,0,Friendly,Libreville,Gabon,False,0,0,Draw
12423,13659,14666,1987,Hungary,Cyprus,1,0,UEFA Euro qualification,Budapest,Hungary,False,1,1,Hungary
12424,13660,14667,1987,Israel,Malta,1,1,Friendly,Haifa,Israel,False,2,0,Draw
12425,13661,14668,1987,Luxembourg,Scotland,0,0,UEFA Euro qualification,Esch-sur-Alzette,Luxembourg,False,0,0,Draw
12426,13662,14669,1987,Tunisia,Malawi,2,3,Friendly,Tunis,Tunisia,False,5,-1,Malawi
12427,13663,14670,1987,Italy,Portugal,3,0,UEFA Euro qualification,Milan,Italy,False,3,3,Italy
12428,13664,14671,1987,Suriname,French Guiana,1,0,CFU Caribbean Cup qualification,Paramaribo,Suriname,False,1,1,Suriname
12429,13665,14672,1987,Mali,Burkina Faso,1,2,Friendly,Bamako,Mali,False,3,-1,Burkina Faso
12430,13666,14673,1987,Trinidad and Tobago,Barbados,5,1,CFU Caribbean Cup qualification,Port of Spain,Trinidad and Tobago,False,6,4,Trinidad and Tobago
12431,13667,14674,1987,Chad,Central African Republic,2,1,UDEAC Cup,N'Djamena,Chad,False,3,1,Chad
12432,13668,14675,1987,Angola,Cuba,3,2,Friendly,Luanda,Angola,False,5,1,Angola
12433,13669,14676,1987,Benin,Ghana,1,1,Friendly,Luanda,Angola,True,2,0,Draw
12434,13670,14677,1987,Cameroon,Equatorial Guinea,1,0,UDEAC Cup,N'Djamena,Chad,True,1,1,Cameroon
12435,13671,14678,1987,Brazil,Chile,2,1,Friendly,Uberlândia,Brazil,False,3,1,Brazil
12436,13672,14679,1987,Central African Republic,Gabon,1,1,UDEAC Cup,N'Djamena,Chad,True,2,0,Draw
12437,13673,14680,1987,Netherlands,Cyprus,4,0,UEFA Euro qualification,Amsterdam,Netherlands,False,4,4,Netherlands
12438,13674,14681,1987,New Caledonia,American Samoa,10,0,South Pacific Games,Nouméa,New Caledonia,False,10,10,New Caledonia
12439,13677,14684,1987,American Samoa,Vanuatu,0,7,South Pacific Games,Nouméa,New Caledonia,True,7,-7,Vanuatu
12440,13678,14685,1987,Angola,Benin,0,0,Friendly,Luanda,Angola,False,0,0,Draw
12441,13679,14686,1987,Burkina Faso,Mali,1,2,Friendly,Ouagadougou,Burkina Faso,False,3,-1,Mali
12442,13680,14687,1987,Cameroon,Equatorial Guinea,0,0,UDEAC Cup,N'Djamena,Chad,True,0,0,Draw
12443,13681,14688,1987,Cuba,Ghana,1,1,Friendly,Luanda,Angola,True,2,0,Draw
12444,13682,14689,1987,New Caledonia,Papua New Guinea,2,0,South Pacific Games,Nouméa,New Caledonia,False,2,2,New Caledonia
12445,13683,14691,1987,Algeria,Tunisia,0,0,UAFA Cup,Algiers,Algeria,False,0,0,Draw
12446,13684,14692,1987,Chad,Gabon,1,1,UDEAC Cup,N'Djamena,Chad,False,2,0,Draw
12447,13686,14694,1987,Brazil,Germany,1,1,Friendly,Brasília,Brazil,False,2,0,Draw
12448,13688,14696,1987,Papua New Guinea,Vanuatu,1,1,South Pacific Games,Nouméa,New Caledonia,True,2,0,Draw
12449,13689,14697,1987,Burkina Faso,Mali,2,1,Friendly,Ouagadougou,Burkina Faso,False,3,1,Burkina Faso
12450,13690,14698,1987,Ethiopia,Tanzania,0,0,CECAFA Cup,Addis Abeba,Ethiopia,False,0,0,Draw
12451,13691,14699,1987,Malawi,Zimbabwe,1,1,CECAFA Cup,Addis Abeba,Ethiopia,True,2,0,Draw
12452,13692,14700,1987,Mauritania,Tunisia,1,2,UAFA Cup,Algiers,Algeria,True,3,-1,Tunisia
12453,13693,14701,1987,Togo,Ivory Coast,1,0,Friendly,Lomé,Togo,False,1,1,Togo
12454,13695,14703,1987,Uganda,Zambia,4,0,CECAFA Cup,Addis Abeba,Ethiopia,True,4,4,Uganda
12455,13696,14704,1987,Algeria,Mauritania,3,0,UAFA Cup,Algiers,Algeria,False,3,3,Algeria
12456,13697,14705,1987,American Samoa,Papua New Guinea,0,20,South Pacific Games,Nouméa,New Caledonia,True,20,-20,Papua New Guinea
12457,13698,14706,1987,Chad,Equatorial Guinea,4,0,UDEAC Cup,N'Djamena,Chad,False,4,4,Chad
12458,13700,14709,1987,Argentina,Germany,1,0,Friendly,Buenos Aires,Argentina,False,1,1,Argentina
12459,13701,14710,1987,Cameroon,Gabon,1,0,UDEAC Cup,N'Djamena,Chad,True,1,1,Cameroon
12460,13702,14711,1987,Greece,Netherlands,0,3,UEFA Euro qualification,Rhodes,Greece,False,3,-3,Netherlands
12461,13703,14712,1987,Israel,Switzerland,0,2,Friendly,Ramat-Gan,Israel,False,2,-2,Switzerland
12462,13704,14713,1987,Kenya,Tanzania,3,2,CECAFA Cup,Addis Abeba,Ethiopia,True,5,1,Kenya
12463,13706,14715,1987,Uganda,Zimbabwe,0,0,CECAFA Cup,Addis Abeba,Ethiopia,True,0,0,Draw
12464,13708,14717,1987,Malawi,Zambia,2,1,CECAFA Cup,Addis Abeba,Ethiopia,True,3,1,Malawi
12465,13710,14719,1987,New Caledonia,Vanuatu,6,0,South Pacific Games,Nouméa,New Caledonia,False,6,6,New Caledonia
12466,13712,14721,1987,Chad,Cameroon,0,1,UDEAC Cup,N'Djamena,Chad,False,1,-1,Cameroon
12467,13713,14722,1987,Equatorial Guinea,Gabon,0,0,UDEAC Cup,N'Djamena,Chad,True,0,0,Draw
12468,13714,14723,1987,Ivory Coast,Senegal,1,0,Friendly,Monrovia,Liberia,True,1,1,Ivory Coast
12469,13716,14725,1987,Papua New Guinea,Vanuatu,3,1,South Pacific Games,Nouméa,New Caledonia,True,4,2,Papua New Guinea
12470,13718,14727,1987,Ethiopia,Kenya,2,1,CECAFA Cup,Addis Abeba,Ethiopia,False,3,1,Ethiopia
12471,13719,14728,1987,Liberia,Burkina Faso,1,0,Friendly,Monrovia,Liberia,False,1,1,Liberia
12472,13720,14729,1987,Malawi,Uganda,0,2,CECAFA Cup,Addis Abeba,Ethiopia,True,2,-2,Uganda
12473,13721,14730,1987,Malta,Portugal,0,1,UEFA Euro qualification,Attard,Malta,False,1,-1,Portugal
12474,13722,14731,1987,Burkina Faso,Senegal,0,1,Friendly,Monrovia,Liberia,True,1,-1,Senegal
12475,13723,14732,1987,Liberia,Ivory Coast,1,2,Friendly,Monrovia,Liberia,False,3,-1,Ivory Coast
12476,13724,14734,1987,Ethiopia,Uganda,3,0,CECAFA Cup,Addis Abeba,Ethiopia,False,3,3,Ethiopia
12477,13726,14736,1987,Ethiopia,Zimbabwe,1,1,CECAFA Cup,Addis Abeba,Ethiopia,False,2,0,Draw
12478,13727,14737,1988,Gambia,Ghana,0,2,Friendly,Banjul,Gambia,False,2,-2,Ghana
12479,13728,14738,1988,Algeria,Congo,4,1,Friendly,Annaba,Algeria,False,5,3,Algeria
12480,13729,14739,1988,Gambia,Ghana,0,0,Friendly,Banjul,Gambia,False,0,0,Draw
12481,13730,14740,1988,Guatemala,Costa Rica,1,2,Friendly,Guatemala,Guatemala,False,3,-1,Costa Rica
12482,13731,14742,1988,Guatemala,United States,1,0,Friendly,Guatemala,Guatemala,False,1,1,Guatemala
12483,13732,14745,1988,Guatemala,United States,0,1,Friendly,Guatemala,Guatemala,False,1,-1,United States
12484,13733,14746,1988,Honduras,Mexico,0,1,Friendly,San Pedro Sula,Honduras,False,1,-1,Mexico
12485,13734,14747,1988,Thailand,Indonesia,3,3,King's Cup,Bangkok,Thailand,False,6,0,Draw
12486,13735,14749,1988,Finland,Sweden,0,1,Friendly,Las Palmas,Spain,True,1,-1,Sweden
12487,13736,14750,1988,Jordan,United Arab Emirates,0,1,Friendly,Manama,Bahrain,True,1,-1,United Arab Emirates
12488,13737,14751,1988,Indonesia,Oman,3,0,King's Cup,Bangkok,Thailand,True,3,3,Indonesia
12489,13738,14752,1988,Jordan,United Arab Emirates,2,0,Friendly,Manama,Bahrain,True,2,2,Jordan
12490,13739,14753,1988,Israel,Belgium,2,3,Friendly,Ramat-Gan,Israel,False,5,-1,Belgium
12491,13740,14754,1988,Thailand,Oman,3,1,King's Cup,Bangkok,Thailand,False,4,2,Thailand
12492,13742,14756,1988,Qatar,Bulgaria,2,3,Friendly,Doha,Qatar,False,5,-1,Bulgaria
12493,13743,14757,1988,United Arab Emirates,Bulgaria,0,3,Friendly,Doha,Qatar,True,3,-3,Bulgaria
12494,13744,14758,1988,Israel,France,1,1,Friendly,Ramat-Gan,Israel,False,2,0,Draw
12495,13746,14760,1988,United Arab Emirates,Japan,1,1,Friendly,Dubai,United Arab Emirates,False,2,0,Draw
12496,13747,14761,1988,United Arab Emirates,Japan,2,0,Friendly,Abu Dhabi,United Arab Emirates,False,2,2,United Arab Emirates
12497,13748,14762,1988,Austria,Morocco,1,3,Tournoi de France,Toulouse,France,True,4,-2,Morocco
12498,13749,14763,1988,France,Switzerland,2,1,Tournoi de France,Toulouse,France,False,3,1,France
12499,13750,14764,1988,Oman,Japan,1,1,Friendly,Muscat,Oman,False,2,0,Draw
12500,13751,14765,1988,Egypt,Bulgaria,1,0,Friendly,Cairo,Egypt,False,1,1,Egypt
12501,13752,14766,1988,Israel,Romania,0,2,Friendly,Haifa,Israel,False,2,-2,Romania
12502,13753,14767,1988,United Arab Emirates,Thailand,3,0,AFC Asian Cup qualification,Abu Dhabi,United Arab Emirates,False,3,3,United Arab Emirates
12503,13754,14768,1988,Austria,Switzerland,1,2,Tournoi de France,Monaco,Monaco,True,3,-1,Switzerland
12504,13755,14770,1988,France,Morocco,2,1,Tournoi de France,Monaco,Monaco,True,3,1,France
12505,13756,14771,1988,Bangladesh,India,0,0,AFC Asian Cup qualification,Abu Dhabi,United Arab Emirates,True,0,0,Draw
12506,13757,14772,1988,Poland,Romania,2,2,Friendly,Haifa,Israel,True,4,0,Draw
12507,13758,14773,1988,Malta,Finland,2,0,Malta International Tournament,Attard,Malta,False,2,2,Malta
12508,13759,14774,1988,United Arab Emirates,Yemen,2,1,AFC Asian Cup qualification,Abu Dhabi,United Arab Emirates,False,3,1,United Arab Emirates
12509,13760,14776,1988,Thailand,India,1,0,AFC Asian Cup qualification,Abu Dhabi,United Arab Emirates,True,1,1,Thailand
12510,13761,14777,1988,Israel,Poland,1,3,Friendly,Ramat-Gan,Israel,False,4,-2,Poland
12511,13762,14778,1988,Malta,Tunisia,2,1,Malta International Tournament,Attard,Malta,False,3,1,Malta
12512,13764,14780,1988,Yemen,India,1,0,AFC Asian Cup qualification,Abu Dhabi,United Arab Emirates,True,1,1,Yemen
12513,13765,14781,1988,Thailand,Bangladesh,1,1,AFC Asian Cup qualification,Abu Dhabi,United Arab Emirates,True,2,0,Draw
12514,13766,14782,1988,Finland,Tunisia,3,0,Malta International Tournament,Attard,Malta,True,3,3,Finland
12515,13767,14783,1988,United Arab Emirates,India,3,0,AFC Asian Cup qualification,Abu Dhabi,United Arab Emirates,False,3,3,United Arab Emirates
12516,13768,14784,1988,Benin,Mali,1,2,Friendly,Cotonou,Benin,False,3,-1,Mali
12517,13769,14786,1988,Yemen,Bangladesh,0,0,AFC Asian Cup qualification,Abu Dhabi,United Arab Emirates,True,0,0,Draw
12518,13770,14788,1988,Yemen,Thailand,3,3,AFC Asian Cup qualification,Abu Dhabi,United Arab Emirates,True,6,0,Draw
12519,13771,14789,1988,Greece,Northern Ireland,3,2,Friendly,Athens,Greece,False,5,1,Greece
12520,13772,14790,1988,Israel,England,0,0,Friendly,Ramat-Gan,Israel,False,0,0,Draw
12521,13773,14791,1988,Saudi Arabia,Scotland,2,2,Friendly,Riyadh,Saudi Arabia,False,4,0,Draw
12522,13774,14792,1988,United Arab Emirates,Bangladesh,4,0,AFC Asian Cup qualification,Abu Dhabi,United Arab Emirates,False,4,4,United Arab Emirates
12523,13775,14793,1988,Bermuda,Canada,0,0,Friendly,Hamilton,Bermuda,False,0,0,Draw
12524,13776,14794,1988,Italy,Russia,4,1,Friendly,Bari,Italy,False,5,3,Italy
12525,13777,14795,1988,United Arab Emirates,Egypt,1,2,Friendly,Dubai,United Arab Emirates,False,3,-1,Egypt
12526,13780,14798,1988,Iraq,Tunisia,2,0,Friendly,Baghdad,Iraq,False,2,2,Iraq
12527,13781,14799,1988,United Arab Emirates,Egypt,1,1,Friendly,Abu Dhabi,United Arab Emirates,False,2,0,Draw
12528,13782,14800,1988,Costa Rica,Guatemala,2,1,Friendly,San José,Costa Rica,False,3,1,Costa Rica
12529,13783,14801,1988,Saudi Arabia,Oman,2,0,Gulf Cup,Riyadh,Saudi Arabia,False,2,2,Saudi Arabia
12530,13785,14803,1988,Qatar,Kuwait,1,1,Gulf Cup,Riyadh,Saudi Arabia,True,2,0,Draw
12531,13786,14804,1988,United Arab Emirates,Bahrain,2,0,Gulf Cup,Riyadh,Saudi Arabia,True,2,2,United Arab Emirates
12532,13787,14805,1988,Iraq,Oman,1,1,Gulf Cup,Riyadh,Saudi Arabia,True,2,0,Draw
12533,13788,14806,1988,Kuwait,United Arab Emirates,0,1,Gulf Cup,Riyadh,Saudi Arabia,True,1,-1,United Arab Emirates
12534,13789,14807,1988,Saudi Arabia,Qatar,0,0,Gulf Cup,Riyadh,Saudi Arabia,False,0,0,Draw
12535,13790,14808,1988,Dominica,Antigua and Barbuda,0,0,CFU Caribbean Cup qualification,Roseau,Dominica,False,0,0,Draw
12536,13791,14809,1988,Oman,Bahrain,0,2,Gulf Cup,Riyadh,Saudi Arabia,True,2,-2,Bahrain
12537,13792,14810,1988,Iraq,Kuwait,1,0,Gulf Cup,Riyadh,Saudi Arabia,True,1,1,Iraq
12538,13793,14811,1988,Qatar,United Arab Emirates,2,1,Gulf Cup,Riyadh,Saudi Arabia,True,3,1,Qatar
12539,13794,14812,1988,Saudi Arabia,Bahrain,1,0,Gulf Cup,Riyadh,Saudi Arabia,False,1,1,Saudi Arabia
12540,13795,14813,1988,Libya,Malta,1,0,Friendly,Tripoli,Libya,False,1,1,Libya
12541,13796,14814,1988,Oman,Qatar,2,1,Gulf Cup,Riyadh,Saudi Arabia,True,3,1,Oman
12542,13797,14815,1988,United Arab Emirates,Iraq,0,0,Gulf Cup,Riyadh,Saudi Arabia,True,0,0,Draw
12543,13798,14816,1988,Guadeloupe,Suriname,0,2,CFU Caribbean Cup qualification,Basse-Terre,Guadeloupe,False,2,-2,Suriname
12544,13799,14817,1988,Kuwait,Bahrain,0,1,Gulf Cup,Riyadh,Saudi Arabia,True,1,-1,Bahrain
12545,13800,14818,1988,Algeria,Ivory Coast,1,1,African Cup of Nations,Casablanca,Morocco,True,2,0,Draw
12546,13801,14819,1988,Gambia,Mali,2,1,Friendly,Banjul,Gambia,False,3,1,Gambia
12547,13802,14820,1988,Morocco,DR Congo,1,1,African Cup of Nations,Casablanca,Morocco,False,2,0,Draw
12548,13803,14821,1988,Qatar,Iraq,0,3,Gulf Cup,Riyadh,Saudi Arabia,True,3,-3,Iraq
12549,13804,14822,1988,Saudi Arabia,United Arab Emirates,2,2,Gulf Cup,Riyadh,Saudi Arabia,False,4,0,Draw
12550,13805,14823,1988,Cameroon,Egypt,1,0,African Cup of Nations,Rabat,Morocco,True,1,1,Cameroon
12551,13806,14824,1988,Kenya,Nigeria,0,3,African Cup of Nations,Rabat,Morocco,True,3,-3,Nigeria
12552,13807,14825,1988,Oman,Kuwait,0,2,Gulf Cup,Riyadh,Saudi Arabia,True,2,-2,Kuwait
12553,13808,14826,1988,Bahrain,Qatar,1,0,Gulf Cup,Riyadh,Saudi Arabia,True,1,1,Bahrain
12554,13809,14827,1988,Guatemala,Uruguay,1,0,Friendly,Guatemala,Guatemala,False,1,1,Guatemala
12555,13810,14828,1988,Hungary,Turkey,1,0,Friendly,Budapest,Hungary,False,1,1,Hungary
12556,13811,14829,1988,Ivory Coast,DR Congo,1,1,African Cup of Nations,Casablanca,Morocco,True,2,0,Draw
12557,13812,14830,1988,Morocco,Algeria,1,0,African Cup of Nations,Casablanca,Morocco,False,1,1,Morocco
12558,13813,14831,1988,Saudi Arabia,Iraq,0,2,Gulf Cup,Riyadh,Saudi Arabia,False,2,-2,Iraq
12559,13814,14832,1988,Cameroon,Nigeria,1,1,African Cup of Nations,Rabat,Morocco,True,2,0,Draw
12560,13815,14833,1988,Egypt,Kenya,3,0,African Cup of Nations,Rabat,Morocco,True,3,3,Egypt
12561,13816,14834,1988,United Arab Emirates,Oman,1,0,Gulf Cup,Riyadh,Saudi Arabia,True,1,1,United Arab Emirates
12562,13817,14835,1988,Bahrain,Iraq,0,1,Gulf Cup,Riyadh,Saudi Arabia,True,1,-1,Iraq
12563,13818,14836,1988,El Salvador,Honduras,0,0,Friendly,Los Angeles,United States,True,0,0,Draw
12564,13819,14837,1988,Saudi Arabia,Kuwait,0,0,Gulf Cup,Riyadh,Saudi Arabia,False,0,0,Draw
12565,13820,14838,1988,Algeria,DR Congo,1,0,African Cup of Nations,Casablanca,Morocco,True,1,1,Algeria
12566,13821,14839,1988,Morocco,Ivory Coast,0,0,African Cup of Nations,Casablanca,Morocco,False,0,0,Draw
12567,13822,14840,1988,Antigua and Barbuda,Dominica,2,1,CFU Caribbean Cup qualification,St. John's,Antigua and Barbuda,False,3,1,Antigua and Barbuda
12568,13823,14841,1988,Cameroon,Kenya,0,0,African Cup of Nations,Rabat,Morocco,True,0,0,Draw
12569,13824,14842,1988,Egypt,Nigeria,0,0,African Cup of Nations,Rabat,Morocco,True,0,0,Draw
12570,13825,14843,1988,Malta,Scotland,1,1,Friendly,Attard,Malta,False,2,0,Draw
12571,13826,14844,1988,Algeria,Nigeria,1,1,African Cup of Nations,Rabat,Morocco,True,2,0,Draw
12572,13828,14846,1988,England,Netherlands,2,2,Friendly,London,England,False,4,0,Draw
12573,13829,14847,1988,France,Spain,2,1,Friendly,Bordeaux,France,False,3,1,France
12574,13830,14848,1988,Greece,Russia,0,4,Friendly,Athens,Greece,False,4,-4,Russia
12575,13831,14849,1988,Republic of Ireland,Romania,2,0,Friendly,Dublin,Republic of Ireland,False,2,2,Republic of Ireland
12576,13832,14850,1988,Morocco,Cameroon,0,1,African Cup of Nations,Casablanca,Morocco,False,1,-1,Cameroon
12577,13833,14851,1988,Northern Ireland,Poland,1,1,Friendly,Belfast,Northern Ireland,False,2,0,Draw
12578,13835,14853,1988,Belgium,Hungary,3,0,Friendly,Brussels,Belgium,False,3,3,Belgium
12579,13836,14854,1988,Morocco,Algeria,1,1,African Cup of Nations,Casablanca,Morocco,False,2,0,Draw
12580,13837,14855,1988,Peru,Canada,1,3,Friendly,Lima,Peru,False,4,-2,Canada
12581,13838,14856,1988,Cameroon,Nigeria,1,0,African Cup of Nations,Casablanca,Morocco,True,1,1,Cameroon
12582,13839,14857,1988,Mexico,El Salvador,8,0,Friendly,Mexico City,Mexico,False,8,8,Mexico
12583,13840,14858,1988,Colombia,Canada,3,0,Friendly,Armenia,Colombia,False,3,3,Colombia
12584,13841,14860,1988,Argentina,Russia,2,4,Friendly,Berlin,Germany,True,6,-2,Russia
12585,13842,14861,1988,Germany,Sweden,1,1,Friendly,Berlin,Germany,False,2,0,Draw
12586,13843,14863,1988,Germany,Argentina,1,0,Friendly,Berlin,Germany,False,1,1,Germany
12587,13844,14864,1988,Sweden,Russia,2,0,Friendly,Berlin,Germany,True,2,2,Sweden
12588,13845,14865,1988,Jamaica,Canada,0,4,Friendly,Kingston,Jamaica,False,4,-4,Canada
12589,13846,14866,1988,Greece,Austria,2,2,Friendly,Piraeus,Greece,False,4,0,Draw
12590,13847,14867,1988,Jamaica,Canada,0,0,Friendly,Montego Bay,Jamaica,False,0,0,Draw
12591,13848,14868,1988,Malaysia,Pakistan,4,0,AFC Asian Cup qualification,Kuala Lumpur,Malaysia,False,4,4,Malaysia
12592,13849,14869,1988,Kuwait,Japan,1,0,AFC Asian Cup qualification,Kuala Lumpur,Malaysia,True,1,1,Kuwait
12593,13850,14870,1988,El Salvador,Guatemala,0,0,Friendly,San Salvador,El Salvador,False,0,0,Draw
12594,13851,14871,1988,Jordan,Pakistan,1,0,AFC Asian Cup qualification,Kuala Lumpur,Malaysia,True,1,1,Jordan
12595,13852,14872,1988,Malaysia,Japan,0,1,AFC Asian Cup qualification,Kuala Lumpur,Malaysia,False,1,-1,Japan
12596,13853,14873,1988,Kuwait,Jordan,0,0,AFC Asian Cup qualification,Kuala Lumpur,Malaysia,True,0,0,Draw
12597,13855,14875,1988,Malaysia,Jordan,0,0,AFC Asian Cup qualification,Kuala Lumpur,Malaysia,False,0,0,Draw
12598,13856,14876,1988,Kuwait,Pakistan,3,0,AFC Asian Cup qualification,Kuala Lumpur,Malaysia,True,3,3,Kuwait
12599,13857,14877,1988,Japan,Jordan,1,1,AFC Asian Cup qualification,Kuala Lumpur,Malaysia,True,2,0,Draw
12600,13858,14878,1988,Guyana,Trinidad and Tobago,0,4,FIFA World Cup qualification,Georgetown,Guyana,False,4,-4,Trinidad and Tobago
12601,13859,14879,1988,Japan,Pakistan,4,1,AFC Asian Cup qualification,Kuala Lumpur,Malaysia,True,5,3,Japan
12602,13860,14880,1988,Malaysia,Kuwait,0,5,AFC Asian Cup qualification,Kuala Lumpur,Malaysia,False,5,-5,Kuwait
12603,13861,14881,1988,Guadeloupe,Suriname,1,1,CFU Caribbean Cup qualification,Basse-Terre,Guadeloupe,False,2,0,Draw
12604,13862,14882,1988,El Salvador,Guatemala,1,0,Friendly,Los Angeles,United States,True,1,1,El Salvador
12605,13863,14883,1988,Mexico,Honduras,4,1,Friendly,Ciudad Victoria,Mexico,False,5,3,Mexico
12606,13864,14884,1988,Austria,Denmark,1,0,Friendly,Vienna,Austria,False,1,1,Austria
12607,13865,14886,1988,Germany,Switzerland,1,0,Friendly,Kaiserslautern,Germany,False,1,1,Germany
12608,13866,14887,1988,Hungary,England,0,0,Friendly,Budapest,Hungary,False,0,0,Draw
12609,13868,14889,1988,Luxembourg,Italy,0,3,Friendly,Luxembourg,Luxembourg,False,3,-3,Italy
12610,13869,14890,1988,Northern Ireland,France,0,0,Friendly,Belfast,Northern Ireland,False,0,0,Draw
12611,13870,14891,1988,Spain,Scotland,0,0,Friendly,Madrid,Spain,False,0,0,Draw
12612,13871,14892,1988,Sweden,Wales,4,1,Friendly,Solna,Sweden,False,5,3,Sweden
12613,13872,14893,1988,Gambia,Senegal,0,4,Amílcar Cabral Cup,Bissau,Guinea-Bissau,True,4,-4,Senegal
12614,13873,14894,1988,Guinea-Bissau,Sierra Leone,0,0,Amílcar Cabral Cup,Bissau,Guinea-Bissau,False,0,0,Draw
12615,13874,14896,1988,Guinea,Mauritania,1,1,Amílcar Cabral Cup,Bissau,Guinea-Bissau,True,2,0,Draw
12616,13875,14897,1988,Cuba,Guatemala,0,1,FIFA World Cup qualification,Havana,Cuba,False,1,-1,Guatemala
12617,13876,14898,1988,Gambia,Sierra Leone,1,3,Amílcar Cabral Cup,Bissau,Guinea-Bissau,True,4,-2,Sierra Leone
12618,13877,14899,1988,Guinea-Bissau,Senegal,1,1,Amílcar Cabral Cup,Bissau,Guinea-Bissau,False,2,0,Draw
12619,13878,14901,1988,Guinea,Mali,1,0,Amílcar Cabral Cup,Bissau,Guinea-Bissau,True,1,1,Guinea
12620,13879,14902,1988,Guinea-Bissau,Gambia,3,1,Amílcar Cabral Cup,Bissau,Guinea-Bissau,False,4,2,Guinea-Bissau
12621,13880,14903,1988,Senegal,Sierra Leone,2,2,Amílcar Cabral Cup,Bissau,Guinea-Bissau,True,4,0,Draw
12622,13881,14905,1988,Mali,Mauritania,2,2,Amílcar Cabral Cup,Bissau,Guinea-Bissau,True,4,0,Draw
12623,13882,14906,1988,Hungary,Iceland,3,0,Friendly,Budapest,Hungary,False,3,3,Hungary
12624,13883,14907,1988,Guinea,Sierra Leone,3,0,Amílcar Cabral Cup,Bissau,Guinea-Bissau,True,3,3,Guinea
12625,13884,14908,1988,Mali,Senegal,1,1,Amílcar Cabral Cup,Bissau,Guinea-Bissau,True,2,0,Draw
12626,13885,14909,1988,Senegal,Sierra Leone,2,1,Amílcar Cabral Cup,Bissau,Guinea-Bissau,True,3,1,Senegal
12627,13886,14911,1988,Guinea,Mali,0,0,Amílcar Cabral Cup,Bissau,Guinea-Bissau,True,0,0,Draw
12628,13887,14912,1988,Trinidad and Tobago,Guyana,1,0,FIFA World Cup qualification,San Fernando,Trinidad and Tobago,False,1,1,Trinidad and Tobago
12629,13888,14913,1988,Hungary,Denmark,2,2,Friendly,Budapest,Hungary,False,4,0,Draw
12630,13889,14914,1988,Guadeloupe,Togo,2,1,Friendly,Paris,France,True,3,1,Guadeloupe
12631,13890,14915,1988,Jamaica,Puerto Rico,1,0,FIFA World Cup qualification,Kingston,Jamaica,False,1,1,Jamaica
12632,13891,14916,1988,Réunion,Togo,1,0,Friendly,Paris,France,True,1,1,Réunion
12633,13892,14917,1988,Guatemala,Cuba,1,1,FIFA World Cup qualification,San Marcos,Guatemala,False,2,0,Draw
12634,13893,14918,1988,Macau,Hong Kong,0,2,Friendly,Macau,Macau,False,2,-2,Hong Kong
12635,13894,14919,1988,Hungary,Austria,0,4,Friendly,Budapest,Hungary,False,4,-4,Austria
12636,13895,14920,1988,Scotland,Colombia,0,0,Rous Cup,Glasgow,Scotland,False,0,0,Draw
12637,13896,14921,1988,Canada,Greece,0,1,Friendly,Montréal,Canada,False,1,-1,Greece
12638,13897,14922,1988,Finland,Colombia,1,3,Friendly,Helsinki,Finland,False,4,-2,Colombia
12639,13898,14923,1988,Canada,Greece,0,3,Friendly,Toronto,Canada,False,3,-3,Greece
12640,13899,14924,1988,England,Scotland,1,0,Rous Cup,London,England,False,1,1,England
12641,13900,14925,1988,Northern Ireland,Malta,3,0,FIFA World Cup qualification,Belfast,Northern Ireland,False,3,3,Northern Ireland
12642,13901,14926,1988,Republic of Ireland,Poland,3,1,Friendly,Dublin,Republic of Ireland,False,4,2,Republic of Ireland
12643,13902,14927,1988,Chile,Greece,0,1,Friendly,Toronto,Canada,True,1,-1,Greece
12644,13903,14928,1988,England,Colombia,1,1,Rous Cup,London,England,False,2,0,Draw
12645,13904,14929,1988,Netherlands,Bulgaria,1,2,Friendly,Rotterdam,Netherlands,False,3,-1,Bulgaria
12646,13905,14930,1988,Burkina Faso,Ghana,3,0,Friendly,Ouagadougou,Burkina Faso,False,3,3,Burkina Faso
12647,13906,14931,1988,Canada,Chile,1,0,Friendly,Toronto,Canada,False,1,1,Canada
12648,13907,14932,1988,Nepal,Hong Kong,0,0,AFC Asian Cup qualification,Kathmandu,Nepal,False,0,0,Draw
12649,13909,14934,1988,Iran,Hong Kong,2,0,AFC Asian Cup qualification,Kathmandu,Nepal,True,2,2,Iran
12650,13910,14935,1988,Canada,Greece,0,0,Friendly,Toronto,Canada,False,0,0,Draw
12651,13912,14937,1988,Switzerland,England,0,1,Friendly,Basel,Switzerland,False,1,-1,England
12652,13913,14938,1988,Puerto Rico,Jamaica,1,2,FIFA World Cup qualification,San Juan,Puerto Rico,False,3,-1,Jamaica
12653,13914,14939,1988,Syria,Iran,1,1,AFC Asian Cup qualification,Kathmandu,Nepal,True,2,0,Draw
12654,13916,14942,1988,Malta,Wales,2,3,Friendly,Attard,Malta,False,5,-1,Wales
12655,13917,14943,1988,Nepal,Syria,0,3,AFC Asian Cup qualification,Kathmandu,Nepal,False,3,-3,Syria
12656,13918,14944,1988,Netherlands,Romania,2,0,Friendly,Amsterdam,Netherlands,False,2,2,Netherlands
12657,13919,14945,1988,Norway,Republic of Ireland,0,0,Friendly,Oslo,Norway,False,0,0,Draw
12658,13920,14946,1988,Russia,Poland,2,1,Friendly,Moscow,Soviet Union,False,3,1,Russia
12659,13921,14947,1988,Spain,Sweden,1,3,Friendly,Salamanca,Spain,False,4,-2,Sweden
12660,13922,14948,1988,United States,Chile,1,1,Friendly,Stockton,United States,False,2,0,Draw
12661,13925,14951,1988,Libya,Burkina Faso,3,0,FIFA World Cup qualification,Tripoli,Libya,False,3,3,Libya
12662,13926,14952,1988,Syria,Hong Kong,2,0,AFC Asian Cup qualification,Kathmandu,Nepal,True,2,2,Syria
12663,13927,14953,1988,United States,Chile,1,3,Friendly,San Diego,United States,False,4,-2,Chile
12664,13929,14955,1988,Italy,Wales,0,1,Friendly,Brescia,Italy,False,1,-1,Wales
12665,13930,14956,1988,Nepal,Iran,0,3,AFC Asian Cup qualification,Kathmandu,Nepal,False,3,-3,Iran
12666,13931,14957,1988,Zambia,Zimbabwe,3,2,Friendly,Lusaka,Zambia,False,5,1,Zambia
12667,13932,14958,1988,Denmark,Belgium,3,1,Friendly,Odense,Denmark,False,4,2,Denmark
12668,13933,14959,1988,Switzerland,Spain,1,1,Friendly,Basel,Switzerland,False,2,0,Draw
12669,13934,14960,1988,United States,Chile,0,3,Friendly,Fresno,United States,False,3,-3,Chile
12670,13935,14961,1988,United States,Ecuador,0,1,Friendly,Albuquerque,United States,False,1,-1,Ecuador
12671,13936,14962,1988,Seychelles,Tanzania,1,1,Friendly,Victoria,Seychelles,False,2,0,Draw
12672,13937,14963,1988,Germany,Italy,1,1,UEFA Euro,Düsseldorf,Germany,False,2,0,Draw
12673,13938,14964,1988,Mozambique,Malawi,1,2,Friendly,Maputo,Mozambique,False,3,-1,Malawi
12674,13939,14965,1988,United States,Ecuador,0,2,Friendly,Houston,United States,False,2,-2,Ecuador
12675,13940,14966,1988,Denmark,Spain,2,3,UEFA Euro,Hanover,Germany,True,5,-1,Spain
12676,13941,14967,1988,England,Republic of Ireland,0,1,UEFA Euro,Stuttgart,Germany,True,1,-1,Republic of Ireland
12677,13942,14968,1988,Netherlands,Russia,0,1,UEFA Euro,Cologne,Germany,True,1,-1,Russia
12678,13943,14969,1988,United States,Ecuador,0,0,Friendly,Fort Worth,United States,False,0,0,Draw
12679,13944,14970,1988,Germany,Denmark,2,0,UEFA Euro,Gelsenkirchen,Germany,False,2,2,Germany
12680,13945,14971,1988,Italy,Spain,1,0,UEFA Euro,Frankfurt am Main,Germany,True,1,1,Italy
12681,13946,14972,1988,Mozambique,Malawi,1,1,Friendly,Maputo,Mozambique,False,2,0,Draw
12682,13947,14973,1988,United States,Costa Rica,1,0,Friendly,San Antonio,United States,False,1,1,United States
12683,13948,14974,1988,England,Netherlands,1,3,UEFA Euro,Düsseldorf,Germany,True,4,-2,Netherlands
12684,13949,14975,1988,Honduras,Ecuador,1,1,Friendly,Tegucigalpa,Honduras,False,2,0,Draw
12685,13950,14976,1988,Republic of Ireland,Russia,1,1,UEFA Euro,Hanover,Germany,True,2,0,Draw
12686,13952,14978,1988,Canada,Costa Rica,0,1,Friendly,Montréal,Canada,False,1,-1,Costa Rica
12687,13953,14979,1988,Germany,Spain,2,0,UEFA Euro,Munich,Germany,False,2,2,Germany
12688,13954,14980,1988,Honduras,Ecuador,0,1,Friendly,Tegucigalpa,Honduras,False,1,-1,Ecuador
12689,13956,14982,1988,Italy,Denmark,2,0,UEFA Euro,Cologne,Germany,True,2,2,Italy
12690,13957,14983,1988,England,Russia,1,3,UEFA Euro,Frankfurt am Main,Germany,True,4,-2,Russia
12691,13958,14984,1988,Republic of Ireland,Netherlands,0,1,UEFA Euro,Gelsenkirchen,Germany,True,1,-1,Netherlands
12692,13959,14985,1988,Antigua and Barbuda,Curaçao,0,1,FIFA World Cup qualification,St. John's,Antigua and Barbuda,False,1,-1,Curaçao
12693,13960,14986,1988,Indonesia,Bahrain,0,0,AFC Asian Cup qualification,Jakarta,Indonesia,False,0,0,Draw
12694,13961,14989,1988,Germany,Netherlands,1,2,UEFA Euro,Hamburg,Germany,False,3,-1,Netherlands
12695,13962,14990,1988,Saudi Arabia,New Zealand,0,2,Friendly,Melbourne,Australia,True,2,-2,New Zealand
12696,13965,14993,1988,Russia,Italy,2,0,UEFA Euro,Stuttgart,Germany,True,2,2,Russia
12697,13966,14994,1988,Saudi Arabia,New Zealand,2,3,Friendly,Melbourne,Australia,True,5,-1,New Zealand
12698,13967,14995,1988,Russia,Netherlands,0,2,UEFA Euro,Munich,Germany,True,2,-2,Netherlands
12699,13968,14996,1988,Hong Kong,Saudi Arabia,0,3,Friendly,Melbourne,Australia,True,3,-3,Saudi Arabia
12700,13969,14997,1988,Curaçao,Costa Rica,1,1,Friendly,Willemstad,Netherlands Antilles,False,2,0,Draw
12701,13970,14998,1988,Hong Kong,Saudi Arabia,0,1,Friendly,Melbourne,Australia,True,1,-1,Saudi Arabia
12702,13971,14999,1988,Burkina Faso,Libya,2,0,FIFA World Cup qualification,Ouagadougou,Burkina Faso,False,2,2,Burkina Faso
12703,13972,15000,1988,Curaçao,Costa Rica,1,0,Friendly,Willemstad,Netherlands Antilles,False,1,1,Curaçao
12704,13973,15001,1988,Guadeloupe,Trinidad and Tobago,0,3,CFU Caribbean Cup,Fort-de-France,Martinique,True,3,-3,Trinidad and Tobago
12705,13974,15002,1988,Martinique,Antigua and Barbuda,2,2,CFU Caribbean Cup,Fort-de-France,Martinique,False,4,0,Draw
12706,13975,15003,1988,Argentina,Saudi Arabia,2,2,Friendly,Adelaide,Australia,True,4,0,Draw
12707,13976,15004,1988,Malawi,Zambia,1,0,Friendly,Blantyre,Malawi,False,1,1,Malawi
12708,13977,15005,1988,Antigua and Barbuda,Trinidad and Tobago,1,1,CFU Caribbean Cup,Fort-de-France,Martinique,True,2,0,Draw
12709,13978,15006,1988,Australia,Brazil,0,1,Friendly,Melbourne,Australia,False,1,-1,Brazil
12710,13979,15007,1988,Martinique,Guadeloupe,2,1,CFU Caribbean Cup,Fort-de-France,Martinique,False,3,1,Martinique
12711,13980,15008,1988,Algeria,Syria,1,1,UAFA Cup,Amman,Jordan,True,2,0,Draw
12712,13981,15009,1988,Jordan,Bahrain,0,0,UAFA Cup,Amman,Jordan,False,0,0,Draw
12713,13982,15010,1988,Malawi,Zambia,0,1,Friendly,Lilongwe,Malawi,False,1,-1,Zambia
12714,13983,15011,1988,Antigua and Barbuda,Guadeloupe,0,0,CFU Caribbean Cup,Fort-de-France,Martinique,True,0,0,Draw
12715,13984,15012,1988,Australia,Saudi Arabia,3,0,Friendly,Sydney,Australia,False,3,3,Australia
12716,13985,15013,1988,Egypt,Saudi Arabia,0,0,UAFA Cup,Amman,Jordan,True,0,0,Draw
12717,13986,15014,1988,Iraq,Tunisia,1,1,UAFA Cup,Amman,Jordan,True,2,0,Draw
12718,13987,15015,1988,Martinique,Trinidad and Tobago,0,3,CFU Caribbean Cup,Fort-de-France,Martinique,False,3,-3,Trinidad and Tobago
12719,13988,15016,1988,Algeria,Bahrain,0,0,UAFA Cup,Amman,Jordan,True,0,0,Draw
12720,13989,15017,1988,Argentina,Brazil,0,0,Friendly,Melbourne,Australia,True,0,0,Draw
12721,13990,15018,1988,Jordan,Kuwait,0,1,UAFA Cup,Amman,Jordan,False,1,-1,Kuwait
12722,13991,15019,1988,Malawi,Zambia,1,1,Friendly,Mzuzu,Malawi,False,2,0,Draw
12723,13992,15020,1988,Iraq,Lebanon,0,0,UAFA Cup,Amman,Jordan,True,0,0,Draw
12724,13993,15021,1988,Saudi Arabia,Tunisia,1,1,UAFA Cup,Amman,Jordan,True,2,0,Draw
12725,13994,15022,1988,Algeria,Kuwait,1,0,UAFA Cup,Amman,Jordan,True,1,1,Algeria
12726,13995,15023,1988,Bahrain,Syria,1,2,UAFA Cup,Amman,Jordan,True,3,-1,Syria
12727,13996,15024,1988,Brazil,Saudi Arabia,4,1,Friendly,Melbourne,Australia,True,5,3,Brazil
12728,13997,15025,1988,Egypt,Tunisia,1,0,UAFA Cup,Amman,Jordan,True,1,1,Egypt
12729,13998,15026,1988,Lebanon,Saudi Arabia,1,0,UAFA Cup,Amman,Jordan,True,1,1,Lebanon
12730,13999,15027,1988,Australia,Argentina,4,1,Friendly,Sydney,Australia,False,5,3,Australia
12731,14000,15028,1988,Jordan,Algeria,2,1,UAFA Cup,Amman,Jordan,False,3,1,Jordan
12732,14001,15029,1988,Kuwait,Syria,0,1,UAFA Cup,Amman,Jordan,True,1,-1,Syria
12733,14002,15030,1988,Canada,Poland,1,2,Friendly,Toronto,Canada,False,3,-1,Poland
12734,14003,15031,1988,Egypt,Lebanon,3,0,UAFA Cup,Amman,Jordan,True,3,3,Egypt
12735,14004,15032,1988,Iraq,Saudi Arabia,2,0,UAFA Cup,Amman,Jordan,True,2,2,Iraq
12736,14005,15033,1988,Argentina,Saudi Arabia,2,0,Friendly,Canberra,Australia,True,2,2,Argentina
12737,14006,15034,1988,Bahrain,Kuwait,1,1,UAFA Cup,Amman,Jordan,True,2,0,Draw
12738,14007,15035,1988,Jordan,Syria,2,0,UAFA Cup,Amman,Jordan,False,2,2,Jordan
12739,14008,15036,1988,Uganda,Malawi,1,0,FIFA World Cup qualification,Kampala,Uganda,False,1,1,Uganda
12740,14009,15037,1988,Australia,Brazil,0,2,Friendly,Sydney,Australia,False,2,-2,Brazil
12741,14010,15038,1988,Costa Rica,Panama,1,1,FIFA World Cup qualification,Alajuela,Costa Rica,False,2,0,Draw
12742,14011,15039,1988,Egypt,Iraq,0,0,UAFA Cup,Amman,Jordan,True,0,0,Draw
12743,14012,15040,1988,Lebanon,Tunisia,1,1,UAFA Cup,Amman,Jordan,True,2,0,Draw
12744,14013,15041,1988,Egypt,Syria,0,0,UAFA Cup,Amman,Jordan,True,0,0,Draw
12745,14014,15042,1988,Jordan,Iraq,0,3,UAFA Cup,Amman,Jordan,False,3,-3,Iraq
12746,14015,15043,1988,Iraq,Syria,1,1,UAFA Cup,Amman,Jordan,True,2,0,Draw
12747,14016,15044,1988,Jordan,Egypt,0,2,UAFA Cup,Amman,Jordan,False,2,-2,Egypt
12748,14017,15045,1988,Burkina Faso,Niger,1,0,Friendly,Ouagadougou,Burkina Faso,False,1,1,Burkina Faso
12749,14018,15046,1988,Jamaica,United States,0,0,FIFA World Cup qualification,Kingston,Jamaica,False,0,0,Draw
12750,14019,15047,1988,Benin,Ghana,1,1,Friendly,Ouagadougou,Burkina Faso,True,2,0,Draw
12751,14020,15048,1988,Burkina Faso,Ghana,3,1,Friendly,Ouagadougou,Burkina Faso,False,4,2,Burkina Faso
12752,14021,15049,1988,Mali,Niger,1,0,Friendly,Ouagadougou,Burkina Faso,True,1,1,Mali
12753,14022,15050,1988,Norway,Brazil,1,1,Friendly,Oslo,Norway,False,2,0,Draw
12754,14023,15051,1988,Benin,Mali,0,1,Friendly,Ouagadougou,Burkina Faso,True,1,-1,Mali
12755,14024,15052,1988,Curaçao,Antigua and Barbuda,3,1,FIFA World Cup qualification,Willemstad,Netherlands Antilles,True,4,2,Curaçao
12756,14025,15053,1988,Ghana,Niger,0,3,Friendly,Ouagadougou,Burkina Faso,True,3,-3,Niger
12757,14026,15054,1988,Malawi,Uganda,3,1,FIFA World Cup qualification,Lilongwe,Malawi,False,4,2,Malawi
12758,14027,15055,1988,Burkina Faso,Benin,1,0,Friendly,Ouagadougou,Burkina Faso,False,1,1,Burkina Faso
12759,14028,15056,1988,Ghana,Mali,1,0,Friendly,Ouagadougou,Burkina Faso,True,1,1,Ghana
12760,14029,15057,1988,Panama,Costa Rica,0,2,FIFA World Cup qualification,Panama City,Panama,False,2,-2,Costa Rica
12761,14030,15058,1988,Angola,Gabon,4,1,Friendly,Luanda,Angola,False,5,3,Angola
12762,14031,15059,1988,Benin,Niger,0,5,Friendly,Ouagadougou,Burkina Faso,True,5,-5,Niger
12763,14032,15060,1988,Burkina Faso,Mali,2,1,Friendly,Ouagadougou,Burkina Faso,False,3,1,Burkina Faso
12764,14033,15061,1988,Austria,Brazil,0,2,Friendly,Vienna,Austria,False,2,-2,Brazil
12765,14034,15062,1988,Zambia,Malawi,4,1,Friendly,Lusaka,Zambia,False,5,3,Zambia
12766,14035,15063,1988,Burkina Faso,Niger,1,0,Friendly,Ouagadougou,Burkina Faso,False,1,1,Burkina Faso
12767,14036,15064,1988,Finland,Bulgaria,1,1,Friendly,Vaasa,Finland,False,2,0,Draw
12768,14037,15065,1988,Zambia,Malawi,7,1,Friendly,Lusaka,Zambia,False,8,6,Zambia
12769,14038,15066,1988,El Salvador,Guatemala,1,2,Friendly,Los Angeles,United States,True,3,-1,Guatemala
12770,14039,15067,1988,Indonesia,Thailand,1,0,Indonesia Tournament,Jakarta,Indonesia,False,1,1,Indonesia
12771,14040,15068,1988,Tunisia,Guinea,5,0,FIFA World Cup qualification,Tunis,Tunisia,False,5,5,Tunisia
12772,14041,15069,1988,Albania,Cuba,0,0,Friendly,Berat,Albania,False,0,0,Draw
12773,14042,15070,1988,Angola,Sudan,0,0,FIFA World Cup qualification,Luanda,Angola,False,0,0,Draw
12774,14043,15071,1988,Colombia,Uruguay,2,1,Friendly,Bogotá,Colombia,False,3,1,Colombia
12775,14044,15072,1988,Ghana,Liberia,0,0,FIFA World Cup qualification,Accra,Ghana,False,0,0,Draw
12776,14045,15073,1988,Iceland,Bulgaria,2,3,Friendly,Reykjavík,Iceland,False,5,-1,Bulgaria
12777,14046,15074,1988,Norway,Bulgaria,1,1,Friendly,Oslo,Norway,False,2,0,Draw
12778,14047,15075,1988,United States,Jamaica,5,1,FIFA World Cup qualification,St. Louis,United States,False,6,4,United States
12779,14048,15076,1988,Finland,Russia,0,0,Friendly,Turku,Finland,False,0,0,Draw
12780,14049,15077,1988,Guinea,Tunisia,3,0,FIFA World Cup qualification,Conakry,Guinea,False,3,3,Guinea
12781,14050,15078,1988,Liberia,Ghana,2,0,FIFA World Cup qualification,Monrovia,Liberia,False,2,2,Liberia
12782,14052,15080,1988,Iceland,Faroe Islands,1,0,Friendly,Akranes,Iceland,False,1,1,Iceland
12783,14053,15081,1988,Poland,Bulgaria,3,2,Friendly,Białystok,Poland,False,5,1,Poland
12784,14055,15083,1988,Austria,Hungary,0,0,Friendly,Linz,Austria,False,0,0,Draw
12785,14056,15084,1988,Finland,Germany,0,4,FIFA World Cup qualification,Helsinki,Finland,False,4,-4,Germany
12786,14057,15086,1988,Iceland,Russia,1,1,FIFA World Cup qualification,Reykjavík,Iceland,False,2,0,Draw
12787,14058,15087,1988,Sweden,Denmark,1,2,Friendly,Solna,Sweden,False,3,-1,Denmark
12788,14059,15088,1988,Ecuador,Paraguay,1,5,Friendly,Guayaquil,Ecuador,False,6,-4,Paraguay
12789,14060,15089,1988,Honduras,Paraguay,0,0,Friendly,San Pedro Sula,Honduras,False,0,0,Draw
12790,14061,15090,1988,Chile,Ecuador,3,1,Friendly,La Serena,Chile,False,4,2,Chile
12791,14062,15091,1988,England,Denmark,1,0,Friendly,London,England,False,1,1,England
12792,14063,15092,1988,Netherlands,Wales,1,0,FIFA World Cup qualification,Amsterdam,Netherlands,False,1,1,Netherlands
12793,14064,15093,1988,Northern Ireland,Republic of Ireland,0,0,FIFA World Cup qualification,Belfast,Northern Ireland,False,0,0,Draw
12794,14065,15094,1988,Norway,Scotland,1,2,FIFA World Cup qualification,Oslo,Norway,False,3,-1,Scotland
12795,14067,15096,1988,Honduras,Paraguay,0,2,Friendly,Tegucigalpa,Honduras,False,2,-2,Paraguay
12796,14068,15097,1988,Saudi Arabia,Iran,1,0,AFC Asian Cup,Doha,Qatar,True,1,1,Saudi Arabia
12797,14069,15099,1988,Romania,Albania,3,0,Friendly,Constanţa,Romania,False,3,3,Romania
12798,14070,15101,1988,Germany,Russia,1,0,Friendly,Düsseldorf,Germany,False,1,1,Germany
12799,14071,15102,1988,Iceland,Hungary,0,3,Friendly,Reykjavík,Iceland,False,3,-3,Hungary
12800,14072,15103,1988,Luxembourg,Switzerland,1,4,FIFA World Cup qualification,Luxembourg,Luxembourg,False,5,-3,Switzerland
12801,14073,15104,1988,Peru,Paraguay,0,1,Friendly,Lima,Peru,False,1,-1,Paraguay
12802,14074,15105,1988,Turkey,Greece,3,1,Friendly,Istanbul,Turkey,False,4,2,Turkey
12803,14075,15106,1988,El Salvador,Honduras,0,0,Friendly,Los Angeles,United States,True,0,0,Draw
12804,14076,15107,1988,Curaçao,Venezuela,0,0,Friendly,Willemstad,Netherlands Antilles,False,0,0,Draw
12805,14077,15108,1988,Malawi,Mozambique,1,1,Friendly,Blantyre,Malawi,False,2,0,Draw
12806,14078,15109,1988,Ecuador,Uruguay,1,2,Friendly,Asunción,Paraguay,True,3,-1,Uruguay
12807,14079,15110,1988,Paraguay,Chile,2,0,Friendly,Asunción,Paraguay,False,2,2,Paraguay
12808,14080,15111,1988,Denmark,Iceland,1,0,Friendly,Copenhagen,Denmark,False,1,1,Denmark
12809,14081,15112,1988,France,Norway,1,0,FIFA World Cup qualification,Paris,France,False,1,1,France
12810,14082,15113,1988,Malawi,Mozambique,1,0,Friendly,Lilongwe,Malawi,False,1,1,Malawi
12811,14083,15114,1988,Chile,Ecuador,0,0,Friendly,Asunción,Paraguay,True,0,0,Draw
12812,14084,15115,1988,Paraguay,Uruguay,3,1,Friendly,Asunción,Paraguay,False,4,2,Paraguay
12813,14085,15116,1988,Curaçao,El Salvador,0,1,FIFA World Cup qualification,Willemstad,Netherlands Antilles,True,1,-1,El Salvador
12814,14086,15117,1988,Indonesia,Qatar,0,1,Friendly,Jakarta,Indonesia,False,1,-1,Qatar
12815,14087,15118,1988,Liberia,Mali,0,1,African Cup of Nations qualification,Monrovia,Liberia,False,1,-1,Mali
12816,14088,15119,1988,Mauritius,Seychelles,3,0,African Cup of Nations qualification,Curepipe,Mauritius,False,3,3,Mauritius
12817,14089,15120,1988,Trinidad and Tobago,Canada,1,2,Friendly,Port of Spain,Trinidad and Tobago,False,3,-1,Canada
12818,14090,15121,1988,Indonesia,Qatar,1,4,Friendly,Jakarta,Indonesia,False,5,-3,Qatar
12819,14091,15122,1988,Gabon,Burkina Faso,3,0,African Cup of Nations qualification,Libreville,Gabon,False,3,3,Gabon
12820,14092,15123,1988,Guatemala,Canada,1,0,FIFA World Cup qualification,Guatemala,Guatemala,False,1,1,Guatemala
12821,14093,15124,1988,Singapore,Qatar,0,1,Friendly,Kallang,Singapore,False,1,-1,Qatar
12822,14094,15125,1988,Belgium,Brazil,1,2,Friendly,Antwerp,Belgium,False,3,-1,Brazil
12823,14095,15126,1988,Cyprus,Malta,0,1,Friendly,Limassol,Cyprus,False,1,-1,Malta
12824,14096,15127,1988,New Zealand,Australia,1,2,Friendly,Dunedin,New Zealand,False,3,-1,Australia
12825,14097,15128,1988,Spain,Argentina,1,1,Friendly,Seville,Spain,False,2,0,Draw
12826,14098,15129,1988,Sweden,Portugal,0,0,Friendly,Gothenburg,Sweden,False,0,0,Draw
12827,14099,15130,1988,Turkey,Iceland,1,1,FIFA World Cup qualification,Istanbul,Turkey,False,2,0,Draw
12828,14100,15131,1988,Uruguay,Paraguay,2,0,Friendly,Montevideo,Uruguay,False,2,2,Uruguay
12829,14101,15132,1988,Canada,Guatemala,3,2,FIFA World Cup qualification,Burnaby,Canada,False,5,1,Canada
12830,14102,15133,1988,Australia,New Zealand,2,0,Friendly,Bendigo,Australia,False,2,2,Australia
12831,14103,15134,1988,El Salvador,Curaçao,5,0,FIFA World Cup qualification,San Salvador,El Salvador,False,5,5,El Salvador
12832,14104,15135,1988,Equatorial Guinea,Angola,0,0,African Cup of Nations qualification,Malabo,Equatorial Guinea,False,0,0,Draw
12833,14105,15136,1988,Mali,Liberia,3,0,African Cup of Nations qualification,Bamako,Mali,False,3,3,Mali
12834,14106,15137,1988,Eswatini,Tanzania,1,1,African Cup of Nations qualification,Mbabane,Eswatini,False,2,0,Draw
12835,14107,15138,1988,Israel,Malta,2,0,Friendly,Beersheba,Israel,False,2,2,Israel
12836,14109,15140,1988,Belgium,Switzerland,1,0,FIFA World Cup qualification,Brussels,Belgium,False,1,1,Belgium
12837,14110,15141,1988,Bulgaria,Romania,1,3,FIFA World Cup qualification,Sofia,Bulgaria,False,4,-2,Romania
12838,14111,15142,1988,England,Sweden,0,0,FIFA World Cup qualification,London,England,False,0,0,Draw
12839,14112,15144,1988,Germany,Netherlands,0,0,FIFA World Cup qualification,Munich,Germany,False,0,0,Draw
12840,14113,15145,1988,Greece,Denmark,1,1,FIFA World Cup qualification,Athens,Greece,False,2,0,Draw
12841,14114,15146,1988,Hungary,Northern Ireland,1,0,FIFA World Cup qualification,Budapest,Hungary,False,1,1,Hungary
12842,14115,15147,1988,Republic of Ireland,Tunisia,4,0,Friendly,Dublin,Republic of Ireland,False,4,4,Republic of Ireland
12843,14116,15148,1988,Italy,Norway,2,1,Friendly,Pescara,Italy,False,3,1,Italy
12844,14117,15149,1988,Poland,Albania,1,0,FIFA World Cup qualification,Chorzów,Poland,False,1,1,Poland
12845,14118,15150,1988,Russia,Austria,2,0,FIFA World Cup qualification,Kyïv,Soviet Union,True,2,2,Russia
12846,14120,15152,1988,Wales,Finland,2,2,FIFA World Cup qualification,Swansea,Wales,False,4,0,Draw
12847,14121,15153,1988,Solomon Islands,Fiji,1,1,Friendly,Honiara,Solomon Islands,False,2,0,Draw
12848,14122,15154,1988,Cyprus,France,1,1,FIFA World Cup qualification,Nicosia,Cyprus,False,2,0,Draw
12849,14123,15155,1988,Burkina Faso,Gabon,1,0,African Cup of Nations qualification,Ouagadougou,Burkina Faso,False,1,1,Burkina Faso
12850,14124,15156,1988,New Caledonia,Vanuatu,6,1,Friendly,Honiara,Solomon Islands,True,7,5,New Caledonia
12851,14125,15157,1988,Fiji,Vanuatu,8,0,Friendly,Honiara,Solomon Islands,True,8,8,Fiji
12852,14126,15158,1988,Solomon Islands,New Caledonia,1,0,Friendly,Honiara,Solomon Islands,False,1,1,Solomon Islands
12853,14127,15159,1988,Chile,Peru,2,0,Copa del Pacífico,Arica,Chile,False,2,2,Chile
12854,14128,15160,1988,Fiji,New Caledonia,2,0,Friendly,Honiara,Solomon Islands,True,2,2,Fiji
12855,14129,15161,1988,Solomon Islands,Vanuatu,5,0,Friendly,Honiara,Solomon Islands,False,5,5,Solomon Islands
12856,14131,15163,1988,New Caledonia,Vanuatu,0,1,Friendly,Honiara,Solomon Islands,True,1,-1,Vanuatu
12857,14132,15164,1988,Solomon Islands,Fiji,1,3,Friendly,Honiara,Solomon Islands,False,4,-2,Fiji
12858,14133,15165,1988,Algeria,Angola,1,1,Friendly,Mascara,Algeria,False,2,0,Draw
12859,14134,15166,1988,Trinidad and Tobago,Honduras,0,0,FIFA World Cup qualification,Port of Spain,Trinidad and Tobago,False,0,0,Draw
12860,14135,15167,1988,Chile,Uruguay,1,1,Copa Juan Pinto Durán,Concepción,Chile,False,2,0,Draw
12861,14136,15168,1988,Austria,Turkey,3,2,FIFA World Cup qualification,Vienna,Austria,False,5,1,Austria
12862,14137,15169,1988,Cyprus,Norway,0,3,FIFA World Cup qualification,Limassol,Cyprus,False,3,-3,Norway
12863,14138,15170,1988,Denmark,Bulgaria,1,1,FIFA World Cup qualification,Copenhagen,Denmark,False,2,0,Draw
12864,14139,15171,1988,Romania,Greece,3,0,FIFA World Cup qualification,Bucharest,Romania,False,3,3,Romania
12865,14140,15172,1988,Kuwait,Finland,0,0,Friendly,Kuwait City,Kuwait,False,0,0,Draw
12866,14141,15174,1988,Albania,Sweden,1,2,FIFA World Cup qualification,Tirana,Albania,False,3,-1,Sweden
12867,14142,15175,1988,Ethiopia,Zambia,0,0,CECAFA Cup,Blantyre,Malawi,True,0,0,Draw
12868,14143,15176,1988,Kuwait,Finland,0,0,Friendly,Kuwait City,Kuwait,False,0,0,Draw
12869,14144,15177,1988,Malawi,Tanzania,0,0,CECAFA Cup,Lilongwe,Malawi,False,0,0,Draw
12870,14146,15179,1988,Tunisia,Angola,5,0,Friendly,Tunis,Tunisia,False,5,5,Tunisia
12871,14147,15180,1988,Uganda,Zimbabwe,0,0,CECAFA Cup,Blantyre,Malawi,True,0,0,Draw
12872,14148,15181,1988,El Salvador,Guatemala,0,0,Friendly,Los Angeles,United States,True,0,0,Draw
12873,14149,15182,1988,Indonesia,Qatar,0,1,Friendly,Jakarta,Indonesia,False,1,-1,Qatar
12874,14150,15183,1988,Uruguay,Chile,3,1,Copa Juan Pinto Durán,Montevideo,Uruguay,False,4,2,Uruguay
12875,14151,15184,1988,Kenya,Tanzania,2,0,CECAFA Cup,Lilongwe,Malawi,True,2,2,Kenya
12876,14153,15186,1988,Ethiopia,Uganda,2,1,CECAFA Cup,Blantyre,Malawi,True,3,1,Ethiopia
12877,14154,15187,1988,Sudan,Angola,1,2,FIFA World Cup qualification,Khartoum,Sudan,False,3,-1,Angola
12878,14155,15188,1988,Zambia,Zimbabwe,1,1,CECAFA Cup,Blantyre,Malawi,True,2,0,Draw
12879,14156,15189,1988,Malawi,Kenya,3,0,CECAFA Cup,Lilongwe,Malawi,False,3,3,Malawi
12880,14158,15191,1988,Algeria,Mali,7,0,Friendly,Algiers,Algeria,False,7,7,Algeria
12881,14159,15192,1988,DR Congo,Congo,1,0,Friendly,Kinshasa,Zaïre,False,1,1,DR Congo
12882,14160,15193,1988,Ethiopia,Zimbabwe,1,2,CECAFA Cup,Blantyre,Malawi,True,3,-1,Zimbabwe
12883,14161,15194,1988,Honduras,Trinidad and Tobago,1,1,FIFA World Cup qualification,Tegucigalpa,Honduras,False,2,0,Draw
12884,14162,15195,1988,Uganda,Zambia,0,3,CECAFA Cup,Blantyre,Malawi,True,3,-3,Zambia
12885,14163,15196,1988,Fiji,New Zealand,1,1,Friendly,Suva,Fiji,False,2,0,Draw
12886,14164,15197,1988,Saudi Arabia,Egypt,0,0,Friendly,Riyadh,Saudi Arabia,False,0,0,Draw
12887,14165,15198,1988,Greece,Hungary,3,0,Friendly,Piraeus,Greece,False,3,3,Greece
12888,14166,15200,1988,Italy,Netherlands,1,0,Friendly,Rome,Italy,False,1,1,Italy
12889,14167,15201,1988,Kuwait,Egypt,2,2,Friendly,Kuwait City,Kuwait,False,4,0,Draw
12890,14168,15202,1988,Portugal,Luxembourg,1,0,FIFA World Cup qualification,Porto,Portugal,False,1,1,Portugal
12891,14169,15203,1988,Saudi Arabia,England,1,1,Friendly,Riyadh,Saudi Arabia,False,2,0,Draw
12892,14170,15204,1988,Spain,Republic of Ireland,2,0,FIFA World Cup qualification,Seville,Spain,False,2,2,Spain
12893,14171,15206,1988,Fiji,New Zealand,2,0,Friendly,Lautoka,Fiji,False,2,2,Fiji
12894,14172,15207,1988,Kenya,Zambia,0,1,CECAFA Cup,Blantyre,Malawi,True,1,-1,Zambia
12895,14173,15208,1988,United Arab Emirates,Jordan,2,1,Friendly,Sharjah,United Arab Emirates,False,3,1,United Arab Emirates
12896,14174,15209,1988,Angola,Senegal,1,2,Friendly,Praia,Cape Verde,True,3,-1,Senegal
12897,14175,15211,1988,Fiji,New Zealand,1,0,Friendly,Ba,Fiji,False,1,1,Fiji
12898,14176,15212,1988,Kenya,Zimbabwe,0,0,CECAFA Cup,Blantyre,Malawi,True,0,0,Draw
12899,14177,15213,1988,Malawi,Zambia,3,1,CECAFA Cup,Blantyre,Malawi,False,4,2,Malawi
12900,14178,15215,1988,United Arab Emirates,Jordan,3,2,Friendly,Dubai,United Arab Emirates,False,5,1,United Arab Emirates
12901,14179,15216,1988,Syria,Russia,0,2,Friendly,Damascus,Syria,False,2,-2,Russia
12902,14180,15217,1988,Kuwait,Russia,0,1,Friendly,Kuwait City,Kuwait,False,1,-1,Russia
12903,14181,15218,1988,Malta,Cyprus,1,1,Friendly,Attard,Malta,False,2,0,Draw
12904,14182,15219,1988,Peru,Chile,1,1,Copa del Pacífico,Lima,Peru,False,2,0,Draw
12905,14183,15220,1988,Romania,Israel,3,0,Friendly,Sibiu,Romania,False,3,3,Romania
12906,14184,15221,1988,United Arab Emirates,Algeria,1,1,Friendly,Dubai,United Arab Emirates,False,2,0,Draw
12907,14185,15222,1988,Guinea,Sierra Leone,1,0,Friendly,Monrovia,Liberia,True,1,1,Guinea
12908,14186,15223,1988,Fiji,Australia,1,0,FIFA World Cup qualification,Nadi,Fiji,False,1,1,Fiji
12909,14187,15224,1988,Liberia,Sierra Leone,0,0,Friendly,Monrovia,Liberia,False,0,0,Draw
12910,14188,15225,1988,Kuwait,Russia,0,2,Friendly,Kuwait City,Kuwait,False,2,-2,Russia
12911,14189,15226,1988,Liberia,Guinea,0,1,Friendly,Monrovia,Liberia,False,1,-1,Guinea
12912,14190,15227,1988,Saudi Arabia,Tunisia,1,0,Friendly,Khobar,Saudi Arabia,False,1,1,Saudi Arabia
12913,14191,15228,1988,Cameroon,Gabon,0,0,UDEAC Cup,Douala,Cameroon,False,0,0,Draw
12914,14192,15229,1988,Congo,Chad,2,1,UDEAC Cup,Douala,Cameroon,True,3,1,Congo
12915,14194,15231,1988,Cameroon,Equatorial Guinea,2,1,UDEAC Cup,Douala,Cameroon,False,3,1,Cameroon
12916,14195,15232,1988,Central African Republic,Chad,2,1,UDEAC Cup,Douala,Cameroon,True,3,1,Central African Republic
12917,14196,15233,1988,Qatar,Iran,0,2,AFC Asian Cup,Doha,Qatar,False,2,-2,Iran
12918,14197,15234,1988,Syria,Saudi Arabia,0,2,AFC Asian Cup,Doha,Qatar,True,2,-2,Saudi Arabia
12919,14198,15235,1988,Australia,Fiji,5,1,FIFA World Cup qualification,Speers Point,Australia,False,6,4,Australia
12920,14199,15236,1988,Kuwait,Bahrain,0,0,AFC Asian Cup,Doha,Qatar,True,0,0,Draw
12921,14201,15238,1988,Central African Republic,Congo,0,1,UDEAC Cup,Douala,Cameroon,True,1,-1,Congo
12922,14202,15240,1988,Equatorial Guinea,Gabon,0,3,UDEAC Cup,Douala,Cameroon,True,3,-3,Gabon
12923,14203,15241,1988,Japan,Iran,0,0,AFC Asian Cup,Doha,Qatar,True,0,0,Draw
12924,14204,15242,1988,Qatar,United Arab Emirates,2,1,AFC Asian Cup,Doha,Qatar,False,3,1,Qatar
12925,14205,15243,1988,Saudi Arabia,Kuwait,0,0,AFC Asian Cup,Doha,Qatar,True,0,0,Draw
12926,14207,15245,1988,Cameroon,Congo,2,0,UDEAC Cup,Douala,Cameroon,False,2,2,Cameroon
12927,14208,15246,1988,Central African Republic,Gabon,0,0,UDEAC Cup,Douala,Cameroon,True,0,0,Draw
12928,14209,15248,1988,Morocco,Egypt,0,0,Friendly,Casablanca,Morocco,False,0,0,Draw
12929,14210,15249,1988,Cameroon,Gabon,0,1,UDEAC Cup,Douala,Cameroon,False,1,-1,Gabon
12930,14211,15250,1988,Central African Republic,Congo,0,3,UDEAC Cup,Douala,Cameroon,True,3,-3,Congo
12931,14212,15251,1988,Iran,United Arab Emirates,1,0,AFC Asian Cup,Doha,Qatar,True,1,1,Iran
12932,14213,15252,1988,Malaysia,Indonesia,0,0,Merdeka Tournament,Kuala Lumpur,Malaysia,False,0,0,Draw
12933,14214,15253,1988,Syria,Kuwait,1,0,AFC Asian Cup,Doha,Qatar,True,1,1,Syria
12934,14215,15254,1988,Oman,Singapore,1,3,Merdeka Tournament,Kuala Lumpur,Malaysia,True,4,-2,Singapore
12935,14217,15256,1988,Saudi Arabia,Bahrain,1,1,AFC Asian Cup,Doha,Qatar,True,2,0,Draw
12936,14218,15257,1988,Ivory Coast,Tunisia,1,0,Friendly,Abidjan,Ivory Coast,False,1,1,Ivory Coast
12937,14220,15259,1988,Malaysia,Thailand,0,0,Merdeka Tournament,Kuala Lumpur,Malaysia,False,0,0,Draw
12938,14221,15260,1988,United Arab Emirates,Japan,1,0,AFC Asian Cup,Doha,Qatar,True,1,1,United Arab Emirates
12939,14222,15261,1988,Bahrain,Syria,0,1,AFC Asian Cup,Doha,Qatar,True,1,-1,Syria
12940,14223,15263,1988,Malta,Hungary,2,2,FIFA World Cup qualification,Attard,Malta,False,4,0,Draw
12941,14224,15266,1988,Indonesia,Thailand,0,0,Merdeka Tournament,Kuala Lumpur,Malaysia,True,0,0,Draw
12942,14225,15267,1988,Qatar,Japan,3,0,AFC Asian Cup,Doha,Qatar,False,3,3,Qatar
12943,14226,15268,1988,Egypt,Switzerland,1,3,Friendly,Cairo,Egypt,False,4,-2,Switzerland
12944,14227,15270,1988,Uruguay,Peru,3,0,Friendly,Montevideo,Uruguay,False,3,3,Uruguay
12945,14228,15271,1988,Morocco,Gabon,5,2,Friendly,Rabat,Morocco,False,7,3,Morocco
12946,14230,15274,1988,Ivory Coast,Tunisia,1,1,Friendly,Abidjan,Ivory Coast,False,2,0,Draw
12947,14231,15276,1988,Liberia,Tunisia,1,1,Friendly,Paynesville,Liberia,False,2,0,Draw
12948,14232,15277,1988,Zambia,Egypt,1,2,Friendly,Kitwe,Zambia,False,3,-1,Egypt
12949,14233,15278,1988,Spain,Northern Ireland,4,0,FIFA World Cup qualification,Seville,Spain,False,4,4,Spain
12950,14234,15279,1988,Italy,Scotland,2,0,Friendly,Perugia,Italy,False,2,2,Italy
12951,14235,15280,1988,Morocco,Guinea,1,0,Friendly,Rabat,Morocco,False,1,1,Morocco
12952,14236,15281,1988,DR Congo,Angola,0,0,Friendly,Kinshasa,Zaïre,False,0,0,Draw
12953,14237,15282,1989,Israel,Netherlands,0,2,Friendly,Ramat-Gan,Israel,False,2,-2,Netherlands
12954,14238,15283,1989,Algeria,Zimbabwe,3,0,FIFA World Cup qualification,Annaba,Algeria,False,3,3,Algeria
12955,14239,15284,1989,Egypt,Liberia,2,0,FIFA World Cup qualification,Cairo,Egypt,False,2,2,Egypt
12956,14240,15285,1989,Oman,Iraq,1,1,FIFA World Cup qualification,Muscat,Oman,False,2,0,Draw
12957,14241,15286,1989,Pakistan,Kuwait,0,1,FIFA World Cup qualification,Islamabad,Pakistan,False,1,-1,Kuwait
12958,14242,15287,1989,Qatar,Jordan,1,0,FIFA World Cup qualification,Doha,Qatar,False,1,1,Qatar
12959,14243,15288,1989,Kenya,Malawi,1,1,FIFA World Cup qualification,Nairobi,Kenya,False,2,0,Draw
12960,14244,15289,1989,Nigeria,Gabon,1,0,FIFA World Cup qualification,Enugu,Nigeria,False,1,1,Nigeria
12961,14245,15290,1989,Cameroon,Angola,1,1,FIFA World Cup qualification,Yaoundé,Cameroon,False,2,0,Draw
12962,14246,15291,1989,DR Congo,Tunisia,3,1,FIFA World Cup qualification,Kinshasa,Zaïre,False,4,2,DR Congo
12963,14247,15292,1989,Ivory Coast,Libya,1,0,FIFA World Cup qualification,Abidjan,Ivory Coast,False,1,1,Ivory Coast
12964,14248,15293,1989,Morocco,Zambia,1,0,FIFA World Cup qualification,Rabat,Morocco,False,1,1,Morocco
12965,14249,15294,1989,Egypt,Finland,2,1,Friendly,Al-Mahalla al-Kubra,Egypt,False,3,1,Egypt
12966,14250,15295,1989,Malta,Israel,1,2,Friendly,Attard,Malta,False,3,-1,Israel
12967,14251,15296,1989,Egypt,Finland,2,1,Friendly,Cairo,Egypt,False,3,1,Egypt
12968,14252,15297,1989,Jordan,Iraq,0,1,FIFA World Cup qualification,Amman,Jordan,False,1,-1,Iraq
12969,14253,15298,1989,Kuwait,United Arab Emirates,3,2,FIFA World Cup qualification,Kuwait City,Kuwait,False,5,1,Kuwait
12970,14254,15299,1989,Oman,Qatar,0,0,FIFA World Cup qualification,Muscat,Oman,False,0,0,Draw
12971,14255,15300,1989,Albania,Greece,1,1,Friendly,Tirana,Albania,False,2,0,Draw
12972,14256,15301,1989,Iran,Japan,2,2,Friendly,Teheran,Iran,False,4,0,Draw
12973,14257,15302,1989,Jordan,Oman,2,0,FIFA World Cup qualification,Amman,Jordan,False,2,2,Jordan
12974,14258,15303,1989,Qatar,Iraq,1,0,FIFA World Cup qualification,Doha,Qatar,False,1,1,Qatar
12975,14259,15304,1989,United Arab Emirates,Pakistan,5,0,FIFA World Cup qualification,Sharjah,United Arab Emirates,False,5,5,United Arab Emirates
12976,14260,15305,1989,Malawi,Egypt,1,1,FIFA World Cup qualification,Lilongwe,Malawi,False,2,0,Draw
12977,14261,15306,1989,Angola,Nigeria,2,2,FIFA World Cup qualification,Luanda,Angola,False,4,0,Draw
12978,14262,15307,1989,Gabon,Cameroon,1,3,FIFA World Cup qualification,Libreville,Gabon,False,4,-2,Cameroon
12979,14263,15308,1989,Liberia,Kenya,0,0,FIFA World Cup qualification,Monrovia,Liberia,False,0,0,Draw
12980,14264,15309,1989,Malta,Spain,0,2,FIFA World Cup qualification,Attard,Malta,False,2,-2,Spain
12981,14265,15310,1989,Tunisia,Morocco,2,1,FIFA World Cup qualification,Tunis,Tunisia,False,3,1,Tunisia
12982,14266,15311,1989,Zambia,DR Congo,4,2,FIFA World Cup qualification,Lusaka,Zambia,False,6,2,Zambia
12983,14267,15312,1989,Zimbabwe,Ivory Coast,0,0,FIFA World Cup qualification,Harare,Zimbabwe,False,0,0,Draw
12984,14268,15313,1989,Greece,Portugal,1,2,Friendly,Athens,Greece,False,3,-1,Portugal
12985,14270,15315,1989,Iraq,Oman,3,1,FIFA World Cup qualification,Baghdad,Iraq,False,4,2,Iraq
12986,14271,15316,1989,Jordan,Qatar,1,1,FIFA World Cup qualification,Amman,Jordan,False,2,0,Draw
12987,14272,15317,1989,Kuwait,Pakistan,2,0,FIFA World Cup qualification,Kuwait City,Kuwait,False,2,2,Kuwait
12988,14273,15318,1989,Thailand,Malaysia,1,0,King's Cup,Bangkok,Thailand,False,1,1,Thailand
12989,14274,15319,1989,Ecuador,Chile,1,0,Friendly,Guayaquil,Ecuador,False,1,1,Ecuador
12990,14275,15320,1989,Senegal,DR Congo,1,1,Friendly,Dakar,Senegal,False,2,0,Draw
12991,14276,15321,1989,Thailand,Indonesia,3,0,King's Cup,Bangkok,Thailand,False,3,3,Thailand
12992,14277,15322,1989,Senegal,DR Congo,2,1,Friendly,Dakar,Senegal,False,3,1,Senegal
12993,14278,15323,1989,Chile,Peru,0,0,Friendly,Armenia,Colombia,True,0,0,Draw
12994,14279,15324,1989,Colombia,Peru,1,0,Friendly,Pereira,Colombia,False,1,1,Colombia
12995,14280,15325,1989,Indonesia,Malaysia,1,3,King's Cup,Bangkok,Thailand,True,4,-2,Malaysia
12996,14281,15326,1989,Iraq,Jordan,4,0,FIFA World Cup qualification,Baghdad,Iraq,False,4,4,Iraq
12997,14282,15327,1989,Qatar,Oman,3,0,FIFA World Cup qualification,Doha,Qatar,False,3,3,Qatar
12998,14283,15328,1989,United Arab Emirates,Kuwait,1,0,FIFA World Cup qualification,Sharjah,United Arab Emirates,False,1,1,United Arab Emirates
12999,14284,15330,1989,Colombia,Chile,1,0,Friendly,Armenia,Colombia,False,1,1,Colombia
13000,14285,15331,1989,Republic of Ireland,France,0,0,Friendly,Dublin,Republic of Ireland,False,0,0,Draw
13001,14286,15332,1989,Algeria,Finland,2,0,Malta International Tournament,Attard,Malta,True,2,2,Algeria
13002,14287,15333,1989,Cyprus,Scotland,2,3,FIFA World Cup qualification,Limassol,Cyprus,False,5,-1,Scotland
13003,14288,15334,1989,Greece,England,1,2,Friendly,Athens,Greece,False,3,-1,England
13004,14289,15335,1989,Israel,Wales,3,3,Friendly,Ramat-Gan,Israel,False,6,0,Draw
13005,14290,15336,1989,Malta,Denmark,0,2,Malta International Tournament,Attard,Malta,False,2,-2,Denmark
13006,14291,15337,1989,Northern Ireland,Spain,0,2,FIFA World Cup qualification,Belfast,Northern Ireland,False,2,-2,Spain
13007,14293,15339,1989,Denmark,Finland,0,0,Malta International Tournament,Attard,Malta,True,0,0,Draw
13008,14294,15340,1989,Iraq,Qatar,2,2,FIFA World Cup qualification,Baghdad,Iraq,False,4,0,Draw
13009,14295,15341,1989,Malta,Algeria,0,1,Malta International Tournament,Attard,Malta,False,1,-1,Algeria
13010,14296,15342,1989,Oman,Jordan,0,2,FIFA World Cup qualification,Muscat,Oman,False,2,-2,Jordan
13011,14297,15343,1989,Pakistan,United Arab Emirates,1,4,FIFA World Cup qualification,Islamabad,Pakistan,False,5,-3,United Arab Emirates
13012,14298,15344,1989,Algeria,Denmark,0,0,Malta International Tournament,Attard,Malta,True,0,0,Draw
13013,14299,15345,1989,Guatemala,Poland,0,1,Friendly,Guatemala,Guatemala,False,1,-1,Poland
13014,14301,15347,1989,Malta,Finland,0,0,Malta International Tournament,Attard,Malta,False,0,0,Draw
13015,14303,15349,1989,Mexico,Poland,3,1,Friendly,Puebla,Mexico,False,4,2,Mexico
13016,14304,15350,1989,Portugal,Belgium,1,1,FIFA World Cup qualification,Lisbon,Portugal,False,2,0,Draw
13017,14305,15351,1989,Thailand,Bangladesh,1,0,FIFA World Cup qualification,Bangkok,Thailand,False,1,1,Thailand
13018,14306,15352,1989,Bulgaria,Russia,1,2,Friendly,Sofia,Bulgaria,False,3,-1,Russia
13019,14307,15353,1989,Costa Rica,El Salvador,1,1,Friendly,Los Angeles,United States,True,2,0,Draw
13020,14308,15354,1989,Guatemala,Mexico,1,2,Friendly,Los Angeles,United States,True,3,-1,Mexico
13021,14309,15355,1989,Greece,Norway,4,2,Friendly,Athens,Greece,False,6,2,Greece
13022,14310,15356,1989,Italy,Denmark,1,0,Friendly,Pisa,Italy,False,1,1,Italy
13023,14311,15358,1989,Costa Rica,Guatemala,2,3,Friendly,Los Angeles,United States,True,5,-1,Guatemala
13024,14312,15359,1989,El Salvador,Mexico,0,2,Friendly,Los Angeles,United States,True,2,-2,Mexico
13025,14313,15360,1989,Thailand,Iran,0,3,FIFA World Cup qualification,Bangkok,Thailand,False,3,-3,Iran
13026,14314,15361,1989,Bangladesh,Iran,1,2,FIFA World Cup qualification,Dhaka,Bangladesh,False,3,-1,Iran
13027,14316,15363,1989,Guatemala,El Salvador,3,0,Friendly,Mazatenango,Guatemala,False,3,3,Guatemala
13028,14318,15365,1989,Israel,New Zealand,1,0,FIFA World Cup qualification,Ramat-Gan,Israel,False,1,1,Israel
13029,14319,15366,1989,Albania,England,0,2,FIFA World Cup qualification,Tirana,Albania,False,2,-2,England
13030,14320,15367,1989,Bangladesh,Thailand,3,1,FIFA World Cup qualification,Dhaka,Bangladesh,False,4,2,Bangladesh
13031,14322,15369,1989,Hungary,Republic of Ireland,0,0,FIFA World Cup qualification,Budapest,Hungary,False,0,0,Draw
13032,14323,15370,1989,Scotland,France,2,0,FIFA World Cup qualification,Glasgow,Scotland,False,2,2,Scotland
13033,14324,15371,1989,Colombia,Argentina,1,0,Friendly,Barranquilla,Colombia,False,1,1,Colombia
13034,14325,15372,1989,Yemen,Syria,0,1,FIFA World Cup qualification,Sana'a,Yemen AR,True,1,-1,Syria
13035,14326,15373,1989,Australia,New Zealand,4,1,FIFA World Cup qualification,Sydney,Australia,False,5,3,Australia
13036,14327,15374,1989,Jamaica,Paraguay,0,3,Friendly,Kingston,Jamaica,False,3,-3,Paraguay
13037,14328,15375,1989,Brazil,Ecuador,1,0,Friendly,Cuiabá,Brazil,False,1,1,Brazil
13038,14329,15376,1989,Martinique,Paraguay,0,2,Friendly,Fort-de-France,Martinique,False,2,-2,Paraguay
13039,14330,15377,1989,Saudi Arabia,Syria,5,4,FIFA World Cup qualification,Jeddah,Saudi Arabia,False,9,1,Saudi Arabia
13040,14331,15378,1989,Tunisia,Egypt,0,0,Friendly,Tunis,Tunisia,False,0,0,Draw
13041,14332,15379,1989,Guadeloupe,Paraguay,0,2,Friendly,Basse-Terre,Guadeloupe,False,2,-2,Paraguay
13042,14333,15380,1989,Iran,Bangladesh,1,0,FIFA World Cup qualification,Teheran,Iran,False,1,1,Iran
13043,14334,15381,1989,Guatemala,Costa Rica,1,0,FIFA World Cup qualification,Guatemala,Guatemala,False,1,1,Guatemala
13044,14335,15382,1989,Israel,Australia,1,1,FIFA World Cup qualification,Ramat-Gan,Israel,False,2,0,Draw
13045,14336,15383,1989,Trinidad and Tobago,Paraguay,2,2,Friendly,Port of Spain,Trinidad and Tobago,False,4,0,Draw
13046,14337,15384,1989,Yemen,Saudi Arabia,0,1,FIFA World Cup qualification,Sana'a,Yemen AR,True,1,-1,Saudi Arabia
13047,14338,15385,1989,Algeria,Morocco,1,1,Friendly,Bejaia,Algeria,False,2,0,Draw
13048,14339,15386,1989,Bulgaria,Germany,1,2,Friendly,Sofia,Bulgaria,False,3,-1,Germany
13049,14340,15388,1989,Netherlands,Russia,2,0,Friendly,Eindhoven,Netherlands,False,2,2,Netherlands
13050,14341,15389,1989,Trinidad and Tobago,Paraguay,1,1,Friendly,Arima,Trinidad and Tobago,False,2,0,Draw
13051,14342,15390,1989,Spain,Malta,4,0,FIFA World Cup qualification,Seville,Spain,False,4,4,Spain
13052,14343,15391,1989,Austria,Italy,0,1,Friendly,Vienna,Austria,False,1,-1,Italy
13053,14344,15392,1989,Syria,Yemen,2,0,FIFA World Cup qualification,Latakia,Syria,False,2,2,Syria
13054,14345,15393,1989,Barbados,Jamaica,1,1,Friendly,Bridgetown,Barbados,False,2,0,Draw
13055,14346,15394,1989,Ethiopia,Malawi,1,1,Friendly,Addis Abeba,Ethiopia,False,2,0,Draw
13056,14347,15395,1989,Venezuela,Paraguay,1,2,Friendly,Caracas,Venezuela,False,3,-1,Paraguay
13057,14348,15396,1989,Qatar,Malaysia,1,0,Friendly,Doha,Qatar,False,1,1,Qatar
13058,14349,15397,1989,Barbados,Jamaica,1,1,Friendly,Bridgetown,Barbados,False,2,0,Draw
13059,14350,15398,1989,Ethiopia,Malawi,1,0,Friendly,Addis Abeba,Ethiopia,False,1,1,Ethiopia
13060,14351,15399,1989,Greece,Turkey,0,1,Friendly,Athens,Greece,False,1,-1,Turkey
13061,14352,15400,1989,Portugal,Angola,6,0,Friendly,Lisbon,Portugal,False,6,6,Portugal
13062,14353,15401,1989,Romania,Italy,1,0,Friendly,Sibiu,Romania,False,1,1,Romania
13063,14354,15402,1989,Syria,Saudi Arabia,0,0,FIFA World Cup qualification,Latakia,Syria,False,0,0,Draw
13064,14355,15403,1989,Venezuela,Paraguay,0,0,Friendly,Maturín,Venezuela,False,0,0,Draw
13065,14356,15404,1989,Aruba,Trinidad and Tobago,0,7,Friendly,Willemstad,Netherlands Antilles,True,7,-7,Trinidad and Tobago
13066,14357,15405,1989,Ethiopia,Zambia,0,1,Friendly,Addis Abeba,Ethiopia,False,1,-1,Zambia
13067,14358,15406,1989,Curaçao,Trinidad and Tobago,1,1,Friendly,Willemstad,Netherlands Antilles,False,2,0,Draw
13068,14359,15407,1989,Costa Rica,Guatemala,2,1,FIFA World Cup qualification,San José,Costa Rica,False,3,1,Costa Rica
13069,14360,15408,1989,Curaçao,Aruba,1,0,Friendly,Willemstad,Netherlands Antilles,False,1,1,Curaçao
13070,14361,15409,1989,Ethiopia,Zambia,2,2,Friendly,Addis Abeba,Ethiopia,False,4,0,Draw
13071,14362,15410,1989,New Zealand,Australia,2,0,FIFA World Cup qualification,Auckland,New Zealand,False,2,2,New Zealand
13072,14363,15411,1989,Algeria,Tunisia,2,0,Friendly,Algiers,Algeria,False,2,2,Algeria
13073,14364,15412,1989,Hungary,Switzerland,3,0,Friendly,Budapest,Hungary,False,3,3,Hungary
13074,14366,15414,1989,Saudi Arabia,Yemen,1,0,FIFA World Cup qualification,Jeddah,Saudi Arabia,False,1,1,Saudi Arabia
13075,14367,15415,1989,Sudan,Kenya,1,0,African Cup of Nations qualification,Khartoum,Sudan,False,1,1,Sudan
13076,14368,15416,1989,Angola,Ivory Coast,0,2,African Cup of Nations qualification,Luanda,Angola,False,2,-2,Ivory Coast
13077,14369,15417,1989,Ethiopia,Egypt,1,0,African Cup of Nations qualification,Addis Abeba,Ethiopia,False,1,1,Ethiopia
13078,14370,15418,1989,Gabon,Ghana,1,0,African Cup of Nations qualification,Libreville,Gabon,False,1,1,Gabon
13079,14371,15419,1989,Mali,Morocco,0,0,African Cup of Nations qualification,Bamako,Mali,False,0,0,Draw
13080,14372,15420,1989,Mauritius,Zimbabwe,1,4,African Cup of Nations qualification,Curepipe,Mauritius,False,5,-3,Zimbabwe
13081,14373,15421,1989,New Zealand,Israel,2,2,FIFA World Cup qualification,Auckland,New Zealand,False,4,0,Draw
13082,14374,15422,1989,Eswatini,Malawi,0,2,African Cup of Nations qualification,Mbabane,Eswatini,False,2,-2,Malawi
13083,14376,15424,1989,Barbados,Bermuda,1,2,Friendly,Bridgetown,Barbados,False,3,-1,Bermuda
13084,14377,15425,1989,Brazil,Paraguay,2,0,Friendly,Teresina,Brazil,False,2,2,Brazil
13085,14378,15426,1989,Denmark,Canada,2,0,Friendly,Aalborg,Denmark,False,2,2,Denmark
13086,14379,15428,1989,Hungary,Malta,1,1,FIFA World Cup qualification,Budapest,Hungary,False,2,0,Draw
13087,14380,15429,1989,Poland,Romania,2,1,Friendly,Warsaw,Poland,False,3,1,Poland
13088,14381,15430,1989,Angola,Mozambique,1,1,Friendly,Luanda,Angola,False,2,0,Draw
13089,14382,15431,1989,Ecuador,Argentina,2,2,Friendly,Guayaquil,Ecuador,False,4,0,Draw
13090,14383,15432,1989,Barbados,Bermuda,2,1,Friendly,Bridgetown,Barbados,False,3,1,Barbados
13091,14384,15433,1989,Faroe Islands,Canada,1,0,Friendly,Tórshavn,Faroe Islands,False,1,1,Faroe Islands
13092,14385,15434,1989,Guinea,Nigeria,1,1,African Cup of Nations qualification,Conakry,Guinea,False,2,0,Draw
13093,14386,15435,1989,Australia,Israel,1,1,FIFA World Cup qualification,Sydney,Australia,False,2,0,Draw
13094,14387,15436,1989,Costa Rica,United States,1,0,FIFA World Cup qualification,San José,Costa Rica,False,1,1,Costa Rica
13095,14388,15437,1989,Faroe Islands,Canada,0,1,Friendly,Klaksvík,Faroe Islands,False,1,-1,Canada
13096,14389,15438,1989,Mozambique,Zambia,0,1,African Cup of Nations qualification,Maputo,Mozambique,False,1,-1,Zambia
13097,14390,15439,1989,Trinidad and Tobago,Bermuda,1,1,Friendly,Port of Spain,Trinidad and Tobago,False,2,0,Draw
13098,14391,15440,1989,Trinidad and Tobago,Bermuda,0,1,Friendly,Arima,Trinidad and Tobago,False,1,-1,Bermuda
13099,14392,15441,1989,Chile,Argentina,1,1,Friendly,Santiago,Chile,False,2,0,Draw
13100,14393,15442,1989,Egypt,Ethiopia,6,1,African Cup of Nations qualification,Cairo,Egypt,False,7,5,Egypt
13101,14394,15443,1989,Italy,Uruguay,1,1,Friendly,Verona,Italy,False,2,0,Draw
13102,14395,15444,1989,Nigeria,Guinea,3,0,African Cup of Nations qualification,Ibadan,Nigeria,False,3,3,Nigeria
13103,14396,15445,1989,Antigua and Barbuda,Jamaica,1,0,CFU Caribbean Cup qualification,St. John's,Antigua and Barbuda,False,1,1,Antigua and Barbuda
13104,14397,15446,1989,Ghana,Gabon,1,0,African Cup of Nations qualification,Accra,Ghana,False,1,1,Ghana
13105,14398,15447,1989,Ivory Coast,Angola,4,1,African Cup of Nations qualification,Abidjan,Ivory Coast,False,5,3,Ivory Coast
13106,14399,15448,1989,Kenya,Sudan,1,0,African Cup of Nations qualification,Nairobi,Kenya,False,1,1,Kenya
13107,14400,15449,1989,Malawi,Eswatini,1,1,African Cup of Nations qualification,Blantyre,Malawi,False,2,0,Draw
13108,14401,15450,1989,Morocco,Mali,1,1,African Cup of Nations qualification,Marrakech,Morocco,False,2,0,Draw
13109,14402,15451,1989,Saint Kitts and Nevis,French Guiana,1,0,CFU Caribbean Cup qualification,Basseterre,Saint Kitts and Nevis,False,1,1,Saint Kitts and Nevis
13110,14403,15452,1989,Saint Lucia,Dominica,0,0,CFU Caribbean Cup qualification,Castries,Saint Lucia,False,0,0,Draw
13111,14404,15453,1989,Trinidad and Tobago,Aruba,11,0,CFU Caribbean Cup qualification,Arima,Trinidad and Tobago,False,11,11,Trinidad and Tobago
13112,14405,15454,1989,Zimbabwe,Mauritius,1,0,African Cup of Nations qualification,Harare,Zimbabwe,False,1,1,Zimbabwe
13113,14406,15455,1989,Bulgaria,Denmark,0,2,FIFA World Cup qualification,Sofia,Bulgaria,False,2,-2,Denmark
13114,14407,15456,1989,Curaçao,Martinique,3,1,CFU Caribbean Cup qualification,Willemstad,Netherlands Antilles,True,4,2,Curaçao
13115,14408,15457,1989,England,Albania,5,0,FIFA World Cup qualification,London,England,False,5,5,England
13116,14409,15458,1989,Greece,Romania,0,0,FIFA World Cup qualification,Athens,Greece,False,0,0,Draw
13117,14410,15459,1989,Republic of Ireland,Spain,1,0,FIFA World Cup qualification,Dublin,Republic of Ireland,False,1,1,Republic of Ireland
13118,14411,15460,1989,Italy,Hungary,4,0,Friendly,Taranto,Italy,False,4,4,Italy
13119,14412,15461,1989,Malta,Northern Ireland,0,2,FIFA World Cup qualification,Attard,Malta,False,2,-2,Northern Ireland
13120,14413,15462,1989,Netherlands,Germany,1,1,FIFA World Cup qualification,Rotterdam,Netherlands,False,2,0,Draw
13121,14414,15463,1989,Portugal,Switzerland,3,1,FIFA World Cup qualification,Lisbon,Portugal,False,4,2,Portugal
13122,14416,15465,1989,Scotland,Cyprus,2,1,FIFA World Cup qualification,Glasgow,Scotland,False,3,1,Scotland
13123,14417,15466,1989,Wales,Sweden,0,2,Friendly,Wrexham,Wales,False,2,-2,Sweden
13124,14420,15469,1989,United States,Costa Rica,1,0,FIFA World Cup qualification,St. Louis,United States,False,1,1,United States
13125,14421,15470,1989,Zambia,Mozambique,3,0,African Cup of Nations qualification,Lusaka,Zambia,False,3,3,Zambia
13126,14422,15471,1989,Norway,Poland,0,3,Friendly,Oslo,Norway,False,3,-3,Poland
13127,14423,15472,1989,Uruguay,Ecuador,3,1,Friendly,Montevideo,Uruguay,False,4,2,Uruguay
13128,14424,15473,1989,El Salvador,Paraguay,1,2,Friendly,Los Angeles,United States,True,3,-1,Paraguay
13129,14425,15474,1989,Guatemala,Chile,0,1,Friendly,Los Angeles,United States,True,1,-1,Chile
13130,14426,15476,1989,El Salvador,Chile,0,1,Friendly,Los Angeles,United States,True,1,-1,Chile
13131,14427,15477,1989,Grenada,Saint Kitts and Nevis,2,1,CFU Caribbean Cup qualification,St. George's,Grenada,False,3,1,Grenada
13132,14428,15478,1989,Guatemala,Paraguay,1,2,Friendly,Los Angeles,United States,True,3,-1,Paraguay
13133,14429,15479,1989,Jamaica,Guadeloupe,1,3,CFU Caribbean Cup qualification,Kingston,Jamaica,False,4,-2,Guadeloupe
13134,14431,15481,1989,Sweden,Poland,2,1,FIFA World Cup qualification,Solna,Sweden,False,3,1,Sweden
13135,14432,15483,1989,Brazil,Peru,4,1,Friendly,Fortaleza,Brazil,False,5,3,Brazil
13136,14433,15484,1989,French Guiana,Trinidad and Tobago,1,3,CFU Caribbean Cup qualification,Cayenne,French Guiana,False,4,-2,Trinidad and Tobago
13137,14435,15486,1989,Turkey,Russia,0,1,FIFA World Cup qualification,Istanbul,Turkey,False,1,-1,Russia
13138,14436,15487,1989,Dominica,Antigua and Barbuda,0,1,CFU Caribbean Cup qualification,Roseau,Dominica,False,1,-1,Antigua and Barbuda
13139,14437,15488,1989,Hong Kong,Macau,2,1,Friendly,So Kon Po,Hong Kong,False,3,1,Hong Kong
13140,14439,15490,1989,Singapore,Indonesia,1,2,Friendly,Singapore,Singapore,False,3,-1,Indonesia
13141,14440,15491,1989,United States,Trinidad and Tobago,1,1,FIFA World Cup qualification,Torrance,United States,False,2,0,Draw
13142,14441,15492,1989,Paraguay,Peru,1,1,Friendly,Asunción,Paraguay,False,2,0,Draw
13143,14442,15493,1989,Namibia,Angola,0,1,Friendly,Windhoek,Namibia,False,1,-1,Angola
13144,14443,15494,1989,Denmark,Greece,7,1,FIFA World Cup qualification,Copenhagen,Denmark,False,8,6,Denmark
13145,14444,15495,1989,Romania,Bulgaria,1,0,FIFA World Cup qualification,Bucharest,Romania,False,1,1,Romania
13146,14445,15496,1989,Peru,Venezuela,2,1,Friendly,Lima,Peru,False,3,1,Peru
13147,14446,15498,1989,Aruba,Grenada,0,0,CFU Caribbean Cup qualification,Oranjestad,Aruba,False,0,0,Draw
13148,14447,15499,1989,Guadeloupe,Dominica,0,0,CFU Caribbean Cup qualification,Basse-Terre,Guadeloupe,False,0,0,Draw
13149,14450,15502,1989,Norway,Cyprus,3,1,FIFA World Cup qualification,Oslo,Norway,False,4,2,Norway
13150,14451,15503,1989,Saint Kitts and Nevis,Trinidad and Tobago,0,2,CFU Caribbean Cup qualification,Basseterre,Saint Kitts and Nevis,False,2,-2,Trinidad and Tobago
13151,14452,15504,1989,Saint Vincent and the Grenadines,Curaçao,3,2,CFU Caribbean Cup qualification,Kingstown,Saint Vincent and the Grenadines,False,5,1,Saint Vincent and the Grenadines
13152,14453,15505,1989,Hong Kong,Japan,0,0,FIFA World Cup qualification,Victoria,Hong Kong,False,0,0,Draw
13153,14454,15506,1989,Ecuador,Uruguay,1,1,Friendly,Quito,Ecuador,False,2,0,Draw
13154,14455,15507,1989,England,Chile,0,0,Rous Cup,London,England,False,0,0,Draw
13155,14456,15509,1989,Malaysia,Nepal,2,0,FIFA World Cup qualification,Seoul,South Korea,True,2,2,Malaysia
13156,14457,15510,1989,Guinea-Bissau,Senegal,0,0,Amílcar Cabral Cup,Bamako,Mali,True,0,0,Draw
13157,14458,15511,1989,Morocco,Algeria,1,0,Friendly,Rabat,Morocco,False,1,1,Morocco
13158,14459,15512,1989,Peru,Brazil,1,1,Friendly,Lima,Peru,False,2,0,Draw
13159,14460,15513,1989,Bolivia,Paraguay,3,2,Friendly,Cochabamba,Bolivia,False,5,1,Bolivia
13160,14461,15515,1989,Malaysia,Singapore,1,0,FIFA World Cup qualification,Seoul,South Korea,True,1,1,Malaysia
13161,14463,15517,1989,Mauritania,Sierra Leone,1,2,Amílcar Cabral Cup,Bamako,Mali,True,3,-1,Sierra Leone
13162,14464,15518,1989,Northern Ireland,Chile,0,1,Friendly,Belfast,Northern Ireland,False,1,-1,Chile
13163,14467,15523,1989,Mali,Senegal,2,2,Amílcar Cabral Cup,Bamako,Mali,False,4,0,Draw
13164,14468,15524,1989,Scotland,England,0,2,Rous Cup,Glasgow,Scotland,False,2,-2,England
13165,14469,15525,1989,Singapore,Nepal,3,0,FIFA World Cup qualification,Seoul,South Korea,True,3,3,Singapore
13166,14470,15526,1989,Indonesia,Japan,0,0,FIFA World Cup qualification,Jakarta,Indonesia,False,0,0,Draw
13167,14471,15527,1989,Republic of Ireland,Malta,2,0,FIFA World Cup qualification,Dublin,Republic of Ireland,False,2,2,Republic of Ireland
13168,14472,15528,1989,Trinidad and Tobago,Costa Rica,1,1,FIFA World Cup qualification,Port of Spain,Trinidad and Tobago,False,2,0,Draw
13169,14473,15530,1989,Guinea,Mauritania,3,1,Amílcar Cabral Cup,Bamako,Mali,True,4,2,Guinea
13170,14474,15531,1989,Iran,Thailand,3,0,FIFA World Cup qualification,Teheran,Iran,False,3,3,Iran
13171,14475,15532,1989,Mali,Guinea-Bissau,2,1,Amílcar Cabral Cup,Bamako,Mali,False,3,1,Mali
13172,14476,15533,1989,Scotland,Chile,2,0,Rous Cup,Glasgow,Scotland,False,2,2,Scotland
13173,14477,15534,1989,Finland,Netherlands,0,1,FIFA World Cup qualification,Helsinki,Finland,False,1,-1,Netherlands
13174,14478,15535,1989,Norway,Austria,4,1,Friendly,Oslo,Norway,False,5,3,Norway
13175,14479,15536,1989,Russia,Iceland,1,1,FIFA World Cup qualification,Moscow,Soviet Union,True,2,0,Draw
13176,14480,15537,1989,Sweden,Algeria,2,0,Friendly,Örebro,Sweden,False,2,2,Sweden
13177,14481,15538,1989,Wales,Germany,0,0,FIFA World Cup qualification,Cardiff,Wales,False,0,0,Draw
13178,14482,15539,1989,Ivory Coast,DR Congo,1,1,Friendly,Abidjan,Ivory Coast,False,2,0,Draw
13179,14483,15540,1989,Luxembourg,Belgium,0,5,FIFA World Cup qualification,Lille,France,True,5,-5,Belgium
13180,14484,15541,1989,Paraguay,Bolivia,2,0,Friendly,Asunción,Paraguay,False,2,2,Paraguay
13181,14485,15543,1989,Mali,Sierra Leone,1,0,Amílcar Cabral Cup,Bamako,Mali,False,1,1,Mali
13182,14487,15546,1989,Egypt,Chile,2,0,Friendly,Cairo,Egypt,False,2,2,Egypt
13183,14488,15547,1989,England,Poland,3,0,FIFA World Cup qualification,London,England,False,3,3,England
13184,14489,15548,1989,Malawi,Tunisia,1,0,Friendly,Lilongwe,Malawi,False,1,1,Malawi
13185,14491,15550,1989,Singapore,Malaysia,2,2,FIFA World Cup qualification,Singapore,Singapore,False,4,0,Draw
13186,14492,15551,1989,Dominica,Jamaica,0,0,CFU Caribbean Cup qualification,Roseau,Dominica,False,0,0,Draw
13187,14493,15552,1989,Gabon,DR Congo,0,0,Friendly,Libreville,Gabon,False,0,0,Draw
13188,14494,15553,1989,Hong Kong,Indonesia,1,1,FIFA World Cup qualification,Victoria,Hong Kong,False,2,0,Draw
13189,14495,15554,1989,Republic of Ireland,Hungary,2,0,FIFA World Cup qualification,Dublin,Republic of Ireland,False,2,2,Republic of Ireland
13190,14497,15556,1989,Mali,Guinea,3,0,Amílcar Cabral Cup,Bamako,Mali,False,3,3,Mali
13191,14498,15557,1989,United States,Peru,3,0,Friendly,East Rutherford,United States,False,3,3,United States
13192,14500,15559,1989,Singapore,Nepal,7,0,FIFA World Cup qualification,Singapore,Singapore,False,7,7,Singapore
13193,14501,15560,1989,Grenada,Trinidad and Tobago,1,0,CFU Caribbean Cup qualification,St. George's,Grenada,False,1,1,Grenada
13194,14502,15561,1989,Denmark,England,1,1,Friendly,Copenhagen,Denmark,False,2,0,Draw
13195,14503,15562,1989,Malaysia,Nepal,3,0,FIFA World Cup qualification,Singapore,Singapore,True,3,3,Malaysia
13196,14504,15563,1989,Martinique,Sint Maarten,10,0,CFU Caribbean Cup qualification,Fort-de-France,Martinique,False,10,10,Martinique
13197,14507,15566,1989,Bolivia,Uruguay,0,0,Friendly,Santa Cruz,Bolivia,False,0,0,Draw
13198,14508,15567,1989,Brazil,Portugal,4,0,Friendly,Rio de Janeiro,Brazil,False,4,4,Brazil
13199,14509,15568,1989,Canada,Belgium,0,2,Friendly,Ottawa,Canada,False,2,-2,Belgium
13200,14510,15569,1989,French Guiana,Aruba,4,0,CFU Caribbean Cup qualification,Cayenne,French Guiana,False,4,4,French Guiana
13201,14511,15570,1989,Kenya,Egypt,0,0,FIFA World Cup qualification,Nairobi,Kenya,False,0,0,Draw
13202,14512,15571,1989,Nigeria,Cameroon,2,0,FIFA World Cup qualification,Ibadan,Nigeria,False,2,2,Nigeria
13203,14513,15572,1989,Angola,Gabon,2,0,FIFA World Cup qualification,Luanda,Angola,False,2,2,Angola
13204,14514,15573,1989,DR Congo,Morocco,0,0,FIFA World Cup qualification,Kinshasa,Zaïre,False,0,0,Draw
13205,14515,15574,1989,Costa Rica,Trinidad and Tobago,1,0,FIFA World Cup qualification,San José,Costa Rica,False,1,1,Costa Rica
13206,14516,15575,1989,Ivory Coast,Algeria,0,0,FIFA World Cup qualification,Abidjan,Ivory Coast,False,0,0,Draw
13207,14517,15576,1989,Japan,Indonesia,5,0,FIFA World Cup qualification,Tokyo,Japan,False,5,5,Japan
13208,14518,15577,1989,Liberia,Malawi,1,0,FIFA World Cup qualification,Monrovia,Liberia,False,1,1,Liberia
13209,14519,15578,1989,Zambia,Tunisia,1,0,FIFA World Cup qualification,Lusaka,Zambia,False,1,1,Zambia
13210,14520,15579,1989,Denmark,Sweden,6,0,Friendly,Copenhagen,Denmark,False,6,6,Denmark
13211,14521,15580,1989,Iceland,Austria,0,0,FIFA World Cup qualification,Reykjavík,Iceland,False,0,0,Draw
13212,14523,15582,1989,Uruguay,Bolivia,1,0,Friendly,Montevideo,Uruguay,False,1,1,Uruguay
13213,14524,15583,1989,Brazil,Sweden,1,2,Friendly,Copenhagen,Denmark,True,3,-1,Sweden
13214,14525,15584,1989,Trinidad and Tobago,Peru,2,1,Friendly,Port of Spain,Trinidad and Tobago,False,3,1,Trinidad and Tobago
13215,14526,15585,1989,Zimbabwe,Zambia,0,0,Friendly,Harare,Zimbabwe,False,0,0,Draw
13216,14527,15586,1989,United States,Guatemala,2,1,FIFA World Cup qualification,New Britain,United States,False,3,1,United States
13217,14528,15587,1989,Aruba,Saint Kitts and Nevis,1,4,CFU Caribbean Cup qualification,Oranjestad,Aruba,False,5,-3,Saint Kitts and Nevis
13218,14529,15588,1989,Denmark,Brazil,4,0,Friendly,Copenhagen,Denmark,False,4,4,Denmark
13219,14530,15589,1989,Jamaica,Saint Lucia,1,1,CFU Caribbean Cup qualification,Kingston,Jamaica,False,2,0,Draw
13220,14531,15590,1989,Japan,Hong Kong,0,0,FIFA World Cup qualification,Kobe,Japan,False,0,0,Draw
13221,14532,15591,1989,Sint Maarten,Curaçao,1,2,CFU Caribbean Cup qualification,Philipsburg,Sint Maarten,False,3,-1,Curaçao
13222,14533,15592,1989,Uruguay,Chile,2,2,Friendly,Montevideo,Uruguay,False,4,0,Draw
13223,14534,15593,1989,Ecuador,Peru,1,2,Friendly,Port of Spain,Trinidad and Tobago,True,3,-1,Peru
13224,14535,15594,1989,Switzerland,Brazil,1,0,Friendly,Basel,Switzerland,False,1,1,Switzerland
13225,14536,15595,1989,Bolivia,Chile,0,1,Friendly,Santa Cruz,Bolivia,False,1,-1,Chile
13226,14537,15596,1989,Malawi,Kenya,1,0,FIFA World Cup qualification,Lilongwe,Malawi,False,1,1,Malawi
13227,14538,15597,1989,United States,Colombia,0,1,Friendly,Miami,United States,False,1,-1,Colombia
13228,14539,15598,1989,Angola,Cameroon,1,2,FIFA World Cup qualification,Luanda,Angola,False,3,-1,Cameroon
13229,14540,15599,1989,El Salvador,Costa Rica,2,4,FIFA World Cup qualification,San Salvador,El Salvador,False,6,-2,Costa Rica
13230,14541,15600,1989,Gabon,Nigeria,2,1,FIFA World Cup qualification,Libreville,Gabon,False,3,1,Gabon
13231,14542,15601,1989,Indonesia,Hong Kong,3,2,FIFA World Cup qualification,Jakarta,Indonesia,False,5,1,Indonesia
13232,14543,15603,1989,Liberia,Egypt,1,0,FIFA World Cup qualification,Monrovia,Liberia,False,1,1,Liberia
13233,14544,15604,1989,Tunisia,DR Congo,1,0,FIFA World Cup qualification,Tunis,Tunisia,False,1,1,Tunisia
13234,14545,15605,1989,Venezuela,Peru,3,1,Friendly,San Cristóbal,Venezuela,False,4,2,Venezuela
13235,14546,15606,1989,Zambia,Morocco,2,1,FIFA World Cup qualification,Lusaka,Zambia,False,3,1,Zambia
13236,14547,15607,1989,Zimbabwe,Algeria,1,2,FIFA World Cup qualification,Harare,Zimbabwe,False,3,-1,Algeria
13237,14548,15609,1989,Chile,Bolivia,2,1,Friendly,Santiago,Chile,False,3,1,Chile
13238,14549,15610,1989,Haiti,Colombia,0,4,Friendly,Miami,United States,True,4,-4,Colombia
13239,14550,15611,1989,Grenada,French Guiana,0,0,CFU Caribbean Cup qualification,St. George's,Grenada,False,0,0,Draw
13240,14551,15612,1989,Brazil,Venezuela,3,1,Copa América,Salvador,Brazil,False,4,2,Brazil
13241,14552,15613,1989,Paraguay,Peru,5,2,Copa América,Salvador,Brazil,True,7,3,Paraguay
13242,14553,15614,1989,Argentina,Chile,1,0,Copa América,Goiânia,Brazil,True,1,1,Argentina
13243,14554,15615,1989,Grenada,Saint Vincent and the Grenadines,2,0,CFU Caribbean Cup,Bridgetown,Barbados,True,2,2,Grenada
13244,14555,15617,1989,Uruguay,Ecuador,0,1,Copa América,Goiânia,Brazil,True,1,-1,Ecuador
13245,14556,15618,1989,Barbados,Guadeloupe,1,0,CFU Caribbean Cup,Bridgetown,Barbados,False,1,1,Barbados
13246,14557,15619,1989,Brazil,Peru,0,0,Copa América,Salvador,Brazil,False,0,0,Draw
13247,14558,15620,1989,Venezuela,Colombia,2,4,Copa América,Salvador,Brazil,True,6,-2,Colombia
13248,14559,15621,1989,Argentina,Ecuador,0,0,Copa América,Goiânia,Brazil,True,0,0,Draw
13249,14560,15622,1989,Curaçao,Saint Vincent and the Grenadines,1,1,CFU Caribbean Cup,Bridgetown,Barbados,True,2,0,Draw
13250,14561,15623,1989,Uruguay,Bolivia,3,0,Copa América,Goiânia,Brazil,True,3,3,Uruguay
13251,14562,15624,1989,Barbados,Trinidad and Tobago,0,3,CFU Caribbean Cup,Bridgetown,Barbados,False,3,-3,Trinidad and Tobago
13252,14563,15625,1989,Colombia,Paraguay,0,1,Copa América,Salvador,Brazil,True,1,-1,Paraguay
13253,14564,15626,1989,Peru,Venezuela,1,1,Copa América,Salvador,Brazil,True,2,0,Draw
13254,14565,15627,1989,Chile,Uruguay,0,3,Copa América,Goiânia,Brazil,True,3,-3,Uruguay
13255,14566,15628,1989,Curaçao,Grenada,1,1,CFU Caribbean Cup,Bridgetown,Barbados,True,2,0,Draw
13256,14567,15629,1989,Ecuador,Bolivia,0,0,Copa América,Goiânia,Brazil,True,0,0,Draw
13257,14568,15630,1989,Malawi,Gabon,2,0,Friendly,Blantyre,Malawi,False,2,2,Malawi
13258,14571,15633,1989,Brazil,Colombia,0,0,Copa América,Salvador,Brazil,False,0,0,Draw
13259,14572,15634,1989,Gabon,Mozambique,1,0,Friendly,Blantyre,Malawi,True,1,1,Gabon
13260,14573,15635,1989,Guadeloupe,Trinidad and Tobago,2,0,CFU Caribbean Cup,Bridgetown,Barbados,True,2,2,Guadeloupe
13261,14574,15636,1989,Paraguay,Venezuela,3,0,Copa América,Salvador,Brazil,True,3,3,Paraguay
13262,14575,15637,1989,Bolivia,Chile,0,5,Copa América,Goiânia,Brazil,True,5,-5,Chile
13263,14576,15638,1989,Uruguay,Argentina,0,1,Copa América,Goiânia,Brazil,True,1,-1,Argentina
13264,14579,15641,1989,Brazil,Paraguay,2,0,Copa América,Recife,Brazil,False,2,2,Brazil
13265,14580,15642,1989,Colombia,Peru,1,1,Copa América,Recife,Brazil,True,2,0,Draw
13266,14581,15643,1989,Grenada,Trinidad and Tobago,1,2,CFU Caribbean Cup,Bridgetown,Barbados,True,3,-1,Trinidad and Tobago
13267,14582,15645,1989,Malawi,Mozambique,0,1,Friendly,Blantyre,Malawi,False,1,-1,Mozambique
13268,14583,15646,1989,Faroe Islands,Greenland,3,0,Island Games,Fuglafjørður,Faroe Islands,False,3,3,Faroe Islands
13269,14585,15648,1989,Argentina,Bolivia,0,0,Copa América,Goiânia,Brazil,True,0,0,Draw
13270,14586,15649,1989,Chile,Ecuador,2,1,Copa América,Goiânia,Brazil,True,3,1,Chile
13271,14587,15650,1989,Kenya,DR Congo,0,1,Friendly,Nairobi,Kenya,False,1,-1,DR Congo
13272,14588,15651,1989,Malawi,Mozambique,0,2,Friendly,Mzuzu,Malawi,False,2,-2,Mozambique
13273,14589,15652,1989,Åland Islands,Greenland,3,0,Island Games,Sandur,Faroe Islands,True,3,3,Åland Islands
13274,14590,15654,1989,Brazil,Argentina,2,0,Copa América,Rio de Janeiro,Brazil,False,2,2,Brazil
13275,14591,15655,1989,Paraguay,Uruguay,0,3,Copa América,Rio de Janeiro,Brazil,True,3,-3,Uruguay
13276,14592,15656,1989,Faroe Islands,Åland Islands,7,1,Island Games,Tórshavn,Faroe Islands,False,8,6,Faroe Islands
13277,14593,15658,1989,Argentina,Uruguay,0,2,Copa América,Rio de Janeiro,Brazil,True,2,-2,Uruguay
13278,14594,15659,1989,Brazil,Paraguay,3,0,Copa América,Rio de Janeiro,Brazil,False,3,3,Brazil
13279,14595,15661,1989,Brazil,Uruguay,1,0,Copa América,Rio de Janeiro,Brazil,False,1,1,Brazil
13280,14596,15662,1989,Costa Rica,El Salvador,1,0,FIFA World Cup qualification,San José,Costa Rica,False,1,1,Costa Rica
13281,14597,15663,1989,Egypt,DR Congo,2,0,African Cup of Nations qualification,Cairo,Egypt,False,2,2,Egypt
13282,14598,15664,1989,Mali,Ivory Coast,2,2,African Cup of Nations qualification,Bamako,Mali,False,4,0,Draw
13283,14599,15665,1989,Paraguay,Argentina,0,0,Copa América,Rio de Janeiro,Brazil,True,0,0,Draw
13284,14600,15666,1989,Senegal,Tunisia,3,0,African Cup of Nations qualification,Dakar,Senegal,False,3,3,Senegal
13285,14602,15668,1989,Brazil,Japan,1,0,Friendly,Rio de Janeiro,Brazil,False,1,1,Brazil
13286,14603,15669,1989,Chile,Peru,2,1,Friendly,Arica,Chile,False,3,1,Chile
13287,14604,15670,1989,Algeria,Qatar,1,1,Friendly,Tlemcen,Algeria,False,2,0,Draw
13288,14605,15671,1989,DR Congo,Egypt,0,0,African Cup of Nations qualification,Kinshasa,Zaïre,False,0,0,Draw
13289,14606,15673,1989,Gabon,Zambia,2,1,African Cup of Nations qualification,Libreville,Gabon,False,3,1,Gabon
13290,14607,15674,1989,Ivory Coast,Mali,3,1,African Cup of Nations qualification,Abidjan,Ivory Coast,False,4,2,Ivory Coast
13291,14608,15675,1989,Trinidad and Tobago,El Salvador,2,0,FIFA World Cup qualification,Port of Spain,Trinidad and Tobago,False,2,2,Trinidad and Tobago
13292,14609,15676,1989,Tunisia,Senegal,0,1,African Cup of Nations qualification,Tunis,Tunisia,False,1,-1,Senegal
13293,14610,15677,1989,Venezuela,Brazil,0,4,FIFA World Cup qualification,Caracas,Venezuela,False,4,-4,Brazil
13294,14611,15678,1989,Zimbabwe,Nigeria,1,1,African Cup of Nations qualification,Harare,Zimbabwe,False,2,0,Draw
13295,14612,15679,1989,Tunisia,Malawi,3,0,Friendly,Tunis,Tunisia,False,3,3,Tunisia
13296,14613,15680,1989,Uruguay,Colombia,0,0,Friendly,Montevideo,Uruguay,False,0,0,Draw
13297,14614,15681,1989,Venezuela,Chile,1,3,FIFA World Cup qualification,Caracas,Venezuela,False,4,-2,Chile
13298,14616,15683,1989,Egypt,Malawi,1,0,FIFA World Cup qualification,Cairo,Egypt,False,1,1,Egypt
13299,14617,15684,1989,Kenya,Liberia,1,0,FIFA World Cup qualification,Nairobi,Kenya,False,1,1,Kenya
13300,14618,15685,1989,Nigeria,Angola,1,0,FIFA World Cup qualification,Lagos,Nigeria,False,1,1,Nigeria
13301,14619,15686,1989,Cameroon,Gabon,2,1,FIFA World Cup qualification,Yaoundé,Cameroon,False,3,1,Cameroon
13302,14620,15687,1989,Chile,Brazil,1,1,FIFA World Cup qualification,Santiago,Chile,False,2,0,Draw
13303,14621,15688,1989,DR Congo,Zambia,1,0,FIFA World Cup qualification,Kinshasa,Zaïre,False,1,1,DR Congo
13304,14622,15689,1989,El Salvador,Trinidad and Tobago,0,0,FIFA World Cup qualification,Tegucigalpa,Honduras,True,0,0,Draw
13305,14623,15690,1989,Ivory Coast,Zimbabwe,5,0,FIFA World Cup qualification,Abidjan,Ivory Coast,False,5,5,Ivory Coast
13306,14624,15691,1989,Morocco,Tunisia,0,0,FIFA World Cup qualification,Casablanca,Morocco,False,0,0,Draw
13307,14626,15693,1989,Sweden,France,2,4,Friendly,Malmö,Sweden,False,6,-2,France
13308,14627,15694,1989,Bolivia,Peru,2,1,FIFA World Cup qualification,La Paz,Bolivia,False,3,1,Bolivia
13309,14628,15695,1989,Brazil,Venezuela,6,0,FIFA World Cup qualification,São Paulo,Brazil,False,6,6,Brazil
13310,14629,15696,1989,Colombia,Ecuador,2,0,FIFA World Cup qualification,Barranquilla,Colombia,False,2,2,Colombia
13311,14630,15697,1989,Guatemala,Trinidad and Tobago,0,1,FIFA World Cup qualification,Guatemala,Guatemala,False,1,-1,Trinidad and Tobago
13312,14631,15698,1989,Austria,Iceland,2,1,FIFA World Cup qualification,Salzburg,Austria,False,3,1,Austria
13313,14632,15699,1989,Belgium,Denmark,3,0,Friendly,Bruges,Belgium,False,3,3,Belgium
13314,14634,15702,1989,Norway,Greece,0,0,Friendly,Oslo,Norway,False,0,0,Draw
13315,14635,15703,1989,Poland,Russia,1,1,Friendly,Lubin,Poland,False,2,0,Draw
13316,14636,15704,1989,Algeria,Ivory Coast,1,0,FIFA World Cup qualification,Annaba,Algeria,False,1,1,Algeria
13317,14637,15705,1989,Egypt,Kenya,2,0,FIFA World Cup qualification,Cairo,Egypt,False,2,2,Egypt
13318,14638,15706,1989,Malawi,Liberia,0,0,FIFA World Cup qualification,Lilongwe,Malawi,False,0,0,Draw
13319,14639,15707,1989,Cameroon,Nigeria,1,0,FIFA World Cup qualification,Yaoundé,Cameroon,False,1,1,Cameroon
13320,14640,15708,1989,Chile,Venezuela,5,0,FIFA World Cup qualification,Mendoza,Argentina,True,5,5,Chile
13321,14641,15709,1989,Gabon,Angola,1,0,FIFA World Cup qualification,Libreville,Gabon,False,1,1,Gabon
13322,14642,15710,1989,Morocco,DR Congo,1,1,FIFA World Cup qualification,Kenitra,Morocco,False,2,0,Draw
13323,14643,15711,1989,Paraguay,Colombia,2,1,FIFA World Cup qualification,Asunción,Paraguay,False,3,1,Paraguay
13324,14644,15712,1989,Peru,Uruguay,0,2,FIFA World Cup qualification,Lima,Peru,False,2,-2,Uruguay
13325,14645,15713,1989,Tunisia,Zambia,1,0,FIFA World Cup qualification,Tunis,Tunisia,False,1,1,Tunisia
13326,14646,15714,1989,Portugal,Romania,0,0,Friendly,Setúbal,Portugal,False,0,0,Draw
13327,14647,15715,1989,Trinidad and Tobago,Panama,2,0,Friendly,Port of Spain,Trinidad and Tobago,False,2,2,Trinidad and Tobago
13328,14648,15716,1989,Bolivia,Uruguay,2,1,FIFA World Cup qualification,La Paz,Bolivia,False,3,1,Bolivia
13329,14649,15717,1989,Brazil,Chile,1,0,FIFA World Cup qualification,Rio de Janeiro,Brazil,False,1,1,Brazil
13330,14650,15718,1989,Ecuador,Colombia,0,0,FIFA World Cup qualification,Guayaquil,Ecuador,False,0,0,Draw
13331,14651,15719,1989,Trinidad and Tobago,Guatemala,2,1,FIFA World Cup qualification,Port of Spain,Trinidad and Tobago,False,3,1,Trinidad and Tobago
13332,14652,15721,1989,Norway,France,1,1,FIFA World Cup qualification,Oslo,Norway,False,2,0,Draw
13333,14653,15722,1989,Poland,Greece,3,0,Friendly,Warsaw,Poland,False,3,3,Poland
13334,14654,15723,1989,Austria,Russia,0,0,FIFA World Cup qualification,Vienna,Austria,False,0,0,Draw
13335,14655,15724,1989,Belgium,Portugal,3,0,FIFA World Cup qualification,Brussels,Belgium,False,3,3,Belgium
13336,14656,15725,1989,Finland,Wales,1,0,FIFA World Cup qualification,Helsinki,Finland,False,1,1,Finland
13337,14658,15727,1989,Republic of Ireland,Germany,1,1,Friendly,Dublin,Republic of Ireland,False,2,0,Draw
13338,14659,15728,1989,Netherlands,Denmark,2,2,Friendly,Amsterdam,Netherlands,False,4,0,Draw
13339,14660,15729,1989,Northern Ireland,Hungary,1,2,FIFA World Cup qualification,Belfast,Northern Ireland,False,3,-1,Hungary
13340,14661,15730,1989,Sweden,England,0,0,FIFA World Cup qualification,Solna,Sweden,False,0,0,Draw
13341,14662,15732,1989,Paraguay,Ecuador,2,1,FIFA World Cup qualification,Asunción,Paraguay,False,3,1,Paraguay
13342,14663,15733,1989,Peru,Bolivia,1,2,FIFA World Cup qualification,Lima,Peru,False,3,-1,Bolivia
13343,14664,15735,1989,Colombia,Paraguay,2,1,FIFA World Cup qualification,Barranquilla,Colombia,False,3,1,Colombia
13344,14665,15736,1989,El Salvador,United States,0,1,FIFA World Cup qualification,Tegucigalpa,Honduras,True,1,-1,United States
13345,14666,15737,1989,Uruguay,Bolivia,2,0,FIFA World Cup qualification,Montevideo,Uruguay,False,2,2,Uruguay
13346,14667,15738,1989,Iceland,Turkey,2,1,FIFA World Cup qualification,Reykjavík,Iceland,False,3,1,Iceland
13347,14668,15739,1989,Italy,Bulgaria,4,0,Friendly,Cesena,Italy,False,4,4,Italy
13348,14670,15741,1989,Spain,Poland,1,0,Friendly,La Coruña,Spain,False,1,1,Spain
13349,14671,15742,1989,Switzerland,Portugal,1,2,FIFA World Cup qualification,Neuchâtel,Switzerland,False,3,-1,Portugal
13350,14672,15744,1989,Kuwait,Qatar,1,0,Friendly,Kuwait City,Kuwait,False,1,1,Kuwait
13351,14673,15745,1989,Ecuador,Paraguay,3,1,FIFA World Cup qualification,Guayaquil,Ecuador,False,4,2,Ecuador
13352,14674,15746,1989,Uruguay,Peru,2,0,FIFA World Cup qualification,Montevideo,Uruguay,False,2,2,Uruguay
13353,14675,15747,1989,Kuwait,Egypt,0,0,Friendly,Kuwait City,Kuwait,False,0,0,Draw
13354,14676,15748,1989,Germany,Finland,6,1,FIFA World Cup qualification,Dortmund,Germany,False,7,5,Germany
13355,14677,15749,1989,Malta,Austria,1,2,Friendly,Attard,Malta,False,3,-1,Austria
13356,14678,15751,1989,Algeria,Egypt,0,0,FIFA World Cup qualification,Constantine,Algeria,False,0,0,Draw
13357,14679,15752,1989,Cameroon,Tunisia,2,0,FIFA World Cup qualification,Yaoundé,Cameroon,False,2,2,Cameroon
13358,14680,15754,1989,Guatemala,United States,0,0,FIFA World Cup qualification,Guatemala,Guatemala,False,0,0,Draw
13359,14681,15755,1989,Sweden,Albania,3,1,FIFA World Cup qualification,Solna,Sweden,False,4,2,Sweden
13360,14682,15756,1989,Bulgaria,Greece,4,0,FIFA World Cup qualification,Varna,Bulgaria,False,4,4,Bulgaria
13361,14683,15757,1989,Cyprus,Malta,0,0,Friendly,Larnaca,Cyprus,False,0,0,Draw
13362,14684,15758,1989,Denmark,Romania,3,0,FIFA World Cup qualification,Copenhagen,Denmark,False,3,3,Denmark
13363,14685,15759,1989,France,Scotland,3,0,FIFA World Cup qualification,Paris,France,False,3,3,France
13364,14686,15760,1989,Hungary,Spain,2,2,FIFA World Cup qualification,Budapest,Hungary,False,4,0,Draw
13365,14687,15761,1989,Republic of Ireland,Northern Ireland,3,0,FIFA World Cup qualification,Dublin,Republic of Ireland,False,3,3,Republic of Ireland
13366,14688,15762,1989,Luxembourg,Portugal,0,3,FIFA World Cup qualification,Saarbrücken,Germany,True,3,-3,Portugal
13367,14689,15763,1989,Poland,England,0,0,FIFA World Cup qualification,Chorzów,Poland,False,0,0,Draw
13368,14690,15764,1989,Switzerland,Belgium,2,2,FIFA World Cup qualification,Basel,Switzerland,False,4,0,Draw
13369,14691,15765,1989,Wales,Netherlands,1,2,FIFA World Cup qualification,Wrexham,Wales,False,3,-1,Netherlands
13370,14693,15770,1989,Italy,Brazil,0,1,Friendly,Bologna,Italy,False,1,-1,Brazil
13371,14694,15771,1989,Colombia,Israel,1,0,FIFA World Cup qualification,Barranquilla,Colombia,False,1,1,Colombia
13372,14695,15772,1989,Iraq,Kuwait,1,0,Friendly,Baghdad,Iraq,False,1,1,Iraq
13373,14696,15774,1989,Qatar,Saudi Arabia,1,1,FIFA World Cup qualification,Singapore,Singapore,True,2,0,Draw
13374,14697,15778,1989,Saudi Arabia,United Arab Emirates,0,0,FIFA World Cup qualification,Singapore,Singapore,True,0,0,Draw
13375,14698,15779,1989,Liberia,Guinea,2,0,Friendly,Monrovia,Liberia,False,2,2,Liberia
13376,14699,15780,1989,Trinidad and Tobago,Finland,0,1,Friendly,Port of Spain,Trinidad and Tobago,False,1,-1,Finland
13377,14700,15782,1989,United Arab Emirates,Qatar,1,1,FIFA World Cup qualification,Singapore,Singapore,True,2,0,Draw
13378,14701,15783,1989,Belgium,Luxembourg,1,1,FIFA World Cup qualification,Brussels,Belgium,False,2,0,Draw
13379,14702,15785,1989,Hungary,Greece,1,1,Friendly,Budapest,Hungary,False,2,0,Draw
13380,14703,15786,1989,Kuwait,Norway,2,2,Friendly,Kuwait City,Kuwait,False,4,0,Draw
13381,14705,15788,1989,Poland,Sweden,0,2,FIFA World Cup qualification,Chorzów,Poland,False,2,-2,Sweden
13382,14707,15790,1989,Trinidad and Tobago,Finland,2,0,Friendly,Port of Spain,Trinidad and Tobago,False,2,2,Trinidad and Tobago
13383,14708,15791,1989,Turkey,Austria,3,0,FIFA World Cup qualification,Istanbul,Turkey,False,3,3,Turkey
13384,14710,15793,1989,Fiji,Papua New Guinea,2,1,Friendly,Suva,Fiji,False,3,1,Fiji
13385,14713,15796,1989,Solomon Islands,Vanuatu,2,0,Friendly,Suva,Fiji,True,2,2,Solomon Islands
13386,14715,15798,1989,Fiji,Vanuatu,2,1,Friendly,Suva,Fiji,False,3,1,Fiji
13387,14716,15799,1989,Israel,Colombia,0,0,FIFA World Cup qualification,Ramat-Gan,Israel,False,0,0,Draw
13388,14717,15800,1989,Kuwait,Lebanon,5,0,Friendly,Kuwait City,Kuwait,False,5,5,Kuwait
13389,14718,15801,1989,New Caledonia,Solomon Islands,2,0,Friendly,Suva,Fiji,True,2,2,New Caledonia
13390,14719,15802,1989,Fiji,New Caledonia,3,0,Friendly,Suva,Fiji,False,3,3,Fiji
13391,14720,15803,1989,Guinea,Iraq,1,0,Friendly,Kuwait City,Kuwait,True,1,1,Guinea
13392,14721,15804,1989,Papua New Guinea,Vanuatu,3,0,Friendly,Suva,Fiji,True,3,3,Papua New Guinea
13393,14723,15806,1989,Tunisia,Algeria,0,0,Friendly,Tunis,Tunisia,False,0,0,Draw
13394,14724,15807,1989,Lebanon,Uganda,0,2,Friendly,Kuwait City,Kuwait,True,2,-2,Uganda
13395,14725,15808,1989,Guinea,Iran,1,1,Friendly,Kuwait City,Kuwait,True,2,0,Draw
13396,14727,15810,1989,New Caledonia,Vanuatu,5,1,Friendly,Ba,Fiji,True,6,4,New Caledonia
13397,14728,15811,1989,Papua New Guinea,Solomon Islands,0,0,Friendly,Suva,Fiji,True,0,0,Draw
13398,14729,15812,1989,Qatar,Egypt,0,2,Friendly,Doha,Qatar,False,2,-2,Egypt
13399,14730,15813,1989,Fiji,Solomon Islands,0,0,Friendly,Suva,Fiji,False,0,0,Draw
13400,14731,15814,1989,Kuwait,Uganda,1,1,Friendly,Kuwait City,Kuwait,False,2,0,Draw
13401,14732,15815,1989,New Caledonia,Papua New Guinea,2,1,Friendly,Suva,Fiji,True,3,1,New Caledonia
13402,14734,15817,1989,Iran,Iraq,0,0,Friendly,Kuwait City,Kuwait,True,0,0,Draw
13403,14735,15818,1989,United States,El Salvador,0,0,FIFA World Cup qualification,St. Louis,United States,False,0,0,Draw
13404,14736,15819,1989,Iran,Uganda,2,2,Friendly,Kuwait City,Kuwait,True,4,0,Draw
13405,14737,15820,1989,Kuwait,Iraq,1,2,Friendly,Kuwait City,Kuwait,False,3,-1,Iraq
13406,14738,15821,1989,Italy,Algeria,1,0,Friendly,Vicenza,Italy,False,1,1,Italy
13407,14739,15822,1989,Iraq,Uganda,1,1,Friendly,Kuwait City,Kuwait,True,2,0,Draw
13408,14740,15823,1989,Kuwait,Iran,1,0,Friendly,Kuwait City,Kuwait,False,1,1,Kuwait
13409,14742,15825,1989,United States,Bermuda,2,1,Friendly,Cocoa Beach,United States,False,3,1,United States
13410,14743,15826,1989,Albania,Poland,1,2,FIFA World Cup qualification,Tirana,Albania,False,3,-1,Poland
13411,14745,15828,1989,England,Italy,0,0,Friendly,London,England,False,0,0,Draw
13412,14746,15829,1989,Germany,Wales,2,1,FIFA World Cup qualification,Cologne,Germany,False,3,1,Germany
13413,14747,15830,1989,Greece,Bulgaria,1,0,FIFA World Cup qualification,Athens,Greece,False,1,1,Greece
13414,14748,15831,1989,Malta,Republic of Ireland,0,2,FIFA World Cup qualification,Attard,Malta,False,2,-2,Republic of Ireland
13415,14749,15832,1989,Netherlands,Finland,3,0,FIFA World Cup qualification,Rotterdam,Netherlands,False,3,3,Netherlands
13416,14751,15834,1989,Romania,Denmark,3,1,FIFA World Cup qualification,Bucharest,Romania,False,4,2,Romania
13417,14752,15835,1989,Russia,Turkey,2,0,FIFA World Cup qualification,Simferopol,Soviet Union,True,2,2,Russia
13418,14753,15836,1989,Scotland,Norway,1,1,FIFA World Cup qualification,Glasgow,Scotland,False,2,0,Draw
13419,14754,15837,1989,Spain,Hungary,4,0,FIFA World Cup qualification,Seville,Spain,False,4,4,Spain
13420,14755,15838,1989,Switzerland,Luxembourg,2,1,FIFA World Cup qualification,St. Gallen,Switzerland,False,3,1,Switzerland
13421,14756,15839,1989,Egypt,Algeria,1,0,FIFA World Cup qualification,Cairo,Egypt,False,1,1,Egypt
13422,14757,15840,1989,France,Cyprus,2,0,FIFA World Cup qualification,Toulouse,France,False,2,2,France
13423,14758,15841,1989,Trinidad and Tobago,United States,0,1,FIFA World Cup qualification,Port of Spain,Trinidad and Tobago,False,1,-1,United States
13424,14759,15842,1989,Tunisia,Cameroon,0,1,FIFA World Cup qualification,Tunis,Tunisia,False,1,-1,Cameroon
13425,14760,15843,1989,Senegal,Central African Republic,3,0,Friendly,Dakar,Senegal,False,3,3,Senegal
13426,14761,15844,1989,Ghana,Guinea,1,1,Friendly,Paynesville,Liberia,True,2,0,Draw
13427,14762,15845,1989,Liberia,Guinea,2,0,Friendly,Paynesville,Liberia,False,2,2,Liberia
13428,14763,15846,1989,Liberia,Ghana,1,1,Friendly,Paynesville,Liberia,False,2,0,Draw
13429,14764,15847,1989,Botswana,Zambia,2,1,Friendly,Gaborone,Botswana,False,3,1,Botswana
13430,14765,15848,1989,Central African Republic,Chad,1,1,UDEAC Cup,Bangui,Central African Republic,False,2,0,Draw
13431,14766,15849,1989,Kenya,Uganda,2,1,CECAFA Cup,Nairobi,Kenya,False,3,1,Kenya
13432,14768,15851,1989,Tanzania,Zimbabwe,0,3,CECAFA Cup,Nairobi,Kenya,True,3,-3,Zimbabwe
13433,14769,15852,1989,Congo,Gabon,0,2,UDEAC Cup,Bangui,Central African Republic,True,2,-2,Gabon
13434,14770,15853,1989,Kenya,Tanzania,2,1,CECAFA Cup,Nairobi,Kenya,False,3,1,Kenya
13435,14771,15854,1989,Chad,Cameroon,0,1,UDEAC Cup,Bangui,Central African Republic,True,1,-1,Cameroon
13436,14772,15855,1989,Uganda,Zimbabwe,1,1,CECAFA Cup,Nairobi,Kenya,True,2,0,Draw
13437,14774,15857,1989,Tanzania,Uganda,1,5,CECAFA Cup,Nairobi,Kenya,True,6,-4,Uganda
13438,14775,15858,1989,Kenya,Zimbabwe,2,1,CECAFA Cup,Nairobi,Kenya,False,3,1,Kenya
13439,14776,15859,1989,Malawi,Zambia,0,0,CECAFA Cup,Nairobi,Kenya,True,0,0,Draw
13440,14777,15860,1989,Chad,Cameroon,0,0,UDEAC Cup,Bangui,Central African Republic,True,0,0,Draw
13441,14778,15861,1989,Chad,Gabon,0,2,UDEAC Cup,Bangui,Central African Republic,True,2,-2,Gabon
13442,14780,15863,1989,Spain,Switzerland,2,1,Friendly,Santa Cruz de Tenerife,Spain,False,3,1,Spain
13443,14781,15864,1989,Uganda,Zambia,3,1,CECAFA Cup,Nairobi,Kenya,True,4,2,Uganda
13444,14782,15865,1989,Kenya,Malawi,0,1,CECAFA Cup,Nairobi,Kenya,False,1,-1,Malawi
13445,14783,15866,1989,Kenya,Zambia,1,0,CECAFA Cup,Nairobi,Kenya,False,1,1,Kenya
13446,14784,15867,1989,Malawi,Uganda,3,3,CECAFA Cup,Nairobi,Kenya,True,6,0,Draw
13447,14785,15868,1989,Netherlands,Brazil,0,1,Friendly,Rotterdam,Netherlands,False,1,-1,Brazil
13448,14786,15869,1989,Italy,Argentina,0,0,Friendly,Cagliari,Italy,False,0,0,Draw
13449,14787,15870,1989,Senegal,Sierra Leone,1,0,Friendly,Dakar,Senegal,False,1,1,Senegal
13450,14788,15871,1989,Senegal,Algeria,0,0,Friendly,Dakar,Senegal,False,0,0,Draw
13451,14789,15872,1990,Algeria,Mali,5,0,Friendly,Paris,France,True,5,5,Algeria
13452,14790,15873,1990,Algeria,Cameroon,3,1,Friendly,Paris,France,True,4,2,Algeria
13453,14791,15874,1990,Greece,Belgium,2,0,Friendly,Athens,Greece,False,2,2,Greece
13454,14792,15875,1990,Mexico,Argentina,2,0,Friendly,Los Angeles,United States,True,2,2,Mexico
13455,14793,15876,1990,Malawi,Tanzania,2,2,Friendly,Lobamba,Eswatini,True,4,0,Draw
13456,14794,15877,1990,Eswatini,Botswana,3,1,Friendly,Lobamba,Eswatini,False,4,2,Eswatini
13457,14795,15878,1990,Botswana,Malawi,2,2,Friendly,Lobamba,Eswatini,True,4,0,Draw
13458,14796,15879,1990,Kuwait,France,0,1,Friendly,Kuwait City,Kuwait,False,1,-1,France
13459,14797,15880,1990,Eswatini,Tanzania,0,1,Friendly,Lobamba,Eswatini,False,1,-1,Tanzania
13460,14798,15881,1990,Botswana,Tanzania,0,0,Friendly,Lobamba,Eswatini,True,0,0,Draw
13461,14800,15883,1990,Liberia,Senegal,0,1,Friendly,Bauchi,Nigeria,True,1,-1,Senegal
13462,14801,15884,1990,Nigeria,Ivory Coast,2,0,Friendly,Bauchi,Nigeria,False,2,2,Nigeria
13463,14802,15885,1990,United Arab Emirates,Egypt,1,2,Friendly,Abu Dhabi,United Arab Emirates,False,3,-1,Egypt
13464,14804,15887,1990,Ivory Coast,Liberia,1,0,Friendly,Bauchi,Nigeria,True,1,1,Ivory Coast
13465,14805,15888,1990,United Arab Emirates,Egypt,1,0,Friendly,Abu Dhabi,United Arab Emirates,False,1,1,United Arab Emirates
13466,14806,15889,1990,Nigeria,Senegal,1,1,Friendly,Bauchi,Nigeria,False,2,0,Draw
13467,14807,15890,1990,Thailand,Kenya,2,1,King's Cup,Bangkok,Thailand,False,3,1,Thailand
13468,14808,15891,1990,Colombia,Uruguay,0,2,Friendly,Miami,United States,True,2,-2,Uruguay
13469,14809,15892,1990,Indonesia,Kenya,2,3,King's Cup,Bangkok,Thailand,True,5,-1,Kenya
13470,14810,15893,1990,Iran,Poland,0,2,Friendly,Teheran,Iran,False,2,-2,Poland
13471,14811,15894,1990,United States,Costa Rica,0,2,Friendly,Miami,United States,False,2,-2,Costa Rica
13472,14812,15895,1990,Algeria,Romania,0,0,Friendly,Algiers,Algeria,False,0,0,Draw
13473,14813,15896,1990,Costa Rica,Uruguay,0,2,Friendly,Miami,United States,True,2,-2,Uruguay
13474,14814,15897,1990,Iran,Poland,0,1,Friendly,Teheran,Iran,False,1,-1,Poland
13475,14815,15899,1990,United States,Colombia,1,1,Friendly,Miami,United States,False,2,0,Draw
13476,14816,15900,1990,Thailand,Indonesia,1,1,King's Cup,Bangkok,Thailand,False,2,0,Draw
13477,14817,15901,1990,United Arab Emirates,Denmark,1,1,Friendly,Dubai,United Arab Emirates,False,2,0,Draw
13478,14818,15902,1990,Malta,Norway,1,1,Malta International Tournament,Attard,Malta,False,2,0,Draw
13479,14820,15904,1990,Uganda,Mauritius,4,1,Friendly,Kampala,Uganda,False,5,3,Uganda
13480,14821,15905,1990,Kuwait,Poland,1,1,Friendly,Cairo,Egypt,True,2,0,Draw
13481,14822,15906,1990,Togo,Cameroon,1,1,Friendly,Lomé,Togo,False,2,0,Draw
13482,14823,15907,1990,United Arab Emirates,Finland,1,1,Friendly,Dubai,United Arab Emirates,False,2,0,Draw
13483,14824,15908,1990,Bermuda,United States,0,1,Friendly,Hamilton,Bermuda,False,1,-1,United States
13484,14825,15909,1990,Egypt,Denmark,0,0,Friendly,Cairo,Egypt,False,0,0,Draw
13485,14826,15910,1990,United Arab Emirates,Sweden,2,1,Friendly,Dubai,United Arab Emirates,False,3,1,United Arab Emirates
13486,14828,15912,1990,Kuwait,Finland,0,1,Friendly,Kuwait City,Kuwait,False,1,-1,Finland
13487,14829,15913,1990,United Arab Emirates,Sweden,0,2,Friendly,Dubai,United Arab Emirates,False,2,-2,Sweden
13488,14831,15915,1990,Colombia,Russia,0,0,Friendly,Los Angeles,United States,True,0,0,Draw
13489,14832,15916,1990,Belgium,Sweden,0,0,Friendly,Brussels,Belgium,False,0,0,Draw
13490,14833,15917,1990,Gambia,Guinea-Bissau,0,1,Friendly,Banjul,Gambia,False,1,-1,Guinea-Bissau
13491,14834,15918,1990,Kuwait,Bahrain,1,0,Gulf Cup,Kuwait City,Kuwait,False,1,1,Kuwait
13492,14835,15919,1990,Morocco,Ivory Coast,2,1,Friendly,Rabat,Morocco,False,3,1,Morocco
13493,14836,15920,1990,Netherlands,Italy,0,0,Friendly,Rotterdam,Netherlands,False,0,0,Draw
13494,14838,15922,1990,Costa Rica,Russia,1,2,Friendly,Los Angeles,United States,True,3,-1,Russia
13495,14839,15923,1990,Oman,United Arab Emirates,1,1,Gulf Cup,Kuwait City,Kuwait,True,2,0,Draw
13496,14840,15924,1990,Qatar,Bahrain,0,0,Gulf Cup,Kuwait City,Kuwait,True,0,0,Draw
13497,14841,15925,1990,Kuwait,Oman,1,1,Gulf Cup,Kuwait City,Kuwait,False,2,0,Draw
13498,14842,15926,1990,United States,Russia,1,3,Friendly,Palo Alto,United States,False,4,-2,Russia
13499,14843,15927,1990,Bahrain,Iraq,0,1,Gulf Cup,Kuwait City,Kuwait,True,1,-1,Iraq
13500,14844,15928,1990,Qatar,United Arab Emirates,0,0,Gulf Cup,Kuwait City,Kuwait,True,0,0,Draw
13501,14845,15929,1990,Egypt,Austria,0,0,Friendly,Cairo,Egypt,False,0,0,Draw
13502,14846,15930,1990,France,Germany,2,1,Friendly,Montpellier,France,False,3,1,France
13503,14847,15931,1990,Kuwait,Iraq,1,1,Gulf Cup,Kuwait City,Kuwait,False,2,0,Draw
13504,14848,15932,1990,Bahrain,Oman,0,0,Gulf Cup,Kuwait City,Kuwait,True,0,0,Draw
13505,14849,15933,1990,Algeria,Nigeria,5,1,African Cup of Nations,Algiers,Algeria,False,6,4,Algeria
13506,14850,15934,1990,Cameroon,Zambia,0,1,African Cup of Nations,Annaba,Algeria,True,1,-1,Zambia
13507,14851,15935,1990,Ivory Coast,Egypt,3,1,African Cup of Nations,Algiers,Algeria,True,4,2,Ivory Coast
13508,14852,15936,1990,Senegal,Kenya,0,0,African Cup of Nations,Annaba,Algeria,True,0,0,Draw
13509,14853,15937,1990,United Arab Emirates,Iraq,2,2,Gulf Cup,Kuwait City,Kuwait,True,4,0,Draw
13510,14854,15938,1990,Oman,Qatar,2,4,Gulf Cup,Kuwait City,Kuwait,True,6,-2,Qatar
13511,14855,15939,1990,Algeria,Ivory Coast,3,0,African Cup of Nations,Algiers,Algeria,False,3,3,Algeria
13512,14856,15940,1990,Bahrain,United Arab Emirates,1,0,Gulf Cup,Kuwait City,Kuwait,True,1,1,Bahrain
13513,14857,15941,1990,Nigeria,Egypt,1,0,African Cup of Nations,Algiers,Algeria,True,1,1,Nigeria
13514,14858,15942,1990,Cameroon,Senegal,0,2,African Cup of Nations,Annaba,Algeria,True,2,-2,Senegal
13515,14859,15943,1990,Mozambique,Angola,2,1,Friendly,Maputo,Mozambique,False,3,1,Mozambique
13516,14860,15944,1990,Zambia,Kenya,1,0,African Cup of Nations,Annaba,Algeria,True,1,1,Zambia
13517,14861,15945,1990,Kuwait,Qatar,2,0,Gulf Cup,Kuwait City,Kuwait,False,2,2,Kuwait
13518,14862,15946,1990,Lesotho,Zimbabwe,1,4,Friendly,Maputo,Mozambique,True,5,-3,Zimbabwe
13519,14863,15947,1990,Algeria,Egypt,2,0,African Cup of Nations,Algiers,Algeria,False,2,2,Algeria
13520,14864,15948,1990,Angola,Zimbabwe,0,2,Friendly,Maputo,Mozambique,True,2,-2,Zimbabwe
13521,14865,15949,1990,Nigeria,Ivory Coast,1,0,African Cup of Nations,Algiers,Algeria,True,1,1,Nigeria
13522,14866,15950,1990,Cameroon,Kenya,2,0,African Cup of Nations,Annaba,Algeria,True,2,2,Cameroon
13523,14867,15951,1990,Kuwait,United Arab Emirates,6,1,Gulf Cup,Kuwait City,Kuwait,False,7,5,Kuwait
13524,14868,15952,1990,Zambia,Senegal,0,0,African Cup of Nations,Annaba,Algeria,True,0,0,Draw
13525,14869,15953,1990,Angola,Lesotho,3,1,Friendly,Maputo,Mozambique,True,4,2,Angola
13526,14870,15954,1990,Mozambique,Zimbabwe,3,1,Friendly,Maputo,Mozambique,False,4,2,Mozambique
13527,14871,15955,1990,United States,Finland,2,1,Friendly,Tampa,United States,False,3,1,United States
13528,14872,15956,1990,Mozambique,Lesotho,3,0,Friendly,Maputo,Mozambique,False,3,3,Mozambique
13529,14873,15957,1990,Algeria,Senegal,2,1,African Cup of Nations,Algiers,Algeria,False,3,1,Algeria
13530,14874,15958,1990,Nigeria,Zambia,2,0,African Cup of Nations,Annaba,Algeria,True,2,2,Nigeria
13531,14875,15959,1990,Senegal,Zambia,0,1,African Cup of Nations,Algiers,Algeria,True,1,-1,Zambia
13532,14876,15960,1990,Algeria,Nigeria,1,0,African Cup of Nations,Algiers,Algeria,False,1,1,Algeria
13533,14877,15961,1990,Jamaica,Barbados,0,1,Friendly,Kingston,Jamaica,False,1,-1,Barbados
13534,14878,15962,1990,Jamaica,Barbados,1,0,Friendly,Kingston,Jamaica,False,1,1,Jamaica
13535,14879,15963,1990,Hungary,United States,2,0,Friendly,Budapest,Hungary,False,2,2,Hungary
13536,14880,15964,1990,Mexico,Uruguay,2,1,Friendly,Los Angeles,United States,True,3,1,Mexico
13537,14881,15966,1990,Sint Maarten,Cayman Islands,1,1,CFU Caribbean Cup qualification,Marigot,Saint Martin,True,2,0,Draw
13538,14882,15967,1990,Saint Kitts and Nevis,Antigua and Barbuda,3,1,Friendly,Basseterre,Saint Kitts and Nevis,False,4,2,Saint Kitts and Nevis
13539,14884,15969,1990,Northern Ireland,Norway,2,3,Friendly,Belfast,Northern Ireland,False,5,-1,Norway
13540,14885,15970,1990,Egypt,Romania,1,3,Friendly,Cairo,Egypt,False,4,-2,Romania
13541,14886,15971,1990,England,Brazil,1,0,Friendly,London,England,False,1,1,England
13542,14887,15973,1990,Greece,Israel,2,1,Friendly,Athens,Greece,False,3,1,Greece
13543,14888,15974,1990,Hungary,France,1,3,Friendly,Budapest,Hungary,False,4,-2,France
13544,14889,15975,1990,Republic of Ireland,Wales,1,0,Friendly,Dublin,Republic of Ireland,False,1,1,Republic of Ireland
13545,14890,15976,1990,Luxembourg,Iceland,1,2,Friendly,Esch-sur-Alzette,Luxembourg,False,3,-1,Iceland
13546,14892,15978,1990,Russia,Netherlands,2,1,Friendly,Kyïv,Soviet Union,False,3,1,Russia
13547,14893,15979,1990,Scotland,Argentina,1,0,Friendly,Glasgow,Scotland,False,1,1,Scotland
13548,14894,15980,1990,Spain,Austria,2,3,Friendly,Málaga,Spain,False,5,-1,Austria
13549,14895,15981,1990,Switzerland,Italy,0,1,Friendly,Basel,Switzerland,False,1,-1,Italy
13550,14896,15982,1990,Zambia,Tanzania,2,0,Friendly,Ndola,Zambia,False,2,2,Zambia
13551,14897,15983,1990,Bermuda,Iceland,0,4,Friendly,Hamilton,Bermuda,False,4,-4,Iceland
13552,14898,15984,1990,Switzerland,Romania,2,1,Friendly,Lucerne,Switzerland,False,3,1,Switzerland
13553,14899,15986,1990,United States,Iceland,4,1,Friendly,St. Louis,United States,False,5,3,United States
13554,14900,15987,1990,Algeria,Sweden,1,1,Friendly,Algiers,Algeria,False,2,0,Draw
13555,14901,15988,1990,Austria,Hungary,3,0,Friendly,Salzburg,Austria,False,3,3,Austria
13556,14902,15989,1990,Denmark,Turkey,1,0,Friendly,Copenhagen,Denmark,False,1,1,Denmark
13557,14903,15991,1990,Bermuda,Antigua and Barbuda,2,2,CFU Caribbean Cup qualification,Hamilton,Bermuda,False,4,0,Draw
13558,14904,15992,1990,Barbados,Saint Lucia,1,0,CFU Caribbean Cup qualification,Bridgetown,Barbados,False,1,1,Barbados
13559,14905,15993,1990,Bermuda,Antigua and Barbuda,3,0,Friendly,Hamilton,Bermuda,False,3,3,Bermuda
13560,14906,15994,1990,Grenada,Curaçao,1,1,CFU Caribbean Cup qualification,St. George's,Grenada,False,2,0,Draw
13561,14907,15995,1990,Mexico,Colombia,2,0,Friendly,Los Angeles,United States,True,2,2,Mexico
13562,14908,15996,1990,Martinique,French Guiana,4,0,CFU Caribbean Cup qualification,Fort-de-France,Martinique,False,4,4,Martinique
13563,14909,15997,1990,Saint Vincent and the Grenadines,Dominica,2,1,CFU Caribbean Cup qualification,Kingstown,Saint Vincent and the Grenadines,False,3,1,Saint Vincent and the Grenadines
13564,14910,15998,1990,United States,Colombia,0,1,Friendly,Miami,United States,False,1,-1,Colombia
13565,14912,16000,1990,Germany,Uruguay,3,3,Friendly,Stuttgart,Germany,False,6,0,Draw
13566,14913,16001,1990,Republic of Ireland,Russia,1,0,Friendly,Dublin,Republic of Ireland,False,1,1,Republic of Ireland
13567,14914,16002,1990,Israel,Romania,1,4,Friendly,Haifa,Israel,False,5,-3,Romania
13568,14916,16004,1990,Sweden,Wales,4,2,Friendly,Solna,Sweden,False,6,2,Sweden
13569,14917,16005,1990,Barbados,Antigua and Barbuda,1,0,CFU Caribbean Cup qualification,Bridgetown,Barbados,False,1,1,Barbados
13570,14918,16006,1990,Gabon,Martinique,0,2,Friendly,Paris,France,True,2,-2,Martinique
13571,14919,16007,1990,Jamaica,Saint Kitts and Nevis,3,0,CFU Caribbean Cup qualification,Kingston,Jamaica,False,3,3,Jamaica
13572,14920,16008,1990,Suriname,Guyana,5,0,CFU Caribbean Cup qualification,Paramaribo,Suriname,False,5,5,Suriname
13573,14921,16009,1990,Guadeloupe,Martinique,1,0,Friendly,Paris,France,True,1,1,Guadeloupe
13574,14922,16010,1990,Austria,Argentina,1,1,Friendly,Vienna,Austria,False,2,0,Draw
13575,14923,16011,1990,Colombia,Poland,2,1,Friendly,Chicago,United States,True,3,1,Colombia
13576,14924,16012,1990,Brazil,Bulgaria,2,1,Friendly,Campinas,Brazil,False,3,1,Brazil
13577,14925,16013,1990,United States,Malta,1,0,Friendly,Piscataway,United States,False,1,1,United States
13578,14926,16014,1990,Cayman Islands,Jamaica,1,2,Friendly,George Town,Cayman Islands,False,3,-1,Jamaica
13579,14927,16015,1990,Costa Rica,Poland,0,2,Friendly,Chicago,United States,True,2,-2,Poland
13580,14928,16016,1990,Saint Martin,Guadeloupe,2,1,CFU Caribbean Cup qualification,Marigot,Saint Martin,False,3,1,Saint Martin
13581,14929,16017,1990,Switzerland,Argentina,1,1,Friendly,Berne,Switzerland,False,2,0,Draw
13582,14930,16019,1990,United States,Poland,3,1,Friendly,Hershey,United States,False,4,2,United States
13583,14932,16021,1990,Canada,Mexico,2,1,NAFU Championship,Burnaby,Canada,False,3,1,Canada
13584,14933,16022,1990,Dominica,French Guiana,1,1,CFU Caribbean Cup qualification,Roseau,Dominica,False,2,0,Draw
13585,14934,16023,1990,Saint Lucia,Bermuda,0,2,CFU Caribbean Cup qualification,Castries,Saint Lucia,False,2,-2,Bermuda
13586,14935,16024,1990,England,Denmark,1,0,Friendly,London,England,False,1,1,England
13587,14936,16025,1990,Grenada,Suriname,3,1,CFU Caribbean Cup qualification,Georgetown,Guyana,True,4,2,Grenada
13588,14937,16026,1990,Republic of Ireland,Finland,1,1,Friendly,Dublin,Republic of Ireland,False,2,0,Draw
13589,14938,16027,1990,Israel,Russia,3,2,Friendly,Ramat-Gan,Israel,False,5,1,Israel
13590,14939,16028,1990,Scotland,Egypt,1,3,Friendly,Aberdeen,Scotland,False,4,-2,Egypt
13591,14940,16029,1990,Barbados,Suriname,5,0,Friendly,Bridgetown,Barbados,False,5,5,Barbados
13592,14941,16030,1990,Mauritania,Gambia,2,0,African Cup of Nations qualification,Nouakchott,Mauritania,False,2,2,Mauritania
13593,14942,16031,1990,Northern Ireland,Uruguay,1,0,Friendly,Belfast,Northern Ireland,False,1,1,Northern Ireland
13594,14943,16032,1990,Zimbabwe,Eswatini,4,4,Friendly,Harare,Zimbabwe,False,8,0,Draw
13595,14944,16033,1990,Scotland,Poland,1,1,Friendly,Glasgow,Scotland,False,2,0,Draw
13596,14945,16034,1990,Saint Kitts and Nevis,Guadeloupe,2,0,CFU Caribbean Cup qualification,Basseterre,Saint Kitts and Nevis,False,2,2,Saint Kitts and Nevis
13597,14946,16035,1990,Guyana,Curaçao,1,1,CFU Caribbean Cup qualification,Georgetown,Guyana,False,2,0,Draw
13598,14947,16036,1990,Jamaica,Saint Martin,1,0,CFU Caribbean Cup qualification,Kingston,Jamaica,False,1,1,Jamaica
13599,14948,16037,1990,Wales,Costa Rica,1,0,Friendly,Cardiff,Wales,False,1,1,Wales
13600,14949,16038,1990,Poland,United Arab Emirates,4,0,Friendly,Marseille,France,True,4,4,Poland
13601,14950,16039,1990,Romania,Egypt,1,0,Friendly,Bucharest,Romania,False,1,1,Romania
13602,14951,16040,1990,England,Uruguay,1,2,Friendly,London,England,False,3,-1,Uruguay
13603,14952,16041,1990,Israel,Argentina,1,2,Friendly,Ramat-Gan,Israel,False,3,-1,Argentina
13604,14953,16042,1990,Belgium,Romania,2,2,Friendly,Brussels,Belgium,False,4,0,Draw
13605,14954,16043,1990,Bermuda,Barbados,1,1,CFU Caribbean Cup qualification,Hamilton,Bermuda,False,2,0,Draw
13606,14955,16044,1990,Egypt,Colombia,1,1,Friendly,Cairo,Egypt,False,2,0,Draw
13607,14956,16045,1990,Gambia,Burkina Faso,0,0,Friendly,Banjul,Gambia,False,0,0,Draw
13608,14958,16047,1990,Turkey,Republic of Ireland,0,0,Friendly,Izmir,Turkey,False,0,0,Draw
13609,14959,16049,1990,Antigua and Barbuda,Saint Lucia,0,2,CFU Caribbean Cup qualification,St. John's,Antigua and Barbuda,False,2,-2,Saint Lucia
13610,14960,16050,1990,Curaçao,Suriname,1,1,CFU Caribbean Cup qualification,Willemstad,Netherlands Antilles,True,2,0,Draw
13611,14961,16051,1990,Georgia,Lithuania,2,2,Friendly,Tbilisi,Soviet Union,False,4,0,Draw
13612,14962,16052,1990,Guyana,Grenada,0,0,CFU Caribbean Cup qualification,Georgetown,Guyana,False,0,0,Draw
13613,14963,16053,1990,Sweden,Finland,6,0,Friendly,Solna,Sweden,False,6,6,Sweden
13614,14964,16054,1990,Hungary,United Arab Emirates,3,0,Friendly,Nîmes,France,True,3,3,Hungary
13615,14965,16055,1990,Malta,Scotland,1,2,Friendly,Attard,Malta,False,3,-1,Scotland
13616,14966,16056,1990,Bermuda,Barbados,3,0,Friendly,Hamilton,Bermuda,False,3,3,Bermuda
13617,14967,16057,1990,Austria,Netherlands,3,2,Friendly,Vienna,Austria,False,5,1,Austria
13618,14968,16058,1990,Burkina Faso,Ghana,1,0,Friendly,Ouagadougou,Burkina Faso,False,1,1,Burkina Faso
13619,14969,16059,1990,French Guiana,Saint Vincent and the Grenadines,2,2,CFU Caribbean Cup qualification,Cayenne,French Guiana,False,4,0,Draw
13620,14970,16060,1990,Germany,Denmark,1,0,Friendly,Gelsenkirchen,Germany,False,1,1,Germany
13621,14971,16061,1990,Guadeloupe,Jamaica,0,0,CFU Caribbean Cup qualification,Pointe-à-Pitre,Guadeloupe,False,0,0,Draw
13622,14972,16062,1990,Iceland,Albania,2,0,UEFA Euro qualification,Reykjavík,Iceland,False,2,2,Iceland
13623,14973,16063,1990,Italy,Greece,0,0,Friendly,Perugia,Italy,False,0,0,Draw
13624,14974,16064,1990,Liechtenstein,United States,1,4,Friendly,Eschen,Liechtenstein,False,5,-3,United States
13625,14975,16065,1990,Martinique,Dominica,0,0,CFU Caribbean Cup qualification,Fort-de-France,Martinique,False,0,0,Draw
13626,14976,16067,1990,Jordan,Iraq,0,2,Friendly,Amman,Jordan,False,2,-2,Iraq
13627,14977,16068,1990,Belgium,Mexico,3,0,Friendly,Brussels,Belgium,False,3,3,Belgium
13628,14978,16069,1990,Hungary,Colombia,3,1,Friendly,Budapest,Hungary,False,4,2,Hungary
13629,14979,16070,1990,Malta,Republic of Ireland,0,3,Friendly,Attard,Malta,False,3,-3,Republic of Ireland
13630,14980,16071,1990,Switzerland,United States,2,1,Friendly,St. Gallen,Switzerland,False,3,1,Switzerland
13631,14981,16072,1990,Tunisia,England,1,1,Friendly,Tunis,Tunisia,False,2,0,Draw
13632,14982,16073,1990,Gambia,Mauritania,2,1,African Cup of Nations qualification,Banjul,Gambia,False,3,1,Gambia
13633,14983,16075,1990,Belgium,Poland,1,1,Friendly,Brussels,Belgium,False,2,0,Draw
13634,14984,16076,1990,Norway,Denmark,1,2,Friendly,Trondheim,Norway,False,3,-1,Denmark
13635,14985,16077,1990,Namibia,Mauritius,1,2,Friendly,Windhoek,Namibia,False,3,-1,Mauritius
13636,14986,16078,1990,Argentina,Cameroon,0,1,FIFA World Cup,Milan,Italy,True,1,-1,Cameroon
13637,14987,16079,1990,Italy,Austria,1,0,FIFA World Cup,Rome,Italy,False,1,1,Italy
13638,14988,16080,1990,Russia,Romania,0,2,FIFA World Cup,Bari,Italy,True,2,-2,Romania
13639,14989,16081,1990,United Arab Emirates,Colombia,0,2,FIFA World Cup,Bologna,Italy,True,2,-2,Colombia
13640,14990,16082,1990,Botswana,Mauritius,0,1,Friendly,Gaborone,Botswana,False,1,-1,Mauritius
13641,14991,16083,1990,Brazil,Sweden,2,1,FIFA World Cup,Turin,Italy,True,3,1,Brazil
13642,14994,16086,1990,Costa Rica,Scotland,1,0,FIFA World Cup,Genoa,Italy,True,1,1,Costa Rica
13643,14995,16087,1990,England,Republic of Ireland,1,1,FIFA World Cup,Cagliari,Italy,True,2,0,Draw
13644,14997,16089,1990,Netherlands,Egypt,1,1,FIFA World Cup,Palermo,Italy,True,2,0,Draw
13645,14998,16090,1990,Argentina,Russia,2,0,FIFA World Cup,Naples,Italy,True,2,2,Argentina
13646,14999,16091,1990,Uruguay,Spain,0,0,FIFA World Cup,Udine,Italy,True,0,0,Draw
13647,15000,16092,1990,Cameroon,Romania,2,1,FIFA World Cup,Bari,Italy,True,3,1,Cameroon
13648,15001,16093,1990,Italy,United States,1,0,FIFA World Cup,Rome,Italy,False,1,1,Italy
13649,15003,16096,1990,Germany,United Arab Emirates,5,1,FIFA World Cup,Milan,Italy,True,6,4,Germany
13650,15004,16097,1990,Brazil,Costa Rica,1,0,FIFA World Cup,Turin,Italy,True,1,1,Brazil
13651,15005,16098,1990,England,Netherlands,0,0,FIFA World Cup,Cagliari,Italy,True,0,0,Draw
13652,15006,16099,1990,Sweden,Scotland,1,2,FIFA World Cup,Genoa,Italy,True,3,-1,Scotland
13653,15007,16100,1990,Belgium,Uruguay,3,1,FIFA World Cup,Verona,Italy,True,4,2,Belgium
13654,15008,16101,1990,Republic of Ireland,Egypt,0,0,FIFA World Cup,Palermo,Italy,True,0,0,Draw
13655,15009,16103,1990,Argentina,Romania,1,1,FIFA World Cup,Naples,Italy,True,2,0,Draw
13656,15010,16104,1990,Cameroon,Russia,0,4,FIFA World Cup,Bari,Italy,True,4,-4,Russia
13657,15011,16105,1990,Austria,United States,2,1,FIFA World Cup,Florence,Italy,True,3,1,Austria
13658,15012,16106,1990,Germany,Colombia,1,1,FIFA World Cup,Milan,Italy,True,2,0,Draw
13659,15014,16109,1990,Brazil,Scotland,1,0,FIFA World Cup,Turin,Italy,True,1,1,Brazil
13660,15015,16110,1990,Sweden,Costa Rica,1,2,FIFA World Cup,Genoa,Italy,True,3,-1,Costa Rica
13661,15016,16111,1990,Belgium,Spain,1,2,FIFA World Cup,Verona,Italy,True,3,-1,Spain
13662,15017,16112,1990,England,Egypt,1,0,FIFA World Cup,Cagliari,Italy,True,1,1,England
13663,15018,16113,1990,Republic of Ireland,Netherlands,1,1,FIFA World Cup,Palermo,Italy,True,2,0,Draw
13664,15019,16115,1990,Cameroon,Colombia,2,1,FIFA World Cup,Naples,Italy,True,3,1,Cameroon
13665,15020,16117,1990,Brazil,Argentina,0,1,FIFA World Cup,Turin,Italy,True,1,-1,Argentina
13666,15021,16118,1990,Germany,Netherlands,2,1,FIFA World Cup,Milan,Italy,True,3,1,Germany
13667,15022,16119,1990,Republic of Ireland,Romania,0,0,FIFA World Cup,Genoa,Italy,True,0,0,Draw
13668,15023,16120,1990,Italy,Uruguay,2,0,FIFA World Cup,Rome,Italy,False,2,2,Italy
13669,15024,16121,1990,England,Belgium,1,0,FIFA World Cup,Bologna,Italy,True,1,1,England
13670,15026,16123,1990,Italy,Republic of Ireland,1,0,FIFA World Cup,Rome,Italy,False,1,1,Italy
13671,15027,16125,1990,Cameroon,England,2,3,FIFA World Cup,Naples,Italy,True,5,-1,England
13672,15029,16127,1990,Italy,Argentina,1,1,FIFA World Cup,Naples,Italy,False,2,0,Draw
13673,15030,16128,1990,Germany,England,1,1,FIFA World Cup,Turin,Italy,True,2,0,Draw
13674,15031,16129,1990,Malawi,Tanzania,2,0,Friendly,Blantyre,Malawi,False,2,2,Malawi
13675,15032,16130,1990,Italy,England,2,1,FIFA World Cup,Bari,Italy,False,3,1,Italy
13676,15033,16131,1990,Germany,Argentina,1,0,FIFA World Cup,Rome,Italy,True,1,1,Germany
13677,15034,16132,1990,Barbados,Grenada,1,1,Friendly,Bridgetown,Barbados,False,2,0,Draw
13678,15035,16133,1990,Malawi,Tanzania,1,1,Friendly,Lilongwe,Malawi,False,2,0,Draw
13679,15036,16134,1990,Barbados,Grenada,4,0,Friendly,Bridgetown,Barbados,False,4,4,Barbados
13680,15037,16135,1990,Malawi,Tanzania,0,0,Friendly,Mzuzu,Malawi,False,0,0,Draw
13681,15038,16136,1990,Barbados,Martinique,2,2,CFU Caribbean Cup,Port of Spain,Trinidad and Tobago,True,4,0,Draw
13682,15040,16139,1990,Trinidad and Tobago,Jamaica,0,0,CFU Caribbean Cup,Port of Spain,Trinidad and Tobago,False,0,0,Draw
13683,15041,16142,1990,Togo,Mali,0,0,Friendly,Lomé,Togo,False,0,0,Draw
13684,15043,16146,1990,Malawi,DR Congo,1,0,Friendly,Blantyre,Malawi,False,1,1,Malawi
13685,15044,16147,1990,Malawi,DR Congo,1,0,Friendly,Lilongwe,Malawi,False,1,1,Malawi
13686,15045,16148,1990,Faroe Islands,Iceland,2,3,Friendly,Tórshavn,Faroe Islands,False,5,-1,Iceland
13687,15046,16149,1990,Malawi,DR Congo,0,0,Friendly,Mzuzu,Malawi,False,0,0,Draw
13688,15047,16150,1990,Tunisia,Morocco,0,0,Friendly,Tunis,Tunisia,False,0,0,Draw
13689,15048,16151,1990,Réunion,Congo,2,1,Friendly,Saint-Pierre,Réunion,False,3,1,Réunion
13690,15049,16152,1990,Gabon,Mali,0,0,Friendly,Libreville,Gabon,False,0,0,Draw
13691,15050,16153,1990,Eswatini,Mozambique,0,0,Friendly,Mbabane,Eswatini,False,0,0,Draw
13692,15051,16154,1990,Zambia,DR Congo,0,0,Friendly,Lusaka,Zambia,False,0,0,Draw
13693,15052,16155,1990,Mozambique,Zimbabwe,2,3,Friendly,Mbabane,Eswatini,True,5,-1,Zimbabwe
13694,15053,16156,1990,France,Poland,0,0,Friendly,Paris,France,False,0,0,Draw
13695,15055,16158,1990,Egypt,Ethiopia,2,0,African Cup of Nations qualification,Cairo,Egypt,False,2,2,Egypt
13696,15056,16159,1990,Indonesia,Singapore,6,0,Friendly,Jakarta,Indonesia,False,6,6,Indonesia
13697,15057,16160,1990,Malawi,Congo,0,1,African Cup of Nations qualification,Zomba,Malawi,False,1,-1,Congo
13698,15058,16161,1990,Cameroon,Mali,0,0,African Cup of Nations qualification,Yaoundé,Cameroon,False,0,0,Draw
13699,15059,16162,1990,DR Congo,Tanzania,2,0,African Cup of Nations qualification,Kinshasa,Zaïre,False,2,2,DR Congo
13700,15060,16163,1990,Gabon,Uganda,1,0,African Cup of Nations qualification,Libreville,Gabon,False,1,1,Gabon
13701,15061,16164,1990,Ivory Coast,Mauritania,2,0,African Cup of Nations qualification,Abidjan,Ivory Coast,False,2,2,Ivory Coast
13702,15062,16165,1990,Morocco,Niger,2,0,African Cup of Nations qualification,Casablanca,Morocco,False,2,2,Morocco
13703,15063,16166,1990,Tunisia,Chad,2,1,African Cup of Nations qualification,Tunis,Tunisia,False,3,1,Tunisia
13704,15064,16167,1990,Zambia,Eswatini,5,0,African Cup of Nations qualification,Lusaka,Zambia,False,5,5,Zambia
13705,15065,16168,1990,Austria,Switzerland,1,3,Friendly,Vienna,Austria,False,4,-2,Switzerland
13706,15066,16169,1990,Norway,Sweden,1,2,Friendly,Stavanger,Norway,False,3,-1,Sweden
13707,15068,16171,1990,Botswana,Eswatini,3,2,Friendly,Gaborone,Botswana,False,5,1,Botswana
13708,15069,16172,1990,Indonesia,Australia,0,3,Friendly,Jakarta,Indonesia,False,3,-3,Australia
13709,15070,16173,1990,Zambia,Zimbabwe,3,1,Friendly,Gaborone,Botswana,True,4,2,Zambia
13710,15071,16174,1990,Botswana,Zimbabwe,0,7,Friendly,Gaborone,Botswana,False,7,-7,Zimbabwe
13711,15072,16175,1990,Mali,Burkina Faso,2,1,Friendly,Bamako,Mali,False,3,1,Mali
13712,15074,16177,1990,Portugal,Germany,1,1,Friendly,Lisbon,Portugal,False,2,0,Draw
13713,15075,16178,1990,Russia,Romania,1,2,Friendly,Moscow,Soviet Union,False,3,-1,Romania
13714,15076,16179,1990,Mozambique,Angola,0,2,Friendly,Maputo,Mozambique,False,2,-2,Angola
13715,15077,16180,1990,Sierra Leone,Cameroon,1,1,African Cup of Nations qualification,Freetown,Sierra Leone,False,2,0,Draw
13716,15078,16181,1990,Uganda,DR Congo,2,1,African Cup of Nations qualification,Kampala,Uganda,False,3,1,Uganda
13717,15079,16182,1990,Congo,Zimbabwe,2,0,African Cup of Nations qualification,Brazzaville,Congo,False,2,2,Congo
13718,15080,16183,1990,Mali,Guinea,1,1,African Cup of Nations qualification,Bamako,Mali,False,2,0,Draw
13719,15081,16184,1990,Morocco,Mauritania,4,0,African Cup of Nations qualification,Casablanca,Morocco,False,4,4,Morocco
13720,15082,16185,1990,Mozambique,Kenya,2,1,African Cup of Nations qualification,Maputo,Mozambique,False,3,1,Mozambique
13721,15083,16186,1990,Eswatini,Angola,1,1,African Cup of Nations qualification,Mbabane,Eswatini,False,2,0,Draw
13722,15084,16187,1990,Greece,Albania,1,0,Friendly,Patras,Greece,False,1,1,Greece
13723,15085,16188,1990,Hungary,Turkey,4,1,Friendly,Budapest,Hungary,False,5,3,Hungary
13724,15086,16189,1990,Iceland,France,1,2,UEFA Euro qualification,Reykjavík,Iceland,False,3,-1,France
13725,15087,16190,1990,Sweden,Denmark,0,1,Friendly,Västerås,Sweden,False,1,-1,Denmark
13726,15088,16192,1990,Malaysia,Yemen,0,1,Friendly,Kuala Lumpur,Malaysia,False,1,-1,Yemen
13727,15089,16194,1990,Denmark,Wales,1,0,Friendly,Copenhagen,Denmark,False,1,1,Denmark
13728,15091,16196,1990,England,Hungary,1,0,Friendly,London,England,False,1,1,England
13729,15092,16197,1990,Faroe Islands,Austria,1,0,UEFA Euro qualification,Landskrona,Sweden,True,1,1,Faroe Islands
13730,15093,16198,1990,Finland,Portugal,0,0,UEFA Euro qualification,Helsinki,Finland,False,0,0,Draw
13731,15094,16199,1990,Republic of Ireland,Morocco,1,0,Friendly,Dublin,Republic of Ireland,False,1,1,Republic of Ireland
13732,15096,16201,1990,Russia,Norway,2,0,UEFA Euro qualification,Moscow,Soviet Union,False,2,2,Russia
13733,15097,16202,1990,Scotland,Romania,2,1,UEFA Euro qualification,Glasgow,Scotland,False,3,1,Scotland
13734,15098,16203,1990,Spain,Brazil,3,0,Friendly,Gijón,Spain,False,3,3,Spain
13735,15099,16204,1990,Switzerland,Bulgaria,2,0,UEFA Euro qualification,Geneva,Switzerland,False,2,2,Switzerland
13736,15100,16205,1990,Singapore,Malaysia,3,0,Friendly,Singapore,Singapore,False,3,3,Singapore
13737,15101,16206,1990,United States,Trinidad and Tobago,3,0,Friendly,High Point,United States,False,3,3,United States
13738,15102,16208,1990,Italy,Netherlands,1,0,Friendly,Palermo,Italy,False,1,1,Italy
13739,15103,16209,1990,Romania,Poland,2,1,Friendly,Bucharest,Romania,False,3,1,Romania
13740,15104,16210,1990,Sweden,Bulgaria,2,0,Friendly,Solna,Sweden,False,2,2,Sweden
13741,15105,16211,1990,Aruba,Curaçao,1,3,Friendly,Oranjestad,Aruba,False,4,-2,Curaçao
13742,15106,16212,1990,Benin,Nigeria,0,1,African Cup of Nations qualification,Cotonou,Benin,False,1,-1,Nigeria
13743,15107,16213,1990,Botswana,Cameroon,0,0,Friendly,Gaborone,Botswana,False,0,0,Draw
13744,15108,16214,1990,Niger,Ivory Coast,0,1,African Cup of Nations qualification,Niamey,Niger,False,1,-1,Ivory Coast
13745,15109,16215,1990,Togo,Ghana,0,1,African Cup of Nations qualification,Lomé,Togo,False,1,-1,Ghana
13746,15110,16216,1990,Denmark,Faroe Islands,4,1,UEFA Euro qualification,Copenhagen,Denmark,False,5,3,Denmark
13747,15111,16217,1990,Greece,Egypt,6,1,Friendly,Athens,Greece,False,7,5,Greece
13748,15112,16218,1990,Norway,Hungary,0,0,UEFA Euro qualification,Bergen,Norway,False,0,0,Draw
13749,15113,16219,1990,Poland,United States,2,3,Friendly,Warsaw,Poland,False,5,-1,United States
13750,15114,16220,1990,Spain,Iceland,2,1,UEFA Euro qualification,Seville,Spain,False,3,1,Spain
13751,15115,16221,1990,Sweden,Germany,1,3,Friendly,Solna,Sweden,False,4,-2,Germany
13752,15117,16224,1990,Benin,Togo,1,1,African Cup of Nations qualification,Cotonou,Benin,False,2,0,Draw
13753,15118,16225,1990,Croatia,United States,2,1,Friendly,Zagreb,Croatia,False,3,1,Croatia
13754,15119,16226,1990,England,Poland,2,0,UEFA Euro qualification,London,England,False,2,2,England
13755,15120,16227,1990,Hungary,Italy,1,1,UEFA Euro qualification,Budapest,Hungary,False,2,0,Draw
13756,15121,16228,1990,Republic of Ireland,Turkey,5,0,UEFA Euro qualification,Dublin,Republic of Ireland,False,5,5,Republic of Ireland
13757,15122,16229,1990,Northern Ireland,Denmark,1,1,UEFA Euro qualification,Belfast,Northern Ireland,False,2,0,Draw
13758,15123,16230,1990,Portugal,Netherlands,1,0,UEFA Euro qualification,Porto,Portugal,False,1,1,Portugal
13759,15124,16231,1990,Romania,Bulgaria,0,3,UEFA Euro qualification,Bucharest,Romania,False,3,-3,Bulgaria
13760,15125,16232,1990,Scotland,Switzerland,2,1,UEFA Euro qualification,Glasgow,Scotland,False,3,1,Scotland
13761,15126,16233,1990,Wales,Belgium,3,1,UEFA Euro qualification,Cardiff,Wales,False,4,2,Wales
13762,15127,16235,1990,Greece,Malta,4,0,UEFA Euro qualification,Athens,Greece,False,4,4,Greece
13763,15128,16236,1990,Hungary,Cyprus,4,2,UEFA Euro qualification,Budapest,Hungary,False,6,2,Hungary
13764,15129,16237,1990,Luxembourg,Germany,2,3,UEFA Euro qualification,Luxembourg,Luxembourg,False,5,-1,Germany
13765,15130,16238,1990,Norway,Cameroon,6,1,Friendly,Oslo,Norway,False,7,5,Norway
13766,15131,16240,1990,Fiji,Solomon Islands,0,0,Friendly,Port Vila,Vanuatu,True,0,0,Draw
13767,15132,16241,1990,Vanuatu,New Caledonia,1,0,Friendly,Port Vila,Vanuatu,False,1,1,Vanuatu
13768,15133,16242,1990,Italy,Russia,0,0,UEFA Euro qualification,Rome,Italy,False,0,0,Draw
13769,15134,16243,1990,New Caledonia,Papua New Guinea,2,1,Friendly,Port Vila,Vanuatu,True,3,1,New Caledonia
13770,15135,16244,1990,Vanuatu,Solomon Islands,1,1,Friendly,Port Vila,Vanuatu,False,2,0,Draw
13771,15136,16245,1990,New Caledonia,Fiji,0,0,Friendly,Port Vila,Vanuatu,True,0,0,Draw
13772,15137,16246,1990,Vanuatu,Papua New Guinea,1,0,Friendly,Port Vila,Vanuatu,False,1,1,Vanuatu
13773,15138,16247,1990,Solomon Islands,Papua New Guinea,1,0,Friendly,Port Vila,Vanuatu,True,1,1,Solomon Islands
13774,15139,16248,1990,Vanuatu,Fiji,1,1,Friendly,Port Vila,Vanuatu,False,2,0,Draw
13775,15140,16249,1990,Tunisia,Norway,1,3,Friendly,Bizerte,Tunisia,False,4,-2,Norway
13776,15141,16250,1990,Brazil,Chile,0,0,Friendly,Belém,Brazil,False,0,0,Draw
13777,15142,16251,1990,Fiji,Papua New Guinea,1,0,Friendly,Port Vila,Vanuatu,True,1,1,Fiji
13778,15143,16252,1990,New Caledonia,Solomon Islands,3,1,Friendly,Port Vila,Vanuatu,True,4,2,New Caledonia
13779,15144,16253,1990,Angola,Mozambique,4,2,Friendly,Luanda,Angola,False,6,2,Angola
13780,15145,16254,1990,Congo,Mozambique,1,0,Friendly,Luanda,Angola,True,1,1,Congo
13781,15146,16255,1990,Angola,Congo,1,0,Friendly,Luanda,Angola,False,1,1,Angola
13782,15147,16256,1990,Tunisia,Finland,1,2,Friendly,Tunis,Tunisia,False,3,-1,Finland
13783,15148,16257,1990,Austria,Northern Ireland,0,0,UEFA Euro qualification,Vienna,Austria,False,0,0,Draw
13784,15149,16258,1990,Bulgaria,Scotland,1,1,UEFA Euro qualification,Sofia,Bulgaria,False,2,0,Draw
13785,15150,16259,1990,Cyprus,Norway,0,3,UEFA Euro qualification,Nicosia,Cyprus,False,3,-3,Norway
13786,15152,16262,1990,Republic of Ireland,England,1,1,UEFA Euro qualification,Dublin,Republic of Ireland,False,2,0,Draw
13787,15153,16263,1990,Luxembourg,Wales,0,1,UEFA Euro qualification,Luxembourg,Luxembourg,False,1,-1,Wales
13788,15154,16264,1990,San Marino,Switzerland,0,4,UEFA Euro qualification,Serravalle,San Marino,False,4,-4,Switzerland
13789,15155,16265,1990,Turkey,Poland,0,1,UEFA Euro qualification,Istanbul,Turkey,False,1,-1,Poland
13790,15156,16266,1990,Albania,France,0,1,UEFA Euro qualification,Tirana,Albania,False,1,-1,France
13791,15157,16267,1990,Ethiopia,Tunisia,0,2,African Cup of Nations qualification,Addis Abeba,Ethiopia,False,2,-2,Tunisia
13792,15158,16268,1990,Trinidad and Tobago,United States,0,0,Friendly,Port of Spain,Trinidad and Tobago,False,0,0,Draw
13793,15159,16269,1990,United States,Russia,0,0,Friendly,Port of Spain,Trinidad and Tobago,True,0,0,Draw
13794,15160,16270,1990,Trinidad and Tobago,Russia,0,2,Friendly,Port of Spain,Trinidad and Tobago,False,2,-2,Russia
13795,15161,16271,1990,Malta,Finland,1,1,UEFA Euro qualification,Attard,Malta,False,2,0,Draw
13796,15162,16272,1990,Tanzania,Uganda,1,1,Friendly,Dar es Salaam,Tanzania,False,2,0,Draw
13797,15163,16273,1990,Guatemala,Russia,0,3,Friendly,Guatemala,Guatemala,False,3,-3,Russia
13798,15164,16274,1990,Romania,San Marino,6,0,UEFA Euro qualification,Bucharest,Romania,False,6,6,Romania
13799,15165,16275,1990,Congo,Chad,3,0,UDEAC Cup,Brazzaville,Congo,False,3,3,Congo
13800,15166,16277,1990,Cameroon,Gabon,2,1,UDEAC Cup,Brazzaville,Congo,True,3,1,Cameroon
13801,15167,16278,1990,Kenya,Uganda,2,2,CECAFA Cup,Zanzibar,Zanzibar,True,4,0,Draw
13802,15168,16279,1990,Malawi,Zimbabwe,0,0,CECAFA Cup,Zanzibar,Zanzibar,True,0,0,Draw
13803,15169,16280,1990,Central African Republic,Gabon,0,1,UDEAC Cup,Brazzaville,Congo,True,1,-1,Gabon
13804,15170,16281,1990,Malawi,Tanzania,1,0,CECAFA Cup,Zanzibar,Zanzibar,True,1,1,Malawi
13805,15171,16282,1990,Chad,Equatorial Guinea,1,0,UDEAC Cup,Brazzaville,Congo,True,1,1,Chad
13806,15172,16283,1990,Kenya,Sudan,1,2,CECAFA Cup,Zanzibar,Zanzibar,True,3,-1,Sudan
13807,15173,16284,1990,Mexico,Brazil,0,0,Friendly,Los Angeles,United States,True,0,0,Draw
13808,15174,16286,1990,Central African Republic,Cameroon,0,3,UDEAC Cup,Brazzaville,Congo,True,3,-3,Cameroon
13809,15175,16287,1990,Congo,Equatorial Guinea,6,0,UDEAC Cup,Brazzaville,Congo,False,6,6,Congo
13810,15176,16288,1990,Sudan,Uganda,2,2,CECAFA Cup,Zanzibar,Zanzibar,True,4,0,Draw
13811,15177,16289,1990,Tanzania,Zimbabwe,2,0,CECAFA Cup,Zanzibar,Zanzibar,True,2,2,Tanzania
13812,15178,16291,1990,Chad,Cameroon,0,1,UDEAC Cup,Brazzaville,Congo,True,1,-1,Cameroon
13813,15179,16292,1990,Congo,Gabon,1,0,UDEAC Cup,Brazzaville,Congo,False,1,1,Congo
13814,15180,16293,1990,Central African Republic,Equatorial Guinea,3,3,UDEAC Cup,Brazzaville,Congo,True,6,0,Draw
13815,15181,16294,1990,Chad,Gabon,2,1,UDEAC Cup,Brazzaville,Congo,True,3,1,Chad
13816,15182,16295,1990,Tanzania,Uganda,1,1,Friendly,Zanzibar,Zanzibar,True,2,0,Draw
13817,15183,16297,1990,Algeria,Senegal,1,0,Friendly,Constantine,Algeria,False,1,1,Algeria
13818,15184,16298,1990,Congo,Cameroon,2,1,UDEAC Cup,Brazzaville,Congo,False,3,1,Congo
13819,15185,16299,1990,Germany,Switzerland,4,0,Friendly,Stuttgart,Germany,False,4,4,Germany
13820,15186,16300,1990,Greece,Poland,1,2,Friendly,Vólos,Greece,False,3,-1,Poland
13821,15187,16301,1990,Malta,Netherlands,0,8,UEFA Euro qualification,Attard,Malta,False,8,-8,Netherlands
13822,15188,16302,1990,Portugal,United States,1,0,Friendly,Maia,Portugal,False,1,1,Portugal
13823,15189,16303,1990,Spain,Albania,9,0,UEFA Euro qualification,Seville,Spain,False,9,9,Spain
13824,15190,16305,1990,Sudan,Uganda,0,2,CECAFA Cup,Zanzibar,Zanzibar,True,2,-2,Uganda
13825,15191,16306,1990,Croatia,Romania,2,0,Friendly,Rijeka,Croatia,False,2,2,Croatia
13826,15192,16307,1990,Cyprus,Italy,0,4,UEFA Euro qualification,Limassol,Cyprus,False,4,-4,Italy
13827,15193,16308,1991,Burkina Faso,Mali,2,0,Friendly,Ouagadougou,Burkina Faso,False,2,2,Burkina Faso
13828,15194,16309,1991,Burkina Faso,Niger,2,2,Friendly,Ouagadougou,Burkina Faso,False,4,0,Draw
13829,15195,16310,1991,Russia,Zambia,4,0,Nehru Cup,Trivandrum,India,True,4,4,Russia
13830,15196,16311,1991,Burkina Faso,Nigeria,1,1,African Cup of Nations qualification,Ouagadougou,Burkina Faso,False,2,0,Draw
13831,15197,16312,1991,Ghana,Benin,4,0,African Cup of Nations qualification,Accra,Ghana,False,4,4,Ghana
13832,15198,16313,1991,Morocco,Ivory Coast,3,1,African Cup of Nations qualification,Rabat,Morocco,False,4,2,Morocco
13833,15199,16314,1991,Hungary,Russia,1,1,Nehru Cup,Trivandrum,India,True,2,0,Draw
13834,15200,16315,1991,Spain,Portugal,1,1,Friendly,Castellón de la Plana,Spain,False,2,0,Draw
13835,15201,16316,1991,India,Hungary,1,2,Nehru Cup,Trivandrum,India,False,3,-1,Hungary
13836,15202,16317,1991,India,Zambia,1,0,Nehru Cup,Trivandrum,India,False,1,1,India
13837,15203,16318,1991,Greece,Portugal,3,2,UEFA Euro qualification,Athens,Greece,False,5,1,Greece
13838,15204,16319,1991,Hungary,Zambia,4,1,Nehru Cup,Trivandrum,India,True,5,3,Hungary
13839,15205,16320,1991,India,Russia,1,3,Nehru Cup,Trivandrum,India,False,4,-2,Russia
13840,15206,16321,1991,Benin,Burkina Faso,1,2,African Cup of Nations qualification,Cotonou,Benin,False,3,-1,Burkina Faso
13841,15207,16322,1991,Niger,Morocco,1,0,African Cup of Nations qualification,Niamey,Niger,False,1,1,Niger
13842,15208,16323,1991,Togo,Nigeria,0,0,African Cup of Nations qualification,Lomé,Togo,False,0,0,Draw
13843,15209,16324,1991,Mexico,Colombia,0,0,Friendly,León,Mexico,False,0,0,Draw
13844,15211,16326,1991,United States,Switzerland,0,1,Friendly,Miami,United States,False,1,-1,Switzerland
13845,15212,16327,1991,Colombia,Switzerland,2,3,Friendly,Miami,United States,True,5,-1,Switzerland
13846,15213,16328,1991,Northern Ireland,Poland,3,1,Friendly,Belfast,Northern Ireland,False,4,2,Northern Ireland
13847,15215,16330,1991,England,Cameroon,2,0,Friendly,London,England,False,2,2,England
13848,15216,16331,1991,Guinea-Bissau,Gambia,2,1,Friendly,Bissau,Guinea-Bissau,False,3,1,Guinea-Bissau
13849,15217,16332,1991,Scotland,Russia,0,1,Friendly,Glasgow,Scotland,False,1,-1,Russia
13850,15218,16333,1991,Wales,Republic of Ireland,0,3,Friendly,Wrexham,Wales,False,3,-3,Republic of Ireland
13851,15219,16334,1991,Guinea-Bissau,Mauritania,2,0,Friendly,Bissau,Guinea-Bissau,False,2,2,Guinea-Bissau
13852,15220,16335,1991,Malta,Portugal,0,1,UEFA Euro qualification,Attard,Malta,False,1,-1,Portugal
13853,15221,16336,1991,Italy,Belgium,0,0,Friendly,Terni,Italy,False,0,0,Draw
13854,15222,16337,1991,Algeria,Cameroon,0,0,Friendly,Dakar,Senegal,True,0,0,Draw
13855,15223,16338,1991,Senegal,Ivory Coast,0,0,Friendly,Dakar,Senegal,False,0,0,Draw
13856,15224,16339,1991,Gambia,Mauritania,0,0,Friendly,Banjul,Gambia,False,0,0,Draw
13857,15225,16340,1991,Ivory Coast,Cameroon,3,2,Friendly,Dakar,Senegal,True,5,1,Ivory Coast
13858,15226,16341,1991,Senegal,Algeria,1,3,Friendly,Dakar,Senegal,False,4,-2,Algeria
13859,15227,16342,1991,Argentina,Hungary,2,0,Friendly,Rosario,Argentina,False,2,2,Argentina
13860,15228,16343,1991,France,Spain,3,1,UEFA Euro qualification,Paris,France,False,4,2,France
13861,15229,16344,1991,Portugal,Malta,5,0,UEFA Euro qualification,Porto,Portugal,False,5,5,Portugal
13862,15230,16345,1991,Bermuda,United States,1,0,Friendly,Hamilton,Bermuda,False,1,1,Bermuda
13863,15231,16346,1991,Belgium,Luxembourg,3,0,UEFA Euro qualification,Brussels,Belgium,False,3,3,Belgium
13864,15232,16347,1991,Brazil,Paraguay,1,1,Friendly,Campo Grande,Brazil,False,2,0,Draw
13865,15233,16348,1991,Cyprus,Greece,1,1,Friendly,Limassol,Cyprus,False,2,0,Draw
13866,15235,16350,1991,Suriname,French Guiana,3,0,Friendly,Paramaribo,Suriname,False,3,3,Suriname
13867,15236,16351,1991,Algeria,Tunisia,2,1,Friendly,Annaba,Algeria,False,3,1,Algeria
13868,15237,16352,1991,Uganda,Sudan,0,1,Friendly,Kampala,Uganda,False,1,-1,Sudan
13869,15238,16353,1991,Liechtenstein,Switzerland,0,6,Friendly,Balzers,Liechtenstein,False,6,-6,Switzerland
13870,15239,16354,1991,United States,Mexico,2,2,NAFU Championship,Los Angeles,United States,False,4,0,Draw
13871,15240,16355,1991,Argentina,Mexico,0,0,Friendly,Buenos Aires,Argentina,False,0,0,Draw
13872,15241,16356,1991,Netherlands,Malta,1,0,UEFA Euro qualification,Rotterdam,Netherlands,False,1,1,Netherlands
13873,15242,16357,1991,Poland,Finland,1,1,Friendly,Warsaw,Poland,False,2,0,Draw
13874,15243,16358,1991,Canada,Mexico,0,3,NAFU Championship,Los Angeles,United States,True,3,-3,Mexico
13875,15244,16359,1991,United States,Canada,2,0,NAFU Championship,Torrance,United States,False,2,2,United States
13876,15245,16360,1991,Argentina,Brazil,3,3,Friendly,Buenos Aires,Argentina,False,6,0,Draw
13877,15246,16361,1991,Belgium,Wales,1,1,UEFA Euro qualification,Brussels,Belgium,False,2,0,Draw
13878,15247,16363,1991,England,Republic of Ireland,1,1,UEFA Euro qualification,London,England,False,2,0,Draw
13879,15248,16364,1991,Germany,Russia,2,1,Friendly,Frankfurt am Main,Germany,False,3,1,Germany
13880,15249,16365,1991,Morocco,Greece,0,0,Friendly,Rabat,Morocco,False,0,0,Draw
13881,15250,16366,1991,San Marino,Romania,1,3,UEFA Euro qualification,Serravalle,San Marino,False,4,-2,Romania
13882,15251,16367,1991,Scotland,Bulgaria,1,1,UEFA Euro qualification,Glasgow,Scotland,False,2,0,Draw
13883,15252,16368,1991,Spain,Hungary,2,4,Friendly,Santander,Spain,False,6,-2,Hungary
13884,15253,16369,1991,Tunisia,Turkey,0,0,Friendly,Tunis,Tunisia,False,0,0,Draw
13885,15254,16371,1991,France,Albania,5,0,UEFA Euro qualification,Paris,France,False,5,5,France
13886,15255,16372,1991,Algeria,Morocco,2,2,Friendly,Annaba,Algeria,False,4,0,Draw
13887,15256,16373,1991,Cyprus,Hungary,0,2,UEFA Euro qualification,Limassol,Cyprus,False,2,-2,Hungary
13888,15257,16374,1991,Switzerland,Romania,0,0,UEFA Euro qualification,Neuchâtel,Switzerland,False,0,0,Draw
13889,15258,16375,1991,Mali,Burkina Faso,5,1,Friendly,Bamako,Mali,False,6,4,Mali
13890,15259,16376,1991,Sudan,Uganda,1,1,Friendly,Khartoum,Sudan,False,2,0,Draw
13891,15260,16377,1991,Tunisia,Algeria,0,0,Friendly,Tunis,Tunisia,False,0,0,Draw
13892,15261,16378,1991,Denmark,Bulgaria,1,1,Friendly,Odense,Denmark,False,2,0,Draw
13893,15262,16379,1991,Mexico,Chile,1,0,Friendly,Veracruz,Mexico,False,1,1,Mexico
13894,15263,16380,1991,Mauritania,Morocco,0,2,African Cup of Nations qualification,Nouakchott,Mauritania,False,2,-2,Morocco
13895,15264,16381,1991,Nigeria,Ghana,0,0,African Cup of Nations qualification,Lagos,Nigeria,False,0,0,Draw
13896,15265,16382,1991,Angola,Zambia,1,2,African Cup of Nations qualification,Luanda,Angola,False,3,-1,Zambia
13897,15266,16383,1991,DR Congo,Gabon,2,1,African Cup of Nations qualification,Kinshasa,Zaïre,False,3,1,DR Congo
13898,15267,16384,1991,Guinea,Cameroon,0,0,African Cup of Nations qualification,Conakry,Guinea,False,0,0,Draw
13899,15268,16385,1991,Mali,Sierra Leone,0,0,African Cup of Nations qualification,Bamako,Mali,False,0,0,Draw
13900,15269,16386,1991,Nicaragua,El Salvador,2,3,UNCAF Cup,Managua,Nicaragua,False,5,-1,El Salvador
13901,15270,16387,1991,Sudan,Kenya,1,0,African Cup of Nations qualification,Khartoum,Sudan,False,1,1,Sudan
13902,15271,16388,1991,Eswatini,Madagascar,0,1,African Cup of Nations qualification,Mbabane,Eswatini,False,1,-1,Madagascar
13903,15272,16389,1991,Tunisia,Egypt,2,2,African Cup of Nations qualification,Tunis,Tunisia,False,4,0,Draw
13904,15273,16390,1991,Uganda,Tanzania,3,2,African Cup of Nations qualification,Kampala,Uganda,False,5,1,Uganda
13905,15274,16391,1991,Zimbabwe,Malawi,4,0,African Cup of Nations qualification,Harare,Zimbabwe,False,4,4,Zimbabwe
13906,15275,16392,1991,Austria,Norway,0,0,Friendly,Vienna,Austria,False,0,0,Draw
13907,15276,16393,1991,Congo,Benin,1,2,Friendly,Brazzaville,Congo,False,3,-1,Benin
13908,15277,16394,1991,Costa Rica,Mexico,0,0,Friendly,San José,Costa Rica,False,0,0,Draw
13909,15278,16395,1991,Greece,Sweden,2,2,Friendly,Athens,Greece,False,4,0,Draw
13910,15279,16396,1991,Hungary,Russia,0,1,UEFA Euro qualification,Budapest,Hungary,False,1,-1,Russia
13911,15280,16397,1991,Netherlands,Finland,2,0,UEFA Euro qualification,Rotterdam,Netherlands,False,2,2,Netherlands
13912,15281,16398,1991,Poland,Turkey,3,0,UEFA Euro qualification,Warsaw,Poland,False,3,3,Poland
13913,15282,16399,1991,Spain,Romania,0,2,Friendly,Cáceres,Spain,False,2,-2,Romania
13914,15283,16400,1991,Togo,Burkina Faso,1,0,African Cup of Nations qualification,Lomé,Togo,False,1,1,Togo
13915,15284,16401,1991,Nigeria,Benin,3,0,African Cup of Nations qualification,Lagos,Nigeria,False,3,3,Nigeria
13916,15285,16402,1991,Tanzania,DR Congo,1,0,African Cup of Nations qualification,Dar es Salaam,Tanzania,False,1,1,Tanzania
13917,15286,16403,1991,Chad,Tunisia,0,0,African Cup of Nations qualification,N'Djamena,Chad,False,0,0,Draw
13918,15287,16404,1991,Congo,Malawi,2,1,African Cup of Nations qualification,Brazzaville,Congo,False,3,1,Congo
13919,15288,16405,1991,Mali,Cameroon,0,2,African Cup of Nations qualification,Bamako,Mali,False,2,-2,Cameroon
13920,15289,16406,1991,Mozambique,Sudan,1,0,African Cup of Nations qualification,Maputo,Mozambique,False,1,1,Mozambique
13921,15290,16407,1991,Sierra Leone,Guinea,0,1,African Cup of Nations qualification,Freetown,Sierra Leone,False,1,-1,Guinea
13922,15291,16408,1991,Eswatini,Zambia,2,1,African Cup of Nations qualification,Mbabane,Eswatini,False,3,1,Eswatini
13923,15292,16409,1991,Ghana,Togo,2,0,African Cup of Nations qualification,Accra,Ghana,False,2,2,Ghana
13924,15293,16410,1991,Ivory Coast,Niger,1,0,African Cup of Nations qualification,Abidjan,Ivory Coast,False,1,1,Ivory Coast
13925,15295,16412,1991,Bulgaria,Switzerland,2,3,UEFA Euro qualification,Sofia,Bulgaria,False,5,-1,Switzerland
13926,15296,16413,1991,Germany,Belgium,1,0,UEFA Euro qualification,Hanover,Germany,False,1,1,Germany
13927,15297,16414,1991,Republic of Ireland,Poland,0,0,UEFA Euro qualification,Dublin,Republic of Ireland,False,0,0,Draw
13928,15298,16415,1991,Italy,Hungary,3,1,UEFA Euro qualification,Salerno,Italy,False,4,2,Italy
13929,15299,16416,1991,Northern Ireland,Faroe Islands,1,1,UEFA Euro qualification,Belfast,Northern Ireland,False,2,0,Draw
13930,15300,16417,1991,Norway,Cyprus,3,0,UEFA Euro qualification,Oslo,Norway,False,3,3,Norway
13931,15301,16418,1991,San Marino,Scotland,0,2,UEFA Euro qualification,Serravalle,San Marino,False,2,-2,Scotland
13932,15302,16419,1991,Sweden,Austria,6,0,Friendly,Solna,Sweden,False,6,6,Sweden
13933,15303,16420,1991,Turkey,England,0,1,UEFA Euro qualification,Izmir,Turkey,False,1,-1,England
13934,15304,16421,1991,Wales,Iceland,1,0,Friendly,Cardiff,Wales,False,1,1,Wales
13935,15305,16423,1991,Jamaica,Haiti,2,1,Friendly,Kingston,Jamaica,False,3,1,Jamaica
13936,15306,16424,1991,Senegal,Ivory Coast,0,0,Friendly,Dakar,Senegal,False,0,0,Draw
13937,15307,16425,1991,United States,Uruguay,1,0,Friendly,Denver,United States,False,1,1,United States
13938,15308,16426,1991,Jamaica,Haiti,2,0,Friendly,Savanna-la-Mar,Jamaica,False,2,2,Jamaica
13939,15309,16427,1991,Malta,Iceland,1,4,Friendly,Attard,Malta,False,5,-3,Iceland
13940,15310,16428,1991,Mexico,Uruguay,0,2,Friendly,Los Angeles,United States,True,2,-2,Uruguay
13941,15311,16429,1991,Aruba,Suriname,0,1,CFU Caribbean Cup qualification,Georgetown,Guyana,True,1,-1,Suriname
13942,15312,16430,1991,Martinique,DR Congo,0,0,Friendly,Paris,France,True,0,0,Draw
13943,15314,16432,1991,Guyana,Aruba,4,1,CFU Caribbean Cup qualification,Georgetown,Guyana,False,5,3,Guyana
13944,15315,16433,1991,Puerto Rico,Haiti,2,3,CFU Caribbean Cup qualification,San Juan,Puerto Rico,False,5,-1,Haiti
13945,15316,16434,1991,Saint Lucia,Montserrat,3,0,CFU Caribbean Cup qualification,Castries,Saint Lucia,False,3,3,Saint Lucia
13946,15317,16435,1991,Dominican Republic,Haiti,1,1,CFU Caribbean Cup qualification,San Juan,Puerto Rico,True,2,0,Draw
13947,15318,16436,1991,Guyana,Suriname,1,1,CFU Caribbean Cup qualification,Georgetown,Guyana,False,2,0,Draw
13948,15319,16437,1991,New Zealand,Australia,0,1,Friendly,Christchurch,New Zealand,False,1,-1,Australia
13949,15320,16438,1991,Panama,Honduras,2,0,UNCAF Cup,Panama City,Panama,False,2,2,Panama
13950,15321,16439,1991,Saint Kitts and Nevis,Cayman Islands,1,1,CFU Caribbean Cup qualification,Basseterre,Saint Kitts and Nevis,False,2,0,Draw
13951,15322,16440,1991,Anguilla,Montserrat,1,1,CFU Caribbean Cup qualification,Castries,Saint Lucia,True,2,0,Draw
13952,15323,16441,1991,Hong Kong,Malaysia,2,0,Friendly,Victoria,Hong Kong,False,2,2,Hong Kong
13953,15324,16442,1991,Puerto Rico,Dominican Republic,1,3,CFU Caribbean Cup qualification,San Juan,Puerto Rico,False,4,-2,Dominican Republic
13954,15326,16444,1991,Australia,New Zealand,2,1,Friendly,Adelaide,Australia,False,3,1,Australia
13955,15327,16445,1991,Martinique,French Guiana,1,2,CFU Caribbean Cup qualification,Fort-de-France,Martinique,False,3,-1,French Guiana
13956,15328,16446,1991,Finland,Malta,2,0,UEFA Euro qualification,Helsinki,Finland,False,2,2,Finland
13957,15329,16447,1991,Saint Lucia,Anguilla,6,0,CFU Caribbean Cup qualification,Castries,Saint Lucia,False,6,6,Saint Lucia
13958,15330,16449,1991,Guadeloupe,French Guiana,1,0,CFU Caribbean Cup qualification,Fort-de-France,Martinique,True,1,1,Guadeloupe
13959,15331,16450,1991,Honduras,Panama,3,0,UNCAF Cup,San Pedro Sula,Honduras,False,3,3,Honduras
13960,15332,16451,1991,Martinique,Guadeloupe,3,1,CFU Caribbean Cup qualification,Fort-de-France,Martinique,False,4,2,Martinique
13961,15333,16452,1991,United States,Argentina,0,1,Friendly,Palo Alto,United States,False,1,-1,Argentina
13962,15334,16453,1991,England,Russia,3,1,Friendly,London,England,False,4,2,England
13963,15335,16454,1991,Guyana,Haiti,1,1,Friendly,Georgetown,Guyana,False,2,0,Draw
13964,15336,16455,1991,Austria,Faroe Islands,3,0,UEFA Euro qualification,Salzburg,Austria,False,3,3,Austria
13965,15337,16456,1991,Republic of Ireland,Chile,1,1,Friendly,Dublin,Republic of Ireland,False,2,0,Draw
13966,15338,16457,1991,San Marino,Bulgaria,0,3,UEFA Euro qualification,Serravalle,San Marino,False,3,-3,Bulgaria
13967,15339,16458,1991,Argentina,Russia,1,1,Friendly,Manchester,England,True,2,0,Draw
13968,15340,16459,1991,Dominican Republic,Trinidad and Tobago,0,7,CFU Caribbean Cup,Kingston,Jamaica,True,7,-7,Trinidad and Tobago
13969,15341,16460,1991,Norway,Romania,1,0,Friendly,Oslo,Norway,False,1,1,Norway
13970,15342,16461,1991,Saint Lucia,Martinique,0,0,CFU Caribbean Cup,Kingston,Jamaica,True,0,0,Draw
13971,15343,16462,1991,Jamaica,Guyana,6,0,CFU Caribbean Cup,Kingston,Jamaica,False,6,6,Jamaica
13972,15344,16463,1991,Dominican Republic,Saint Lucia,0,0,CFU Caribbean Cup,Kingston,Jamaica,True,0,0,Draw
13973,15345,16464,1991,England,Argentina,2,2,Friendly,London,England,False,4,0,Draw
13974,15346,16465,1991,Martinique,Trinidad and Tobago,0,1,CFU Caribbean Cup,Kingston,Jamaica,True,1,-1,Trinidad and Tobago
13975,15347,16466,1991,Albania,Iceland,1,0,UEFA Euro qualification,Tirana,Albania,False,1,1,Albania
13976,15348,16467,1991,Costa Rica,Honduras,2,0,UNCAF Cup,San José,Costa Rica,False,2,2,Costa Rica
13977,15349,16468,1991,Guatemala,El Salvador,0,0,UNCAF Cup,San José,Costa Rica,True,0,0,Draw
13978,15350,16469,1991,Jamaica,Cayman Islands,3,2,CFU Caribbean Cup,Kingston,Jamaica,False,5,1,Jamaica
13979,15351,16470,1991,Dominican Republic,Martinique,1,4,CFU Caribbean Cup,Kingston,Jamaica,True,5,-3,Martinique
13980,15352,16471,1991,Saint Lucia,Trinidad and Tobago,2,1,CFU Caribbean Cup,Kingston,Jamaica,True,3,1,Saint Lucia
13981,15353,16472,1991,Brazil,Bulgaria,3,0,Friendly,Uberlândia,Brazil,False,3,3,Brazil
13982,15354,16473,1991,Cayman Islands,Guyana,1,2,CFU Caribbean Cup,Kingston,Jamaica,True,3,-1,Guyana
13983,15355,16474,1991,Costa Rica,El Salvador,7,1,UNCAF Cup,San José,Costa Rica,False,8,6,Costa Rica
13984,15356,16475,1991,Guatemala,Honduras,0,0,UNCAF Cup,San José,Costa Rica,True,0,0,Draw
13985,15357,16476,1991,Poland,Wales,0,0,Friendly,Radom,Poland,False,0,0,Draw
13986,15358,16477,1991,Russia,Cyprus,4,0,UEFA Euro qualification,Moscow,Soviet Union,False,4,4,Russia
13987,15359,16478,1991,Chile,Uruguay,2,1,Friendly,Santiago,Chile,False,3,1,Chile
13988,15360,16479,1991,Guyana,Trinidad and Tobago,1,3,CFU Caribbean Cup,Kingston,Jamaica,True,4,-2,Trinidad and Tobago
13989,15361,16480,1991,Jamaica,Saint Lucia,2,0,CFU Caribbean Cup,Kingston,Jamaica,False,2,2,Jamaica
13990,15362,16481,1991,Australia,England,0,1,Friendly,Sydney,Australia,False,1,-1,England
13991,15363,16482,1991,United States,Republic of Ireland,1,1,Friendly,Foxborough,United States,False,2,0,Draw
13992,15364,16483,1991,Costa Rica,Guatemala,1,0,UNCAF Cup,San José,Costa Rica,False,1,1,Costa Rica
13993,15365,16484,1991,Guyana,Saint Lucia,1,4,CFU Caribbean Cup,Kingston,Jamaica,True,5,-3,Saint Lucia
13994,15366,16485,1991,Honduras,El Salvador,2,1,UNCAF Cup,San José,Costa Rica,True,3,1,Honduras
13995,15367,16486,1991,Jamaica,Trinidad and Tobago,2,0,CFU Caribbean Cup,Kingston,Jamaica,False,2,2,Jamaica
13996,15368,16487,1991,Japan,Thailand,1,0,Kirin Cup,Tendo,Japan,False,1,1,Japan
13997,15369,16488,1991,New Zealand,England,0,1,Friendly,Auckland,New Zealand,False,1,-1,England
13998,15370,16489,1991,Denmark,Austria,2,1,UEFA Euro qualification,Odense,Denmark,False,3,1,Denmark
13999,15371,16490,1991,Finland,Netherlands,1,1,UEFA Euro qualification,Helsinki,Finland,False,2,0,Draw
14000,15373,16492,1991,Norway,Italy,2,1,UEFA Euro qualification,Oslo,Norway,False,3,1,Norway
14001,15374,16493,1991,Sweden,Colombia,2,2,Friendly,Solna,Sweden,False,4,0,Draw
14002,15375,16494,1991,Switzerland,San Marino,7,0,UEFA Euro qualification,St. Gallen,Switzerland,False,7,7,Switzerland
14003,15376,16495,1991,Wales,Germany,1,0,UEFA Euro qualification,Cardiff,Wales,False,1,1,Wales
14004,15377,16496,1991,Peru,Ecuador,0,1,Friendly,Lima,Peru,False,1,-1,Ecuador
14005,15378,16497,1991,Indonesia,Malta,0,3,Korea Cup,Seoul,South Korea,True,3,-3,Malta
14006,15379,16499,1991,New Zealand,England,0,2,Friendly,Wellington,New Zealand,False,2,-2,England
14007,15380,16500,1991,Egypt,Malta,5,2,Korea Cup,Daejeon,South Korea,True,7,3,Egypt
14008,15381,16501,1991,Ivory Coast,Senegal,2,0,Friendly,Abidjan,Ivory Coast,False,2,2,Ivory Coast
14009,15382,16503,1991,Egypt,Indonesia,6,0,Korea Cup,Seoul,South Korea,True,6,6,Egypt
14010,15383,16505,1991,Denmark,Italy,0,2,Friendly,Malmö,Sweden,True,2,-2,Italy
14011,15384,16506,1991,Malaysia,England,2,4,Friendly,Kuala Lumpur,Malaysia,False,6,-2,England
14012,15385,16507,1991,Peru,Uruguay,1,0,Friendly,Lima,Peru,False,1,1,Peru
14013,15386,16508,1991,Sweden,Russia,2,3,Friendly,Gothenburg,Sweden,False,5,-1,Russia
14014,15387,16509,1991,Bolivia,Paraguay,0,1,Copa Paz del Chaco,Santa Cruz,Bolivia,False,1,-1,Paraguay
14015,15388,16511,1991,Sweden,Denmark,4,0,Friendly,Norrköping,Sweden,False,4,4,Sweden
14016,15389,16512,1991,Italy,Russia,1,1,Friendly,Solna,Sweden,True,2,0,Draw
14017,15390,16514,1991,Paraguay,Bolivia,0,0,Copa Paz del Chaco,Asunción,Paraguay,False,0,0,Draw
14018,15391,16515,1991,Ecuador,Chile,2,1,Friendly,Guayaquil,Ecuador,False,3,1,Ecuador
14019,15392,16516,1991,Slovenia,Croatia,0,1,Friendly,Murska Sobota,Slovenia,False,1,-1,Croatia
14020,15393,16517,1991,Mozambique,Botswana,2,0,Friendly,Maputo,Mozambique,False,2,2,Mozambique
14021,15394,16518,1991,Uruguay,Peru,0,0,Friendly,Montevideo,Uruguay,False,0,0,Draw
14022,15395,16519,1991,Mozambique,Eswatini,2,1,Friendly,Maputo,Mozambique,False,3,1,Mozambique
14023,15396,16520,1991,Philippines,Brunei,2,1,Friendly,Manila,Philippines,False,3,1,Philippines
14024,15398,16522,1991,Jersey,Greenland,4,3,Island Games,Åland,Finland,True,7,1,Jersey
14025,15400,16525,1991,Costa Rica,Colombia,0,1,Friendly,San José,Costa Rica,False,1,-1,Colombia
14026,15401,16526,1991,Ecuador,Peru,2,2,Friendly,Guayaquil,Ecuador,False,4,0,Draw
14027,15402,16527,1991,Mozambique,Botswana,1,1,Friendly,Maputo,Mozambique,False,2,0,Draw
14028,15403,16528,1991,Faroe Islands,Greenland,3,2,Island Games,Åland,Finland,True,5,1,Faroe Islands
14029,15405,16530,1991,Åland Islands,Guernsey,2,0,Island Games,Åland,Finland,False,2,2,Åland Islands
14030,15406,16532,1991,Uruguay,Chile,2,1,Friendly,Montevideo,Uruguay,False,3,1,Uruguay
14031,15407,16533,1991,Faroe Islands,Jersey,5,3,Island Games,Åland,Finland,True,8,2,Faroe Islands
14032,15409,16537,1991,Brazil,Argentina,1,1,Friendly,Curitiba,Brazil,False,2,0,Draw
14033,15410,16538,1991,Canada,Honduras,2,4,Gold Cup,Los Angeles,United States,True,6,-2,Honduras
14034,15411,16539,1991,Gambia,Ghana,2,3,Friendly,Lagos,Nigeria,True,5,-1,Ghana
14035,15412,16540,1991,Mexico,Jamaica,4,1,Gold Cup,Los Angeles,United States,True,5,3,Mexico
14036,15413,16543,1991,Åland Islands,Jersey,0,2,Island Games,Åland,Finland,False,2,-2,Jersey
14037,15414,16544,1991,Costa Rica,Guatemala,2,0,Gold Cup,Pasadena,United States,True,2,2,Costa Rica
14038,15415,16545,1991,United States,Trinidad and Tobago,2,1,Gold Cup,Pasadena,United States,False,3,1,United States
14039,15417,16547,1991,Canada,Mexico,1,3,Gold Cup,Los Angeles,United States,True,4,-2,Mexico
14040,15418,16548,1991,Chile,Ecuador,3,1,Friendly,Santiago,Chile,False,4,2,Chile
14041,15419,16549,1991,Jamaica,Honduras,0,5,Gold Cup,Los Angeles,United States,True,5,-5,Honduras
14042,15420,16550,1991,Trinidad and Tobago,Costa Rica,2,1,Gold Cup,Pasadena,United States,True,3,1,Trinidad and Tobago
14043,15421,16551,1991,United States,Guatemala,3,0,Gold Cup,Pasadena,United States,False,3,3,United States
14044,15422,16552,1991,Moldova,Georgia,2,4,Friendly,Chişinău,Moldova,False,6,-2,Georgia
14045,15423,16553,1991,Jamaica,Canada,2,3,Gold Cup,Los Angeles,United States,True,5,-1,Canada
14046,15424,16554,1991,Mexico,Honduras,1,1,Gold Cup,Los Angeles,United States,True,2,0,Draw
14047,15425,16555,1991,Trinidad and Tobago,Guatemala,0,1,Gold Cup,Los Angeles,United States,True,1,-1,Guatemala
14048,15426,16556,1991,United States,Costa Rica,3,2,Gold Cup,Los Angeles,United States,False,5,1,United States
14049,15427,16557,1991,Honduras,Costa Rica,2,0,Gold Cup,Los Angeles,United States,True,2,2,Honduras
14050,15428,16558,1991,United States,Mexico,2,0,Gold Cup,Los Angeles,United States,False,2,2,United States
14051,15429,16559,1991,Chile,Venezuela,2,0,Copa América,Santiago,Chile,False,2,2,Chile
14052,15430,16560,1991,Malawi,Kenya,0,2,Friendly,Blantyre,Malawi,False,2,-2,Kenya
14053,15431,16561,1991,Paraguay,Peru,1,0,Copa América,Santiago,Chile,True,1,1,Paraguay
14054,15432,16562,1991,Bolivia,Uruguay,1,1,Copa América,Valparaíso,Chile,True,2,0,Draw
14055,15433,16563,1991,Colombia,Ecuador,1,0,Copa América,Valparaíso,Chile,True,1,1,Colombia
14056,15434,16564,1991,Gabon,Ghana,0,1,Friendly,Libreville,Gabon,False,1,-1,Ghana
14057,15435,16565,1991,Mexico,Costa Rica,2,0,Gold Cup,Los Angeles,United States,True,2,2,Mexico
14058,15436,16566,1991,United States,Honduras,0,0,Gold Cup,Los Angeles,United States,False,0,0,Draw
14059,15437,16567,1991,Argentina,Venezuela,3,0,Copa América,Santiago,Chile,True,3,3,Argentina
14060,15438,16568,1991,Chile,Peru,4,2,Copa América,Concepción,Chile,False,6,2,Chile
14061,15439,16569,1991,Malawi,Kenya,1,1,Friendly,Lilongwe,Malawi,False,2,0,Draw
14062,15440,16570,1991,Bolivia,Brazil,1,2,Copa América,Viña del Mar,Chile,True,3,-1,Brazil
14063,15441,16571,1991,Congo,DR Congo,0,0,Friendly,Brazzaville,Congo,False,0,0,Draw
14064,15442,16572,1991,Ecuador,Uruguay,1,1,Copa América,Viña del Mar,Chile,True,2,0,Draw
14065,15443,16573,1991,Chile,Argentina,0,1,Copa América,Santiago,Chile,False,1,-1,Argentina
14066,15444,16574,1991,Malawi,Kenya,1,1,Friendly,Mzuzu,Malawi,False,2,0,Draw
14067,15445,16575,1991,Paraguay,Venezuela,5,0,Copa América,Santiago,Chile,True,5,5,Paraguay
14068,15446,16576,1991,Bolivia,Colombia,0,0,Copa América,Viña del Mar,Chile,True,0,0,Draw
14069,15447,16577,1991,Brazil,Uruguay,1,1,Copa América,Viña del Mar,Chile,True,2,0,Draw
14070,15448,16578,1991,Argentina,Paraguay,4,1,Copa América,Concepción,Chile,True,5,3,Argentina
14071,15449,16579,1991,Egypt,Chad,5,1,African Cup of Nations qualification,Cairo,Egypt,False,6,4,Egypt
14072,15450,16580,1991,Peru,Venezuela,5,1,Copa América,Santiago,Chile,True,6,4,Peru
14073,15451,16581,1991,Bolivia,Ecuador,0,4,Copa América,Viña del Mar,Chile,True,4,-4,Ecuador
14074,15452,16582,1991,Brazil,Colombia,0,2,Copa América,Viña del Mar,Chile,True,2,-2,Colombia
14075,15453,16583,1991,Argentina,Peru,3,2,Copa América,Santiago,Chile,True,5,1,Argentina
14076,15454,16584,1991,Cameroon,Sierra Leone,1,0,African Cup of Nations qualification,Yaoundé,Cameroon,False,1,1,Cameroon
14077,15455,16585,1991,Chile,Paraguay,4,0,Copa América,Santiago,Chile,False,4,4,Chile
14078,15456,16586,1991,DR Congo,Uganda,1,0,African Cup of Nations qualification,Kinshasa,Zaïre,False,1,1,DR Congo
14079,15457,16587,1991,Gabon,Tanzania,1,0,African Cup of Nations qualification,Libreville,Gabon,False,1,1,Gabon
14080,15458,16588,1991,Guinea,Mali,2,1,African Cup of Nations qualification,Conakry,Guinea,False,3,1,Guinea
14081,15459,16589,1991,Kenya,Mozambique,1,0,African Cup of Nations qualification,Nairobi,Kenya,False,1,1,Kenya
14082,15460,16590,1991,Togo,Benin,2,0,African Cup of Nations qualification,Lomé,Togo,False,2,2,Togo
14083,15461,16591,1991,Zambia,Madagascar,2,1,African Cup of Nations qualification,Lusaka,Zambia,False,3,1,Zambia
14084,15462,16592,1991,Zimbabwe,Congo,2,2,African Cup of Nations qualification,Harare,Zimbabwe,False,4,0,Draw
14085,15463,16593,1991,Brazil,Ecuador,3,1,Copa América,Viña del Mar,Chile,True,4,2,Brazil
14086,15464,16594,1991,Colombia,Uruguay,0,1,Copa América,Viña del Mar,Chile,True,1,-1,Uruguay
14087,15465,16595,1991,Faroe Islands,Turkey,1,1,Friendly,Tórshavn,Faroe Islands,False,2,0,Draw
14088,15466,16596,1991,Argentina,Brazil,3,2,Copa América,Santiago,Chile,True,5,1,Argentina
14089,15467,16597,1991,Chile,Colombia,1,1,Copa América,Santiago,Chile,False,2,0,Draw
14090,15468,16598,1991,Iceland,Turkey,5,1,Friendly,Reykjavík,Iceland,False,6,4,Iceland
14091,15469,16599,1991,Brazil,Colombia,2,0,Copa América,Santiago,Chile,True,2,2,Brazil
14092,15470,16600,1991,Chile,Argentina,0,0,Copa América,Santiago,Chile,False,0,0,Draw
14093,15471,16601,1991,Argentina,Colombia,2,1,Copa América,Santiago,Chile,True,3,1,Argentina
14094,15472,16602,1991,Chile,Brazil,0,2,Copa América,Santiago,Chile,False,2,-2,Brazil
14095,15473,16603,1991,Ivory Coast,Guinea,0,0,Friendly,Abidjan,Ivory Coast,False,0,0,Draw
14096,15474,16604,1991,Egypt,Tunisia,2,2,African Cup of Nations qualification,Cairo,Egypt,False,4,0,Draw
14097,15475,16605,1991,Mauritania,Niger,0,1,African Cup of Nations qualification,Nouakchott,Mauritania,False,1,-1,Niger
14098,15477,16607,1991,Malawi,Zimbabwe,2,2,African Cup of Nations qualification,Zomba,Malawi,False,4,0,Draw
14099,15478,16608,1991,Nigeria,Burkina Faso,7,1,African Cup of Nations qualification,Lagos,Nigeria,False,8,6,Nigeria
14100,15479,16609,1991,Benin,Ghana,0,0,African Cup of Nations qualification,Cotonou,Benin,False,0,0,Draw
14101,15480,16610,1991,Cameroon,Guinea,1,0,African Cup of Nations qualification,Yaoundé,Cameroon,False,1,1,Cameroon
14102,15481,16611,1991,Gabon,DR Congo,0,0,African Cup of Nations qualification,Libreville,Gabon,False,0,0,Draw
14103,15482,16612,1991,Ivory Coast,Morocco,2,0,African Cup of Nations qualification,Abidjan,Ivory Coast,False,2,2,Ivory Coast
14104,15483,16613,1991,Sierra Leone,Mali,2,0,African Cup of Nations qualification,Freetown,Sierra Leone,False,2,2,Sierra Leone
14105,15484,16615,1991,Norway,Sweden,1,2,Friendly,Oslo,Norway,False,3,-1,Sweden
14106,15485,16616,1991,Benin,Ivory Coast,0,3,Friendly,Cotonou,Benin,False,3,-3,Ivory Coast
14107,15486,16617,1991,Poland,France,1,5,Friendly,Poznań,Poland,False,6,-4,France
14108,15487,16618,1991,Malawi,Mozambique,1,0,Friendly,Sucoma,Malawi,False,1,1,Malawi
14109,15488,16619,1991,Malawi,Mozambique,2,0,Friendly,Blantyre,Malawi,False,2,2,Malawi
14110,15489,16620,1991,Bulgaria,Turkey,0,0,Friendly,Stara Zagora,Bulgaria,False,0,0,Draw
14111,15490,16622,1991,Poland,Sweden,2,0,Friendly,Gdynia,Poland,False,2,2,Poland
14112,15491,16623,1991,Norway,Russia,0,1,UEFA Euro qualification,Oslo,Norway,False,1,-1,Russia
14113,15492,16624,1991,Romania,United States,0,2,Friendly,Braşov,Romania,False,2,-2,United States
14114,15493,16625,1991,Ivory Coast,Benin,1,0,Friendly,Abidjan,Ivory Coast,False,1,1,Ivory Coast
14115,15494,16627,1991,Greece,Albania,0,2,Friendly,Athens,Greece,False,2,-2,Albania
14116,15495,16628,1991,Iceland,Denmark,0,0,Friendly,Reykjavík,Iceland,False,0,0,Draw
14117,15496,16629,1991,Portugal,Austria,1,1,Friendly,Porto,Portugal,False,2,0,Draw
14118,15497,16630,1991,Spain,Uruguay,2,1,Friendly,Oviedo,Spain,False,3,1,Spain
14119,15499,16632,1991,Turkey,United States,1,1,Friendly,Istanbul,Turkey,False,2,0,Draw
14120,15500,16633,1991,Mali,Guinea,0,0,Friendly,Bamako,Mali,False,0,0,Draw
14121,15502,16635,1991,Papua New Guinea,Solomon Islands,0,0,South Pacific Games,Lae,Papua New Guinea,False,0,0,Draw
14122,15503,16636,1991,Fiji,New Caledonia,3,1,South Pacific Games,Lae,Papua New Guinea,True,4,2,Fiji
14123,15505,16638,1991,England,Germany,0,1,Friendly,London,England,False,1,-1,Germany
14124,15506,16639,1991,Faroe Islands,Northern Ireland,0,5,UEFA Euro qualification,Landskrona,Sweden,True,5,-5,Northern Ireland
14125,15507,16640,1991,Hungary,Republic of Ireland,1,2,Friendly,Győr,Hungary,False,3,-1,Republic of Ireland
14126,15508,16641,1991,Luxembourg,Belgium,0,2,UEFA Euro qualification,Luxembourg,Luxembourg,False,2,-2,Belgium
14127,15509,16642,1991,Netherlands,Poland,1,1,Friendly,Eindhoven,Netherlands,False,2,0,Draw
14128,15511,16644,1991,Portugal,Finland,1,0,UEFA Euro qualification,Porto,Portugal,False,1,1,Portugal
14129,15513,16646,1991,Switzerland,Scotland,2,2,UEFA Euro qualification,Berne,Switzerland,False,4,0,Draw
14130,15514,16647,1991,Wales,Brazil,1,0,Friendly,Cardiff,Wales,False,1,1,Wales
14131,15515,16648,1991,Bermuda,Jamaica,1,1,Friendly,Hamilton,Bermuda,False,2,0,Draw
14132,15516,16649,1991,Fiji,Guam,14,1,South Pacific Games,Lae,Papua New Guinea,True,15,13,Fiji
14133,15517,16650,1991,Papua New Guinea,Vanuatu,0,1,South Pacific Games,Lae,Papua New Guinea,False,1,-1,Vanuatu
14134,15519,16652,1991,Solomon Islands,Vanuatu,3,0,South Pacific Games,Lae,Papua New Guinea,True,3,3,Solomon Islands
14135,15520,16653,1991,United States,Jamaica,1,0,Friendly,High Point,United States,False,1,1,United States
14136,15521,16654,1991,Guam,New Caledonia,0,18,South Pacific Games,Lae,Papua New Guinea,True,18,-18,New Caledonia
14137,15523,16656,1991,Fiji,Vanuatu,3,1,South Pacific Games,Lae,Papua New Guinea,True,4,2,Fiji
14138,15524,16657,1991,New Caledonia,Solomon Islands,1,4,South Pacific Games,Lae,Papua New Guinea,True,5,-3,Solomon Islands
14139,15525,16660,1991,Fiji,Solomon Islands,1,1,South Pacific Games,Lae,Papua New Guinea,True,2,0,Draw
14140,15526,16661,1991,New Caledonia,Vanuatu,3,1,South Pacific Games,Lae,Papua New Guinea,True,4,2,New Caledonia
14141,15527,16662,1991,Botswana,Eswatini,2,1,Friendly,Gaborone,Botswana,False,3,1,Botswana
14142,15528,16663,1991,Egypt,Nigeria,1,2,Friendly,Ismailia,Egypt,False,3,-1,Nigeria
14143,15529,16664,1991,Uganda,Zimbabwe,1,2,Friendly,Ismailia,Egypt,True,3,-1,Zimbabwe
14144,15530,16665,1991,Cameroon,Mali,1,0,Friendly,Alexandria,Egypt,True,1,1,Cameroon
14145,15531,16666,1991,Mauritius,Tunisia,0,3,Friendly,Alexandria,Egypt,True,3,-3,Tunisia
14146,15532,16667,1991,Egypt,Zimbabwe,2,3,Friendly,Ismailia,Egypt,False,5,-1,Zimbabwe
14147,15533,16668,1991,Nigeria,Uganda,8,1,Friendly,Ismailia,Egypt,True,9,7,Nigeria
14148,15534,16669,1991,Cameroon,Tunisia,0,1,Friendly,Alexandria,Egypt,True,1,-1,Tunisia
14149,15535,16670,1991,Mali,Mauritius,5,0,Friendly,Alexandria,Egypt,True,5,5,Mali
14150,15536,16671,1991,Bulgaria,Italy,2,1,Friendly,Sofia,Bulgaria,False,3,1,Bulgaria
14151,15537,16672,1991,Egypt,Uganda,1,0,Friendly,Ismailia,Egypt,False,1,1,Egypt
14152,15538,16673,1991,Faroe Islands,Denmark,0,4,UEFA Euro qualification,Landskrona,Sweden,True,4,-4,Denmark
14153,15539,16674,1991,Iceland,Spain,2,0,UEFA Euro qualification,Reykjavík,Iceland,False,2,2,Iceland
14154,15540,16675,1991,Nigeria,Zimbabwe,1,0,Friendly,Ismailia,Egypt,True,1,1,Nigeria
14155,15542,16677,1991,Russia,Hungary,2,2,UEFA Euro qualification,Moscow,Soviet Union,False,4,0,Draw
14156,15543,16678,1991,Cameroon,Mauritius,1,0,Friendly,Alexandria,Egypt,True,1,1,Cameroon
14157,15544,16679,1991,Mali,Tunisia,0,0,Friendly,Alexandria,Egypt,True,0,0,Draw
14158,15545,16680,1991,Cameroon,Nigeria,1,0,Friendly,Ismailia,Egypt,True,1,1,Cameroon
14159,15546,16681,1991,Egypt,Mali,0,0,Friendly,Ismailia,Egypt,False,0,0,Draw
14160,15547,16682,1991,Mauritius,Uganda,3,0,Friendly,Alexandria,Egypt,True,3,3,Mauritius
14161,15548,16683,1991,Tunisia,Zimbabwe,3,1,Friendly,Alexandria,Egypt,True,4,2,Tunisia
14162,15549,16684,1991,Botswana,Ghana,0,0,Friendly,Gaborone,Botswana,False,0,0,Draw
14163,15550,16685,1991,Cameroon,Tunisia,1,0,Friendly,Cairo,Egypt,True,1,1,Cameroon
14164,15551,16686,1991,Nigeria,Zimbabwe,3,0,Friendly,Cairo,Egypt,True,3,3,Nigeria
14165,15552,16687,1991,Singapore,Indonesia,2,0,Friendly,Singapore,Singapore,False,2,2,Singapore
14166,15553,16688,1991,Austria,Denmark,0,3,UEFA Euro qualification,Vienna,Austria,False,3,-3,Denmark
14167,15554,16689,1991,Finland,Greece,1,1,UEFA Euro qualification,Helsinki,Finland,False,2,0,Draw
14168,15555,16690,1991,Hungary,Belgium,0,2,Friendly,Székesfehérvár,Hungary,False,2,-2,Belgium
14169,15556,16691,1991,Switzerland,Sweden,3,1,Friendly,Lucerne,Switzerland,False,4,2,Switzerland
14170,15557,16692,1991,Luxembourg,Portugal,1,1,Friendly,Luxembourg,Luxembourg,False,2,0,Draw
14171,15558,16693,1991,Russia,Italy,0,0,UEFA Euro qualification,Moscow,Soviet Union,False,0,0,Draw
14172,15559,16694,1991,Spain,France,1,2,UEFA Euro qualification,Seville,Spain,False,3,-1,France
14173,15560,16695,1991,Algeria,Iran,1,0,Friendly,Algiers,Algeria,False,1,1,Algeria
14174,15561,16696,1991,Bulgaria,San Marino,4,0,UEFA Euro qualification,Sofia,Bulgaria,False,4,4,Bulgaria
14175,15562,16697,1991,Cyprus,Iceland,1,1,Friendly,Larnaca,Cyprus,False,2,0,Draw
14176,15563,16699,1991,England,Turkey,1,0,UEFA Euro qualification,London,England,False,1,1,England
14177,15565,16701,1991,Germany,Wales,4,1,UEFA Euro qualification,Nuremberg,Germany,False,5,3,Germany
14178,15566,16702,1991,Netherlands,Portugal,1,0,UEFA Euro qualification,Rotterdam,Netherlands,False,1,1,Netherlands
14179,15567,16703,1991,Northern Ireland,Austria,2,1,UEFA Euro qualification,Belfast,Northern Ireland,False,3,1,Northern Ireland
14180,15568,16704,1991,Poland,Republic of Ireland,3,3,UEFA Euro qualification,Poznań,Poland,False,6,0,Draw
14181,15569,16705,1991,Romania,Scotland,1,0,UEFA Euro qualification,Bucharest,Romania,False,1,1,Romania
14182,15572,16708,1991,Greece,Finland,2,0,UEFA Euro qualification,Athens,Greece,False,2,2,Greece
14183,15573,16709,1991,Hungary,Norway,0,0,UEFA Euro qualification,Szombathely,Hungary,False,0,0,Draw
14184,15574,16710,1991,Ghana,Senegal,2,3,Friendly,Abidjan,Ivory Coast,True,5,-1,Senegal
14185,15575,16711,1991,Ivory Coast,Nigeria,2,0,Friendly,Abidjan,Ivory Coast,False,2,2,Ivory Coast
14186,15576,16712,1991,Ghana,Nigeria,1,0,Friendly,Abidjan,Ivory Coast,True,1,1,Ghana
14187,15577,16713,1991,Ivory Coast,Senegal,1,0,Friendly,Abidjan,Ivory Coast,False,1,1,Ivory Coast
14188,15578,16714,1991,Tanzania,Kenya,1,1,Friendly,Dar es Salaam,Tanzania,False,2,0,Draw
14189,15580,16716,1991,Cyprus,Russia,0,3,UEFA Euro qualification,Larnaca,Cyprus,False,3,-3,Russia
14190,15581,16717,1991,Denmark,Northern Ireland,2,1,UEFA Euro qualification,Odense,Denmark,False,3,1,Denmark
14191,15582,16718,1991,Italy,Norway,1,1,UEFA Euro qualification,Genoa,Italy,False,2,0,Draw
14192,15583,16719,1991,Poland,England,1,1,UEFA Euro qualification,Poznań,Poland,False,2,0,Draw
14193,15584,16720,1991,Romania,Switzerland,1,0,UEFA Euro qualification,Bucharest,Romania,False,1,1,Romania
14194,15585,16721,1991,Scotland,San Marino,4,0,UEFA Euro qualification,Glasgow,Scotland,False,4,4,Scotland
14195,15587,16723,1991,Turkey,Republic of Ireland,1,3,UEFA Euro qualification,Istanbul,Turkey,False,4,-2,Republic of Ireland
14196,15588,16724,1991,Wales,Luxembourg,1,0,UEFA Euro qualification,Cardiff,Wales,False,1,1,Wales
14197,15589,16725,1991,Lithuania,Estonia,4,1,Baltic Cup,Klaipėda,Lithuania,False,5,3,Lithuania
14198,15590,16726,1991,Estonia,Latvia,0,2,Baltic Cup,Klaipėda,Lithuania,True,2,-2,Latvia
14199,15591,16727,1991,Tanzania,Kenya,1,2,Friendly,Dar es Salaam,Tanzania,False,3,-1,Kenya
14200,15592,16728,1991,Lithuania,Latvia,1,1,Baltic Cup,Kretinga,Lithuania,False,2,0,Draw
14201,15593,16729,1991,Belgium,Germany,0,1,UEFA Euro qualification,Brussels,Belgium,False,1,-1,Germany
14202,15594,16730,1991,Bulgaria,Romania,1,1,UEFA Euro qualification,Sofia,Bulgaria,False,2,0,Draw
14203,15595,16731,1991,France,Iceland,3,1,UEFA Euro qualification,Paris,France,False,4,2,France
14204,15596,16732,1991,Mexico,Uruguay,1,1,Friendly,Veracruz,Mexico,False,2,0,Draw
14205,15597,16733,1991,Portugal,Greece,1,0,UEFA Euro qualification,Lisbon,Portugal,False,1,1,Portugal
14206,15598,16735,1991,Gambia,Mali,1,0,Amílcar Cabral Cup,Dakar,Senegal,True,1,1,Gambia
14207,15599,16736,1991,Ivory Coast,Niger,5,2,Friendly,Abidjan,Ivory Coast,False,7,3,Ivory Coast
14208,15600,16737,1991,Kenya,Zambia,0,1,CECAFA Cup,Kampala,Uganda,True,1,-1,Zambia
14209,15601,16738,1991,Guinea,Sierra Leone,0,1,Amílcar Cabral Cup,Dakar,Senegal,True,1,-1,Sierra Leone
14210,15602,16739,1991,Senegal,Guinea-Bissau,4,0,Amílcar Cabral Cup,Dakar,Senegal,False,4,4,Senegal
14211,15603,16740,1991,Sudan,Tanzania,1,1,CECAFA Cup,Kampala,Uganda,True,2,0,Draw
14212,15604,16741,1991,United States,Costa Rica,1,1,Friendly,Dallas,United States,False,2,0,Draw
14213,15606,16743,1991,Gambia,Guinea,0,0,Amílcar Cabral Cup,Dakar,Senegal,True,0,0,Draw
14214,15607,16744,1991,Mali,Sierra Leone,1,1,Amílcar Cabral Cup,Dakar,Senegal,True,2,0,Draw
14215,15608,16745,1991,Costa Rica,Mexico,1,1,Friendly,Los Angeles,United States,True,2,0,Draw
14216,15609,16746,1991,Malta,Libya,2,0,Friendly,Attard,Malta,False,2,2,Malta
14217,15611,16748,1991,Tunisia,Ivory Coast,5,3,Friendly,Tunis,Tunisia,False,8,2,Tunisia
14218,15612,16749,1991,Uganda,Sudan,2,0,CECAFA Cup,Kampala,Uganda,False,2,2,Uganda
14219,15614,16751,1991,Gambia,Sierra Leone,0,0,Amílcar Cabral Cup,Dakar,Senegal,True,0,0,Draw
14220,15615,16752,1991,Guinea,Mali,0,2,Amílcar Cabral Cup,Dakar,Senegal,True,2,-2,Mali
14221,15616,16753,1991,Kenya,Malawi,1,0,CECAFA Cup,Kampala,Uganda,True,1,1,Kenya
14222,15618,16756,1991,Senegal,Gambia,2,0,Amílcar Cabral Cup,Dakar,Senegal,False,2,2,Senegal
14223,15619,16757,1991,Uganda,Tanzania,5,0,CECAFA Cup,Kampala,Uganda,False,5,5,Uganda
14224,15620,16758,1991,Malawi,Zambia,0,0,CECAFA Cup,Kampala,Uganda,True,0,0,Draw
14225,15622,16760,1991,Egypt,Poland,4,0,Friendly,Cairo,Egypt,False,4,4,Egypt
14226,15623,16761,1991,Greece,Netherlands,0,2,UEFA Euro qualification,Salonica,Greece,False,2,-2,Netherlands
14227,15624,16762,1991,Mexico,Hungary,3,0,Friendly,León,Mexico,False,3,3,Mexico
14228,15625,16763,1991,Morocco,Mali,3,0,Friendly,Casablanca,Morocco,False,3,3,Morocco
14229,15626,16764,1991,Uganda,Kenya,1,3,CECAFA Cup,Kampala,Uganda,False,4,-2,Kenya
14230,15627,16765,1991,Egypt,Poland,0,0,Friendly,Cairo,Egypt,False,0,0,Draw
14231,15628,16766,1991,Sudan,Zambia,2,3,CECAFA Cup,Kampala,Uganda,True,5,-1,Zambia
14232,15629,16767,1991,Kenya,Zambia,0,2,CECAFA Cup,Kampala,Uganda,True,2,-2,Zambia
14233,15630,16768,1991,Uganda,Sudan,3,1,CECAFA Cup,Kampala,Uganda,False,4,2,Uganda
14234,15631,16769,1991,El Salvador,Hungary,1,1,Friendly,San Salvador,El Salvador,False,2,0,Draw
14235,15632,16770,1991,Kuwait,Poland,0,2,Friendly,Kuwait City,Kuwait,False,2,-2,Poland
14236,15633,16771,1991,Algeria,Senegal,3,1,Friendly,Algiers,Algeria,False,4,2,Algeria
14237,15635,16773,1991,Germany,Luxembourg,4,0,UEFA Euro qualification,Leverkusen,Germany,False,4,4,Germany
14238,15636,16774,1991,Egypt,Romania,3,1,Friendly,Cairo,Egypt,False,4,2,Egypt
14239,15637,16775,1991,Italy,Cyprus,2,0,UEFA Euro qualification,Foggia,Italy,False,2,2,Italy
14240,15638,16776,1991,Malta,Greece,1,1,UEFA Euro qualification,Attard,Malta,False,2,0,Draw
14241,15639,16777,1991,Egypt,Romania,1,1,Friendly,Port Said,Egypt,False,2,0,Draw
14242,15640,16778,1991,Tunisia,Cameroon,2,2,Friendly,Tunis,Tunisia,False,4,0,Draw
14243,15641,16779,1991,Morocco,Algeria,1,1,Friendly,Casablanca,Morocco,False,2,0,Draw
14244,15642,16780,1991,Malawi,Zambia,0,2,Friendly,Blantyre,Malawi,False,2,-2,Zambia
14245,15644,16782,1992,DR Congo,Ivory Coast,2,0,Friendly,Kinshasa,Zaïre,False,2,2,DR Congo
14246,15645,16783,1992,Guyana,Barbados,0,2,Friendly,Georgetown,Guyana,False,2,-2,Barbados
14247,15646,16784,1992,Egypt,Norway,0,0,Friendly,Cairo,Egypt,False,0,0,Draw
14248,15647,16785,1992,Cameroon,Morocco,1,0,African Cup of Nations,Dakar,Senegal,True,1,1,Cameroon
14249,15648,16786,1992,Senegal,Nigeria,1,2,African Cup of Nations,Dakar,Senegal,False,3,-1,Nigeria
14250,15649,16787,1992,Algeria,Ivory Coast,0,3,African Cup of Nations,Ziguinchor,Senegal,True,3,-3,Ivory Coast
14251,15650,16788,1992,Egypt,Zambia,0,1,African Cup of Nations,Ziguinchor,Senegal,True,1,-1,Zambia
14252,15651,16789,1992,Morocco,DR Congo,1,1,African Cup of Nations,Dakar,Senegal,True,2,0,Draw
14253,15652,16790,1992,Nigeria,Kenya,2,1,African Cup of Nations,Dakar,Senegal,True,3,1,Nigeria
14254,15653,16791,1992,Ivory Coast,Congo,0,0,African Cup of Nations,Ziguinchor,Senegal,True,0,0,Draw
14255,15654,16792,1992,Portugal,Spain,0,0,Friendly,Torres Novas,Portugal,False,0,0,Draw
14256,15655,16793,1992,Zambia,Ghana,0,1,African Cup of Nations,Ziguinchor,Senegal,True,1,-1,Ghana
14257,15656,16794,1992,Cameroon,DR Congo,1,1,African Cup of Nations,Dakar,Senegal,True,2,0,Draw
14258,15657,16795,1992,Senegal,Kenya,3,0,African Cup of Nations,Dakar,Senegal,False,3,3,Senegal
14259,15658,16796,1992,Algeria,Congo,1,1,African Cup of Nations,Ziguinchor,Senegal,True,2,0,Draw
14260,15659,16797,1992,Egypt,Ghana,0,1,African Cup of Nations,Ziguinchor,Senegal,True,1,-1,Ghana
14261,15660,16798,1992,Nigeria,DR Congo,1,0,African Cup of Nations,Dakar,Senegal,True,1,1,Nigeria
14262,15661,16799,1992,Senegal,Cameroon,0,1,African Cup of Nations,Dakar,Senegal,False,1,-1,Cameroon
14263,15662,16800,1992,Ghana,Congo,2,1,African Cup of Nations,Dakar,Senegal,True,3,1,Ghana
14264,15663,16801,1992,Ivory Coast,Zambia,1,0,African Cup of Nations,Dakar,Senegal,True,1,1,Ivory Coast
14265,15664,16802,1992,Cameroon,Ivory Coast,0,0,African Cup of Nations,Dakar,Senegal,True,0,0,Draw
14266,15665,16803,1992,Nigeria,Ghana,1,2,African Cup of Nations,Dakar,Senegal,True,3,-1,Ghana
14267,15666,16804,1992,Cameroon,Nigeria,1,2,African Cup of Nations,Dakar,Senegal,True,3,-1,Nigeria
14268,15667,16805,1992,United States,Russia,0,1,Friendly,Miami Gardens,United States,False,1,-1,Russia
14269,15668,16806,1992,Australia,Sweden,0,0,Friendly,Sydney,Australia,False,0,0,Draw
14270,15669,16807,1992,Ghana,Ivory Coast,0,0,African Cup of Nations,Dakar,Senegal,True,0,0,Draw
14271,15670,16808,1992,Albania,Greece,1,0,Friendly,Tirana,Albania,False,1,1,Albania
14272,15671,16809,1992,Australia,Sweden,1,0,Friendly,Adelaide,Australia,False,1,1,Australia
14273,15672,16810,1992,El Salvador,Russia,0,3,Friendly,San Salvador,El Salvador,False,3,-3,Russia
14274,15673,16811,1992,Australia,Sweden,1,0,Friendly,Melbourne,Australia,False,1,1,Australia
14275,15674,16812,1992,United States,Russia,2,1,Friendly,Pontiac,United States,False,3,1,United States
14276,15675,16813,1992,Bermuda,Norway,1,3,Friendly,Hamilton,Bermuda,False,4,-2,Norway
14277,15676,16814,1992,Malta,Iceland,1,0,Malta International Tournament,Attard,Malta,False,1,1,Malta
14278,15677,16815,1992,Costa Rica,United States,0,0,Friendly,San José,Costa Rica,False,0,0,Draw
14279,15678,16816,1992,Greece,Romania,1,0,Friendly,Ioannina,Greece,False,1,1,Greece
14280,15679,16817,1992,Israel,Russia,1,2,Friendly,Jerusalem,Israel,False,3,-1,Russia
14281,15680,16818,1992,Portugal,Netherlands,2,0,Friendly,Faro,Portugal,False,2,2,Portugal
14282,15681,16819,1992,Turkey,Finland,1,1,Friendly,Adana,Turkey,False,2,0,Draw
14283,15682,16820,1992,El Salvador,United States,2,0,Friendly,San Salvador,El Salvador,False,2,2,El Salvador
14284,15683,16821,1992,England,France,2,0,Friendly,London,England,False,2,2,England
14285,15684,16822,1992,Republic of Ireland,Wales,0,1,Friendly,Dublin,Republic of Ireland,False,1,-1,Wales
14286,15685,16823,1992,Italy,San Marino,4,0,Friendly,Cesena,Italy,False,4,4,Italy
14287,15686,16824,1992,Scotland,Northern Ireland,1,0,Friendly,Glasgow,Scotland,False,1,1,Scotland
14288,15687,16825,1992,Spain,Russia,1,1,Friendly,Valencia,Spain,False,2,0,Draw
14289,15688,16826,1992,Tunisia,Nigeria,1,1,Friendly,Tunis,Tunisia,False,2,0,Draw
14290,15689,16827,1992,Brazil,United States,3,0,Friendly,Fortaleza,Brazil,False,3,3,Brazil
14291,15690,16828,1992,Tunisia,Belgium,2,1,Friendly,Tunis,Tunisia,False,3,1,Tunisia
14292,15691,16829,1992,United Arab Emirates,Iceland,0,1,Friendly,Dubai,United Arab Emirates,False,1,-1,Iceland
14293,15692,16830,1992,Israel,Cyprus,2,1,Friendly,Bat Yam,Israel,False,3,1,Israel
14294,15693,16831,1992,Costa Rica,El Salvador,2,0,Friendly,San José,Costa Rica,False,2,2,Costa Rica
14295,15694,16832,1992,Saint Vincent and the Grenadines,Curaçao,2,2,CFU Caribbean Cup qualification,Bridgetown,Barbados,True,4,0,Draw
14296,15695,16833,1992,Dominica,Guadeloupe,0,0,CFU Caribbean Cup qualification,Castries,Saint Lucia,True,0,0,Draw
14297,15696,16834,1992,Barbados,Curaçao,1,0,CFU Caribbean Cup qualification,Bridgetown,Barbados,False,1,1,Barbados
14298,15697,16835,1992,Grenada,Curaçao,0,1,CFU Caribbean Cup qualification,Bridgetown,Barbados,True,1,-1,Curaçao
14299,15698,16836,1992,Mexico,Russia,4,0,Friendly,Mexico City,Mexico,False,4,4,Mexico
14300,15699,16837,1992,Mexico,Russia,1,1,Friendly,Ciudad Madero,Mexico,False,2,0,Draw
14301,15700,16838,1992,Spain,United States,2,0,Friendly,Valladolid,Spain,False,2,2,Spain
14302,15701,16839,1992,El Salvador,Honduras,1,1,Friendly,Los Angeles,United States,True,2,0,Draw
14303,15702,16840,1992,Morocco,United States,3,1,Friendly,Casablanca,Morocco,False,4,2,Morocco
14304,15703,16841,1992,Dominican Republic,Puerto Rico,1,2,FIFA World Cup qualification,Santo Domingo,Dominican Republic,False,3,-1,Puerto Rico
14305,15704,16842,1992,Saint Lucia,Saint Vincent and the Grenadines,1,0,FIFA World Cup qualification,Castries,Saint Lucia,False,1,1,Saint Lucia
14306,15705,16843,1992,Cyprus,Greece,1,3,Friendly,Limassol,Cyprus,False,4,-2,Greece
14307,15706,16845,1992,France,Belgium,3,3,Friendly,Paris,France,False,6,0,Draw
14308,15707,16846,1992,Hungary,Austria,2,1,Friendly,Budapest,Hungary,False,3,1,Hungary
14309,15708,16847,1992,Republic of Ireland,Switzerland,2,1,Friendly,Dublin,Republic of Ireland,False,3,1,Republic of Ireland
14310,15709,16848,1992,Italy,Germany,1,0,Friendly,Turin,Italy,False,1,1,Italy
14311,15710,16849,1992,Luxembourg,Turkey,2,3,Friendly,Luxembourg,Luxembourg,False,5,-1,Turkey
14312,15712,16851,1992,Scotland,Finland,1,1,Friendly,Glasgow,Scotland,False,2,0,Draw
14313,15713,16852,1992,Puerto Rico,Dominican Republic,1,1,FIFA World Cup qualification,San Juan,Puerto Rico,False,2,0,Draw
14314,15714,16853,1992,Saint Vincent and the Grenadines,Saint Lucia,3,1,FIFA World Cup qualification,Kingstown,Saint Vincent and the Grenadines,False,4,2,Saint Vincent and the Grenadines
14315,15715,16854,1992,Cayman Islands,Martinique,0,7,CFU Caribbean Cup qualification,Philipsburg,Sint Maarten,True,7,-7,Martinique
14316,15717,16856,1992,Sint Maarten,Cayman Islands,4,2,CFU Caribbean Cup qualification,Philipsburg,Sint Maarten,False,6,2,Sint Maarten
14317,15719,16858,1992,Sint Maarten,Martinique,1,1,CFU Caribbean Cup qualification,Philipsburg,Sint Maarten,False,2,0,Draw
14318,15720,16859,1992,Togo,Ghana,1,0,Friendly,Lomé,Togo,False,1,1,Togo
14319,15721,16860,1992,Israel,Iceland,2,2,Friendly,Ramat-Gan,Israel,False,4,0,Draw
14320,15722,16861,1992,Romania,Latvia,2,0,Friendly,Bucharest,Romania,False,2,2,Romania
14321,15723,16862,1992,Turkey,Denmark,2,1,Friendly,Ankara,Turkey,False,3,1,Turkey
14322,15724,16863,1992,Jamaica,Bermuda,0,0,Friendly,Kingston,Jamaica,False,0,0,Draw
14323,15725,16864,1992,Austria,Lithuania,4,0,Friendly,Vienna,Austria,False,4,4,Austria
14324,15726,16865,1992,Antigua and Barbuda,Montserrat,5,0,CFU Caribbean Cup qualification,Basseterre,Saint Kitts and Nevis,True,5,5,Antigua and Barbuda
14325,15727,16866,1992,Brazil,Finland,3,1,Friendly,Cuiabá,Brazil,False,4,2,Brazil
14326,15730,16869,1992,Saint Kitts and Nevis,Montserrat,10,0,CFU Caribbean Cup qualification,Basseterre,Saint Kitts and Nevis,False,10,10,Saint Kitts and Nevis
14327,15731,16870,1992,Barbados,Trinidad and Tobago,1,2,FIFA World Cup qualification,Bridgetown,Barbados,False,3,-1,Trinidad and Tobago
14328,15732,16871,1992,Curaçao,Antigua and Barbuda,1,1,FIFA World Cup qualification,Willemstad,Netherlands Antilles,True,2,0,Draw
14329,15733,16872,1992,Singapore,Malaysia,1,1,AFC Asian Cup qualification,Singapore,Singapore,False,2,0,Draw
14330,15734,16874,1992,Belgium,Cyprus,1,0,FIFA World Cup qualification,Brussels,Belgium,False,1,1,Belgium
14331,15735,16876,1992,Singapore,Indonesia,1,2,AFC Asian Cup qualification,Singapore,Singapore,False,3,-1,Indonesia
14332,15736,16877,1992,Spain,Albania,3,0,FIFA World Cup qualification,Seville,Spain,False,3,3,Spain
14333,15737,16878,1992,Tunisia,Sweden,0,1,Friendly,Tunis,Tunisia,False,1,-1,Sweden
14334,15738,16880,1992,Indonesia,Malaysia,1,1,AFC Asian Cup qualification,Singapore,Singapore,True,2,0,Draw
14335,15739,16881,1992,Antigua and Barbuda,Curaçao,3,0,FIFA World Cup qualification,St. John's,Antigua and Barbuda,False,3,3,Antigua and Barbuda
14336,15740,16882,1992,Bermuda,Haiti,1,0,FIFA World Cup qualification,Hamilton,Bermuda,False,1,1,Bermuda
14337,15741,16883,1992,Guyana,Suriname,1,2,FIFA World Cup qualification,Georgetown,Guyana,False,3,-1,Suriname
14338,15743,16885,1992,Northern Ireland,Lithuania,2,2,FIFA World Cup qualification,Belfast,Northern Ireland,False,4,0,Draw
14339,15744,16886,1992,Switzerland,Bulgaria,0,2,Friendly,Berne,Switzerland,False,2,-2,Bulgaria
14340,15745,16887,1992,Austria,Wales,1,1,Friendly,Vienna,Austria,False,2,0,Draw
14341,15746,16888,1992,Denmark,Norway,1,0,Friendly,Århus,Denmark,False,1,1,Denmark
14342,15747,16889,1992,El Salvador,Costa Rica,1,1,Friendly,San Salvador,El Salvador,False,2,0,Draw
14343,15748,16890,1992,Republic of Ireland,United States,4,1,Friendly,Dublin,Republic of Ireland,False,5,3,Republic of Ireland
14344,15749,16891,1992,Russia,England,2,2,Friendly,Moscow,Russia,False,4,0,Draw
14345,15750,16892,1992,Ukraine,Hungary,1,3,Friendly,Uzhhorod,Ukraine,False,4,-2,Hungary
14346,15751,16893,1992,Uruguay,Brazil,1,0,Friendly,Montevideo,Uruguay,False,1,1,Uruguay
14347,15752,16894,1992,Anguilla,Cuba,0,3,CFU Caribbean Cup qualification,The Valley,Anguilla,False,3,-3,Cuba
14348,15753,16895,1992,French Guiana,Guyana,1,1,CFU Caribbean Cup qualification,Paramaribo,Suriname,True,2,0,Draw
14349,15754,16896,1992,Romania,Faroe Islands,7,0,FIFA World Cup qualification,Bucharest,Romania,False,7,7,Romania
14350,15755,16897,1992,Sweden,Poland,5,0,Friendly,Solna,Sweden,False,5,5,Sweden
14351,15756,16898,1992,Aruba,French Guiana,0,2,CFU Caribbean Cup qualification,Paramaribo,Suriname,True,2,-2,French Guiana
14352,15757,16899,1992,Congo,Haiti,4,1,Friendly,Paris,France,True,5,3,Congo
14353,15758,16900,1992,Congo,Guadeloupe,1,1,Friendly,Paris,France,True,2,0,Draw
14354,15759,16901,1992,Cuba,Anguilla,5,0,CFU Caribbean Cup qualification,Havana,Cuba,False,5,5,Cuba
14355,15760,16902,1992,Suriname,French Guiana,3,2,CFU Caribbean Cup qualification,Paramaribo,Suriname,False,5,1,Suriname
14356,15761,16903,1992,Iran,Pakistan,7,0,AFC Asian Cup qualification,Calcutta,India,True,7,7,Iran
14357,15762,16904,1992,Hungary,England,0,1,Friendly,Budapest,Hungary,False,1,-1,England
14358,15763,16905,1992,Greece,Iceland,1,0,FIFA World Cup qualification,Athens,Greece,False,1,1,Greece
14359,15764,16906,1992,Norway,Faroe Islands,2,0,Friendly,Oslo,Norway,False,2,2,Norway
14360,15765,16907,1992,Finland,Bulgaria,0,3,FIFA World Cup qualification,Helsinki,Finland,False,3,-3,Bulgaria
14361,15766,16908,1992,Kuwait,Syria,0,0,Friendly,Kuwait City,Kuwait,False,0,0,Draw
14362,15767,16909,1992,United Arab Emirates,Qatar,1,0,Friendly,Abu Dhabi,United Arab Emirates,False,1,1,United Arab Emirates
14363,15768,16910,1992,India,Iran,0,3,AFC Asian Cup qualification,Calcutta,India,False,3,-3,Iran
14364,15769,16911,1992,England,Brazil,1,1,Friendly,London,England,False,2,0,Draw
14365,15770,16912,1992,Qatar,Kuwait,0,0,Friendly,Doha,Qatar,False,0,0,Draw
14366,15771,16913,1992,United Arab Emirates,Syria,2,0,Friendly,Al Ain,United Arab Emirates,False,2,2,United Arab Emirates
14367,15772,16914,1992,United States,Scotland,0,1,Friendly,Denver,United States,False,1,-1,Scotland
14368,15773,16915,1992,Austria,Poland,2,4,Friendly,Salzburg,Austria,False,6,-2,Poland
14369,15774,16916,1992,Bahrain,Algeria,0,0,Friendly,Manama,Bahrain,False,0,0,Draw
14370,15775,16917,1992,Canada,Scotland,1,3,Friendly,Toronto,Canada,False,4,-2,Scotland
14371,15776,16918,1992,Moldova,Lithuania,1,1,Friendly,Chişinău,Moldova,False,2,0,Draw
14372,15777,16919,1992,Romania,Wales,5,1,FIFA World Cup qualification,Bucharest,Romania,False,6,4,Romania
14373,15778,16920,1992,United Arab Emirates,Syria,0,0,Friendly,Sharjah,United Arab Emirates,False,0,0,Draw
14374,15779,16921,1992,Jamaica,Puerto Rico,2,1,FIFA World Cup qualification,Kingston,Jamaica,False,3,1,Jamaica
14375,15780,16922,1992,Guatemala,Ecuador,1,1,Friendly,Guatemala,Guatemala,False,2,0,Draw
14376,15781,16923,1992,Haiti,Bermuda,2,1,FIFA World Cup qualification,Port-au-Prince,Haiti,False,3,1,Haiti
14377,15782,16924,1992,Suriname,Guyana,1,1,FIFA World Cup qualification,Paramaribo,Suriname,False,2,0,Draw
14378,15783,16925,1992,Ethiopia,Sudan,5,1,Friendly,Addis Abeba,Ethiopia,False,6,4,Ethiopia
14379,15784,16926,1992,Republic of Ireland,Albania,2,0,FIFA World Cup qualification,Dublin,Republic of Ireland,False,2,2,Republic of Ireland
14380,15785,16927,1992,Malta,Latvia,1,0,Friendly,Attard,Malta,False,1,1,Malta
14381,15786,16928,1992,Costa Rica,Ecuador,2,1,Friendly,San José,Costa Rica,False,3,1,Costa Rica
14382,15787,16929,1992,Netherlands,Austria,3,2,Friendly,Sittard,Netherlands,False,5,1,Netherlands
14383,15789,16931,1992,Sweden,Hungary,2,1,Friendly,Solna,Sweden,False,3,1,Sweden
14384,15790,16932,1992,Switzerland,France,2,1,Friendly,Lausanne,Switzerland,False,3,1,Switzerland
14385,15791,16933,1992,Qatar,Syria,4,2,AFC Asian Cup qualification,Doha,Qatar,False,6,2,Qatar
14386,15792,16934,1992,Germany,Turkey,1,0,Friendly,Gelsenkirchen,Germany,False,1,1,Germany
14387,15793,16935,1992,Netherlands,Wales,4,0,Friendly,Utrecht,Netherlands,False,4,4,Netherlands
14388,15794,16936,1992,Puerto Rico,Jamaica,0,1,FIFA World Cup qualification,San Juan,Puerto Rico,False,1,-1,Jamaica
14389,15795,16937,1992,United States,Republic of Ireland,3,1,USA Cup,Washington,United States,False,4,2,United States
14390,15796,16938,1992,Italy,Portugal,0,0,USA Cup,New Haven,United States,True,0,0,Draw
14391,15797,16939,1992,Qatar,Oman,4,0,AFC Asian Cup qualification,Doha,Qatar,False,4,4,Qatar
14392,15798,16940,1992,Trinidad and Tobago,Barbados,3,0,FIFA World Cup qualification,Port of Spain,Trinidad and Tobago,False,3,3,Trinidad and Tobago
14393,15799,16941,1992,Kazakhstan,Turkmenistan,1,0,Friendly,Almaty,Kazakhstan,False,1,1,Kazakhstan
14394,15800,16942,1992,Germany,Northern Ireland,1,1,Friendly,Bremen,Germany,False,2,0,Draw
14395,15801,16943,1992,Albania,Lithuania,1,0,FIFA World Cup qualification,Tirana,Albania,False,1,1,Albania
14396,15802,16944,1992,Argentina,Wales,1,0,Kirin Cup,Gifu,Japan,True,1,1,Argentina
14397,15803,16945,1992,Denmark,Russia,1,1,Friendly,Brøndby,Denmark,False,2,0,Draw
14398,15804,16946,1992,Estonia,Slovenia,1,1,Friendly,Tallinn,Estonia,False,2,0,Draw
14399,15805,16947,1992,Faroe Islands,Belgium,0,3,FIFA World Cup qualification,Toftir,Faroe Islands,False,3,-3,Belgium
14400,15806,16948,1992,Finland,England,1,2,Friendly,Helsinki,Finland,False,3,-1,England
14401,15807,16949,1992,Hungary,Iceland,1,2,FIFA World Cup qualification,Budapest,Hungary,False,3,-1,Iceland
14402,15808,16951,1992,Macau,Hong Kong,2,2,AFC Asian Cup qualification,P'yongyang,North Korea,True,4,0,Draw
14403,15809,16952,1992,Norway,Scotland,0,0,Friendly,Oslo,Norway,False,0,0,Draw
14404,15810,16953,1992,United States,Portugal,1,0,USA Cup,Chicago,United States,False,1,1,United States
14405,15811,16954,1992,Republic of Ireland,Italy,0,2,USA Cup,Foxborough,United States,True,2,-2,Italy
14406,15812,16955,1992,France,Netherlands,1,1,Friendly,Lens,France,False,2,0,Draw
14407,15814,16958,1992,United States,Italy,1,1,USA Cup,Chicago,United States,False,2,0,Draw
14408,15815,16959,1992,Guatemala,Nicaragua,7,1,Friendly,Guatemala,Guatemala,False,8,6,Guatemala
14409,15816,16960,1992,Republic of Ireland,Portugal,2,0,USA Cup,Foxborough,United States,True,2,2,Republic of Ireland
14410,15817,16961,1992,Japan,Wales,0,1,Kirin Cup,Matsuyama,Japan,False,1,-1,Wales
14411,15819,16964,1992,New Zealand,Fiji,3,0,FIFA World Cup qualification,Auckland,New Zealand,False,3,3,New Zealand
14412,15820,16965,1992,Sweden,France,1,1,UEFA Euro,Solna,Sweden,False,2,0,Draw
14413,15821,16966,1992,Denmark,England,0,0,UEFA Euro,Malmö,Sweden,True,0,0,Draw
14414,15822,16967,1992,Netherlands,Scotland,1,0,UEFA Euro,Gothenburg,Sweden,True,1,1,Netherlands
14415,15823,16968,1992,Russia,Germany,1,1,UEFA Euro,Norrköping,Sweden,True,2,0,Draw
14416,15824,16969,1992,Canada,Hong Kong,3,1,Friendly,Toronto,Canada,False,4,2,Canada
14417,15825,16970,1992,United States,Australia,0,1,Friendly,Orlando,United States,False,1,-1,Australia
14418,15826,16971,1992,Antigua and Barbuda,Bermuda,0,3,FIFA World Cup qualification,St. John's,Antigua and Barbuda,False,3,-3,Bermuda
14419,15827,16972,1992,France,England,0,0,UEFA Euro,Malmö,Sweden,True,0,0,Draw
14420,15828,16973,1992,Gabon,Togo,1,0,Friendly,Libreville,Gabon,False,1,1,Gabon
14421,15830,16975,1992,Lesotho,Botswana,0,0,African Cup of Nations qualification,Maseru,Lesotho,False,0,0,Draw
14422,15831,16976,1992,Sweden,Denmark,1,0,UEFA Euro,Solna,Sweden,False,1,1,Sweden
14423,15832,16977,1992,Netherlands,Russia,0,0,UEFA Euro,Gothenburg,Sweden,True,0,0,Draw
14424,15833,16978,1992,Scotland,Germany,0,2,UEFA Euro,Norrköping,Sweden,True,2,-2,Germany
14425,15834,16979,1992,Faroe Islands,Cyprus,0,2,FIFA World Cup qualification,Toftir,Faroe Islands,False,2,-2,Cyprus
14426,15835,16980,1992,France,Denmark,1,2,UEFA Euro,Malmö,Sweden,True,3,-1,Denmark
14427,15836,16981,1992,Sweden,England,2,1,UEFA Euro,Solna,Sweden,False,3,1,Sweden
14428,15837,16982,1992,Tajikistan,Uzbekistan,2,2,Friendly,Dushanbe,Tajikistan,False,4,0,Draw
14429,15838,16983,1992,Argentina,Australia,2,0,Friendly,Buenos Aires,Argentina,False,2,2,Argentina
14430,15839,16984,1992,Netherlands,Germany,3,1,UEFA Euro,Gothenburg,Sweden,True,4,2,Netherlands
14431,15840,16985,1992,Scotland,Russia,3,0,UEFA Euro,Norrköping,Sweden,True,3,3,Scotland
14432,15841,16986,1992,Antigua and Barbuda,Suriname,1,1,CFU Caribbean Cup,Port of Spain,Trinidad and Tobago,True,2,0,Draw
14433,15842,16988,1992,Guadeloupe,Jamaica,0,1,CFU Caribbean Cup,San Fernando,Trinidad and Tobago,True,1,-1,Jamaica
14434,15843,16989,1992,Mozambique,Eswatini,4,1,Friendly,Maputo,Mozambique,False,5,3,Mozambique
14435,15844,16990,1992,Antigua and Barbuda,Martinique,1,4,CFU Caribbean Cup,Port of Spain,Trinidad and Tobago,True,5,-3,Martinique
14436,15845,16991,1992,Gabon,Burundi,0,1,Friendly,Libreville,Gabon,False,1,-1,Burundi
14437,15846,16992,1992,Sweden,Germany,2,3,UEFA Euro,Solna,Sweden,False,5,-1,Germany
14438,15848,16994,1992,Uruguay,Australia,2,0,Friendly,Montevideo,Uruguay,False,2,2,Uruguay
14439,15849,16995,1992,Cuba,Jamaica,0,0,CFU Caribbean Cup,San Fernando,Trinidad and Tobago,True,0,0,Draw
14440,15850,16996,1992,Netherlands,Denmark,2,2,UEFA Euro,Gothenburg,Sweden,True,4,0,Draw
14441,15851,16997,1992,Thailand,Bangladesh,1,0,AFC Asian Cup qualification,Bangkok,Thailand,False,1,1,Thailand
14442,15852,16998,1992,Jamaica,Martinique,1,0,CFU Caribbean Cup,Port of Spain,Trinidad and Tobago,True,1,1,Jamaica
14443,15853,16999,1992,Trinidad and Tobago,Cuba,1,0,CFU Caribbean Cup,Port of Spain,Trinidad and Tobago,False,1,1,Trinidad and Tobago
14444,15854,17000,1992,Denmark,Germany,2,0,UEFA Euro,Gothenburg,Sweden,True,2,2,Denmark
14445,15855,17001,1992,Sudan,Eritrea,1,1,Friendly,Khartoum,Sudan,False,2,0,Draw
14446,15856,17002,1992,Cuba,Martinique,1,1,CFU Caribbean Cup,Port of Spain,Trinidad and Tobago,True,2,0,Draw
14447,15857,17003,1992,Trinidad and Tobago,Jamaica,3,1,CFU Caribbean Cup,Port of Spain,Trinidad and Tobago,False,4,2,Trinidad and Tobago
14448,15858,17004,1992,United States,Ukraine,0,0,Friendly,Piscataway,United States,False,0,0,Draw
14449,15859,17005,1992,Vanuatu,New Zealand,1,4,FIFA World Cup qualification,Port Vila,Vanuatu,False,5,-3,New Zealand
14450,15860,17006,1992,Botswana,Lesotho,0,4,African Cup of Nations qualification,Gaborone,Botswana,False,4,-4,Lesotho
14451,15861,17008,1992,Chad,Eritrea,0,1,Friendly,Khartoum,Sudan,True,1,-1,Eritrea
14452,15862,17010,1992,Honduras,Panama,4,0,Friendly,Tegucigalpa,Honduras,False,4,4,Honduras
14453,15863,17011,1992,Uzbekistan,Turkmenistan,2,1,Friendly,Tashkent,Uzbekistan,False,3,1,Uzbekistan
14454,15864,17012,1992,Honduras,Panama,4,0,Friendly,San Pedro Sula,Honduras,False,4,4,Honduras
14455,15865,17013,1992,Sudan,Chad,1,0,Friendly,Khartoum,Sudan,False,1,1,Sudan
14456,15866,17014,1992,New Zealand,Vanuatu,8,0,FIFA World Cup qualification,Auckland,New Zealand,False,8,8,New Zealand
14457,15867,17015,1992,Kazakhstan,Libya,1,0,Friendly,P'yongyang,North Korea,True,1,1,Kazakhstan
14458,15868,17016,1992,Bermuda,Antigua and Barbuda,2,1,FIFA World Cup qualification,Hamilton,Bermuda,False,3,1,Bermuda
14459,15869,17017,1992,Uruguay,Ecuador,3,1,Friendly,Montevideo,Uruguay,False,4,2,Uruguay
14460,15870,17018,1992,Australia,Croatia,1,0,Friendly,Melbourne,Australia,False,1,1,Australia
14461,15871,17019,1992,Guatemala,Poland,2,2,Friendly,Guatemala,Guatemala,False,4,0,Draw
14462,15873,17021,1992,Trinidad and Tobago,Jamaica,1,2,FIFA World Cup qualification,Port of Spain,Trinidad and Tobago,False,3,-1,Jamaica
14463,15874,17022,1992,Malawi,Zimbabwe,0,0,Friendly,Blantyre,Malawi,False,0,0,Draw
14464,15875,17023,1992,South Africa,Cameroon,1,0,Friendly,Durban,South Africa,False,1,1,South Africa
14465,15876,17024,1992,Australia,Croatia,3,1,Friendly,Adelaide,Australia,False,4,2,Australia
14466,15877,17025,1992,Malawi,Zimbabwe,0,0,Friendly,Blantyre,Malawi,False,0,0,Draw
14467,15878,17026,1992,South Africa,Cameroon,1,2,Friendly,Cape Town,South Africa,False,3,-1,Cameroon
14468,15879,17027,1992,Latvia,Estonia,2,1,Baltic Cup,Liepāja,Latvia,False,3,1,Latvia
14469,15880,17028,1992,Estonia,Lithuania,1,1,Baltic Cup,Liepāja,Latvia,True,2,0,Draw
14470,15881,17029,1992,South Africa,Cameroon,2,2,Friendly,Johannesburg,South Africa,False,4,0,Draw
14471,15882,17030,1992,Turkmenistan,Tajikistan,3,3,Friendly,Ashgabat,Turkmenistan,False,6,0,Draw
14472,15883,17031,1992,Australia,Croatia,0,0,Friendly,Sydney,Australia,False,0,0,Draw
14473,15884,17032,1992,Latvia,Lithuania,2,3,Baltic Cup,Liepāja,Latvia,False,5,-1,Lithuania
14474,15886,17034,1992,Kazakhstan,Uzbekistan,1,0,Friendly,Almaty,Kazakhstan,False,1,1,Kazakhstan
14475,15888,17036,1992,Guatemala,Honduras,0,0,FIFA World Cup qualification,Guatemala,Guatemala,False,0,0,Draw
14476,15889,17037,1992,Nicaragua,El Salvador,0,5,FIFA World Cup qualification,Managua,Nicaragua,False,5,-5,El Salvador
14477,15891,17039,1992,Cameroon,Egypt,0,1,Friendly,Yaoundé,Cameroon,False,1,-1,Egypt
14478,15893,17041,1992,El Salvador,Nicaragua,5,1,FIFA World Cup qualification,San Salvador,El Salvador,False,6,4,El Salvador
14479,15894,17042,1992,Fiji,Solomon Islands,2,1,Friendly,Port Vila,Vanuatu,True,3,1,Fiji
14480,15895,17043,1992,Vanuatu,New Caledonia,0,1,Friendly,Port Vila,Vanuatu,False,1,-1,New Caledonia
14481,15896,17044,1992,El Salvador,Mexico,1,2,Friendly,San Salvador,El Salvador,False,3,-1,Mexico
14482,15897,17045,1992,Honduras,Guatemala,2,0,FIFA World Cup qualification,Tegucigalpa,Honduras,False,2,2,Honduras
14483,15898,17046,1992,Ivory Coast,Egypt,2,0,Friendly,Abidjan,Ivory Coast,False,2,2,Ivory Coast
14484,15899,17047,1992,Vanuatu,Solomon Islands,1,3,Friendly,Port Vila,Vanuatu,False,4,-2,Solomon Islands
14485,15900,17048,1992,Fiji,New Caledonia,2,2,Friendly,Port Vila,Vanuatu,True,4,0,Draw
14486,15901,17049,1992,Ivory Coast,Egypt,2,2,Friendly,Abidjan,Ivory Coast,False,4,0,Draw
14487,15902,17050,1992,New Caledonia,Solomon Islands,1,0,Friendly,Port Vila,Vanuatu,True,1,1,New Caledonia
14488,15903,17051,1992,Vanuatu,Fiji,0,2,Friendly,Port Vila,Vanuatu,False,2,-2,Fiji
14489,15904,17052,1992,Brazil,Mexico,5,0,Friendly,Los Angeles,United States,True,5,5,Brazil
14490,15905,17053,1992,United States,Colombia,0,1,Friendly,Los Angeles,United States,False,1,-1,Colombia
14491,15906,17054,1992,Lesotho,Namibia,2,0,Friendly,Maseru,Lesotho,False,2,2,Lesotho
14492,15907,17055,1992,Lesotho,Namibia,2,2,Friendly,Maseru,Lesotho,False,4,0,Draw
14493,15908,17056,1992,Mexico,Colombia,0,0,Friendly,Los Angeles,United States,True,0,0,Draw
14494,15909,17057,1992,Uruguay,Costa Rica,2,1,Friendly,Montevideo,Uruguay,False,3,1,Uruguay
14495,15910,17058,1992,United States,Brazil,0,1,Friendly,Los Angeles,United States,False,1,-1,Brazil
14496,15911,17059,1992,Faroe Islands,Israel,1,1,Friendly,Toftir,Faroe Islands,False,2,0,Draw
14497,15912,17060,1992,Ecuador,Costa Rica,1,1,Friendly,Guayaquil,Ecuador,False,2,0,Draw
14498,15913,17061,1992,Indonesia,Malaysia,1,1,Friendly,Jakarta,Indonesia,False,2,0,Draw
14499,15914,17062,1992,Lesotho,Mauritius,1,0,Friendly,Maseru,Lesotho,False,1,1,Lesotho
14500,15915,17063,1992,Iceland,Israel,0,2,Friendly,Reykjavík,Iceland,False,2,-2,Israel
14501,15916,17064,1992,Lesotho,Mauritius,2,2,Friendly,Maseru,Lesotho,False,4,0,Draw
14502,15917,17065,1992,Libya,Niger,0,0,Friendly,Tripoli,Libya,False,0,0,Draw
14503,15918,17066,1992,Australia,Malaysia,0,1,Friendly,Jakarta,Indonesia,True,1,-1,Malaysia
14504,15919,17067,1992,El Salvador,Honduras,0,3,Friendly,Los Angeles,United States,True,3,-3,Honduras
14505,15920,17068,1992,Latvia,Lithuania,1,2,FIFA World Cup qualification,Riga,Latvia,False,3,-1,Lithuania
14506,15921,17069,1992,Libya,Mali,0,1,Friendly,Tripoli,Libya,False,1,-1,Mali
14507,15922,17070,1992,Algeria,Guinea-Bissau,3,1,African Cup of Nations qualification,Oran,Algeria,False,4,2,Algeria
14508,15923,17071,1992,Indonesia,Australia,0,3,Friendly,Jakarta,Indonesia,False,3,-3,Australia
14509,15924,17072,1992,Mali,Libya,2,1,Friendly,Bamako,Mali,False,3,1,Mali
14510,15925,17073,1992,Tanzania,Ghana,2,2,African Cup of Nations qualification,Mwanza,Tanzania,False,4,0,Draw
14511,15926,17074,1992,Uganda,Ethiopia,3,1,African Cup of Nations qualification,Kampala,Uganda,False,4,2,Uganda
14512,15927,17075,1992,Benin,Niger,1,2,African Cup of Nations qualification,Cotonou,Benin,False,3,-1,Niger
14513,15928,17076,1992,Burundi,Congo,1,0,African Cup of Nations qualification,Bujumbura,Burundi,False,1,1,Burundi
14514,15929,17077,1992,Chad,Guinea,0,3,African Cup of Nations qualification,N'Djamena,Chad,False,3,-3,Guinea
14515,15930,17078,1992,DR Congo,Mozambique,2,0,African Cup of Nations qualification,Kinshasa,Zaïre,False,2,2,DR Congo
14516,15931,17079,1992,Estonia,Switzerland,0,6,FIFA World Cup qualification,Tallinn,Estonia,False,6,-6,Switzerland
14517,15932,17080,1992,Gabon,Cameroon,0,0,African Cup of Nations qualification,Libreville,Gabon,False,0,0,Draw
14518,15933,17081,1992,Lesotho,Kenya,2,2,African Cup of Nations qualification,Maseru,Lesotho,False,4,0,Draw
14519,15934,17082,1992,Panama,Costa Rica,1,0,FIFA World Cup qualification,Panama City,Panama,False,1,1,Panama
14520,15935,17083,1992,Senegal,Togo,2,0,African Cup of Nations qualification,Dakar,Senegal,False,2,2,Senegal
14521,15936,17084,1992,Zimbabwe,South Africa,4,1,African Cup of Nations qualification,Harare,Zimbabwe,False,5,3,Zimbabwe
14522,15937,17085,1992,Ethiopia,Iraq,0,13,Jordan International Tournament,Irbid,Jordan,True,13,-13,Iraq
14523,15938,17086,1992,Jordan,Sudan,3,0,Jordan International Tournament,Amman,Jordan,False,3,3,Jordan
14524,15939,17087,1992,Moldova,Pakistan,5,0,Jordan International Tournament,Amman,Jordan,True,5,5,Moldova
14525,15940,17088,1992,Bulgaria,Mexico,1,1,Friendly,Sofia,Bulgaria,False,2,0,Draw
14526,15941,17090,1992,Congo,Iraq,0,3,Jordan International Tournament,Irbid,Jordan,True,3,-3,Iraq
14527,15942,17091,1992,Jordan,Pakistan,2,0,Jordan International Tournament,Amman,Jordan,False,2,2,Jordan
14528,15943,17092,1992,Moldova,Sudan,2,1,Jordan International Tournament,Amman,Jordan,True,3,1,Moldova
14529,15944,17094,1992,Congo,Ethiopia,3,0,Jordan International Tournament,Irbid,Jordan,True,3,3,Congo
14530,15946,17096,1992,Jordan,Moldova,1,0,Jordan International Tournament,Amman,Jordan,False,1,1,Jordan
14531,15947,17097,1992,Pakistan,Sudan,0,4,Jordan International Tournament,Amman,Jordan,True,4,-4,Sudan
14532,15948,17098,1992,Costa Rica,Panama,5,1,FIFA World Cup qualification,San José,Costa Rica,False,6,4,Costa Rica
14533,15949,17099,1992,Uzbekistan,Kyrgyzstan,3,0,Friendly,Tashkent,Uzbekistan,False,3,3,Uzbekistan
14534,15950,17103,1992,Finland,Poland,0,0,Friendly,Jakobstad,Finland,False,0,0,Draw
14535,15951,17104,1992,France,Brazil,0,2,Friendly,Paris,France,False,2,-2,Brazil
14536,15952,17105,1992,Hungary,Ukraine,2,1,Friendly,Nyíregyháza,Hungary,False,3,1,Hungary
14537,15953,17106,1992,Iraq,Moldova,1,0,Jordan International Tournament,Irbid,Jordan,True,1,1,Iraq
14538,15955,17108,1992,Jordan,Congo,2,1,Jordan International Tournament,Amman,Jordan,False,3,1,Jordan
14539,15956,17109,1992,Latvia,Denmark,0,0,FIFA World Cup qualification,Riga,Latvia,False,0,0,Draw
14540,15957,17110,1992,Norway,Sweden,2,2,Friendly,Oslo,Norway,False,4,0,Draw
14541,15958,17111,1992,Romania,Mexico,2,0,Friendly,Bucharest,Romania,False,2,2,Romania
14542,15959,17112,1992,Turkey,Bulgaria,3,2,Friendly,Trabzon,Turkey,False,5,1,Turkey
14543,15960,17113,1992,Congo,Moldova,1,3,Jordan International Tournament,Amman,Jordan,True,4,-2,Moldova
14544,15961,17114,1992,Jordan,Iraq,2,0,Jordan International Tournament,Amman,Jordan,False,2,2,Jordan
14545,15963,17117,1992,Kenya,DR Congo,1,3,African Cup of Nations qualification,Nairobi,Kenya,False,4,-2,DR Congo
14546,15964,17118,1992,Malawi,Mali,1,1,African Cup of Nations qualification,Lilongwe,Malawi,False,2,0,Draw
14547,15965,17119,1992,Nigeria,Uganda,2,0,African Cup of Nations qualification,Lagos,Nigeria,False,2,2,Nigeria
14548,15966,17120,1992,Sierra Leone,Algeria,1,0,African Cup of Nations qualification,Freetown,Sierra Leone,False,1,1,Sierra Leone
14549,15967,17121,1992,Cameroon,Benin,2,0,African Cup of Nations qualification,Yaoundé,Cameroon,False,2,2,Cameroon
14550,15968,17122,1992,Congo,Chad,2,0,African Cup of Nations qualification,Brazzaville,Congo,False,2,2,Congo
14551,15969,17123,1992,Ethiopia,Sudan,3,0,African Cup of Nations qualification,Addis Abeba,Ethiopia,False,3,3,Ethiopia
14552,15970,17124,1992,Ghana,Burkina Faso,3,0,African Cup of Nations qualification,Accra,Ghana,False,3,3,Ghana
14553,15971,17125,1992,Guinea,Burundi,2,2,African Cup of Nations qualification,Conakry,Guinea,False,4,0,Draw
14554,15972,17126,1992,Liberia,Tanzania,1,1,African Cup of Nations qualification,Monrovia,Liberia,False,2,0,Draw
14555,15973,17127,1992,Mauritius,Zimbabwe,0,1,African Cup of Nations qualification,Curepipe,Mauritius,False,1,-1,Zimbabwe
14556,15974,17128,1992,Mozambique,Lesotho,3,0,African Cup of Nations qualification,Maputo,Mozambique,False,3,3,Mozambique
14557,15975,17129,1992,Niger,Gabon,1,3,African Cup of Nations qualification,Niamey,Niger,False,4,-2,Gabon
14558,15976,17130,1992,Senegal,Guinea-Bissau,3,0,African Cup of Nations qualification,Dakar,Senegal,False,3,3,Senegal
14559,15977,17131,1992,South Africa,Zambia,0,1,African Cup of Nations qualification,Johannesburg,South Africa,False,1,-1,Zambia
14560,15978,17132,1992,Austria,Portugal,1,1,Friendly,Linz,Austria,False,2,0,Draw
14561,15979,17134,1992,Greece,Cyprus,2,3,Friendly,Salonica,Greece,False,5,-1,Cyprus
14562,15980,17135,1992,Lithuania,Georgia,1,0,Friendly,Kaunas,Lithuania,False,1,1,Lithuania
14563,15981,17136,1992,Canada,United States,0,2,Friendly,Saint John,Canada,False,2,-2,United States
14564,15982,17137,1992,Solomon Islands,Australia,1,2,FIFA World Cup qualification,Honiara,Solomon Islands,False,3,-1,Australia
14565,15983,17138,1992,Bulgaria,France,2,0,FIFA World Cup qualification,Sofia,Bulgaria,False,2,2,Bulgaria
14566,15984,17139,1992,Denmark,Germany,1,2,Friendly,Copenhagen,Denmark,False,3,-1,Germany
14567,15985,17140,1992,Finland,Sweden,0,1,FIFA World Cup qualification,Helsinki,Finland,False,1,-1,Sweden
14568,15986,17141,1992,Republic of Ireland,Latvia,4,0,FIFA World Cup qualification,Dublin,Republic of Ireland,False,4,4,Republic of Ireland
14569,15987,17142,1992,Luxembourg,Hungary,0,3,FIFA World Cup qualification,Luxembourg,Luxembourg,False,3,-3,Hungary
14570,15988,17143,1992,Netherlands,Italy,2,3,Friendly,Eindhoven,Netherlands,False,5,-1,Italy
14571,15989,17144,1992,Northern Ireland,Albania,3,0,FIFA World Cup qualification,Belfast,Northern Ireland,False,3,3,Northern Ireland
14572,15990,17145,1992,Norway,San Marino,10,0,FIFA World Cup qualification,Oslo,Norway,False,10,10,Norway
14573,15991,17146,1992,Poland,Israel,1,1,Friendly,Mielec,Poland,False,2,0,Draw
14574,15992,17147,1992,Spain,England,1,0,Friendly,Santander,Spain,False,1,1,Spain
14575,15993,17148,1992,Switzerland,Scotland,3,1,FIFA World Cup qualification,Berne,Switzerland,False,4,2,Switzerland
14576,15994,17149,1992,Wales,Faroe Islands,6,0,FIFA World Cup qualification,Cardiff,Wales,False,6,6,Wales
14577,15995,17151,1992,Fiji,Vanuatu,3,0,FIFA World Cup qualification,Nausori,Fiji,False,3,3,Fiji
14578,15996,17152,1992,El Salvador,Honduras,3,1,Friendly,San Salvador,El Salvador,False,4,2,El Salvador
14579,15997,17153,1992,Turkmenistan,Kazakhstan,1,1,Friendly,Ashgabat,Turkmenistan,False,2,0,Draw
14580,15998,17154,1992,Georgia,Azerbaijan,6,3,Friendly,Gurjaani,Georgia,False,9,3,Georgia
14581,15999,17155,1992,Honduras,El Salvador,1,1,Friendly,San Pedro Sula,Honduras,False,2,0,Draw
14582,16001,17157,1992,Honduras,Jamaica,5,1,Friendly,Tegucigalpa,Honduras,False,6,4,Honduras
14583,16002,17158,1992,Brazil,Costa Rica,4,2,Friendly,Paranavaí,Brazil,False,6,2,Brazil
14584,16003,17160,1992,Hungary,Israel,0,0,Friendly,Budapest,Hungary,False,0,0,Draw
14585,16004,17161,1992,Latvia,Spain,0,0,FIFA World Cup qualification,Riga,Latvia,False,0,0,Draw
14586,16005,17162,1992,Lithuania,Denmark,0,0,FIFA World Cup qualification,Vilnius,Lithuania,False,0,0,Draw
14587,16006,17163,1992,Norway,Netherlands,2,1,FIFA World Cup qualification,Oslo,Norway,False,3,1,Norway
14588,16007,17164,1992,Poland,Turkey,1,0,FIFA World Cup qualification,Poznań,Poland,False,1,1,Poland
14589,16008,17165,1992,Uruguay,Argentina,0,0,Copa Lipton,Montevideo,Uruguay,False,0,0,Draw
14590,16009,17166,1992,Honduras,Jamaica,7,0,Friendly,San Pedro Sula,Honduras,False,7,7,Honduras
14591,16010,17167,1992,Australia,Solomon Islands,6,1,FIFA World Cup qualification,Newcastle,Australia,False,7,5,Australia
14592,16011,17168,1992,Kyrgyzstan,Kazakhstan,1,1,Friendly,Bishkek,Kyrgyzstan,False,2,0,Draw
14593,16012,17169,1992,Vanuatu,Fiji,0,3,FIFA World Cup qualification,Port Vila,Vanuatu,False,3,-3,Fiji
14594,16013,17170,1992,Saint Vincent and the Grenadines,Jamaica,0,1,Friendly,Kingstown,Saint Vincent and the Grenadines,False,1,-1,Jamaica
14595,16014,17171,1992,Botswana,Kenya,1,3,Friendly,Gaborone,Botswana,False,4,-2,Kenya
14596,16015,17172,1992,Iran,Cameroon,1,1,Friendly,Teheran,Iran,False,2,0,Draw
14597,16016,17173,1992,Botswana,Kenya,0,1,Friendly,Gaborone,Botswana,False,1,-1,Kenya
14598,16017,17174,1992,Kyrgyzstan,Uzbekistan,2,6,Friendly,Bishkek,Kyrgyzstan,False,8,-4,Uzbekistan
14599,16018,17175,1992,Gabon,Chad,1,0,Friendly,Libreville,Gabon,False,1,1,Gabon
14600,16019,17176,1992,Guinea-Bissau,Sierra Leone,0,3,African Cup of Nations qualification,Bissau,Guinea-Bissau,False,3,-3,Sierra Leone
14601,16020,17177,1992,Iran,Cameroon,0,0,Friendly,Teheran,Iran,False,0,0,Draw
14602,16021,17178,1992,Jamaica,Saint Vincent and the Grenadines,3,3,Friendly,Kingston,Jamaica,False,6,0,Draw
14603,16022,17179,1992,Mali,Morocco,2,1,African Cup of Nations qualification,Bamako,Mali,False,3,1,Mali
14604,16023,17180,1992,Togo,Algeria,0,0,African Cup of Nations qualification,Lomé,Togo,False,0,0,Draw
14605,16024,17181,1992,Saudi Arabia,Cameroon,2,1,Friendly,Riyadh,Saudi Arabia,False,3,1,Saudi Arabia
14606,16025,17182,1992,Cyprus,Malta,3,0,Friendly,Limassol,Cyprus,False,3,3,Cyprus
14607,16026,17183,1992,El Salvador,Mexico,0,2,Friendly,Los Angeles,United States,True,2,-2,Mexico
14608,16027,17184,1992,Iceland,Greece,0,1,FIFA World Cup qualification,Reykjavík,Iceland,False,1,-1,Greece
14609,16028,17185,1992,San Marino,Norway,0,2,FIFA World Cup qualification,Serravalle,San Marino,False,2,-2,Norway
14610,16029,17186,1992,Sweden,Bulgaria,2,0,FIFA World Cup qualification,Solna,Sweden,False,2,2,Sweden
14611,16030,17187,1992,Algeria,Burundi,3,1,FIFA World Cup qualification,Tlemcen,Algeria,False,4,2,Algeria
14612,16031,17189,1992,United States,Canada,0,0,Friendly,Greensboro,United States,False,0,0,Draw
14613,16032,17190,1992,Zimbabwe,Togo,1,0,FIFA World Cup qualification,Harare,Zimbabwe,False,1,1,Zimbabwe
14614,16033,17191,1992,Nigeria,South Africa,4,0,FIFA World Cup qualification,Lagos,Nigeria,False,4,4,Nigeria
14615,16034,17192,1992,DR Congo,Liberia,4,2,FIFA World Cup qualification,Kinshasa,Zaïre,False,6,2,DR Congo
14616,16035,17193,1992,Egypt,Angola,1,0,FIFA World Cup qualification,Cairo,Egypt,False,1,1,Egypt
14617,16036,17194,1992,Gabon,Mozambique,3,1,FIFA World Cup qualification,Libreville,Gabon,False,4,2,Gabon
14618,16037,17195,1992,Ivory Coast,Botswana,6,0,FIFA World Cup qualification,Abidjan,Ivory Coast,False,6,6,Ivory Coast
14619,16038,17196,1992,Madagascar,Namibia,3,0,FIFA World Cup qualification,Antananarivo,Madagascar,False,3,3,Madagascar
14620,16039,17197,1992,Morocco,Ethiopia,5,0,FIFA World Cup qualification,Casablanca,Morocco,False,5,5,Morocco
14621,16040,17198,1992,Qatar,Hungary,1,4,Friendly,Doha,Qatar,False,5,-3,Hungary
14622,16041,17199,1992,Tunisia,Benin,5,1,FIFA World Cup qualification,Tunis,Tunisia,False,6,4,Tunisia
14623,16042,17200,1992,Zambia,Tanzania,2,0,FIFA World Cup qualification,Lusaka,Zambia,False,2,2,Zambia
14624,16043,17201,1992,Qatar,Hungary,1,1,Friendly,Doha,Qatar,False,2,0,Draw
14625,16044,17202,1992,Armenia,Moldova,0,0,Friendly,Yerevan,Armenia,False,0,0,Draw
14626,16045,17203,1992,Belgium,Romania,1,0,FIFA World Cup qualification,Brussels,Belgium,False,1,1,Belgium
14627,16046,17204,1992,Cyprus,Wales,0,1,FIFA World Cup qualification,Limassol,Cyprus,False,1,-1,Wales
14628,16047,17205,1992,Denmark,Republic of Ireland,0,0,FIFA World Cup qualification,Copenhagen,Denmark,False,0,0,Draw
14629,16048,17206,1992,England,Norway,1,1,FIFA World Cup qualification,London,England,False,2,0,Draw
14630,16049,17207,1992,France,Austria,2,0,FIFA World Cup qualification,Paris,France,False,2,2,France
14631,16050,17208,1992,Germany,Mexico,1,1,Friendly,Dresden,Germany,False,2,0,Draw
14632,16051,17209,1992,Italy,Switzerland,2,2,FIFA World Cup qualification,Cagliari,Italy,False,4,0,Draw
14633,16052,17210,1992,Lithuania,Slovakia,0,1,Friendly,Vilnius,Lithuania,False,1,-1,Slovakia
14634,16053,17211,1992,Netherlands,Poland,2,2,FIFA World Cup qualification,Rotterdam,Netherlands,False,4,0,Draw
14635,16054,17212,1992,Northern Ireland,Spain,0,0,FIFA World Cup qualification,Belfast,Northern Ireland,False,0,0,Draw
14636,16055,17213,1992,Russia,Iceland,1,0,FIFA World Cup qualification,Moscow,Russia,False,1,1,Russia
14637,16056,17214,1992,Scotland,Portugal,0,0,FIFA World Cup qualification,Glasgow,Scotland,False,0,0,Draw
14638,16057,17215,1992,Turkmenistan,Kyrgyzstan,4,0,Friendly,Ashgabat,Turkmenistan,False,4,4,Turkmenistan
14639,16058,17216,1992,Uzbekistan,Kazakhstan,1,1,Friendly,Tashkent,Uzbekistan,False,2,0,Draw
14640,16059,17217,1992,Saudi Arabia,United States,3,0,Confederations Cup,Riyadh,Saudi Arabia,False,3,3,Saudi Arabia
14641,16060,17218,1992,Argentina,Ivory Coast,4,0,Confederations Cup,Riyadh,Saudi Arabia,True,4,4,Argentina
14642,16061,17219,1992,Bermuda,El Salvador,1,0,FIFA World Cup qualification,Hamilton,Bermuda,False,1,1,Bermuda
14643,16062,17220,1992,Cameroon,Eswatini,5,0,FIFA World Cup qualification,Yaoundé,Cameroon,False,5,5,Cameroon
14644,16063,17221,1992,Jamaica,Canada,1,1,FIFA World Cup qualification,Kingston,Jamaica,False,2,0,Draw
14645,16064,17222,1992,Kuwait,Iran,1,1,Friendly,Kuwait City,Kuwait,False,2,0,Draw
14646,16065,17223,1992,Niger,Mali,0,2,Friendly,Niamey,Niger,False,2,-2,Mali
14647,16066,17224,1992,United States,Ivory Coast,5,2,Confederations Cup,Riyadh,Saudi Arabia,True,7,3,United States
14648,16067,17225,1992,Saudi Arabia,Argentina,1,3,Confederations Cup,Riyadh,Saudi Arabia,False,4,-2,Argentina
14649,16068,17227,1992,Croatia,Mexico,3,0,Friendly,Zagreb,Croatia,False,3,3,Croatia
14650,16069,17228,1992,Kuwait,Oman,4,0,Friendly,Kuwait City,Kuwait,False,4,4,Kuwait
14651,16070,17229,1992,South Africa,Congo,1,0,FIFA World Cup qualification,Johannesburg,South Africa,False,1,1,South Africa
14652,16071,17230,1992,Benin,Morocco,0,1,FIFA World Cup qualification,Cotonou,Benin,False,1,-1,Morocco
14653,16072,17231,1992,Bermuda,Jamaica,1,1,FIFA World Cup qualification,Hamilton,Bermuda,False,2,0,Draw
14654,16073,17232,1992,Burundi,Ghana,1,0,FIFA World Cup qualification,Bujumbura,Burundi,False,1,1,Burundi
14655,16074,17233,1992,El Salvador,Canada,1,1,FIFA World Cup qualification,San Salvador,El Salvador,False,2,0,Draw
14656,16075,17234,1992,Ethiopia,Tunisia,0,0,FIFA World Cup qualification,Addis Abeba,Ethiopia,False,0,0,Draw
14657,16076,17235,1992,Kazakhstan,Kyrgyzstan,2,0,Friendly,Qyzylorda,Kazakhstan,False,2,2,Kazakhstan
14658,16077,17236,1992,Malta,Estonia,0,0,FIFA World Cup qualification,Attard,Malta,False,0,0,Draw
14659,16078,17237,1992,Mozambique,Senegal,0,1,FIFA World Cup qualification,Maputo,Mozambique,False,1,-1,Senegal
14660,16079,17238,1992,Namibia,Zambia,0,4,FIFA World Cup qualification,Windhoek,Namibia,False,4,-4,Zambia
14661,16080,17239,1992,Niger,Ivory Coast,0,0,FIFA World Cup qualification,Niamey,Niger,False,0,0,Draw
14662,16081,17240,1992,Eswatini,DR Congo,1,0,FIFA World Cup qualification,Manzini,Eswatini,False,1,1,Eswatini
14663,16082,17241,1992,Tanzania,Madagascar,0,0,FIFA World Cup qualification,Zanzibar,Tanzania,False,0,0,Draw
14664,16083,17242,1992,Togo,Egypt,1,4,FIFA World Cup qualification,Lomé,Togo,False,5,-3,Egypt
14665,16084,17243,1992,Turkmenistan,Uzbekistan,1,0,Friendly,Ashgabat,Turkmenistan,False,1,1,Turkmenistan
14666,16085,17244,1992,Austria,Israel,5,2,FIFA World Cup qualification,Vienna,Austria,False,7,3,Austria
14667,16086,17245,1992,Belarus,Ukraine,1,1,Friendly,Minsk,Belarus,False,2,0,Draw
14668,16087,17246,1992,Lithuania,Latvia,1,1,FIFA World Cup qualification,Vilnius,Lithuania,False,2,0,Draw
14669,16088,17247,1992,Russia,Luxembourg,2,0,FIFA World Cup qualification,Moscow,Russia,False,2,2,Russia
14670,16089,17248,1992,Turkey,San Marino,4,1,FIFA World Cup qualification,Ankara,Turkey,False,5,3,Turkey
14671,16090,17249,1992,Qatar,Thailand,1,1,AFC Asian Cup,Hiroshima,Japan,True,2,0,Draw
14672,16092,17251,1992,Japan,United Arab Emirates,0,0,AFC Asian Cup,Onomichi,Japan,False,0,0,Draw
14673,16093,17254,1992,Saudi Arabia,Qatar,1,1,AFC Asian Cup,Hiroshima,Japan,True,2,0,Draw
14674,16094,17255,1992,Canada,Jamaica,1,0,FIFA World Cup qualification,Toronto,Canada,False,1,1,Canada
14675,16095,17256,1992,El Salvador,Bermuda,4,1,FIFA World Cup qualification,San Salvador,El Salvador,False,5,3,El Salvador
14676,16097,17258,1992,United Arab Emirates,Iran,0,0,AFC Asian Cup,Hiroshima,Japan,True,0,0,Draw
14677,16098,17260,1992,Egypt,Kuwait,1,1,Friendly,Cairo,Egypt,False,2,0,Draw
14678,16099,17261,1992,Saudi Arabia,Thailand,4,0,AFC Asian Cup,Onomichi,Japan,True,4,4,Saudi Arabia
14679,16100,17262,1992,Japan,Iran,1,0,AFC Asian Cup,Hiroshima,Japan,False,1,1,Japan
14680,16103,17265,1992,Saudi Arabia,United Arab Emirates,2,0,AFC Asian Cup,Hiroshima,Japan,True,2,2,Saudi Arabia
14681,16104,17266,1992,Tunisia,Finland,1,1,Friendly,Tunis,Tunisia,False,2,0,Draw
14682,16105,17267,1992,Zimbabwe,Malawi,0,1,Friendly,Harare,Zimbabwe,False,1,-1,Malawi
14683,16106,17268,1992,Canada,El Salvador,2,3,FIFA World Cup qualification,Burnaby,Canada,False,5,-1,El Salvador
14684,16107,17270,1992,Costa Rica,Honduras,2,3,FIFA World Cup qualification,San José,Costa Rica,False,5,-1,Honduras
14685,16108,17271,1992,Jamaica,Bermuda,3,2,FIFA World Cup qualification,Kingston,Jamaica,False,5,1,Jamaica
14686,16109,17272,1992,Japan,Saudi Arabia,1,0,AFC Asian Cup,Hiroshima,Japan,False,1,1,Japan
14687,16110,17273,1992,Morocco,Egypt,0,0,African Cup of Nations qualification,Casablanca,Morocco,False,0,0,Draw
14688,16111,17274,1992,Togo,Guinea-Bissau,0,0,African Cup of Nations qualification,Lomé,Togo,False,0,0,Draw
14689,16112,17275,1992,Zimbabwe,Malawi,4,1,Friendly,Harare,Zimbabwe,False,5,3,Zimbabwe
14690,16113,17276,1992,Albania,Latvia,1,1,FIFA World Cup qualification,Tirana,Albania,False,2,0,Draw
14691,16114,17277,1992,Bulgaria,Portugal,1,2,Friendly,Saint-Ouen,France,True,3,-1,Portugal
14692,16115,17278,1992,Greece,Hungary,0,0,FIFA World Cup qualification,Salonica,Greece,False,0,0,Draw
14693,16116,17279,1992,Israel,Sweden,1,3,FIFA World Cup qualification,Ramat-Gan,Israel,False,4,-2,Sweden
14694,16117,17280,1992,France,Finland,2,1,FIFA World Cup qualification,Paris,France,False,3,1,France
14695,16119,17282,1992,Canada,Bermuda,4,2,FIFA World Cup qualification,Burnaby,Canada,False,6,2,Canada
14696,16121,17284,1992,Kenya,Uganda,1,1,CECAFA Cup,Arusha,Tanzania,True,2,0,Draw
14697,16122,17285,1992,Mexico,Honduras,2,0,FIFA World Cup qualification,Mexico City,Mexico,False,2,2,Mexico
14698,16123,17286,1992,Niger,Mali,0,1,Friendly,Niamey,Niger,False,1,-1,Mali
14699,16124,17287,1992,Tanzania,Malawi,1,1,CECAFA Cup,Mwanza,Tanzania,False,2,0,Draw
14700,16125,17288,1992,Ethiopia,Zambia,2,3,CECAFA Cup,Mwanza,Tanzania,True,5,-1,Zambia
14701,16126,17289,1992,United Arab Emirates,Senegal,1,1,Friendly,Abu Dhabi,United Arab Emirates,False,2,0,Draw
14702,16127,17290,1992,Belgium,Wales,2,0,FIFA World Cup qualification,Brussels,Belgium,False,2,2,Belgium
14703,16128,17291,1992,Cyprus,Slovenia,1,1,Friendly,Larnaca,Cyprus,False,2,0,Draw
14704,16129,17292,1992,England,Turkey,4,0,FIFA World Cup qualification,London,England,False,4,4,England
14705,16130,17293,1992,Germany,Austria,0,0,Friendly,Nuremberg,Germany,False,0,0,Draw
14706,16131,17294,1992,Kenya,Seychelles,2,1,CECAFA Cup,Arusha,Tanzania,True,3,1,Kenya
14707,16132,17295,1992,Northern Ireland,Denmark,0,1,FIFA World Cup qualification,Belfast,Northern Ireland,False,1,-1,Denmark
14708,16133,17296,1992,Poland,Latvia,1,0,Friendly,Iława,Poland,False,1,1,Poland
14709,16134,17297,1992,Scotland,Italy,0,0,FIFA World Cup qualification,Glasgow,Scotland,False,0,0,Draw
14710,16135,17298,1992,Spain,Republic of Ireland,0,0,FIFA World Cup qualification,Seville,Spain,False,0,0,Draw
14711,16136,17299,1992,Switzerland,Malta,3,0,FIFA World Cup qualification,Berne,Switzerland,False,3,3,Switzerland
14712,16138,17301,1992,Malawi,Zambia,1,0,CECAFA Cup,Mwanza,Tanzania,True,1,1,Malawi
14713,16139,17302,1992,United Arab Emirates,Senegal,2,2,Friendly,Abu Dhabi,United Arab Emirates,False,4,0,Draw
14714,16140,17303,1992,Egypt,Kuwait,1,1,Friendly,Cairo,Egypt,False,2,0,Draw
14715,16141,17304,1992,Tanzania,Ethiopia,2,1,CECAFA Cup,Mwanza,Tanzania,False,3,1,Tanzania
14716,16142,17305,1992,Seychelles,Uganda,2,5,CECAFA Cup,Arusha,Tanzania,True,7,-3,Uganda
14717,16144,17307,1992,Ethiopia,Malawi,1,2,CECAFA Cup,Mwanza,Tanzania,True,3,-1,Malawi
14718,16145,17308,1992,Jamaica,El Salvador,0,2,FIFA World Cup qualification,Kingston,Jamaica,False,2,-2,El Salvador
14719,16146,17309,1992,Mexico,Costa Rica,4,0,FIFA World Cup qualification,Mexico City,Mexico,False,4,4,Mexico
14720,16147,17310,1992,Tanzania,Zambia,1,2,CECAFA Cup,Mwanza,Tanzania,False,3,-1,Zambia
14721,16148,17311,1992,Algeria,United Arab Emirates,0,0,Friendly,Manama,Bahrain,True,0,0,Draw
14722,16150,17313,1992,Brazil,Uruguay,1,2,Friendly,Campina Grande,Brazil,False,3,-1,Uruguay
14723,16151,17314,1992,Uganda,Zambia,0,0,Friendly,Mwanza,Tanzania,True,0,0,Draw
14724,16152,17315,1992,Argentina,Poland,2,0,Friendly,Buenos Aires,Argentina,False,2,2,Argentina
14725,16153,17316,1992,Qatar,Oman,2,0,Gulf Cup,Doha,Qatar,False,2,2,Qatar
14726,16154,17317,1992,Malawi,Zambia,0,4,CECAFA Cup,Mwanza,Tanzania,True,4,-4,Zambia
14727,16155,17318,1992,Saudi Arabia,Bahrain,1,2,Gulf Cup,Doha,Qatar,True,3,-1,Bahrain
14728,16156,17319,1992,United Arab Emirates,Kuwait,0,2,Gulf Cup,Doha,Qatar,True,2,-2,Kuwait
14729,16157,17320,1992,Costa Rica,Mexico,2,0,FIFA World Cup qualification,San José,Costa Rica,False,2,2,Costa Rica
14730,16158,17321,1992,Cyprus,Romania,1,4,FIFA World Cup qualification,Larnaca,Cyprus,False,5,-3,Romania
14731,16159,17322,1992,Uruguay,Poland,0,1,Friendly,Montevideo,Uruguay,False,1,-1,Poland
14732,16160,17323,1992,Kuwait,Oman,2,1,Gulf Cup,Doha,Qatar,True,3,1,Kuwait
14733,16161,17324,1992,Saudi Arabia,United Arab Emirates,0,1,Gulf Cup,Doha,Qatar,True,1,-1,United Arab Emirates
14734,16162,17326,1992,Guatemala,Jamaica,2,1,Friendly,Guatemala,Guatemala,False,3,1,Guatemala
14735,16163,17327,1992,Israel,Bulgaria,0,2,FIFA World Cup qualification,Ramat-Gan,Israel,False,2,-2,Bulgaria
14736,16164,17328,1992,Qatar,Kuwait,4,0,Gulf Cup,Doha,Qatar,False,4,4,Qatar
14737,16165,17329,1992,Bahrain,United Arab Emirates,0,2,Gulf Cup,Doha,Qatar,True,2,-2,United Arab Emirates
14738,16166,17330,1992,Oman,Saudi Arabia,0,2,Gulf Cup,Doha,Qatar,True,2,-2,Saudi Arabia
14739,16167,17331,1992,Honduras,Costa Rica,2,1,FIFA World Cup qualification,Tegucigalpa,Honduras,False,3,1,Honduras
14740,16168,17332,1992,Bermuda,Canada,0,0,FIFA World Cup qualification,Hamilton,Bermuda,False,0,0,Draw
14741,16169,17333,1992,El Salvador,Jamaica,2,1,FIFA World Cup qualification,San Salvador,El Salvador,False,3,1,El Salvador
14742,16170,17334,1992,Kuwait,Saudi Arabia,1,2,Gulf Cup,Doha,Qatar,True,3,-1,Saudi Arabia
14743,16171,17335,1992,Qatar,United Arab Emirates,1,0,Gulf Cup,Doha,Qatar,False,1,1,Qatar
14744,16172,17336,1992,Bahrain,Oman,3,0,Gulf Cup,Doha,Qatar,True,3,3,Bahrain
14745,16173,17337,1992,Singapore,Malaysia,3,0,Merlion Cup,Kallang,Singapore,False,3,3,Singapore
14746,16174,17338,1992,Oman,United Arab Emirates,0,1,Gulf Cup,Doha,Qatar,True,1,-1,United Arab Emirates
14747,16175,17339,1992,Kuwait,Bahrain,0,1,Gulf Cup,Doha,Qatar,True,1,-1,Bahrain
14748,16176,17340,1992,Qatar,Saudi Arabia,0,1,Gulf Cup,Doha,Qatar,False,1,-1,Saudi Arabia
14749,16177,17341,1992,Honduras,Mexico,1,1,FIFA World Cup qualification,Tegucigalpa,Honduras,False,2,0,Draw
14750,16178,17342,1992,Niger,Ghana,0,1,Friendly,Niamey,Niger,False,1,-1,Ghana
14751,16179,17343,1992,Brazil,Germany,3,1,Friendly,Porto Alegre,Brazil,False,4,2,Brazil
14752,16180,17344,1992,Guinea,Sierra Leone,0,0,Friendly,Conakry,Guinea,False,0,0,Draw
14753,16181,17345,1992,Spain,Latvia,5,0,FIFA World Cup qualification,Seville,Spain,False,5,5,Spain
14754,16182,17346,1992,Turkey,Netherlands,1,3,FIFA World Cup qualification,Istanbul,Turkey,False,4,-2,Netherlands
14755,16183,17347,1992,Malta,Italy,1,2,FIFA World Cup qualification,Attard,Malta,False,3,-1,Italy
14756,16184,17348,1992,Tanzania,Namibia,2,0,FIFA World Cup qualification,Mwanza,Tanzania,False,2,2,Tanzania
14757,16185,17349,1992,Botswana,Niger,0,1,FIFA World Cup qualification,Gaborone,Botswana,False,1,-1,Niger
14758,16186,17350,1992,Congo,Nigeria,0,1,FIFA World Cup qualification,Pointe-Noire,Congo,False,1,-1,Nigeria
14759,16187,17351,1992,Ethiopia,Benin,3,1,FIFA World Cup qualification,Addis Abeba,Ethiopia,False,4,2,Ethiopia
14760,16188,17352,1992,Gabon,Senegal,3,2,FIFA World Cup qualification,Libreville,Gabon,False,5,1,Gabon
14761,16189,17353,1992,Ghana,Algeria,2,0,FIFA World Cup qualification,Accra,Ghana,False,2,2,Ghana
14762,16190,17354,1992,Guinea,Kenya,4,0,FIFA World Cup qualification,Conakry,Guinea,False,4,4,Guinea
14763,16191,17355,1992,Madagascar,Zambia,2,0,FIFA World Cup qualification,Antananarivo,Madagascar,False,2,2,Madagascar
14764,16192,17356,1992,Tunisia,Morocco,1,1,FIFA World Cup qualification,Tunis,Tunisia,False,2,0,Draw
14765,16193,17357,1992,Uruguay,Germany,1,4,Friendly,Montevideo,Uruguay,False,5,-3,Germany
14766,16194,17358,1992,Zimbabwe,Egypt,2,1,FIFA World Cup qualification,Harare,Zimbabwe,False,3,1,Zimbabwe
14767,16195,17359,1992,Cyprus,Georgia,1,0,Friendly,Limassol,Cyprus,False,1,1,Cyprus
14768,16196,17360,1992,Burkina Faso,Mali,3,1,Friendly,Ouagadougou,Burkina Faso,False,4,2,Burkina Faso
14769,16197,17361,1993,Ghana,Mali,1,1,Friendly,Libreville,Gabon,True,2,0,Draw
14770,16198,17362,1993,Gabon,Burkina Faso,1,1,Friendly,Libreville,Gabon,False,2,0,Draw
14771,16199,17363,1993,Kuwait,Lebanon,2,0,Friendly,Kuwait City,Kuwait,False,2,2,Kuwait
14772,16200,17364,1993,Burkina Faso,Mali,1,0,Friendly,Libreville,Gabon,True,1,1,Burkina Faso
14773,16201,17365,1993,Gabon,Ghana,2,3,Friendly,Libreville,Gabon,False,5,-1,Ghana
14774,16202,17366,1993,Uganda,Tanzania,3,1,Friendly,Kampala,Uganda,False,4,2,Uganda
14775,16203,17367,1993,Sierra Leone,Togo,0,0,African Cup of Nations qualification,Conakry,Guinea,True,0,0,Draw
14776,16204,17368,1993,Angola,Zimbabwe,1,1,FIFA World Cup qualification,Luanda,Angola,False,2,0,Draw
14777,16205,17369,1993,Botswana,South Africa,0,2,Friendly,Gaborone,Botswana,False,2,-2,South Africa
14778,16206,17370,1993,DR Congo,Cameroon,1,2,FIFA World Cup qualification,Kinshasa,Zaïre,False,3,-1,Cameroon
14779,16207,17371,1993,Senegal,Algeria,1,2,African Cup of Nations qualification,Dakar,Senegal,False,3,-1,Algeria
14780,16208,17372,1993,Tunisia,Bulgaria,3,0,Friendly,Béja,Tunisia,False,3,3,Tunisia
14781,16209,17373,1993,Uganda,Tanzania,2,0,Friendly,Kampala,Uganda,False,2,2,Uganda
14782,16210,17374,1993,South Africa,Nigeria,0,0,FIFA World Cup qualification,Johannesburg,South Africa,False,0,0,Draw
14783,16211,17375,1993,Tanzania,Zambia,1,3,FIFA World Cup qualification,Mwanza,Tanzania,False,4,-2,Zambia
14784,16212,17376,1993,Benin,Tunisia,0,5,FIFA World Cup qualification,Cotonou,Benin,False,5,-5,Tunisia
14785,16213,17377,1993,Botswana,Ivory Coast,0,0,FIFA World Cup qualification,Gaborone,Botswana,False,0,0,Draw
14786,16214,17378,1993,Burundi,Algeria,0,0,FIFA World Cup qualification,Bujumbura,Burundi,False,0,0,Draw
14787,16215,17379,1993,Ethiopia,Morocco,0,1,FIFA World Cup qualification,Addis Abeba,Ethiopia,False,1,-1,Morocco
14788,16216,17380,1993,Mozambique,Gabon,1,1,FIFA World Cup qualification,Maputo,Mozambique,False,2,0,Draw
14789,16217,17381,1993,Namibia,Madagascar,0,1,FIFA World Cup qualification,Windhoek,Namibia,False,1,-1,Madagascar
14790,16218,17382,1993,Eswatini,Cameroon,0,0,FIFA World Cup qualification,Mbabane,Eswatini,False,0,0,Draw
14791,16219,17383,1993,Togo,Zimbabwe,1,2,FIFA World Cup qualification,Lomé,Togo,False,3,-1,Zimbabwe
14792,16220,17384,1993,Angola,Egypt,0,0,FIFA World Cup qualification,Luanda,Angola,False,0,0,Draw
14793,16221,17386,1993,Guinea-Bissau,Guinea,2,1,Friendly,Bissau,Guinea-Bissau,False,3,1,Guinea-Bissau
14794,16222,17387,1993,India,Finland,0,0,Nehru Cup,Madras,India,False,0,0,Draw
14795,16223,17388,1993,Italy,Mexico,2,0,Friendly,Florence,Italy,False,2,2,Italy
14796,16224,17389,1993,Cameroon,Finland,0,0,Nehru Cup,Madras,India,True,0,0,Draw
14797,16225,17390,1993,Ghana,Niger,4,0,Friendly,Kumasi,Ghana,False,4,4,Ghana
14798,16226,17391,1993,Guinea-Bissau,Algeria,1,4,African Cup of Nations qualification,Bissau,Guinea-Bissau,False,5,-3,Algeria
14799,16227,17392,1993,Venezuela,Peru,0,0,Friendly,Puerto Ordaz,Venezuela,False,0,0,Draw
14800,16228,17393,1993,India,Cameroon,1,1,Nehru Cup,Madras,India,False,2,0,Draw
14801,16229,17394,1993,Malta,Portugal,0,1,FIFA World Cup qualification,Attard,Malta,False,1,-1,Portugal
14802,16230,17395,1993,Togo,Senegal,1,1,African Cup of Nations qualification,Lomé,Togo,False,2,0,Draw
14803,16231,17396,1993,Bolivia,Russia,1,2,Nehru Cup,Madras,India,True,3,-1,Russia
14804,16232,17397,1993,India,Finland,0,2,Nehru Cup,Madras,India,False,2,-2,Finland
14805,16233,17398,1993,Ecuador,Belarus,1,1,Friendly,Guayaquil,Ecuador,False,2,0,Draw
14806,16234,17399,1993,Peru,Honduras,1,1,Friendly,Lima,Peru,False,2,0,Draw
14807,16235,17400,1993,Spain,Mexico,1,1,Friendly,Las Palmas,Spain,False,2,0,Draw
14808,16236,17401,1993,Cameroon,Finland,2,0,Nehru Cup,Madras,India,True,2,2,Cameroon
14809,16237,17402,1993,Bolivia,Honduras,3,1,Friendly,Cochabamba,Bolivia,False,4,2,Bolivia
14810,16238,17403,1993,India,Cameroon,2,2,Nehru Cup,Madras,India,False,4,0,Draw
14811,16239,17404,1993,Peru,Belarus,1,1,Friendly,Lima,Peru,False,2,0,Draw
14812,16240,17405,1993,Senegal,Mozambique,6,1,FIFA World Cup qualification,Dakar,Senegal,False,7,5,Senegal
14813,16241,17406,1993,United States,Denmark,2,2,Friendly,Tempe,United States,False,4,0,Draw
14814,16242,17407,1993,Zambia,Namibia,4,0,FIFA World Cup qualification,Lusaka,Zambia,False,4,4,Zambia
14815,16243,17408,1993,Congo,South Africa,0,1,FIFA World Cup qualification,Pointe-Noire,Congo,False,1,-1,South Africa
14816,16244,17409,1993,Ecuador,Romania,3,0,Friendly,Guayaquil,Ecuador,False,3,3,Ecuador
14817,16245,17410,1993,Egypt,Togo,3,0,FIFA World Cup qualification,Cairo,Egypt,False,3,3,Egypt
14818,16246,17411,1993,Ghana,Burundi,1,0,FIFA World Cup qualification,Kumasi,Ghana,False,1,1,Ghana
14819,16247,17412,1993,Ivory Coast,Niger,1,0,FIFA World Cup qualification,Abidjan,Ivory Coast,False,1,1,Ivory Coast
14820,16248,17414,1993,Morocco,Benin,5,0,FIFA World Cup qualification,Rabat,Morocco,False,5,5,Morocco
14821,16249,17415,1993,Tunisia,Ethiopia,3,0,FIFA World Cup qualification,Tunis,Tunisia,False,3,3,Tunisia
14822,16250,17416,1993,Zimbabwe,Angola,2,1,FIFA World Cup qualification,Harare,Zimbabwe,False,3,1,Zimbabwe
14823,16251,17417,1993,Cyprus,Poland,0,0,Friendly,Nicosia,Cyprus,False,0,0,Draw
14824,16252,17418,1993,Israel,Poland,0,0,Friendly,Ramat-Gan,Israel,False,0,0,Draw
14825,16253,17419,1993,Peru,Romania,0,2,Friendly,Lima,Peru,False,2,-2,Romania
14826,16254,17420,1993,Malaysia,Singapore,2,1,Merdeka Tournament,Kuala Lumpur,Malaysia,False,3,1,Malaysia
14827,16255,17421,1993,Ghana,Indonesia,2,0,Merdeka Tournament,Kuala Lumpur,Malaysia,True,2,2,Ghana
14828,16256,17422,1993,United States,Romania,1,1,Friendly,Santa Barbara,United States,False,2,0,Draw
14829,16257,17423,1993,Malaysia,Thailand,1,1,Merdeka Tournament,Kuala Lumpur,Malaysia,False,2,0,Draw
14830,16258,17425,1993,Singapore,Thailand,1,1,Merdeka Tournament,Kuala Lumpur,Malaysia,True,2,0,Draw
14831,16260,17427,1993,Mexico,Romania,0,2,Friendly,Monterrey,Mexico,False,2,-2,Romania
14832,16261,17428,1993,Portugal,Norway,1,1,Friendly,Faro,Portugal,False,2,0,Draw
14833,16263,17430,1993,Cyprus,Belgium,0,3,FIFA World Cup qualification,Nicosia,Cyprus,False,3,-3,Belgium
14834,16264,17431,1993,United States,Russia,0,1,Friendly,Orlando,United States,False,1,-1,Russia
14835,16266,17433,1993,Costa Rica,Nicaragua,6,0,UNCAF Cup,San José,Costa Rica,False,6,6,Costa Rica
14836,16268,17435,1993,Albania,Northern Ireland,1,2,FIFA World Cup qualification,Tirana,Albania,False,3,-1,Northern Ireland
14837,16269,17436,1993,El Salvador,Russia,1,2,Friendly,Pasadena,United States,True,3,-1,Russia
14838,16270,17437,1993,England,San Marino,6,0,FIFA World Cup qualification,London,England,False,6,6,England
14839,16271,17438,1993,Greece,Luxembourg,2,0,FIFA World Cup qualification,Athens,Greece,False,2,2,Greece
14840,16272,17439,1993,Republic of Ireland,Wales,2,1,Friendly,Dublin,Republic of Ireland,False,3,1,Republic of Ireland
14841,16273,17440,1993,Israel,France,0,4,FIFA World Cup qualification,Ramat-Gan,Israel,False,4,-4,France
14842,16274,17441,1993,Scotland,Malta,3,0,FIFA World Cup qualification,Glasgow,Scotland,False,3,3,Scotland
14843,16275,17442,1993,Argentina,Brazil,1,1,Friendly,Buenos Aires,Argentina,False,2,0,Draw
14844,16276,17443,1993,United Arab Emirates,Bulgaria,1,0,Friendly,Dubai,United Arab Emirates,False,1,1,United Arab Emirates
14845,16277,17444,1993,Costa Rica,Nicaragua,2,0,UNCAF Cup,San José,Costa Rica,False,2,2,Costa Rica
14846,16278,17445,1993,Finland,Estonia,0,0,Friendly,Vantaa,Finland,False,0,0,Draw
14847,16279,17446,1993,Latvia,Lithuania,1,2,Friendly,Vantaa,Finland,True,3,-1,Lithuania
14848,16280,17447,1993,United Arab Emirates,Bulgaria,1,3,Friendly,Dubai,United Arab Emirates,False,4,-2,Bulgaria
14849,16281,17448,1993,Estonia,Latvia,0,2,Friendly,Vantaa,Finland,True,2,-2,Latvia
14850,16282,17449,1993,Finland,Lithuania,3,0,Friendly,Vantaa,Finland,False,3,3,Finland
14851,16283,17450,1993,United States,Russia,0,0,Friendly,Palo Alto,United States,False,0,0,Draw
14852,16284,17451,1993,Argentina,Denmark,1,1,Friendly,Mar del Plata,Argentina,False,2,0,Draw
14853,16286,17453,1993,Netherlands,Turkey,3,1,FIFA World Cup qualification,Utrecht,Netherlands,False,4,2,Netherlands
14854,16287,17454,1993,Portugal,Italy,1,3,FIFA World Cup qualification,Porto,Portugal,False,4,-2,Italy
14855,16288,17455,1993,Spain,Lithuania,5,0,FIFA World Cup qualification,Seville,Spain,False,5,5,Spain
14856,16289,17456,1993,Venezuela,Colombia,0,0,Friendly,San Cristóbal,Venezuela,False,0,0,Draw
14857,16290,17457,1993,Algeria,Ghana,2,1,FIFA World Cup qualification,Tlemcen,Algeria,False,3,1,Algeria
14858,16291,17458,1993,Kenya,Guinea,2,0,FIFA World Cup qualification,Nairobi,Kenya,False,2,2,Kenya
14859,16292,17459,1993,Nigeria,Congo,2,0,FIFA World Cup qualification,Enugu,Nigeria,False,2,2,Nigeria
14860,16293,17460,1993,Senegal,Gabon,1,0,FIFA World Cup qualification,Dakar,Senegal,False,1,1,Senegal
14861,16294,17461,1993,Benin,Ethiopia,1,0,FIFA World Cup qualification,Cotonou,Benin,False,1,1,Benin
14862,16295,17462,1993,Morocco,Tunisia,0,0,FIFA World Cup qualification,Casablanca,Morocco,False,0,0,Draw
14863,16296,17463,1993,Niger,Botswana,2,1,FIFA World Cup qualification,Niamey,Niger,False,3,1,Niger
14864,16297,17464,1993,Togo,Angola,0,1,FIFA World Cup qualification,Lomé,Togo,False,1,-1,Angola
14865,16298,17465,1993,Zambia,Madagascar,3,1,FIFA World Cup qualification,Lusaka,Zambia,False,4,2,Zambia
14866,16299,17466,1993,Cameroon,DR Congo,0,0,FIFA World Cup qualification,Yaoundé,Cameroon,False,0,0,Draw
14867,16300,17467,1993,Jordan,Syria,1,1,Friendly,Irbid,Jordan,False,2,0,Draw
14868,16301,17468,1993,Martinique,French Guiana,2,1,CFU Caribbean Cup qualification,Fort-de-France,Martinique,False,3,1,Martinique
14869,16302,17469,1993,Paraguay,Bolivia,1,0,Copa Paz del Chaco,Asunción,Paraguay,False,1,1,Paraguay
14870,16303,17470,1993,El Salvador,Costa Rica,0,1,UNCAF Cup,Tegucigalpa,Honduras,True,1,-1,Costa Rica
14871,16304,17471,1993,Honduras,Panama,2,0,UNCAF Cup,Tegucigalpa,Honduras,False,2,2,Honduras
14872,16305,17472,1993,El Salvador,Panama,1,1,UNCAF Cup,Tegucigalpa,Honduras,True,2,0,Draw
14873,16306,17473,1993,Honduras,Costa Rica,2,0,UNCAF Cup,Tegucigalpa,Honduras,False,2,2,Honduras
14874,16307,17474,1993,Japan,Hungary,0,1,Kirin Cup,Fukuoka,Japan,False,1,-1,Hungary
14875,16309,17476,1993,Costa Rica,Panama,2,0,UNCAF Cup,Tegucigalpa,Honduras,True,2,2,Costa Rica
14876,16310,17477,1993,Honduras,El Salvador,3,0,UNCAF Cup,Tegucigalpa,Honduras,False,3,3,Honduras
14877,16311,17478,1993,Austria,Greece,2,1,Friendly,Vienna,Austria,False,3,1,Austria
14878,16312,17479,1993,Hungary,United States,0,0,Kirin Cup,Nagoya,Japan,True,0,0,Draw
14879,16313,17480,1993,San Marino,Turkey,0,0,FIFA World Cup qualification,Serravalle,San Marino,False,0,0,Draw
14880,16315,17482,1993,Guyana,Cayman Islands,3,2,CFU Caribbean Cup qualification,Georgetown,Guyana,False,5,1,Guyana
14881,16316,17483,1993,Puerto Rico,Barbados,1,0,CFU Caribbean Cup qualification,Georgetown,Guyana,True,1,1,Puerto Rico
14882,16317,17484,1993,Cayman Islands,Barbados,1,6,CFU Caribbean Cup qualification,Georgetown,Guyana,True,7,-5,Barbados
14883,16318,17485,1993,El Salvador,Bolivia,2,2,Friendly,San Salvador,El Salvador,False,4,0,Draw
14884,16319,17486,1993,Guyana,Puerto Rico,0,2,CFU Caribbean Cup qualification,Georgetown,Guyana,False,2,-2,Puerto Rico
14885,16320,17487,1993,Qatar,Jordan,1,2,Friendly,Doha,Qatar,False,3,-1,Jordan
14886,16321,17488,1993,Guyana,Barbados,0,3,CFU Caribbean Cup qualification,Georgetown,Guyana,False,3,-3,Barbados
14887,16322,17489,1993,Honduras,Bolivia,0,0,Friendly,San Pedro Sula,Honduras,False,0,0,Draw
14888,16323,17490,1993,Japan,United States,3,1,Kirin Cup,Tokyo,Japan,False,4,2,Japan
14889,16324,17491,1993,Puerto Rico,Cayman Islands,4,0,CFU Caribbean Cup qualification,Georgetown,Guyana,True,4,4,Puerto Rico
14890,16325,17492,1993,Honduras,Bolivia,0,0,Friendly,Tegucigalpa,Honduras,False,0,0,Draw
14891,16326,17493,1993,Kuwait,Syria,2,1,Friendly,Kuwait City,Kuwait,False,3,1,Kuwait
14892,16327,17494,1993,Brazil,Poland,2,2,Friendly,Ribeirão Preto,Brazil,False,4,0,Draw
14893,16328,17495,1993,Tunisia,Switzerland,0,1,Friendly,Tunis,Tunisia,False,1,-1,Switzerland
14894,16329,17496,1993,El Salvador,United States,2,2,Friendly,San Salvador,El Salvador,False,4,0,Draw
14895,16330,17497,1993,Costa Rica,Canada,0,1,Friendly,San José,Costa Rica,False,1,-1,Canada
14896,16331,17498,1993,Cyprus,Czech Republic,1,1,FIFA World Cup qualification,Limassol,Cyprus,False,2,0,Draw
14897,16332,17499,1993,French Guiana,Guadeloupe,2,1,CFU Caribbean Cup qualification,Cayenne,French Guiana,False,3,1,French Guiana
14898,16333,17500,1993,Israel,Russia,2,2,Friendly,Haifa,Israel,False,4,0,Draw
14899,16334,17501,1993,Italy,Malta,6,1,FIFA World Cup qualification,Palermo,Italy,False,7,5,Italy
14900,16335,17502,1993,Netherlands,San Marino,6,0,FIFA World Cup qualification,Utrecht,Netherlands,False,6,6,Netherlands
14901,16336,17503,1993,Scotland,Germany,0,1,Friendly,Glasgow,Scotland,False,1,-1,Germany
14902,16337,17504,1993,Honduras,United States,4,1,Friendly,Tegucigalpa,Honduras,False,5,3,Honduras
14903,16338,17505,1993,Lebanon,Jordan,1,0,Friendly,Beirut,Lebanon,False,1,1,Lebanon
14904,16339,17506,1993,Austria,France,0,1,FIFA World Cup qualification,Vienna,Austria,False,1,-1,France
14905,16340,17507,1993,Malawi,Zambia,1,0,Friendly,Lilongwe,Malawi,False,1,1,Malawi
14906,16341,17508,1993,Qatar,Norway,1,6,Friendly,Doha,Qatar,False,7,-5,Norway
14907,16342,17509,1993,Slovakia,Lithuania,2,2,Friendly,Dunajská Streda,Slovakia,False,4,0,Draw
14908,16343,17510,1993,Chile,Bolivia,2,1,Friendly,Arica,Chile,False,3,1,Chile
14909,16344,17511,1993,Colombia,Costa Rica,4,1,Friendly,Medellín,Colombia,False,5,3,Colombia
14910,16345,17512,1993,Denmark,Spain,1,0,FIFA World Cup qualification,Copenhagen,Denmark,False,1,1,Denmark
14911,16346,17513,1993,Hungary,Greece,0,1,FIFA World Cup qualification,Budapest,Hungary,False,1,-1,Greece
14912,16347,17514,1993,Republic of Ireland,Northern Ireland,3,0,FIFA World Cup qualification,Dublin,Republic of Ireland,False,3,3,Republic of Ireland
14913,16348,17515,1993,Poland,Lithuania,1,1,Friendly,Brzeszcze,Poland,False,2,0,Draw
14914,16349,17516,1993,Switzerland,Portugal,1,1,FIFA World Cup qualification,Berne,Switzerland,False,2,0,Draw
14915,16350,17517,1993,Turkey,England,0,2,FIFA World Cup qualification,Izmir,Turkey,False,2,-2,England
14916,16351,17518,1993,Wales,Belgium,2,0,FIFA World Cup qualification,Cardiff,Wales,False,2,2,Wales
14917,16352,17519,1993,Malaysia,United Arab Emirates,0,1,Friendly,Kuala Lumpur,Malaysia,False,1,-1,United Arab Emirates
14918,16354,17521,1993,Niger,Benin,2,2,Friendly,Niamey,Niger,False,4,0,Draw
14919,16355,17522,1993,Anguilla,Antigua and Barbuda,0,4,CFU Caribbean Cup qualification,The Valley,Anguilla,False,4,-4,Antigua and Barbuda
14920,16357,17524,1993,El Salvador,Mexico,2,1,FIFA World Cup qualification,San Salvador,El Salvador,False,3,1,El Salvador
14921,16358,17525,1993,Honduras,Canada,2,2,FIFA World Cup qualification,Tegucigalpa,Honduras,False,4,0,Draw
14922,16359,17526,1993,Kuwait,Egypt,1,3,Friendly,Kuwait City,Kuwait,False,4,-2,Egypt
14923,16360,17527,1993,Antigua and Barbuda,Sint Maarten,0,2,CFU Caribbean Cup qualification,The Valley,Anguilla,True,2,-2,Sint Maarten
14924,16361,17528,1993,Anguilla,Sint Maarten,0,1,CFU Caribbean Cup qualification,The Valley,Anguilla,False,1,-1,Sint Maarten
14925,16362,17529,1993,Saint Kitts and Nevis,Dominican Republic,2,2,CFU Caribbean Cup qualification,Basseterre,Saint Kitts and Nevis,False,4,0,Draw
14926,16363,17530,1993,Slovenia,Estonia,2,0,Friendly,Ljubljana,Slovenia,False,2,2,Slovenia
14927,16364,17531,1993,Japan,Thailand,1,0,FIFA World Cup qualification,Kobe,Japan,False,1,1,Japan
14928,16365,17532,1993,Sri Lanka,United Arab Emirates,0,4,FIFA World Cup qualification,Kyoto,Japan,True,4,-4,United Arab Emirates
14929,16366,17533,1993,Algeria,Sierra Leone,0,0,African Cup of Nations qualification,Annaba,Algeria,False,0,0,Draw
14930,16367,17534,1993,Egypt,Mali,2,1,African Cup of Nations qualification,Cairo,Egypt,False,3,1,Egypt
14931,16368,17536,1993,Oman,Malaysia,1,0,Friendly,Muscat,Oman,False,1,1,Oman
14932,16369,17537,1993,Qatar,Indonesia,3,1,FIFA World Cup qualification,Doha,Qatar,False,4,2,Qatar
14933,16370,17538,1993,South Africa,Mauritius,0,0,African Cup of Nations qualification,Johannesburg,South Africa,False,0,0,Draw
14934,16371,17539,1993,Canada,El Salvador,2,0,FIFA World Cup qualification,Burnaby,Canada,False,2,2,Canada
14935,16372,17540,1993,Ethiopia,Nigeria,1,0,African Cup of Nations qualification,Addis Abeba,Ethiopia,False,1,1,Ethiopia
14936,16373,17541,1993,Gabon,Benin,2,0,African Cup of Nations qualification,Libreville,Gabon,False,2,2,Gabon
14937,16374,17542,1993,Guinea,Congo,1,0,African Cup of Nations qualification,Conakry,Guinea,False,1,1,Guinea
14938,16375,17543,1993,Guinea-Bissau,Senegal,0,3,African Cup of Nations qualification,Bissau,Guinea-Bissau,False,3,-3,Senegal
14939,16376,17544,1993,Japan,Bangladesh,8,0,FIFA World Cup qualification,Tokyo,Japan,False,8,8,Japan
14940,16377,17546,1993,Lesotho,DR Congo,1,1,African Cup of Nations qualification,Maseru,Lesotho,False,2,0,Draw
14941,16378,17547,1993,Mexico,Honduras,3,0,FIFA World Cup qualification,Mexico City,Mexico,False,3,3,Mexico
14942,16379,17548,1993,Morocco,Malawi,0,1,African Cup of Nations qualification,Rabat,Morocco,False,1,-1,Malawi
14943,16380,17549,1993,Mozambique,Kenya,0,0,African Cup of Nations qualification,Maputo,Mozambique,False,0,0,Draw
14944,16381,17550,1993,Niger,Cameroon,0,0,African Cup of Nations qualification,Niamey,Niger,False,0,0,Draw
14945,16382,17551,1993,Qatar,Vietnam,4,0,FIFA World Cup qualification,Doha,Qatar,False,4,4,Qatar
14946,16383,17552,1993,Thailand,Sri Lanka,1,0,FIFA World Cup qualification,Kobe,Japan,True,1,1,Thailand
14947,16384,17554,1993,Poland,Finland,2,1,Friendly,Radom,Poland,False,3,1,Poland
14948,16385,17555,1993,Sri Lanka,Bangladesh,0,1,FIFA World Cup qualification,Yokohama,Japan,True,1,-1,Bangladesh
14949,16386,17556,1993,United Arab Emirates,Thailand,1,0,FIFA World Cup qualification,Tokyo,Japan,True,1,1,United Arab Emirates
14950,16387,17557,1993,Vietnam,Singapore,2,3,FIFA World Cup qualification,Doha,Qatar,True,5,-1,Singapore
14951,16388,17558,1993,Austria,Bulgaria,3,1,FIFA World Cup qualification,Vienna,Austria,False,4,2,Austria
14952,16389,17559,1993,Denmark,Latvia,2,0,FIFA World Cup qualification,Copenhagen,Denmark,False,2,2,Denmark
14953,16390,17560,1993,Germany,Ghana,6,1,Friendly,Bochum,Germany,False,7,5,Germany
14954,16391,17561,1993,Guadeloupe,Martinique,1,4,CFU Caribbean Cup qualification,Pointe-à-Pitre,Guadeloupe,False,5,-3,Martinique
14955,16392,17562,1993,Italy,Estonia,2,0,FIFA World Cup qualification,Trieste,Italy,False,2,2,Italy
14956,16393,17563,1993,Lithuania,Albania,3,1,FIFA World Cup qualification,Vilnius,Lithuania,False,4,2,Lithuania
14957,16394,17564,1993,Luxembourg,Russia,0,4,FIFA World Cup qualification,Luxembourg,Luxembourg,False,4,-4,Russia
14958,16395,17565,1993,Romania,Cyprus,2,1,FIFA World Cup qualification,Bucharest,Romania,False,3,1,Romania
14959,16396,17566,1993,Egypt,Zimbabwe,0,0,FIFA World Cup qualification,Lyon,France,True,0,0,Draw
14960,16397,17567,1993,Hungary,Sweden,0,2,Friendly,Budapest,Hungary,False,2,-2,Sweden
14961,16398,17568,1993,Japan,Sri Lanka,5,0,FIFA World Cup qualification,Tokyo,Japan,False,5,5,Japan
14962,16399,17569,1993,United Arab Emirates,Bangladesh,1,0,FIFA World Cup qualification,Yokohama,Japan,True,1,1,United Arab Emirates
14963,16400,17570,1993,Algeria,Ivory Coast,1,1,FIFA World Cup qualification,Tlemcen,Algeria,False,2,0,Draw
14964,16401,17571,1993,Australia,Kuwait,1,0,Friendly,Singapore,Singapore,True,1,1,Australia
14965,16402,17572,1993,Qatar,Singapore,4,1,FIFA World Cup qualification,Doha,Qatar,False,5,3,Qatar
14966,16403,17573,1993,Vietnam,Indonesia,1,0,FIFA World Cup qualification,Doha,Qatar,True,1,1,Vietnam
14967,16404,17574,1993,Malta,Switzerland,0,2,FIFA World Cup qualification,Attard,Malta,False,2,-2,Switzerland
14968,16405,17575,1993,United States,Iceland,1,1,Friendly,Costa Mesa,United States,False,2,0,Draw
14969,16406,17576,1993,Cameroon,Guinea,3,1,FIFA World Cup qualification,Yaoundé,Cameroon,False,4,2,Cameroon
14970,16407,17577,1993,Canada,Honduras,3,1,FIFA World Cup qualification,Burnaby,Canada,False,4,2,Canada
14971,16408,17578,1993,Indonesia,Singapore,0,2,FIFA World Cup qualification,Doha,Qatar,True,2,-2,Singapore
14972,16409,17579,1993,Japan,United Arab Emirates,2,0,FIFA World Cup qualification,Tokyo,Japan,False,2,2,Japan
14973,16410,17580,1993,Mexico,El Salvador,3,1,FIFA World Cup qualification,Mexico City,Mexico,False,4,2,Mexico
14974,16411,17581,1993,Morocco,Senegal,1,0,FIFA World Cup qualification,Casablanca,Morocco,False,1,1,Morocco
14975,16413,17583,1993,Saudi Arabia,New Zealand,3,1,Friendly,Singapore,Singapore,True,4,2,Saudi Arabia
14976,16414,17584,1993,Thailand,Bangladesh,4,1,FIFA World Cup qualification,Tokyo,Japan,True,5,3,Thailand
14977,16415,17585,1993,Australia,Kuwait,1,3,Friendly,Singapore,Singapore,True,4,-2,Kuwait
14978,16416,17586,1993,Singapore,Saudi Arabia,0,3,Friendly,Singapore,Singapore,False,3,-3,Saudi Arabia
14979,16417,17587,1993,Hong Kong,Kuwait,2,2,Friendly,Singapore,Singapore,True,4,0,Draw
14980,16418,17588,1993,Indonesia,Qatar,1,4,FIFA World Cup qualification,Singapore,Singapore,True,5,-3,Qatar
14981,16419,17589,1993,Kenya,Lesotho,3,0,African Cup of Nations qualification,Nairobi,Kenya,False,3,3,Kenya
14982,16420,17590,1993,Saudi Arabia,New Zealand,1,0,Friendly,Singapore,Singapore,True,1,1,Saudi Arabia
14983,16421,17591,1993,Sierra Leone,Guinea-Bissau,2,0,African Cup of Nations qualification,Freetown,Sierra Leone,False,2,2,Sierra Leone
14984,16422,17592,1993,South Africa,Zimbabwe,1,1,African Cup of Nations qualification,Johannesburg,South Africa,False,2,0,Draw
14985,16424,17594,1993,Cameroon,Gabon,0,0,African Cup of Nations qualification,Yaoundé,Cameroon,False,0,0,Draw
14986,16425,17595,1993,Congo,Burundi,0,0,African Cup of Nations qualification,Pointe-Noire,Congo,False,0,0,Draw
14987,16426,17596,1993,Cyprus,Faroe Islands,3,1,FIFA World Cup qualification,Limassol,Cyprus,False,4,2,Cyprus
14988,16427,17597,1993,Ethiopia,Uganda,2,2,African Cup of Nations qualification,Addis Abeba,Ethiopia,False,4,0,Draw
14989,16428,17598,1993,Grenada,Dominica,1,1,CFU Caribbean Cup qualification,St. George's,Grenada,False,2,0,Draw
14990,16429,17599,1993,Honduras,El Salvador,2,0,FIFA World Cup qualification,Tegucigalpa,Honduras,False,2,2,Honduras
14991,16430,17600,1993,Hong Kong,Kuwait,0,1,Friendly,Singapore,Singapore,True,1,-1,Kuwait
14992,16431,17602,1993,Mauritius,Zambia,0,3,African Cup of Nations qualification,Port Louis,Mauritius,False,3,-3,Zambia
14993,16432,17603,1993,Mexico,Canada,4,0,FIFA World Cup qualification,Mexico City,Mexico,False,4,4,Mexico
14994,16433,17604,1993,Morocco,Mali,1,0,African Cup of Nations qualification,Casablanca,Morocco,False,1,1,Morocco
14995,16434,17605,1993,Mozambique,DR Congo,0,0,African Cup of Nations qualification,Maputo,Mozambique,False,0,0,Draw
14996,16435,17606,1993,Niger,Benin,4,1,African Cup of Nations qualification,Niamey,Niger,False,5,3,Niger
14997,16436,17607,1993,Saint Vincent and the Grenadines,Saint Lucia,0,1,CFU Caribbean Cup qualification,St. George's,Grenada,True,1,-1,Saint Lucia
14998,16438,17609,1993,Vietnam,Qatar,0,4,FIFA World Cup qualification,Singapore,Singapore,True,4,-4,Qatar
14999,16439,17610,1993,Dominica,Saint Lucia,2,4,CFU Caribbean Cup qualification,St. George's,Grenada,True,6,-2,Saint Lucia
15000,16440,17611,1993,Ukraine,Israel,1,1,Friendly,Odesa,Ukraine,False,2,0,Draw
15001,16441,17612,1993,Bulgaria,Finland,2,0,FIFA World Cup qualification,Sofia,Bulgaria,False,2,2,Bulgaria
15002,16442,17613,1993,Czech Republic,Wales,1,1,FIFA World Cup qualification,Ostrava,Czech Republic,False,2,0,Draw
15003,16443,17614,1993,England,Netherlands,2,2,FIFA World Cup qualification,London,England,False,4,0,Draw
15004,16444,17615,1993,France,Sweden,2,1,FIFA World Cup qualification,Paris,France,False,3,1,France
15005,16446,17617,1993,Republic of Ireland,Denmark,1,1,FIFA World Cup qualification,Dublin,Republic of Ireland,False,2,0,Draw
15006,16447,17619,1993,Norway,Turkey,3,1,FIFA World Cup qualification,Oslo,Norway,False,4,2,Norway
15007,16448,17620,1993,Poland,San Marino,1,0,FIFA World Cup qualification,Łódź,Poland,False,1,1,Poland
15008,16449,17621,1993,Portugal,Scotland,5,0,FIFA World Cup qualification,Lisbon,Portugal,False,5,5,Portugal
15009,16450,17622,1993,Russia,Hungary,3,0,FIFA World Cup qualification,Moscow,Russia,False,3,3,Russia
15010,16451,17623,1993,Singapore,Vietnam,1,0,FIFA World Cup qualification,Singapore,Singapore,False,1,1,Singapore
15011,16452,17624,1993,Spain,Northern Ireland,3,1,FIFA World Cup qualification,Seville,Spain,False,4,2,Spain
15012,16453,17625,1993,Thailand,Japan,0,1,FIFA World Cup qualification,Dubai,United Arab Emirates,True,1,-1,Japan
15013,16454,17626,1993,United Arab Emirates,Sri Lanka,3,0,FIFA World Cup qualification,Al Ain,United Arab Emirates,False,3,3,United Arab Emirates
15014,16455,17627,1993,Dominica,Saint Vincent and the Grenadines,0,2,CFU Caribbean Cup qualification,St. George's,Grenada,True,2,-2,Saint Vincent and the Grenadines
15015,16456,17628,1993,Grenada,Saint Lucia,0,1,CFU Caribbean Cup qualification,St. George's,Grenada,False,1,-1,Saint Lucia
15016,16457,17629,1993,Bangladesh,Japan,1,4,FIFA World Cup qualification,Dubai,United Arab Emirates,True,5,-3,Japan
15017,16458,17630,1993,Indonesia,Vietnam,2,1,FIFA World Cup qualification,Singapore,Singapore,True,3,1,Indonesia
15018,16459,17631,1993,Singapore,Qatar,1,0,FIFA World Cup qualification,Singapore,Singapore,False,1,1,Singapore
15019,16460,17632,1993,United Arab Emirates,Thailand,2,1,FIFA World Cup qualification,Al Ain,United Arab Emirates,False,3,1,United Arab Emirates
15020,16461,17633,1993,Macau,Saudi Arabia,0,6,FIFA World Cup qualification,Kuala Lumpur,Malaysia,True,6,-6,Saudi Arabia
15021,16462,17634,1993,Malaysia,Kuwait,1,1,FIFA World Cup qualification,Kuala Lumpur,Malaysia,False,2,0,Draw
15022,16463,17635,1993,Switzerland,Italy,1,0,FIFA World Cup qualification,Berne,Switzerland,False,1,1,Switzerland
15023,16464,17636,1993,El Salvador,Canada,1,2,FIFA World Cup qualification,San Salvador,El Salvador,False,3,-1,Canada
15024,16465,17637,1993,Guinea,Zimbabwe,3,0,FIFA World Cup qualification,Conakry,Guinea,False,3,3,Guinea
15025,16466,17638,1993,Honduras,Mexico,1,4,FIFA World Cup qualification,Tegucigalpa,Honduras,False,5,-3,Mexico
15026,16467,17639,1993,Ivory Coast,Nigeria,2,1,FIFA World Cup qualification,Abidjan,Ivory Coast,False,3,1,Ivory Coast
15027,16468,17641,1993,Singapore,Indonesia,2,1,FIFA World Cup qualification,Singapore,Singapore,False,3,1,Singapore
15028,16469,17642,1993,Guernsey,Jersey,1,2,Friendly,St. Sampson,Guernsey,False,3,-1,Jersey
15029,16470,17643,1993,Macau,Kuwait,1,10,FIFA World Cup qualification,Kuala Lumpur,Malaysia,True,11,-9,Kuwait
15030,16471,17644,1993,Malaysia,Saudi Arabia,1,1,FIFA World Cup qualification,Kuala Lumpur,Malaysia,False,2,0,Draw
15031,16472,17645,1993,Sri Lanka,Thailand,0,3,FIFA World Cup qualification,Dubai,United Arab Emirates,True,3,-3,Thailand
15032,16473,17646,1993,United Arab Emirates,Bangladesh,7,0,FIFA World Cup qualification,Al Ain,United Arab Emirates,False,7,7,United Arab Emirates
15033,16474,17647,1993,Bangladesh,Thailand,1,4,FIFA World Cup qualification,Dubai,United Arab Emirates,True,5,-3,Thailand
15034,16475,17648,1993,Kuwait,Saudi Arabia,0,0,FIFA World Cup qualification,Kuala Lumpur,Malaysia,True,0,0,Draw
15035,16476,17649,1993,Malaysia,Macau,9,0,FIFA World Cup qualification,Kuala Lumpur,Malaysia,False,9,9,Malaysia
15036,16477,17650,1993,Sri Lanka,Japan,0,6,FIFA World Cup qualification,Dubai,United Arab Emirates,True,6,-6,Japan
15037,16478,17651,1993,Bangladesh,Sri Lanka,3,0,FIFA World Cup qualification,Dubai,United Arab Emirates,True,3,3,Bangladesh
15038,16479,17652,1993,Hong Kong,Bahrain,2,1,FIFA World Cup qualification,Beirut,Lebanon,True,3,1,Hong Kong
15039,16480,17653,1993,Lebanon,India,2,2,FIFA World Cup qualification,Beirut,Lebanon,False,4,0,Draw
15040,16481,17654,1993,United Arab Emirates,Japan,1,1,FIFA World Cup qualification,Al Ain,United Arab Emirates,False,2,0,Draw
15041,16482,17655,1993,United States,Colombia,1,2,Friendly,Miami,United States,False,3,-1,Colombia
15042,16484,17657,1993,Canada,Mexico,1,2,FIFA World Cup qualification,Toronto,Canada,False,3,-1,Mexico
15043,16485,17658,1993,El Salvador,Honduras,2,1,FIFA World Cup qualification,San Salvador,El Salvador,False,3,1,El Salvador
15044,16486,17659,1993,Lebanon,Hong Kong,2,2,FIFA World Cup qualification,Beirut,Lebanon,False,4,0,Draw
15045,16487,17660,1993,India,Hong Kong,1,2,FIFA World Cup qualification,Beirut,Lebanon,True,3,-1,Hong Kong
15046,16489,17662,1993,Bulgaria,Israel,2,2,FIFA World Cup qualification,Sofia,Bulgaria,False,4,0,Draw
15047,16490,17663,1993,Estonia,Malta,0,1,FIFA World Cup qualification,Tallinn,Estonia,False,1,-1,Malta
15048,16491,17664,1993,Finland,Austria,3,1,FIFA World Cup qualification,Turku,Finland,False,4,2,Finland
15049,16493,17666,1993,Lebanon,Bahrain,0,0,FIFA World Cup qualification,Beirut,Lebanon,False,0,0,Draw
15050,16494,17667,1993,Kuwait,Malaysia,2,0,FIFA World Cup qualification,Ta'if,Saudi Arabia,True,2,2,Kuwait
15051,16495,17668,1993,Saudi Arabia,Macau,8,0,FIFA World Cup qualification,Ta'if,Saudi Arabia,False,8,8,Saudi Arabia
15052,16496,17669,1993,Bahrain,India,2,1,FIFA World Cup qualification,Beirut,Lebanon,True,3,1,Bahrain
15053,16498,17671,1993,Latvia,Albania,0,0,FIFA World Cup qualification,Riga,Latvia,False,0,0,Draw
15054,16499,17672,1993,Kuwait,Macau,8,0,FIFA World Cup qualification,Ta'if,Saudi Arabia,True,8,8,Kuwait
15055,16500,17673,1993,Saudi Arabia,Malaysia,3,0,FIFA World Cup qualification,Ta'if,Saudi Arabia,False,3,3,Saudi Arabia
15056,16501,17674,1993,Lithuania,Ukraine,1,2,Friendly,Vilnius,Lithuania,False,3,-1,Ukraine
15057,16502,17675,1993,Macau,Malaysia,0,5,FIFA World Cup qualification,Ta'if,Saudi Arabia,True,5,-5,Malaysia
15058,16503,17676,1993,Saudi Arabia,Kuwait,2,0,FIFA World Cup qualification,Ta'if,Saudi Arabia,False,2,2,Saudi Arabia
15059,16504,17677,1993,Estonia,Scotland,0,3,FIFA World Cup qualification,Tallinn,Estonia,False,3,-3,Scotland
15060,16505,17678,1993,San Marino,Poland,0,3,FIFA World Cup qualification,Serravalle,San Marino,False,3,-3,Poland
15061,16506,17679,1993,Sweden,Austria,1,0,FIFA World Cup qualification,Solna,Sweden,False,1,1,Sweden
15062,16507,17680,1993,Guadeloupe,Réunion,0,3,Friendly,Créteil,France,True,3,-3,Réunion
15063,16508,17681,1993,Luxembourg,Iceland,1,1,FIFA World Cup qualification,Luxembourg,Luxembourg,False,2,0,Draw
15064,16509,17682,1993,Zambia,Malawi,1,1,Friendly,Lusaka,Zambia,False,2,0,Draw
15065,16510,17683,1993,Colombia,Venezuela,1,1,Friendly,Bogotá,Colombia,False,2,0,Draw
15066,16511,17684,1993,Jamaica,Saint Kitts and Nevis,4,1,CFU Caribbean Cup,Kingston,Jamaica,False,5,3,Jamaica
15067,16512,17685,1993,Martinique,Saint Lucia,2,0,CFU Caribbean Cup,Montego Bay,Jamaica,True,2,2,Martinique
15068,16513,17686,1993,Puerto Rico,Sint Maarten,3,0,CFU Caribbean Cup,Kingston,Jamaica,True,3,3,Puerto Rico
15069,16514,17687,1993,Belgium,Faroe Islands,3,0,FIFA World Cup qualification,Brussels,Belgium,False,3,3,Belgium
15070,16515,17688,1993,Burkina Faso,Guadeloupe,2,0,Friendly,Créteil,France,True,2,2,Burkina Faso
15071,16516,17689,1993,Jordan,Yemen,1,1,FIFA World Cup qualification,Irbid,Jordan,False,2,0,Draw
15072,16517,17690,1993,New Zealand,Fiji,2,0,Friendly,Napier,New Zealand,False,2,2,New Zealand
15073,16519,17692,1993,Zambia,Malawi,0,1,Friendly,Lusaka,Zambia,False,1,-1,Malawi
15074,16520,17693,1993,Jamaica,Sint Maarten,2,0,CFU Caribbean Cup,Kingston,Jamaica,False,2,2,Jamaica
15075,16521,17694,1993,Russia,Greece,1,1,FIFA World Cup qualification,Moscow,Russia,False,2,0,Draw
15076,16522,17695,1993,Saint Kitts and Nevis,Puerto Rico,1,0,CFU Caribbean Cup,Kingston,Jamaica,True,1,1,Saint Kitts and Nevis
15077,16523,17696,1993,Trinidad and Tobago,Saint Lucia,1,1,CFU Caribbean Cup,Montego Bay,Jamaica,True,2,0,Draw
15078,16524,17697,1993,United States,Bolivia,0,0,Friendly,Fullerton,United States,False,0,0,Draw
15079,16525,17698,1993,Jordan,Iraq,1,1,FIFA World Cup qualification,Irbid,Jordan,False,2,0,Draw
15080,16526,17699,1993,New Zealand,Fiji,5,0,Friendly,Palmerston North,New Zealand,False,5,5,New Zealand
15081,16527,17700,1993,Yemen,Pakistan,5,1,FIFA World Cup qualification,Irbid,Jordan,True,6,4,Yemen
15082,16528,17701,1993,Zambia,Malawi,4,2,Friendly,Lusaka,Zambia,False,6,2,Zambia
15083,16529,17702,1993,Azerbaijan,Georgia,1,0,Friendly,Gəncə,Azerbaijan,False,1,1,Azerbaijan
15084,16530,17703,1993,Jamaica,Puerto Rico,1,0,CFU Caribbean Cup,Kingston,Jamaica,False,1,1,Jamaica
15085,16531,17704,1993,Lithuania,Northern Ireland,0,1,FIFA World Cup qualification,Vilnius,Lithuania,False,1,-1,Northern Ireland
15086,16532,17705,1993,Martinique,Trinidad and Tobago,3,2,CFU Caribbean Cup,Montego Bay,Jamaica,True,5,1,Martinique
15087,16533,17706,1993,Saint Kitts and Nevis,Sint Maarten,2,2,CFU Caribbean Cup,Kingston,Jamaica,True,4,0,Draw
15088,16534,17707,1993,Saint Vincent and the Grenadines,Saint Lucia,4,1,CFU Caribbean Cup,Montego Bay,Jamaica,True,5,3,Saint Vincent and the Grenadines
15089,16535,17708,1993,Albania,Republic of Ireland,1,2,FIFA World Cup qualification,Tirana,Albania,False,3,-1,Republic of Ireland
15090,16536,17709,1993,Ethiopia,Sudan,1,1,Friendly,Addis Abeba,Ethiopia,False,2,0,Draw
15091,16538,17711,1993,United States,Peru,0,0,Friendly,Mission Viejo,United States,False,0,0,Draw
15092,16539,17712,1993,Yemen,Iraq,1,6,FIFA World Cup qualification,Irbid,Jordan,True,7,-5,Iraq
15093,16540,17713,1993,Bolivia,Paraguay,2,1,Copa Paz del Chaco,Cochabamba,Bolivia,False,3,1,Bolivia
15094,16541,17714,1993,Jamaica,Trinidad and Tobago,3,0,CFU Caribbean Cup,Kingston,Jamaica,False,3,3,Jamaica
15095,16542,17715,1993,Martinique,Saint Kitts and Nevis,1,1,CFU Caribbean Cup,Montego Bay,Jamaica,True,2,0,Draw
15096,16543,17716,1993,Pakistan,Iraq,0,8,FIFA World Cup qualification,Irbid,Jordan,True,8,-8,Iraq
15097,16545,17718,1993,Republic of Ireland,Hungary,2,4,Friendly,Dublin,Republic of Ireland,False,6,-2,Hungary
15098,16546,17719,1993,Poland,England,1,1,FIFA World Cup qualification,Chorzów,Poland,False,2,0,Draw
15099,16547,17720,1993,Chile,Colombia,1,1,Friendly,Santiago,Chile,False,2,0,Draw
15100,16548,17721,1993,Ecuador,Peru,1,0,Friendly,Quito,Ecuador,False,1,1,Ecuador
15101,16550,17723,1993,Jamaica,Martinique,0,0,CFU Caribbean Cup,Kingston,Jamaica,False,0,0,Draw
15102,16551,17724,1993,Jordan,Pakistan,3,1,FIFA World Cup qualification,Irbid,Jordan,False,4,2,Jordan
15103,16552,17725,1993,New Zealand,Australia,0,1,FIFA World Cup qualification,Auckland,New Zealand,False,1,-1,Australia
15104,16553,17726,1993,Trinidad and Tobago,Saint Kitts and Nevis,3,2,CFU Caribbean Cup,Kingston,Jamaica,True,5,1,Trinidad and Tobago
15105,16554,17727,1993,Czech Republic,Romania,5,2,FIFA World Cup qualification,Košice,Slovakia,True,7,3,Czech Republic
15106,16555,17728,1993,Denmark,Albania,4,0,FIFA World Cup qualification,Copenhagen,Denmark,False,4,4,Denmark
15107,16556,17729,1993,Iceland,Russia,1,1,FIFA World Cup qualification,Reykjavík,Iceland,False,2,0,Draw
15108,16557,17730,1993,Latvia,Northern Ireland,1,2,FIFA World Cup qualification,Riga,Latvia,False,3,-1,Northern Ireland
15109,16558,17731,1993,Lithuania,Spain,0,2,FIFA World Cup qualification,Vilnius,Lithuania,False,2,-2,Spain
15110,16559,17732,1993,Norway,England,2,0,FIFA World Cup qualification,Oslo,Norway,False,2,2,Norway
15111,16560,17733,1993,Scotland,Estonia,3,1,FIFA World Cup qualification,Aberdeen,Scotland,False,4,2,Scotland
15112,16561,17734,1993,Sweden,Israel,5,0,FIFA World Cup qualification,Solna,Sweden,False,5,5,Sweden
15113,16562,17735,1993,Turkmenistan,Tajikistan,6,0,Friendly,Ashgabat,Turkmenistan,False,6,6,Turkmenistan
15114,16563,17736,1993,Bahrain,Lebanon,0,0,FIFA World Cup qualification,Seoul,South Korea,True,0,0,Draw
15115,16564,17738,1993,Australia,New Zealand,3,0,FIFA World Cup qualification,Melbourne,Australia,False,3,3,Australia
15116,16565,17739,1993,Azerbaijan,Tajikistan,2,0,Friendly,Teheran,Iran,True,2,2,Azerbaijan
15117,16566,17740,1993,Colombia,Chile,1,0,Friendly,Bogotá,Colombia,False,1,1,Colombia
15118,16567,17741,1993,Faroe Islands,Wales,0,3,FIFA World Cup qualification,Toftir,Faroe Islands,False,3,-3,Wales
15119,16568,17742,1993,Iran,Pakistan,5,0,Friendly,Teheran,Iran,False,5,5,Iran
15120,16569,17743,1993,Peru,Bolivia,1,0,Friendly,Lima,Peru,False,1,1,Peru
15121,16570,17744,1993,United States,Brazil,0,2,USA Cup,New Haven,United States,False,2,-2,Brazil
15122,16571,17745,1993,Azerbaijan,Kyrgyzstan,3,2,Friendly,Teheran,Iran,True,5,1,Azerbaijan
15123,16572,17746,1993,India,Bahrain,0,3,FIFA World Cup qualification,Seoul,South Korea,True,3,-3,Bahrain
15124,16573,17748,1993,Pakistan,Turkmenistan,0,4,Friendly,Teheran,Iran,True,4,-4,Turkmenistan
15125,16574,17749,1993,Iran,Turkmenistan,2,1,Friendly,Teheran,Iran,False,3,1,Iran
15126,16575,17750,1993,Kyrgyzstan,Tajikistan,1,1,Friendly,Teheran,Iran,True,2,0,Draw
15127,16576,17751,1993,Ecuador,Chile,1,2,Friendly,Quito,Ecuador,False,3,-1,Chile
15128,16577,17752,1993,Hong Kong,Lebanon,1,2,FIFA World Cup qualification,Seoul,South Korea,True,3,-1,Lebanon
15129,16578,17754,1993,Latvia,Republic of Ireland,0,2,FIFA World Cup qualification,Riga,Latvia,False,2,-2,Republic of Ireland
15130,16579,17755,1993,Netherlands,Norway,0,0,FIFA World Cup qualification,Rotterdam,Netherlands,False,0,0,Draw
15131,16580,17756,1993,United States,England,2,0,USA Cup,Foxborough,United States,False,2,2,United States
15132,16581,17757,1993,Brazil,Germany,3,3,USA Cup,Washington,United States,True,6,0,Draw
15133,16582,17758,1993,Mexico,Paraguay,3,1,Friendly,Mexico City,Mexico,False,4,2,Mexico
15134,16583,17759,1993,Bahrain,Hong Kong,3,0,FIFA World Cup qualification,Seoul,South Korea,True,3,3,Bahrain
15135,16584,17760,1993,India,Lebanon,1,2,FIFA World Cup qualification,Seoul,South Korea,True,3,-1,Lebanon
15136,16585,17762,1993,Martinique,Trinidad and Tobago,1,1,Friendly,Fort-de-France,Martinique,False,2,0,Draw
15137,16586,17763,1993,Peru,Venezuela,3,1,Friendly,Arequipa,Peru,False,4,2,Peru
15138,16587,17765,1993,Yemen,Jordan,1,1,FIFA World Cup qualification,Chengdu,China PR,True,2,0,Draw
15139,16588,17766,1993,Bolivia,Chile,1,3,Friendly,La Paz,Bolivia,False,4,-2,Chile
15140,16589,17767,1993,Brazil,England,1,1,USA Cup,Washington,United States,True,2,0,Draw
15141,16590,17768,1993,Hong Kong,India,1,3,FIFA World Cup qualification,Seoul,South Korea,True,4,-2,India
15142,16591,17769,1993,Iran,Tajikistan,1,0,Friendly,Teheran,Iran,False,1,1,Iran
15143,16592,17771,1993,United States,Germany,3,4,USA Cup,Chicago,United States,False,7,-1,Germany
15144,16593,17772,1993,Iran,Turkmenistan,2,1,Friendly,Teheran,Iran,False,3,1,Iran
15145,16594,17773,1993,Iraq,Jordan,4,0,FIFA World Cup qualification,Chengdu,China PR,True,4,4,Iraq
15146,16595,17775,1993,Pakistan,Yemen,0,3,FIFA World Cup qualification,Chengdu,China PR,True,3,-3,Yemen
15147,16596,17776,1993,Ecuador,Venezuela,6,1,Copa América,Quito,Ecuador,False,7,5,Ecuador
15148,16597,17778,1993,Colombia,Mexico,2,1,Copa América,Machala,Ecuador,True,3,1,Colombia
15149,16598,17779,1993,Faroe Islands,Czech Republic,0,3,FIFA World Cup qualification,Toftir,Faroe Islands,False,3,-3,Czech Republic
15150,16599,17780,1993,Finland,Israel,0,0,FIFA World Cup qualification,Lahti,Finland,False,0,0,Draw
15151,16600,17781,1993,Iceland,Hungary,2,0,FIFA World Cup qualification,Reykjavík,Iceland,False,2,2,Iceland
15152,16601,17782,1993,Iraq,Yemen,3,0,FIFA World Cup qualification,Chengdu,China PR,True,3,3,Iraq
15153,16602,17783,1993,Lithuania,Republic of Ireland,0,1,FIFA World Cup qualification,Vilnius,Lithuania,False,1,-1,Republic of Ireland
15154,16603,17784,1993,Uruguay,United States,1,0,Copa América,Ambato,Ecuador,True,1,1,Uruguay
15155,16604,17785,1993,Argentina,Bolivia,1,0,Copa América,Guayaquil,Ecuador,True,1,1,Argentina
15156,16605,17786,1993,Brazil,Peru,0,0,Copa América,Cuenca,Ecuador,True,0,0,Draw
15157,16606,17788,1993,Iraq,Pakistan,4,0,FIFA World Cup qualification,Chengdu,China PR,True,4,4,Iraq
15158,16607,17789,1993,Paraguay,Chile,1,0,Copa América,Cuenca,Ecuador,True,1,1,Paraguay
15159,16608,17790,1993,Ecuador,United States,2,0,Copa América,Quito,Ecuador,False,2,2,Ecuador
15160,16609,17791,1993,England,Germany,1,2,USA Cup,Pontiac,United States,True,3,-1,Germany
15161,16610,17793,1993,Portugal,Malta,4,0,FIFA World Cup qualification,Porto,Portugal,False,4,4,Portugal
15162,16611,17794,1993,Uruguay,Venezuela,2,2,Copa América,Ambato,Ecuador,True,4,0,Draw
15163,16612,17795,1993,Argentina,Mexico,1,1,Copa América,Guayaquil,Ecuador,True,2,0,Draw
15164,16613,17797,1993,Colombia,Bolivia,1,1,Copa América,Machala,Ecuador,True,2,0,Draw
15165,16614,17798,1993,Mali,Senegal,0,2,Friendly,Bamako,Mali,False,2,-2,Senegal
15166,16615,17799,1993,Pakistan,Jordan,0,5,FIFA World Cup qualification,Chengdu,China PR,True,5,-5,Jordan
15167,16616,17800,1993,Brazil,Chile,2,3,Copa América,Cuenca,Ecuador,True,5,-1,Chile
15168,16617,17801,1993,Paraguay,Peru,1,1,Copa América,Cuenca,Ecuador,True,2,0,Draw
15169,16618,17802,1993,Ecuador,Uruguay,2,1,Copa América,Quito,Ecuador,False,3,1,Ecuador
15170,16619,17803,1993,United States,Venezuela,3,3,Copa América,Quito,Ecuador,True,6,0,Draw
15171,16620,17804,1993,Argentina,Colombia,1,1,Copa América,Guayaquil,Ecuador,True,2,0,Draw
15172,16621,17805,1993,Costa Rica,Panama,3,1,Friendly,San José,Costa Rica,False,4,2,Costa Rica
15173,16622,17806,1993,Iran,Oman,0,0,FIFA World Cup qualification,Teheran,Iran,False,0,0,Draw
15174,16623,17807,1993,Mexico,Bolivia,0,0,Copa América,Portoviejo,Ecuador,True,0,0,Draw
15175,16624,17808,1993,Brazil,Paraguay,3,0,Copa América,Cuenca,Ecuador,True,3,3,Brazil
15176,16625,17809,1993,Chile,Peru,0,1,Copa América,Cuenca,Ecuador,True,1,-1,Peru
15177,16626,17810,1993,Croatia,Ukraine,3,1,Friendly,Zagreb,Croatia,False,4,2,Croatia
15178,16628,17812,1993,Oman,Syria,0,0,FIFA World Cup qualification,Teheran,Iran,True,0,0,Draw
15179,16629,17813,1993,Colombia,Uruguay,1,1,Copa América,Guayaquil,Ecuador,True,2,0,Draw
15180,16630,17814,1993,Ecuador,Paraguay,3,0,Copa América,Quito,Ecuador,False,3,3,Ecuador
15181,16631,17815,1993,Egypt,Romania,3,2,Korea Cup,Seoul,South Korea,True,5,1,Egypt
15182,16632,17817,1993,Brazil,Argentina,1,1,Copa América,Guayaquil,Ecuador,True,2,0,Draw
15183,16633,17818,1993,Iran,Syria,1,1,FIFA World Cup qualification,Teheran,Iran,False,2,0,Draw
15184,16635,17820,1993,Peru,Mexico,2,4,Copa América,Quito,Ecuador,True,6,-2,Mexico
15185,16636,17822,1993,Costa Rica,Mexico,0,2,Friendly,San José,Costa Rica,False,2,-2,Mexico
15186,16637,17823,1993,Ecuador,Mexico,0,2,Copa América,Quito,Ecuador,False,2,-2,Mexico
15187,16638,17824,1993,Colombia,Argentina,0,0,Copa América,Guayaquil,Ecuador,True,0,0,Draw
15188,16639,17825,1993,Estonia,Latvia,0,2,Baltic Cup,Pärnu,Estonia,False,2,-2,Latvia
15189,16640,17826,1993,Oman,Iran,0,1,FIFA World Cup qualification,Damascus,Syria,True,1,-1,Iran
15190,16642,17828,1993,Ecuador,Colombia,0,1,Copa América,Portoviejo,Ecuador,False,1,-1,Colombia
15191,16643,17829,1993,Latvia,Lithuania,0,0,Baltic Cup,Pärnu,Estonia,True,0,0,Draw
15192,16644,17830,1993,Nigeria,Algeria,4,1,FIFA World Cup qualification,Lagos,Nigeria,False,5,3,Nigeria
15193,16645,17831,1993,Argentina,Mexico,2,1,Copa América,Guayaquil,Ecuador,True,3,1,Argentina
15194,16646,17832,1993,Estonia,Lithuania,2,1,Baltic Cup,Pärnu,Estonia,False,3,1,Estonia
15195,16647,17833,1993,Gabon,Mali,0,2,Friendly,Moanda,Gabon,False,2,-2,Mali
15196,16648,17834,1993,Jamaica,Costa Rica,1,1,Friendly,Kingston,Jamaica,False,2,0,Draw
15197,16649,17835,1993,Syria,Oman,2,1,FIFA World Cup qualification,Damascus,Syria,False,3,1,Syria
15198,16650,17836,1993,Zambia,Morocco,2,1,FIFA World Cup qualification,Lusaka,Zambia,False,3,1,Zambia
15199,16651,17837,1993,Zimbabwe,Cameroon,1,0,FIFA World Cup qualification,Harare,Zimbabwe,False,1,1,Zimbabwe
15200,16652,17838,1993,Gibraltar,Jersey,1,2,Island Games,Isle of Wight,England,True,3,-1,Jersey
15201,16654,17842,1993,Jersey,Greenland,4,2,Island Games,Isle of Wight,England,True,6,2,Jersey
15202,16655,17844,1993,Isle of Man,Åland Islands,2,0,Island Games,Isle of Wight,England,True,2,2,Isle of Man
15203,16656,17846,1993,Malawi,Eswatini,3,1,Friendly,Blantyre,Malawi,False,4,2,Malawi
15204,16657,17847,1993,Syria,Iran,1,1,FIFA World Cup qualification,Damascus,Syria,False,2,0,Draw
15205,16658,17848,1993,Greenland,Gibraltar,5,0,Island Games,Isle of Wight,England,True,5,5,Greenland
15206,16660,17852,1993,Ivory Coast,Niger,3,2,Friendly,Abidjan,Ivory Coast,False,5,1,Ivory Coast
15207,16661,17853,1993,Malawi,Eswatini,1,1,Friendly,Lilongwe,Malawi,False,2,0,Draw
15208,16662,17856,1993,Greenland,Åland Islands,1,2,Island Games,Isle of Wight,England,True,3,-1,Åland Islands
15209,16663,17857,1993,Jersey,Isle of Man,5,1,Island Games,Isle of Wight,England,True,6,4,Jersey
15210,16664,17858,1993,Honduras,Panama,5,1,Gold Cup,Dallas,United States,True,6,4,Honduras
15211,16665,17859,1993,Malawi,Eswatini,0,1,Friendly,Mzuzu,Malawi,False,1,-1,Eswatini
15212,16666,17860,1993,United States,Jamaica,1,0,Gold Cup,Dallas,United States,False,1,1,United States
15213,16667,17861,1993,Benin,Cameroon,0,3,African Cup of Nations qualification,Cotonou,Benin,False,3,-3,Cameroon
15214,16668,17862,1993,Burundi,Guinea,2,2,African Cup of Nations qualification,Bujumbura,Burundi,False,4,0,Draw
15215,16669,17863,1993,Canada,Costa Rica,1,1,Gold Cup,Mexico City,Mexico,True,2,0,Draw
15216,16670,17864,1993,DR Congo,Kenya,0,1,African Cup of Nations qualification,Kinshasa,Zaïre,False,1,-1,Kenya
15217,16671,17865,1993,Egypt,Morocco,1,1,African Cup of Nations qualification,Alexandria,Egypt,False,2,0,Draw
15218,16672,17866,1993,Gabon,Niger,3,0,African Cup of Nations qualification,Libreville,Gabon,False,3,3,Gabon
15219,16673,17867,1993,Lesotho,Mozambique,1,1,African Cup of Nations qualification,Maseru,Lesotho,False,2,0,Draw
15220,16674,17868,1993,Mali,Malawi,2,1,African Cup of Nations qualification,Bamako,Mali,False,3,1,Mali
15221,16675,17869,1993,Mexico,Martinique,9,0,Gold Cup,Mexico City,Mexico,False,9,9,Mexico
15222,16676,17870,1993,Senegal,Sierra Leone,1,1,African Cup of Nations qualification,Dakar,Senegal,False,2,0,Draw
15223,16677,17871,1993,Zambia,South Africa,3,0,African Cup of Nations qualification,Lusaka,Zambia,False,3,3,Zambia
15224,16678,17872,1993,Zimbabwe,Mauritius,2,0,African Cup of Nations qualification,Harare,Zimbabwe,False,2,2,Zimbabwe
15225,16679,17873,1993,Peru,Uruguay,1,2,Friendly,Lima,Peru,False,3,-1,Uruguay
15226,16680,17874,1993,Brazil,Paraguay,2,0,Friendly,Rio de Janeiro,Brazil,False,2,2,Brazil
15227,16681,17875,1993,Honduras,Jamaica,1,3,Gold Cup,Dallas,United States,True,4,-2,Jamaica
15228,16682,17876,1993,United States,Panama,2,1,Gold Cup,Dallas,United States,False,3,1,United States
15229,16683,17877,1993,Canada,Martinique,2,2,Gold Cup,Mexico City,Mexico,True,4,0,Draw
15230,16684,17878,1993,Mexico,Costa Rica,1,1,Gold Cup,Mexico City,Mexico,False,2,0,Draw
15231,16685,17879,1993,Jamaica,Panama,1,1,Gold Cup,Dallas,United States,True,2,0,Draw
15232,16686,17880,1993,Senegal,Morocco,1,3,FIFA World Cup qualification,Dakar,Senegal,False,4,-2,Morocco
15233,16687,17881,1993,Uganda,Nigeria,0,0,African Cup of Nations qualification,Kampala,Uganda,False,0,0,Draw
15234,16688,17882,1993,Uruguay,Peru,3,0,Friendly,Montevideo,Uruguay,False,3,3,Uruguay
15235,16689,17883,1993,United States,Honduras,1,0,Gold Cup,Dallas,United States,False,1,1,United States
15236,16690,17884,1993,Costa Rica,Martinique,3,1,Gold Cup,Mexico City,Mexico,True,4,2,Costa Rica
15237,16691,17885,1993,Ecuador,Brazil,0,0,FIFA World Cup qualification,Guayaquil,Ecuador,False,0,0,Draw
15238,16692,17886,1993,Guinea,Cameroon,0,1,FIFA World Cup qualification,Conakry,Guinea,False,1,-1,Cameroon
15239,16693,17887,1993,Ivory Coast,Algeria,1,0,FIFA World Cup qualification,Abidjan,Ivory Coast,False,1,1,Ivory Coast
15240,16694,17888,1993,Mexico,Canada,8,0,Gold Cup,Mexico City,Mexico,False,8,8,Mexico
15241,16695,17889,1993,Venezuela,Bolivia,1,7,FIFA World Cup qualification,Puerto Ordaz,Venezuela,False,8,-6,Bolivia
15242,16696,17890,1993,United States,Costa Rica,1,0,Gold Cup,Dallas,United States,False,1,1,United States
15243,16697,17891,1993,Mexico,Jamaica,6,1,Gold Cup,Mexico City,Mexico,False,7,5,Mexico
15244,16698,17892,1993,Nigeria,Ethiopia,6,0,African Cup of Nations qualification,Lagos,Nigeria,False,6,6,Nigeria
15245,16699,17893,1993,Uganda,Sudan,1,0,African Cup of Nations qualification,Kampala,Uganda,False,1,1,Uganda
15246,16700,17894,1993,Algeria,Senegal,4,0,African Cup of Nations qualification,Tlemcen,Algeria,False,4,4,Algeria
15247,16701,17895,1993,Benin,Gabon,1,2,African Cup of Nations qualification,Cotonou,Benin,False,3,-1,Gabon
15248,16702,17896,1993,Bolivia,Brazil,2,0,FIFA World Cup qualification,La Paz,Bolivia,False,2,2,Bolivia
15249,16703,17897,1993,Cameroon,Niger,2,0,African Cup of Nations qualification,Yaoundé,Cameroon,False,2,2,Cameroon
15250,16704,17898,1993,DR Congo,Lesotho,7,0,African Cup of Nations qualification,Kinshasa,Zaïre,False,7,7,DR Congo
15251,16705,17899,1993,Jamaica,Costa Rica,1,1,Gold Cup,Mexico City,Mexico,True,2,0,Draw
15252,16706,17900,1993,Liberia,Ghana,0,2,African Cup of Nations qualification,Monrovia,Liberia,False,2,-2,Ghana
15253,16707,17901,1993,Malawi,Morocco,0,2,African Cup of Nations qualification,Lilongwe,Malawi,False,2,-2,Morocco
15254,16708,17902,1993,Mali,Egypt,2,1,African Cup of Nations qualification,Bamako,Mali,False,3,1,Mali
15255,16709,17903,1993,Mauritius,South Africa,1,3,African Cup of Nations qualification,Mapou,Mauritius,False,4,-2,South Africa
15256,16710,17904,1993,Mexico,United States,4,0,Gold Cup,Mexico City,Mexico,False,4,4,Mexico
15257,16711,17905,1993,Venezuela,Uruguay,0,1,FIFA World Cup qualification,San Cristóbal,Venezuela,False,1,-1,Uruguay
15258,16712,17906,1993,Zimbabwe,Zambia,1,1,African Cup of Nations qualification,Harare,Zimbabwe,False,2,0,Draw
15259,16713,17907,1993,France,Russia,3,1,Friendly,Caen,France,False,4,2,France
15260,16714,17908,1993,Malawi,Eswatini,3,0,Friendly,Blantyre,Malawi,False,3,3,Malawi
15261,16715,17909,1993,Canada,Australia,2,1,FIFA World Cup qualification,Edmonton,Canada,False,3,1,Canada
15262,16716,17910,1993,Colombia,Paraguay,0,0,FIFA World Cup qualification,Barranquilla,Colombia,False,0,0,Draw
15263,16717,17911,1993,Peru,Argentina,0,1,FIFA World Cup qualification,Lima,Peru,False,1,-1,Argentina
15264,16718,17912,1993,Uruguay,Ecuador,0,0,FIFA World Cup qualification,Montevideo,Uruguay,False,0,0,Draw
15265,16719,17913,1993,Venezuela,Brazil,1,5,FIFA World Cup qualification,San Cristóbal,Venezuela,False,6,-4,Brazil
15266,16720,17914,1993,Senegal,Zambia,0,0,FIFA World Cup qualification,Abidjan,Ivory Coast,True,0,0,Draw
15267,16721,17915,1993,Bolivia,Uruguay,3,1,FIFA World Cup qualification,La Paz,Bolivia,False,4,2,Bolivia
15268,16722,17916,1993,Brazil,Mexico,1,1,Friendly,Maceió,Brazil,False,2,0,Draw
15269,16723,17917,1993,Ecuador,Venezuela,5,0,FIFA World Cup qualification,Quito,Ecuador,False,5,5,Ecuador
15270,16724,17918,1993,Guinea,Sierra Leone,1,0,Friendly,Conakry,Guinea,False,1,1,Guinea
15271,16725,17919,1993,Paraguay,Argentina,1,3,FIFA World Cup qualification,Asunción,Paraguay,False,4,-2,Argentina
15272,16726,17920,1993,Peru,Colombia,0,1,FIFA World Cup qualification,Lima,Peru,False,1,-1,Colombia
15273,16727,17921,1993,Zimbabwe,Eswatini,2,0,Friendly,Harare,Zimbabwe,False,2,2,Zimbabwe
15274,16728,17922,1993,Guinea,Sierra Leone,4,0,Friendly,Conakry,Guinea,False,4,4,Guinea
15275,16729,17923,1993,Faroe Islands,Norway,0,7,Friendly,Toftir,Faroe Islands,False,7,-7,Norway
15276,16730,17924,1993,Sweden,Switzerland,1,2,Friendly,Borås,Sweden,False,3,-1,Switzerland
15277,16731,17925,1993,Australia,Canada,2,1,FIFA World Cup qualification,Sydney,Australia,False,3,1,Australia
15278,16732,17926,1993,Bolivia,Ecuador,1,0,FIFA World Cup qualification,La Paz,Bolivia,False,1,1,Bolivia
15279,16733,17927,1993,Colombia,Argentina,2,1,FIFA World Cup qualification,Barranquilla,Colombia,False,3,1,Colombia
15280,16734,17928,1993,Congo,Guinea,0,0,African Cup of Nations qualification,Pointe-Noire,Congo,False,0,0,Draw
15281,16735,17929,1993,Paraguay,Peru,2,1,FIFA World Cup qualification,Asunción,Paraguay,False,3,1,Paraguay
15282,16736,17930,1993,Uruguay,Brazil,1,1,FIFA World Cup qualification,Montevideo,Uruguay,False,2,0,Draw
15283,16737,17931,1993,Argentina,Peru,2,1,FIFA World Cup qualification,Buenos Aires,Argentina,False,3,1,Argentina
15284,16738,17932,1993,Bolivia,Venezuela,7,0,FIFA World Cup qualification,La Paz,Bolivia,False,7,7,Bolivia
15285,16739,17933,1993,Brazil,Ecuador,2,0,FIFA World Cup qualification,São Paulo,Brazil,False,2,2,Brazil
15286,16740,17934,1993,Paraguay,Colombia,1,1,FIFA World Cup qualification,Asunción,Paraguay,False,2,0,Draw
15287,16741,17935,1993,Sweden,France,1,1,FIFA World Cup qualification,Solna,Sweden,False,2,0,Draw
15288,16742,17936,1993,Austria,Finland,3,0,FIFA World Cup qualification,Vienna,Austria,False,3,3,Austria
15289,16743,17937,1993,Denmark,Lithuania,4,0,FIFA World Cup qualification,Copenhagen,Denmark,False,4,4,Denmark
15290,16744,17938,1993,Argentina,Paraguay,0,0,FIFA World Cup qualification,Buenos Aires,Argentina,False,0,0,Draw
15291,16745,17939,1993,Brazil,Bolivia,6,0,FIFA World Cup qualification,Recife,Brazil,False,6,6,Brazil
15292,16746,17940,1993,Colombia,Peru,4,0,FIFA World Cup qualification,Barranquilla,Colombia,False,4,4,Colombia
15293,16747,17941,1993,Uruguay,Venezuela,4,0,FIFA World Cup qualification,Montevideo,Uruguay,False,4,4,Uruguay
15294,16748,17942,1993,Iceland,United States,0,1,Friendly,Reykjavík,Iceland,False,1,-1,United States
15295,16749,17943,1993,Argentina,Colombia,0,5,FIFA World Cup qualification,Buenos Aires,Argentina,False,5,-5,Colombia
15296,16750,17944,1993,Brazil,Venezuela,4,0,FIFA World Cup qualification,Belo Horizonte,Brazil,False,4,4,Brazil
15297,16751,17945,1993,Ecuador,Uruguay,0,1,FIFA World Cup qualification,Guayaquil,Ecuador,False,1,-1,Uruguay
15298,16752,17946,1993,Estonia,Portugal,0,2,FIFA World Cup qualification,Tallinn,Estonia,False,2,-2,Portugal
15299,16753,17947,1993,Peru,Paraguay,2,2,FIFA World Cup qualification,Lima,Peru,False,4,0,Draw
15300,16754,17948,1993,Eswatini,Zimbabwe,0,1,Friendly,Mbabane,Eswatini,False,1,-1,Zimbabwe
15301,16755,17949,1993,Albania,Denmark,0,1,FIFA World Cup qualification,Tirana,Albania,False,1,-1,Denmark
15302,16756,17950,1993,Bulgaria,Sweden,1,1,FIFA World Cup qualification,Sofia,Bulgaria,False,2,0,Draw
15303,16757,17951,1993,England,Poland,3,0,FIFA World Cup qualification,London,England,False,3,3,England
15304,16758,17952,1993,Faroe Islands,Romania,0,4,FIFA World Cup qualification,Toftir,Faroe Islands,False,4,-4,Romania
15305,16759,17953,1993,Finland,France,0,2,FIFA World Cup qualification,Tampere,Finland,False,2,-2,France
15306,16760,17954,1993,Hungary,Russia,1,3,FIFA World Cup qualification,Budapest,Hungary,False,4,-2,Russia
15307,16761,17955,1993,Iceland,Luxembourg,1,0,FIFA World Cup qualification,Reykjavík,Iceland,False,1,1,Iceland
15308,16762,17956,1993,Republic of Ireland,Lithuania,2,0,FIFA World Cup qualification,Dublin,Republic of Ireland,False,2,2,Republic of Ireland
15309,16763,17957,1993,Northern Ireland,Latvia,2,0,FIFA World Cup qualification,Belfast,Northern Ireland,False,2,2,Northern Ireland
15310,16764,17958,1993,Norway,United States,1,0,Friendly,Oslo,Norway,False,1,1,Norway
15311,16765,17959,1993,Scotland,Switzerland,1,1,FIFA World Cup qualification,Aberdeen,Scotland,False,2,0,Draw
15312,16766,17960,1993,Spain,Chile,2,0,Friendly,Alicante,Spain,False,2,2,Spain
15313,16767,17961,1993,Wales,Czech Republic,2,2,FIFA World Cup qualification,Cardiff,Wales,False,4,0,Draw
15314,16768,17962,1993,Uruguay,Bolivia,2,1,FIFA World Cup qualification,Montevideo,Uruguay,False,3,1,Uruguay
15315,16769,17963,1993,Venezuela,Ecuador,2,1,FIFA World Cup qualification,Puerto Ordaz,Venezuela,False,3,1,Venezuela
15316,16770,17964,1993,Morocco,Mali,3,0,Friendly,Casablanca,Morocco,False,3,3,Morocco
15317,16771,17965,1993,Saudi Arabia,Thailand,4,0,Friendly,Dammam,Saudi Arabia,False,4,4,Saudi Arabia
15318,16772,17966,1993,Brazil,Uruguay,2,0,FIFA World Cup qualification,Rio de Janeiro,Brazil,False,2,2,Brazil
15319,16773,17967,1993,Ecuador,Bolivia,1,1,FIFA World Cup qualification,Guayaquil,Ecuador,False,2,0,Draw
15320,16774,17968,1993,Zimbabwe,Senegal,2,0,Friendly,Harare,Zimbabwe,False,2,2,Zimbabwe
15321,16775,17969,1993,Saudi Arabia,Thailand,3,0,Friendly,Dammam,Saudi Arabia,False,3,3,Saudi Arabia
15322,16776,17970,1993,Albania,Spain,1,5,FIFA World Cup qualification,Tirana,Albania,False,6,-4,Spain
15323,16777,17971,1993,Estonia,Italy,0,3,FIFA World Cup qualification,Tallinn,Estonia,False,3,-3,Italy
15324,16778,17972,1993,Mexico,Cameroon,1,0,Friendly,Los Angeles,United States,True,1,1,Mexico
15325,16779,17973,1993,Norway,Poland,1,0,FIFA World Cup qualification,Oslo,Norway,False,1,1,Norway
15326,16780,17974,1993,Romania,Israel,1,0,Friendly,Bucharest,Romania,False,1,1,Romania
15327,16781,17975,1993,San Marino,Netherlands,0,7,FIFA World Cup qualification,Bologna,Italy,True,7,-7,Netherlands
15328,16782,17976,1993,Tunisia,Germany,1,1,Friendly,Tunis,Tunisia,False,2,0,Draw
15329,16783,17977,1993,Saudi Arabia,Costa Rica,1,2,Friendly,Khobar,Saudi Arabia,False,3,-1,Costa Rica
15330,16784,17979,1993,Nigeria,Ivory Coast,4,1,FIFA World Cup qualification,Lagos,Nigeria,False,5,3,Nigeria
15331,16785,17981,1993,Zambia,Senegal,4,0,FIFA World Cup qualification,Lusaka,Zambia,False,4,4,Zambia
15332,16786,17982,1993,Zimbabwe,Guinea,1,0,FIFA World Cup qualification,Harare,Zimbabwe,False,1,1,Zimbabwe
15333,16787,17983,1993,Saudi Arabia,Costa Rica,3,2,Friendly,Khobar,Saudi Arabia,False,5,1,Saudi Arabia
15334,16788,17984,1993,Mexico,Poland,0,0,Friendly,Oakland,United States,True,0,0,Draw
15335,16789,17985,1993,Morocco,Gabon,1,0,Friendly,Rabat,Morocco,False,1,1,Morocco
15336,16790,17986,1993,Japan,Ivory Coast,1,0,Friendly,Tokyo,Japan,False,1,1,Japan
15337,16791,17987,1993,Cyprus,Israel,2,2,Friendly,Limassol,Cyprus,False,4,0,Draw
15338,16792,17988,1993,Belgium,Gabon,2,1,Friendly,Brussels,Belgium,False,3,1,Belgium
15339,16793,17989,1993,Mexico,South Africa,4,0,Friendly,Los Angeles,United States,True,4,4,Mexico
15340,16794,17990,1993,Saudi Arabia,Russia,4,2,Friendly,Khobar,Saudi Arabia,False,6,2,Saudi Arabia
15341,16795,17991,1993,Algeria,Nigeria,1,1,FIFA World Cup qualification,Algiers,Algeria,False,2,0,Draw
15342,16796,17992,1993,Cameroon,Zimbabwe,3,1,FIFA World Cup qualification,Yaoundé,Cameroon,False,4,2,Cameroon
15343,16797,17993,1993,Morocco,Zambia,1,0,FIFA World Cup qualification,Casablanca,Morocco,False,1,1,Morocco
15344,16798,17994,1993,Luxembourg,Greece,1,3,FIFA World Cup qualification,Luxembourg,Luxembourg,False,4,-2,Greece
15345,16799,17995,1993,Bulgaria,Austria,4,1,FIFA World Cup qualification,Sofia,Bulgaria,False,5,3,Bulgaria
15346,16800,17996,1993,Denmark,Northern Ireland,1,0,FIFA World Cup qualification,Copenhagen,Denmark,False,1,1,Denmark
15347,16801,17997,1993,France,Israel,2,3,FIFA World Cup qualification,Paris,France,False,5,-1,Israel
15348,16802,17998,1993,Germany,Uruguay,5,0,Friendly,Karlsruhe,Germany,False,5,5,Germany
15349,16803,17999,1993,Republic of Ireland,Spain,1,3,FIFA World Cup qualification,Dublin,Republic of Ireland,False,4,-2,Spain
15350,16804,18000,1993,Italy,Scotland,3,1,FIFA World Cup qualification,Rome,Italy,False,4,2,Italy
15351,16805,18001,1993,Netherlands,England,2,0,FIFA World Cup qualification,Rotterdam,Netherlands,False,2,2,Netherlands
15352,16806,18002,1993,Poland,Norway,0,3,FIFA World Cup qualification,Poznań,Poland,False,3,-3,Norway
15353,16807,18003,1993,Portugal,Switzerland,1,0,FIFA World Cup qualification,Porto,Portugal,False,1,1,Portugal
15354,16808,18004,1993,Romania,Belgium,2,1,FIFA World Cup qualification,Bucharest,Romania,False,3,1,Romania
15355,16810,18006,1993,Sweden,Finland,3,2,FIFA World Cup qualification,Solna,Sweden,False,5,1,Sweden
15356,16811,18007,1993,United States,Mexico,1,1,Friendly,Washington,United States,False,2,0,Draw
15357,16812,18008,1993,Wales,Cyprus,2,0,FIFA World Cup qualification,Cardiff,Wales,False,2,2,Wales
15358,16813,18010,1993,Saudi Arabia,Japan,0,0,FIFA World Cup qualification,Doha,Qatar,True,0,0,Draw
15359,16815,18012,1993,United States,Ukraine,1,2,Friendly,High Point,United States,False,3,-1,Ukraine
15360,16816,18013,1993,Tunisia,Iceland,3,1,Friendly,Tunis,Tunisia,False,4,2,Tunisia
15361,16817,18014,1993,Japan,Iran,1,2,FIFA World Cup qualification,Doha,Qatar,True,3,-1,Iran
15362,16819,18017,1993,Mexico,Ukraine,2,1,Friendly,San Diego,United States,True,3,1,Mexico
15363,16820,18019,1993,Iran,Iraq,1,2,FIFA World Cup qualification,Doha,Qatar,True,3,-1,Iraq
15364,16821,18021,1993,United States,Ukraine,0,1,Friendly,Bethlehem,United States,False,1,-1,Ukraine
15365,16822,18022,1993,Burundi,Guinea,0,0,African Cup of Nations qualification,Libreville,Gabon,True,0,0,Draw
15366,16823,18023,1993,Iraq,Saudi Arabia,1,1,FIFA World Cup qualification,Doha,Qatar,True,2,0,Draw
15367,16826,18026,1993,Liechtenstein,Estonia,0,2,Friendly,Balzers,Liechtenstein,False,2,-2,Estonia
15368,16827,18027,1993,United Arab Emirates,Jordan,2,1,Friendly,Al Ain,United Arab Emirates,False,3,1,United Arab Emirates
15369,16828,18028,1993,Czech Republic,Cyprus,3,0,FIFA World Cup qualification,Košice,Slovakia,True,3,3,Czech Republic
15370,16829,18029,1993,Hungary,Luxembourg,1,0,FIFA World Cup qualification,Budapest,Hungary,False,1,1,Hungary
15371,16830,18030,1993,Israel,Austria,1,1,FIFA World Cup qualification,Ramat-Gan,Israel,False,2,0,Draw
15372,16831,18031,1993,Turkey,Poland,2,1,FIFA World Cup qualification,Istanbul,Turkey,False,3,1,Turkey
15373,16832,18032,1993,Iraq,Japan,2,2,FIFA World Cup qualification,Doha,Qatar,True,4,0,Draw
15374,16833,18034,1993,Saudi Arabia,Iran,4,3,FIFA World Cup qualification,Doha,Qatar,True,7,1,Saudi Arabia
15375,16834,18035,1993,United Arab Emirates,Jordan,0,2,Friendly,Al Ain,United Arab Emirates,False,2,-2,Jordan
15376,16835,18036,1993,Australia,Argentina,1,1,FIFA World Cup qualification,Sydney,Australia,False,2,0,Draw
15377,16837,18038,1993,Egypt,Malta,3,0,Friendly,Tunis,Tunisia,True,3,3,Egypt
15378,16838,18039,1993,Tunisia,Gabon,4,0,Friendly,Tunis,Tunisia,False,4,4,Tunisia
15379,16839,18040,1993,Gabon,Malta,1,2,Friendly,Tunis,Tunisia,True,3,-1,Malta
15380,16840,18041,1993,Tunisia,Egypt,2,1,Friendly,Tunis,Tunisia,False,3,1,Tunisia
15381,16841,18042,1993,United States,Jamaica,1,0,Friendly,Fullerton,United States,False,1,1,United States
15382,16842,18043,1993,Austria,Sweden,1,1,FIFA World Cup qualification,Vienna,Austria,False,2,0,Draw
15383,16843,18044,1993,Israel,Finland,1,3,FIFA World Cup qualification,Ramat-Gan,Israel,False,4,-2,Finland
15384,16844,18045,1993,Portugal,Estonia,3,0,FIFA World Cup qualification,Lisbon,Portugal,False,3,3,Portugal
15385,16845,18046,1993,Turkey,Norway,2,1,FIFA World Cup qualification,Istanbul,Turkey,False,3,1,Turkey
15386,16846,18047,1993,Antigua and Barbuda,Saint Kitts and Nevis,3,0,Friendly,St. John's,Antigua and Barbuda,False,3,3,Antigua and Barbuda
15387,16847,18048,1993,United States,Cayman Islands,8,1,Friendly,Mission Viejo,United States,False,9,7,United States
15388,16848,18049,1993,Slovakia,Slovenia,2,0,Friendly,Prievidza,Slovakia,False,2,2,Slovakia
15389,16849,18050,1993,Argentina,Australia,1,0,FIFA World Cup qualification,Buenos Aires,Argentina,False,1,1,Argentina
15390,16850,18051,1993,Belgium,Czech Republic,0,0,FIFA World Cup qualification,Brussels,Belgium,False,0,0,Draw
15391,16851,18052,1993,France,Bulgaria,1,2,FIFA World Cup qualification,Paris,France,False,3,-1,Bulgaria
15392,16852,18053,1993,Germany,Brazil,2,1,Friendly,Cologne,Germany,False,3,1,Germany
15393,16853,18054,1993,Greece,Russia,1,0,FIFA World Cup qualification,Athens,Greece,False,1,1,Greece
15394,16854,18055,1993,Italy,Portugal,1,0,FIFA World Cup qualification,Milan,Italy,False,1,1,Italy
15395,16855,18056,1993,Malta,Scotland,0,2,FIFA World Cup qualification,Attard,Malta,False,2,-2,Scotland
15396,16856,18057,1993,Northern Ireland,Republic of Ireland,1,1,FIFA World Cup qualification,Belfast,Northern Ireland,False,2,0,Draw
15397,16857,18058,1993,Poland,Netherlands,1,3,FIFA World Cup qualification,Poznań,Poland,False,4,-2,Netherlands
15398,16858,18059,1993,San Marino,England,1,7,FIFA World Cup qualification,Bologna,Italy,True,8,-6,England
15399,16859,18060,1993,Spain,Denmark,1,0,FIFA World Cup qualification,Seville,Spain,False,1,1,Spain
15400,16860,18061,1993,Switzerland,Estonia,4,0,FIFA World Cup qualification,Zürich,Switzerland,False,4,4,Switzerland
15401,16861,18062,1993,Wales,Romania,1,2,FIFA World Cup qualification,Cardiff,Wales,False,3,-1,Romania
15402,16862,18063,1993,Gambia,Mauritania,2,4,Friendly,Banjul,Gambia,False,6,-2,Mauritania
15403,16863,18064,1993,Gambia,Ghana,3,0,Friendly,Freetown,Sierra Leone,True,3,3,Gambia
15404,16864,18065,1993,Sierra Leone,Guinea,1,1,Amílcar Cabral Cup,Freetown,Sierra Leone,False,2,0,Draw
15405,16865,18066,1993,Guinea-Bissau,Mauritania,1,0,Amílcar Cabral Cup,Freetown,Sierra Leone,True,1,1,Guinea-Bissau
15406,16866,18067,1993,Senegal,Mali,0,1,Amílcar Cabral Cup,Freetown,Sierra Leone,True,1,-1,Mali
15407,16867,18068,1993,Guinea,Gambia,1,2,Amílcar Cabral Cup,Freetown,Sierra Leone,True,3,-1,Gambia
15408,16868,18069,1993,Sierra Leone,Ghana,2,3,Friendly,Freetown,Sierra Leone,False,5,-1,Ghana
15409,16869,18070,1993,Mali,Guinea-Bissau,3,0,Amílcar Cabral Cup,Freetown,Sierra Leone,True,3,3,Mali
15410,16870,18071,1993,Senegal,Mauritania,4,0,Amílcar Cabral Cup,Freetown,Sierra Leone,True,4,4,Senegal
15411,16871,18072,1993,Ghana,Guinea,1,0,Friendly,Freetown,Sierra Leone,True,1,1,Ghana
15412,16872,18073,1993,Sierra Leone,Gambia,1,1,Amílcar Cabral Cup,Freetown,Sierra Leone,False,2,0,Draw
15413,16873,18075,1993,Kenya,Uganda,2,1,Friendly,Nairobi,Kenya,False,3,1,Kenya
15414,16874,18076,1993,Mali,Mauritania,0,0,Amílcar Cabral Cup,Freetown,Sierra Leone,True,0,0,Draw
15415,16875,18077,1993,Senegal,Guinea-Bissau,0,0,Amílcar Cabral Cup,Freetown,Sierra Leone,True,0,0,Draw
15416,16876,18078,1993,Gambia,Senegal,0,2,Amílcar Cabral Cup,Freetown,Sierra Leone,True,2,-2,Senegal
15417,16877,18079,1993,Sierra Leone,Mali,2,0,Amílcar Cabral Cup,Freetown,Sierra Leone,False,2,2,Sierra Leone
15418,16878,18080,1993,Gambia,Mali,2,0,Amílcar Cabral Cup,Freetown,Sierra Leone,True,2,2,Gambia
15419,16879,18081,1993,Sierra Leone,Senegal,2,0,Amílcar Cabral Cup,Freetown,Sierra Leone,False,2,2,Sierra Leone
15420,16880,18082,1993,United States,El Salvador,7,0,Friendly,Mission Viejo,United States,False,7,7,United States
15421,16881,18083,1993,Tanzania,Uganda,1,0,Friendly,Nairobi,Kenya,True,1,1,Tanzania
15422,16882,18084,1993,Bangladesh,Burma,3,1,Friendly,Dhaka,Bangladesh,False,4,2,Bangladesh
15423,16883,18085,1993,Kenya,Tanzania,2,1,Friendly,Nairobi,Kenya,False,3,1,Kenya
15424,16884,18086,1993,Argentina,Germany,2,1,Friendly,Miami,United States,True,3,1,Argentina
15425,16885,18087,1993,Mexico,Brazil,0,1,Friendly,Guadalajara,Mexico,False,1,-1,Brazil
15426,16886,18088,1993,United States,Germany,0,3,Friendly,Palo Alto,United States,False,3,-3,Germany
15427,16887,18089,1993,Mali,Ivory Coast,0,1,Friendly,Bamako,Mali,False,1,-1,Ivory Coast
15428,16888,18090,1993,Mexico,Germany,0,0,Friendly,Mexico City,Mexico,False,0,0,Draw
15429,16889,18092,1993,Ghana,Egypt,0,0,Friendly,Accra,Ghana,False,0,0,Draw
15430,16890,18093,1993,Ghana,Tunisia,1,1,Friendly,Accra,Ghana,False,2,0,Draw
15431,16891,18094,1994,Barbados,Grenada,0,0,Friendly,Bridgetown,Barbados,False,0,0,Draw
15432,16892,18095,1994,Ghana,Egypt,2,1,Friendly,Accra,Ghana,False,3,1,Ghana
15433,16893,18096,1994,Mali,Burkina Faso,1,1,Friendly,Bamako,Mali,False,2,0,Draw
15434,16894,18097,1994,Mauritania,Mali,1,3,Friendly,Nouakchott,Mauritania,False,4,-2,Mali
15435,16895,18098,1994,Thailand,Nigeria,1,1,Friendly,Bangkok,Thailand,False,2,0,Draw
15436,16896,18099,1994,United States,Norway,2,1,Friendly,Tempe,United States,False,3,1,United States
15437,16897,18100,1994,Guinea,Ivory Coast,3,0,Friendly,Conakry,Guinea,False,3,3,Guinea
15438,16898,18101,1994,Costa Rica,Norway,0,0,Friendly,San Diego,United States,True,0,0,Draw
15439,16899,18102,1994,Mexico,Bulgaria,1,1,Friendly,San Diego,United States,True,2,0,Draw
15440,16900,18103,1994,Spain,Portugal,2,2,Friendly,Vigo,Spain,False,4,0,Draw
15441,16901,18104,1994,Suriname,French Guiana,1,0,CFU Caribbean Cup qualification,Paramaribo,Suriname,False,1,1,Suriname
15442,16902,18105,1994,Tunisia,Netherlands,2,2,Friendly,Tunis,Tunisia,False,4,0,Draw
15443,16903,18106,1994,Guyana,French Guiana,1,1,CFU Caribbean Cup qualification,Paramaribo,Suriname,True,2,0,Draw
15444,16904,18107,1994,United States,Switzerland,1,1,Friendly,Fullerton,United States,False,2,0,Draw
15445,16905,18108,1994,Barbados,Puerto Rico,0,1,CFU Caribbean Cup qualification,Bridgetown,Barbados,False,1,-1,Puerto Rico
15446,16906,18109,1994,Mali,Senegal,1,0,Friendly,Bamako,Mali,False,1,1,Mali
15447,16908,18111,1994,Suriname,Guyana,2,0,CFU Caribbean Cup qualification,Paramaribo,Suriname,False,2,2,Suriname
15448,16909,18112,1994,Grenada,Puerto Rico,1,0,CFU Caribbean Cup qualification,Bridgetown,Barbados,True,1,1,Grenada
15449,16910,18113,1994,Qatar,Finland,1,0,Friendly,Doha,Qatar,False,1,1,Qatar
15450,16911,18114,1994,Mexico,Switzerland,1,5,Friendly,Oakland,United States,True,6,-4,Switzerland
15451,16913,18116,1994,Barbados,Grenada,3,2,CFU Caribbean Cup qualification,Bridgetown,Barbados,False,5,1,Barbados
15452,16914,18117,1994,Qatar,Finland,0,0,Friendly,Doha,Qatar,False,0,0,Draw
15453,16915,18118,1994,Venezuela,Colombia,1,2,Friendly,Barinas,Venezuela,False,3,-1,Colombia
15454,16916,18119,1994,Burkina Faso,Guinea,1,1,Friendly,Ouagadougou,Burkina Faso,False,2,0,Draw
15455,16917,18120,1994,Ivory Coast,Niger,5,3,Friendly,Ouagadougou,Burkina Faso,True,8,2,Ivory Coast
15456,16918,18121,1994,United States,Russia,1,1,Friendly,Seattle,United States,False,2,0,Draw
15457,16919,18122,1994,Burkina Faso,Ivory Coast,0,1,Friendly,Ouagadougou,Burkina Faso,False,1,-1,Ivory Coast
15458,16920,18123,1994,Guinea,Niger,1,3,Friendly,Ouagadougou,Burkina Faso,True,4,-2,Niger
15459,16921,18124,1994,Oman,Finland,0,2,Friendly,Muscat,Oman,False,2,-2,Finland
15460,16922,18125,1994,Senegal,Mali,0,0,Friendly,Dakar,Senegal,False,0,0,Draw
15461,16923,18126,1994,Oman,Finland,1,1,Friendly,Muscat,Oman,False,2,0,Draw
15462,16924,18127,1994,Egypt,Morocco,1,1,United Arab Emirates Friendship Tournament,Sharjah,United Arab Emirates,True,2,0,Draw
15463,16925,18128,1994,Mexico,Russia,1,4,Friendly,Oakland,United States,True,5,-3,Russia
15464,16926,18129,1994,United Arab Emirates,Slovakia,0,1,United Arab Emirates Friendship Tournament,Sharjah,United Arab Emirates,False,1,-1,Slovakia
15465,16927,18130,1994,Egypt,Slovakia,1,0,United Arab Emirates Friendship Tournament,Sharjah,United Arab Emirates,True,1,1,Egypt
15466,16928,18131,1994,Oman,Kenya,1,0,Friendly,Muscat,Oman,False,1,1,Oman
15467,16929,18132,1994,United Arab Emirates,Morocco,1,1,United Arab Emirates Friendship Tournament,Sharjah,United Arab Emirates,False,2,0,Draw
15468,16930,18133,1994,Morocco,Slovakia,2,1,United Arab Emirates Friendship Tournament,Sharjah,United Arab Emirates,True,3,1,Morocco
15469,16931,18134,1994,Oman,Kenya,2,0,Friendly,Muscat,Oman,False,2,2,Oman
15470,16932,18135,1994,Saudi Arabia,Colombia,1,1,Friendly,Jeddah,Saudi Arabia,False,2,0,Draw
15471,16933,18136,1994,United Arab Emirates,Egypt,0,1,United Arab Emirates Friendship Tournament,Dubai,United Arab Emirates,False,1,-1,Egypt
15472,16934,18137,1994,Gambia,Senegal,0,0,Friendly,Banjul,Gambia,False,0,0,Draw
15473,16935,18138,1994,Georgia,Slovenia,0,1,Malta International Tournament,Attard,Malta,True,1,-1,Slovenia
15474,16936,18139,1994,Malta,Tunisia,1,1,Malta International Tournament,Attard,Malta,False,2,0,Draw
15475,16937,18140,1994,Spain,Poland,1,1,Friendly,Santa Cruz de Tenerife,Spain,False,2,0,Draw
15476,16938,18141,1994,Malta,Georgia,0,1,Malta International Tournament,Attard,Malta,False,1,-1,Georgia
15477,16939,18142,1994,Slovenia,Tunisia,2,2,Malta International Tournament,Attard,Malta,True,4,0,Draw
15478,16940,18143,1994,Georgia,Tunisia,2,0,Malta International Tournament,Attard,Malta,True,2,2,Georgia
15479,16941,18144,1994,Malawi,Zambia,0,3,Friendly,Blantyre,Malawi,False,3,-3,Zambia
15480,16942,18145,1994,Malta,Slovenia,0,1,Malta International Tournament,Attard,Malta,False,1,-1,Slovenia
15481,16943,18146,1994,Malawi,Zambia,0,2,Friendly,Blantyre,Malawi,False,2,-2,Zambia
15482,16944,18147,1994,Romania,United States,2,1,Lunar New Year Cup,Kowloon,Hong Kong,True,3,1,Romania
15483,16945,18148,1994,Italy,France,0,1,Friendly,Naples,Italy,False,1,-1,France
15484,16946,18150,1994,Malta,Belgium,1,0,Friendly,Attard,Malta,False,1,1,Malta
15485,16947,18151,1994,Colombia,Sweden,0,0,Friendly,Miami,United States,True,0,0,Draw
15486,16948,18152,1994,United States,Bolivia,1,1,Friendly,Miami,United States,False,2,0,Draw
15487,16949,18153,1994,Bolivia,Colombia,0,2,Friendly,Miami,United States,True,2,-2,Colombia
15488,16950,18154,1994,United States,Sweden,1,3,Friendly,Miami,United States,False,4,-2,Sweden
15489,16951,18155,1994,Dominica,Antigua and Barbuda,3,2,CFU Caribbean Cup qualification,Basseterre,Saint Kitts and Nevis,True,5,1,Dominica
15490,16952,18156,1994,Israel,Georgia,2,0,Friendly,Ashdod,Israel,False,2,2,Israel
15491,16953,18157,1994,Mali,Ghana,0,0,Friendly,Bamako,Mali,False,0,0,Draw
15492,16954,18158,1994,Morocco,Finland,0,0,Friendly,Casablanca,Morocco,False,0,0,Draw
15493,16955,18159,1994,Saint Kitts and Nevis,Montserrat,9,1,CFU Caribbean Cup qualification,Basseterre,Saint Kitts and Nevis,False,10,8,Saint Kitts and Nevis
15494,16956,18160,1994,Turkey,Czech Republic,1,4,Friendly,Istanbul,Turkey,False,5,-3,Czech Republic
15495,16957,18161,1994,Mexico,Sweden,2,1,Friendly,Fresno,United States,True,3,1,Mexico
15496,16958,18162,1994,Antigua and Barbuda,Montserrat,8,0,CFU Caribbean Cup qualification,Basseterre,Saint Kitts and Nevis,True,8,8,Antigua and Barbuda
15497,16959,18163,1994,Saint Kitts and Nevis,Dominica,2,3,CFU Caribbean Cup qualification,Basseterre,Saint Kitts and Nevis,False,5,-1,Dominica
15498,16961,18165,1994,Zimbabwe,Zambia,2,2,Friendly,Harare,Zimbabwe,False,4,0,Draw
15499,16962,18166,1994,Gabon,Senegal,0,0,Friendly,Moanda,Gabon,False,0,0,Draw
15500,16964,18168,1994,Jamaica,Sint Maarten,3,2,CFU Caribbean Cup qualification,George Town,Cayman Islands,True,5,1,Jamaica
15501,16965,18169,1994,Mexico,Colombia,0,0,Friendly,Mexico City,Mexico,False,0,0,Draw
15502,16966,18170,1994,Cayman Islands,Sint Maarten,5,0,CFU Caribbean Cup qualification,George Town,Cayman Islands,False,5,5,Cayman Islands
15503,16967,18171,1994,Guadeloupe,Anguilla,9,0,CFU Caribbean Cup qualification,Kingstown,Saint Vincent and the Grenadines,True,9,9,Guadeloupe
15504,16970,18174,1994,Cayman Islands,Jamaica,3,2,CFU Caribbean Cup qualification,West Bay,Cayman Islands,False,5,1,Cayman Islands
15505,16972,18176,1994,Saint Vincent and the Grenadines,Anguilla,2,0,CFU Caribbean Cup qualification,Kingstown,Saint Vincent and the Grenadines,False,2,2,Saint Vincent and the Grenadines
15506,16973,18177,1994,Cyprus,Estonia,2,0,Friendly,Paralímni,Cyprus,False,2,2,Cyprus
15507,16974,18178,1994,England,Denmark,1,0,Friendly,London,England,False,1,1,England
15508,16975,18179,1994,Hungary,Switzerland,1,2,Friendly,Budapest,Hungary,False,3,-1,Switzerland
15509,16976,18180,1994,Nigeria,Ghana,0,0,Friendly,Lagos,Nigeria,False,0,0,Draw
15510,16977,18181,1994,Wales,Norway,1,3,Friendly,Cardiff,Wales,False,4,-2,Norway
15511,16978,18182,1994,Dominican Republic,Haiti,0,1,CFU Caribbean Cup qualification,Santo Domingo,Dominican Republic,False,1,-1,Haiti
15512,16979,18183,1994,Congo,DR Congo,2,1,Friendly,Brazzaville,Congo,False,3,1,Congo
15513,16981,18185,1994,Zambia,Zimbabwe,2,1,Friendly,Lusaka,Zambia,False,3,1,Zambia
15514,16982,18186,1994,Gabon,DR Congo,2,1,Friendly,Libreville,Gabon,False,3,1,Gabon
15515,16983,18187,1994,Israel,Ukraine,1,0,Friendly,Haifa,Israel,False,1,1,Israel
15516,16984,18188,1994,Egypt,Cameroon,0,0,Friendly,Cairo,Egypt,False,0,0,Draw
15517,16985,18189,1994,Tunisia,Niger,4,2,Friendly,Tunis,Tunisia,False,6,2,Tunisia
15518,16986,18190,1994,Angola,Gabon,2,1,Friendly,Luanda,Angola,False,3,1,Angola
15519,16987,18191,1994,France,Chile,3,1,Friendly,Lyon,France,False,4,2,France
15520,16988,18192,1994,Austria,Hungary,1,1,Friendly,Linz,Austria,False,2,0,Draw
15521,16989,18193,1994,Brazil,Argentina,2,0,Friendly,Recife,Brazil,False,2,2,Brazil
15522,16990,18194,1994,Germany,Italy,2,1,Friendly,Stuttgart,Germany,False,3,1,Germany
15523,16991,18195,1994,Greece,Poland,0,0,Friendly,Salonica,Greece,False,0,0,Draw
15524,16992,18196,1994,Republic of Ireland,Russia,0,0,Friendly,Dublin,Republic of Ireland,False,0,0,Draw
15525,16993,18197,1994,Luxembourg,Morocco,1,2,Friendly,Luxembourg,Luxembourg,False,3,-1,Morocco
15526,16994,18199,1994,Northern Ireland,Romania,2,0,Friendly,Belfast,Northern Ireland,False,2,2,Northern Ireland
15527,16995,18200,1994,Scotland,Netherlands,0,1,Friendly,Glasgow,Scotland,False,1,-1,Netherlands
15528,16996,18201,1994,Spain,Croatia,0,2,Friendly,Valencia,Spain,False,2,-2,Croatia
15529,16997,18202,1994,Nigeria,Gabon,3,0,African Cup of Nations,Tunis,Tunisia,True,3,3,Nigeria
15530,16998,18203,1994,Saudi Arabia,Chile,0,2,Friendly,Riyadh,Saudi Arabia,False,2,-2,Chile
15531,16999,18204,1994,Tunisia,Mali,0,2,African Cup of Nations,Tunis,Tunisia,False,2,-2,Mali
15532,17000,18205,1994,United States,Bolivia,2,2,Friendly,Dallas,United States,False,4,0,Draw
15533,17001,18206,1994,Ghana,Guinea,1,0,African Cup of Nations,Sousse,Tunisia,True,1,1,Ghana
15534,17002,18207,1994,Ivory Coast,Sierra Leone,4,0,African Cup of Nations,Sousse,Tunisia,True,4,4,Ivory Coast
15535,17003,18208,1994,Egypt,Gabon,4,0,African Cup of Nations,Tunis,Tunisia,True,4,4,Egypt
15536,17004,18209,1994,Mali,DR Congo,0,1,African Cup of Nations,Tunis,Tunisia,True,1,-1,DR Congo
15537,17005,18210,1994,Senegal,Guinea,2,1,African Cup of Nations,Sousse,Tunisia,True,3,1,Senegal
15538,17006,18211,1994,Zambia,Sierra Leone,0,0,African Cup of Nations,Sousse,Tunisia,True,0,0,Draw
15539,17007,18212,1994,Malta,Slovakia,1,2,Friendly,Attard,Malta,False,3,-1,Slovakia
15540,17008,18213,1994,Nigeria,Egypt,0,0,African Cup of Nations,Tunis,Tunisia,True,0,0,Draw
15541,17009,18214,1994,Tunisia,DR Congo,1,1,African Cup of Nations,Tunis,Tunisia,False,2,0,Draw
15542,17010,18215,1994,Ghana,Senegal,1,0,African Cup of Nations,Sousse,Tunisia,True,1,1,Ghana
15543,17011,18216,1994,Zambia,Ivory Coast,1,0,African Cup of Nations,Sousse,Tunisia,True,1,1,Zambia
15544,17012,18217,1994,DR Congo,Nigeria,0,2,African Cup of Nations,Tunis,Tunisia,True,2,-2,Nigeria
15545,17013,18218,1994,Egypt,Mali,0,1,African Cup of Nations,Tunis,Tunisia,True,1,-1,Mali
15546,17014,18219,1994,Ghana,Ivory Coast,1,2,African Cup of Nations,Sousse,Tunisia,True,3,-1,Ivory Coast
15547,17015,18220,1994,Zambia,Senegal,1,0,African Cup of Nations,Sousse,Tunisia,True,1,1,Zambia
15548,17016,18221,1994,Hungary,Slovenia,0,1,Friendly,Szombathely,Hungary,False,1,-1,Slovenia
15549,17017,18222,1994,Nigeria,Ivory Coast,2,2,African Cup of Nations,Tunis,Tunisia,True,4,0,Draw
15550,17018,18223,1994,Zambia,Mali,4,0,African Cup of Nations,Tunis,Tunisia,True,4,4,Zambia
15551,17019,18224,1994,Cayman Islands,Haiti,2,3,CFU Caribbean Cup,San Fernando,Trinidad and Tobago,True,5,-1,Haiti
15552,17020,18225,1994,Colombia,Bolivia,0,1,Friendly,Villavicencio,Colombia,False,1,-1,Bolivia
15553,17021,18226,1994,Martinique,Suriname,2,0,CFU Caribbean Cup,San Fernando,Trinidad and Tobago,True,2,2,Martinique
15554,17022,18227,1994,Martinique,Haiti,3,0,CFU Caribbean Cup,San Fernando,Trinidad and Tobago,True,3,3,Martinique
15555,17023,18228,1994,Suriname,Cayman Islands,2,0,CFU Caribbean Cup,San Fernando,Trinidad and Tobago,True,2,2,Suriname
15556,17024,18229,1994,Ivory Coast,Mali,3,1,African Cup of Nations,Tunis,Tunisia,True,4,2,Ivory Coast
15557,17025,18230,1994,Nigeria,Zambia,2,1,African Cup of Nations,Tunis,Tunisia,True,3,1,Nigeria
15558,17026,18231,1994,Kazakhstan,Tajikistan,1,0,Friendly,Tashkent,Uzbekistan,True,1,1,Kazakhstan
15559,17027,18232,1994,Martinique,Cayman Islands,1,1,CFU Caribbean Cup,San Fernando,Trinidad and Tobago,True,2,0,Draw
15560,17028,18233,1994,Suriname,Haiti,1,1,CFU Caribbean Cup,San Fernando,Trinidad and Tobago,True,2,0,Draw
15561,17029,18234,1994,Uzbekistan,Turkmenistan,4,0,Friendly,Tashkent,Uzbekistan,False,4,4,Uzbekistan
15562,17030,18235,1994,Kyrgyzstan,Turkmenistan,1,5,Friendly,Tashkent,Uzbekistan,True,6,-4,Turkmenistan
15563,17031,18236,1994,Poland,Saudi Arabia,1,0,Friendly,Cannes,France,True,1,1,Poland
15564,17032,18237,1994,Uzbekistan,Kazakhstan,1,0,Friendly,Tashkent,Uzbekistan,False,1,1,Uzbekistan
15565,17033,18238,1994,Martinique,Guadeloupe,4,2,CFU Caribbean Cup,Port of Spain,Trinidad and Tobago,True,6,2,Martinique
15566,17034,18239,1994,Trinidad and Tobago,Suriname,3,2,CFU Caribbean Cup,Port of Spain,Trinidad and Tobago,False,5,1,Trinidad and Tobago
15567,17035,18240,1994,Kazakhstan,Turkmenistan,0,0,Friendly,Tashkent,Uzbekistan,True,0,0,Draw
15568,17036,18241,1994,Kyrgyzstan,Tajikistan,0,1,Friendly,Tashkent,Uzbekistan,True,1,-1,Tajikistan
15569,17037,18242,1994,Oman,Bulgaria,1,1,Friendly,Muscat,Oman,False,2,0,Draw
15570,17038,18243,1994,United States,Moldova,1,1,Friendly,Jacksonville,United States,False,2,0,Draw
15571,17039,18244,1994,Colombia,Nigeria,1,0,Friendly,Armenia,Colombia,False,1,1,Colombia
15572,17040,18245,1994,Guadeloupe,Suriname,2,0,CFU Caribbean Cup,Port of Spain,Trinidad and Tobago,True,2,2,Guadeloupe
15573,17041,18246,1994,Kazakhstan,Kyrgyzstan,0,0,Friendly,Tashkent,Uzbekistan,True,0,0,Draw
15574,17042,18247,1994,Trinidad and Tobago,Martinique,7,2,CFU Caribbean Cup,Port of Spain,Trinidad and Tobago,False,9,5,Trinidad and Tobago
15575,17043,18248,1994,Uzbekistan,Tajikistan,1,1,Friendly,Tashkent,Uzbekistan,False,2,0,Draw
15576,17044,18249,1994,Tunisia,Saudi Arabia,2,0,Friendly,Tunis,Tunisia,False,2,2,Tunisia
15577,17045,18250,1994,Malta,Azerbaijan,5,0,Friendly,Attard,Malta,False,5,5,Malta
15578,17046,18251,1994,Tajikistan,Turkmenistan,0,2,Friendly,Tashkent,Uzbekistan,True,2,-2,Turkmenistan
15579,17047,18252,1994,Uzbekistan,Kyrgyzstan,3,0,Friendly,Tashkent,Uzbekistan,False,3,3,Uzbekistan
15580,17048,18253,1994,Argentina,Morocco,3,1,Friendly,Salta,Argentina,False,4,2,Argentina
15581,17049,18254,1994,Austria,Scotland,1,2,Friendly,Vienna,Austria,False,3,-1,Scotland
15582,17050,18255,1994,Denmark,Hungary,3,1,Friendly,Copenhagen,Denmark,False,4,2,Denmark
15583,17051,18256,1994,Iceland,Saudi Arabia,0,2,Friendly,Toulon,France,True,2,-2,Saudi Arabia
15584,17052,18257,1994,Lithuania,Israel,1,1,Friendly,Vilnius,Lithuania,False,2,0,Draw
15585,17053,18258,1994,Netherlands,Republic of Ireland,0,1,Friendly,Tilburg,Netherlands,False,1,-1,Republic of Ireland
15586,17054,18259,1994,Northern Ireland,Liechtenstein,4,1,UEFA Euro qualification,Belfast,Northern Ireland,False,5,3,Northern Ireland
15587,17055,18260,1994,Norway,Portugal,0,0,Friendly,Oslo,Norway,False,0,0,Draw
15588,17056,18261,1994,Romania,Bolivia,3,0,Friendly,Bucharest,Romania,False,3,3,Romania
15589,17057,18262,1994,Slovakia,Croatia,4,1,Friendly,Bratislava,Slovakia,False,5,3,Slovakia
15590,17058,18263,1994,Switzerland,Czech Republic,3,0,Friendly,Zürich,Switzerland,False,3,3,Switzerland
15591,17059,18264,1994,Turkey,Russia,0,1,Friendly,Bursa,Turkey,False,1,-1,Russia
15592,17060,18265,1994,United States,Moldova,3,0,Friendly,Davidson,United States,False,3,3,United States
15593,17061,18266,1994,Wales,Sweden,0,2,Friendly,Wrexham,Wales,False,2,-2,Sweden
15594,17062,18267,1994,Eswatini,Mozambique,0,1,Friendly,Mbabane,Eswatini,False,1,-1,Mozambique
15595,17063,18268,1994,South Africa,Zimbabwe,1,0,Friendly,Mafikeng,South Africa,False,1,1,South Africa
15596,17064,18269,1994,United States,Iceland,1,2,Friendly,Chula Vista,United States,False,3,-1,Iceland
15597,17065,18270,1994,Greece,Saudi Arabia,5,1,Friendly,Athens,Greece,False,6,4,Greece
15598,17066,18271,1994,Slovenia,Cyprus,3,0,Friendly,Maribor,Slovenia,False,3,3,Slovenia
15599,17067,18272,1994,United Arab Emirates,Germany,0,2,Friendly,Abu Dhabi,United Arab Emirates,False,2,-2,Germany
15600,17068,18273,1994,Kuwait,Bulgaria,2,2,Friendly,Kuwait City,Kuwait,False,4,0,Draw
15601,17069,18274,1994,United States,Chile,0,2,Friendly,Albuquerque,United States,False,2,-2,Chile
15602,17070,18276,1994,Jersey,Guernsey,3,1,Friendly,St. Helier,Jersey,False,4,2,Jersey
15603,17071,18277,1994,Colombia,Peru,1,0,Friendly,Miami,United States,True,1,1,Colombia
15604,17072,18278,1994,El Salvador,Honduras,3,1,Friendly,Miami,United States,True,4,2,El Salvador
15605,17073,18280,1994,Bolivia,Saudi Arabia,1,0,Friendly,Cannes,France,True,1,1,Bolivia
15606,17074,18281,1994,Brazil,Iceland,3,0,Friendly,Florianópolis,Brazil,False,3,3,Brazil
15607,17075,18282,1994,Poland,Hungary,3,2,Friendly,Cracow,Poland,False,5,1,Poland
15608,17076,18283,1994,Colombia,El Salvador,3,0,Friendly,Miami,United States,True,3,3,Colombia
15609,17077,18284,1994,Honduras,Peru,2,1,Friendly,Miami,United States,True,3,1,Honduras
15610,17078,18285,1994,Sweden,Nigeria,3,1,Friendly,Solna,Sweden,False,4,2,Sweden
15611,17079,18286,1994,United States,Estonia,4,0,Friendly,Fullerton,United States,False,4,4,United States
15612,17080,18287,1994,Greece,Cameroon,0,3,Friendly,Piraeus,Greece,False,3,-3,Cameroon
15613,17081,18288,1994,Bolivia,Cameroon,1,1,Friendly,Piraeus,Greece,True,2,0,Draw
15614,17082,18289,1994,Greece,Bolivia,0,0,Friendly,Piraeus,Greece,False,0,0,Draw
15615,17083,18291,1994,Nigeria,Suriname,2,1,Friendly,Amsterdam,Netherlands,True,3,1,Nigeria
15616,17084,18292,1994,United States,Armenia,1,0,Friendly,Fullerton,United States,False,1,1,United States
15617,17085,18293,1994,England,Greece,5,0,Friendly,London,England,False,5,5,England
15618,17086,18294,1994,Poland,Austria,3,4,Friendly,Katowice,Poland,False,7,-1,Austria
15619,17087,18295,1994,Chile,Argentina,3,3,Friendly,Santiago,Chile,False,6,0,Draw
15620,17088,18296,1994,Hungary,Croatia,2,2,Friendly,Győr,Hungary,False,4,0,Draw
15621,17089,18297,1994,Iceland,Bolivia,1,0,Friendly,Reykjavík,Iceland,False,1,1,Iceland
15622,17090,18298,1994,England,Norway,0,0,Friendly,London,England,False,0,0,Draw
15623,17091,18299,1994,Japan,Australia,1,1,Kirin Cup,Hiroshima,Japan,False,2,0,Draw
15624,17092,18300,1994,Estonia,Wales,1,2,Friendly,Tallinn,Estonia,False,3,-1,Wales
15625,17094,18302,1994,Republic of Ireland,Bolivia,1,0,Friendly,Dublin,Republic of Ireland,False,1,1,Republic of Ireland
15626,17095,18303,1994,Chile,Peru,2,1,Friendly,Santiago,Chile,False,3,1,Chile
15627,17096,18304,1994,Czech Republic,Lithuania,5,3,Friendly,Ostrava,Czech Republic,False,8,2,Czech Republic
15628,17097,18305,1994,Ecuador,Argentina,1,0,Friendly,Guayaquil,Ecuador,False,1,1,Ecuador
15629,17099,18307,1994,Ukraine,Belarus,3,1,Friendly,Kyïv,Ukraine,False,4,2,Ukraine
15630,17100,18308,1994,United States,Saudi Arabia,0,0,Friendly,Piscataway,United States,False,0,0,Draw
15631,17101,18309,1994,Australia,France,0,1,Kirin Cup,Kobe,Japan,True,1,-1,France
15632,17102,18310,1994,Denmark,Sweden,1,0,Friendly,Copenhagen,Denmark,False,1,1,Denmark
15633,17103,18311,1994,Italy,Finland,2,0,Friendly,Parma,Italy,False,2,2,Italy
15634,17104,18312,1994,Netherlands,Scotland,3,1,Friendly,Utrecht,Netherlands,False,4,2,Netherlands
15635,17105,18313,1994,Switzerland,Liechtenstein,2,0,Friendly,Basel,Switzerland,False,2,2,Switzerland
15636,17106,18314,1994,United States,Greece,1,1,Friendly,New Haven,United States,False,2,0,Draw
15637,17107,18315,1994,Germany,Republic of Ireland,0,2,Friendly,Hanover,Germany,False,2,-2,Republic of Ireland
15638,17108,18316,1994,Japan,France,1,4,Kirin Cup,Tokyo,Japan,False,5,-3,France
15639,17109,18317,1994,Russia,Slovakia,2,1,Friendly,Moscow,Russia,False,3,1,Russia
15640,17110,18318,1994,Israel,Argentina,0,3,Friendly,Ramat-Gan,Israel,False,3,-3,Argentina
15641,17111,18319,1994,Canada,Morocco,1,1,Friendly,Montréal,Canada,False,2,0,Draw
15642,17112,18321,1994,Netherlands,Hungary,7,1,Friendly,Eindhoven,Netherlands,False,8,6,Netherlands
15643,17113,18322,1994,Norway,Denmark,2,1,Friendly,Oslo,Norway,False,3,1,Norway
15644,17114,18323,1994,Romania,Slovenia,0,0,Friendly,Bucharest,Romania,False,0,0,Draw
15645,17115,18324,1994,Austria,Germany,1,5,Friendly,Vienna,Austria,False,6,-4,Germany
15646,17116,18325,1994,Finland,Spain,1,2,Friendly,Tampere,Finland,False,3,-1,Spain
15647,17117,18326,1994,Latvia,Malta,2,0,Friendly,Riga,Latvia,False,2,2,Latvia
15648,17118,18327,1994,Bulgaria,Ukraine,1,1,Friendly,Sofia,Bulgaria,False,2,0,Draw
15649,17119,18328,1994,Colombia,Northern Ireland,2,0,Friendly,Foxborough,United States,True,2,2,Colombia
15650,17120,18329,1994,Italy,Switzerland,1,0,Friendly,Rome,Italy,False,1,1,Italy
15651,17121,18330,1994,Croatia,Argentina,0,0,Friendly,Zagreb,Croatia,False,0,0,Draw
15652,17122,18331,1994,Trinidad and Tobago,Saudi Arabia,2,3,Friendly,Pomona,United States,True,5,-1,Saudi Arabia
15653,17123,18332,1994,United States,Mexico,1,0,Friendly,Pasadena,United States,False,1,1,United States
15654,17124,18333,1994,Canada,Brazil,1,1,Friendly,Edmonton,Canada,False,2,0,Draw
15655,17125,18334,1994,Colombia,Greece,2,0,Friendly,East Rutherford,United States,True,2,2,Colombia
15656,17127,18336,1994,Republic of Ireland,Czech Republic,1,3,Friendly,Dublin,Republic of Ireland,False,4,-2,Czech Republic
15657,17128,18337,1994,Ivory Coast,Liberia,4,1,Friendly,Abidjan,Ivory Coast,False,5,3,Ivory Coast
15658,17129,18338,1994,Sweden,Norway,2,0,Friendly,Solna,Sweden,False,2,2,Sweden
15659,17130,18339,1994,Australia,South Africa,1,0,Friendly,Adelaide,Australia,False,1,1,Australia
15660,17131,18340,1994,Belgium,Hungary,3,1,Friendly,Brussels,Belgium,False,4,2,Belgium
15661,17132,18341,1994,Bolivia,Peru,0,0,Friendly,Santa Cruz,Bolivia,False,0,0,Draw
15662,17133,18342,1994,Canada,Germany,0,2,Friendly,Toronto,Canada,False,2,-2,Germany
15663,17134,18343,1994,Honduras,Brazil,2,8,Friendly,San Diego,United States,True,10,-6,Brazil
15664,17135,18344,1994,Canada,Spain,0,2,Friendly,Montréal,Canada,False,2,-2,Spain
15665,17136,18345,1994,Bolivia,Switzerland,0,0,Friendly,Montréal,Canada,True,0,0,Draw
15666,17137,18346,1994,Costa Rica,Italy,0,1,Friendly,New Haven,United States,True,1,-1,Italy
15667,17139,18348,1994,Mexico,Northern Ireland,3,0,Friendly,Miami,United States,True,3,3,Mexico
15668,17140,18349,1994,Nigeria,Georgia,5,1,Friendly,Ibadan,Nigeria,False,6,4,Nigeria
15669,17141,18350,1994,Australia,South Africa,1,0,Friendly,Sydney,Australia,False,1,1,Australia
15670,17142,18351,1994,Canada,Netherlands,0,3,Friendly,Toronto,Canada,False,3,-3,Netherlands
15671,17143,18352,1994,El Salvador,Brazil,0,4,Friendly,Fresno,United States,True,4,-4,Brazil
15672,17144,18353,1994,Romania,Sweden,1,1,Friendly,Mission Viejo,United States,True,2,0,Draw
15673,17145,18354,1994,Germany,Bolivia,1,0,FIFA World Cup,Chicago,United States,True,1,1,Germany
15674,17147,18356,1994,Colombia,Romania,1,3,FIFA World Cup,Pasadena,United States,True,4,-2,Romania
15675,17148,18357,1994,Italy,Republic of Ireland,0,1,FIFA World Cup,East Rutherford,United States,True,1,-1,Republic of Ireland
15676,17149,18358,1994,United States,Switzerland,1,1,FIFA World Cup,Pontiac,United States,False,2,0,Draw
15677,17150,18359,1994,Belgium,Morocco,1,0,FIFA World Cup,Orlando,United States,True,1,1,Belgium
15678,17151,18360,1994,Cameroon,Sweden,2,2,FIFA World Cup,Pasadena,United States,True,4,0,Draw
15679,17152,18361,1994,Norway,Mexico,1,0,FIFA World Cup,Washington,United States,True,1,1,Norway
15680,17153,18362,1994,Brazil,Russia,2,0,FIFA World Cup,Palo Alto,United States,True,2,2,Brazil
15681,17154,18363,1994,Netherlands,Saudi Arabia,2,1,FIFA World Cup,Washington,United States,True,3,1,Netherlands
15682,17155,18364,1994,Argentina,Greece,4,0,FIFA World Cup,Foxborough,United States,True,4,4,Argentina
15683,17156,18365,1994,Germany,Spain,1,1,FIFA World Cup,Chicago,United States,True,2,0,Draw
15684,17157,18366,1994,Nigeria,Bulgaria,3,0,FIFA World Cup,Dallas,United States,True,3,3,Nigeria
15685,17158,18367,1994,Romania,Switzerland,1,4,FIFA World Cup,Pontiac,United States,True,5,-3,Switzerland
15686,17159,18368,1994,United States,Colombia,2,1,FIFA World Cup,Pasadena,United States,False,3,1,United States
15687,17160,18369,1994,Italy,Norway,1,0,FIFA World Cup,East Rutherford,United States,True,1,1,Italy
15688,17161,18371,1994,Brazil,Cameroon,3,0,FIFA World Cup,Palo Alto,United States,True,3,3,Brazil
15689,17162,18372,1994,Mexico,Republic of Ireland,2,1,FIFA World Cup,Orlando,United States,True,3,1,Mexico
15690,17163,18373,1994,Sweden,Russia,3,1,FIFA World Cup,Pontiac,United States,True,4,2,Sweden
15691,17164,18374,1994,Argentina,Nigeria,2,1,FIFA World Cup,Foxborough,United States,True,3,1,Argentina
15692,17165,18375,1994,Belgium,Netherlands,1,0,FIFA World Cup,Orlando,United States,True,1,1,Belgium
15693,17166,18376,1994,Saudi Arabia,Morocco,2,1,FIFA World Cup,East Rutherford,United States,True,3,1,Saudi Arabia
15694,17167,18377,1994,Bulgaria,Greece,4,0,FIFA World Cup,Chicago,United States,True,4,4,Bulgaria
15695,17168,18378,1994,Latvia,Georgia,1,3,Friendly,Riga,Latvia,False,4,-2,Georgia
15696,17169,18379,1994,Switzerland,Colombia,0,2,FIFA World Cup,Palo Alto,United States,True,2,-2,Colombia
15697,17170,18380,1994,United States,Romania,0,1,FIFA World Cup,Pasadena,United States,False,1,-1,Romania
15698,17171,18381,1994,Bolivia,Spain,1,3,FIFA World Cup,Chicago,United States,True,4,-2,Spain
15699,17173,18383,1994,Brazil,Sweden,1,1,FIFA World Cup,Pontiac,United States,True,2,0,Draw
15700,17174,18384,1994,Republic of Ireland,Norway,0,0,FIFA World Cup,East Rutherford,United States,True,0,0,Draw
15701,17175,18385,1994,Italy,Mexico,1,1,FIFA World Cup,Washington,United States,True,2,0,Draw
15702,17176,18386,1994,Russia,Cameroon,6,1,FIFA World Cup,Palo Alto,United States,True,7,5,Russia
15703,17177,18387,1994,Belgium,Saudi Arabia,0,1,FIFA World Cup,Washington,United States,True,1,-1,Saudi Arabia
15704,17178,18388,1994,Morocco,Netherlands,1,2,FIFA World Cup,Orlando,United States,True,3,-1,Netherlands
15705,17179,18389,1994,Argentina,Bulgaria,0,2,FIFA World Cup,Dallas,United States,True,2,-2,Bulgaria
15706,17180,18390,1994,Greece,Nigeria,0,2,FIFA World Cup,Foxborough,United States,True,2,-2,Nigeria
15707,17181,18391,1994,Botswana,Namibia,0,1,Friendly,Gaborone,Botswana,False,1,-1,Namibia
15708,17182,18392,1994,Germany,Belgium,3,2,FIFA World Cup,Chicago,United States,True,5,1,Germany
15709,17183,18393,1994,Spain,Switzerland,3,0,FIFA World Cup,Washington,United States,True,3,3,Spain
15710,17184,18394,1994,Papua New Guinea,New Caledonia,1,0,Oceania Nations Cup qualification,Honiara,Solomon Islands,True,1,1,Papua New Guinea
15711,17185,18395,1994,Romania,Argentina,3,2,FIFA World Cup,Pasadena,United States,True,5,1,Romania
15712,17186,18396,1994,Saudi Arabia,Sweden,1,3,FIFA World Cup,Dallas,United States,True,4,-2,Sweden
15713,17187,18397,1994,Fiji,New Caledonia,3,1,Oceania Nations Cup qualification,Honiara,Solomon Islands,True,4,2,Fiji
15714,17188,18398,1994,Netherlands,Republic of Ireland,2,0,FIFA World Cup,Orlando,United States,True,2,2,Netherlands
15715,17189,18399,1994,United States,Brazil,0,1,FIFA World Cup,Palo Alto,United States,False,1,-1,Brazil
15716,17190,18400,1994,Mexico,Bulgaria,1,1,FIFA World Cup,East Rutherford,United States,True,2,0,Draw
15717,17191,18401,1994,Nigeria,Italy,1,2,FIFA World Cup,Foxborough,United States,True,3,-1,Italy
15718,17192,18402,1994,Solomon Islands,Papua New Guinea,2,0,Oceania Nations Cup qualification,Honiara,Solomon Islands,False,2,2,Solomon Islands
15719,17193,18403,1994,Vanuatu,New Caledonia,2,3,Oceania Nations Cup qualification,Honiara,Solomon Islands,True,5,-1,New Caledonia
15720,17194,18404,1994,Papua New Guinea,Fiji,0,1,Oceania Nations Cup qualification,Honiara,Solomon Islands,True,1,-1,Fiji
15721,17195,18405,1994,Solomon Islands,Vanuatu,4,0,Oceania Nations Cup qualification,Honiara,Solomon Islands,False,4,4,Solomon Islands
15722,17196,18406,1994,Solomon Islands,Fiji,1,0,Oceania Nations Cup qualification,Honiara,Solomon Islands,False,1,1,Solomon Islands
15723,17197,18407,1994,Vanuatu,Papua New Guinea,1,1,Oceania Nations Cup qualification,Honiara,Solomon Islands,True,2,0,Draw
15724,17198,18408,1994,Japan,Ghana,3,2,Friendly,Nagoya,Japan,False,5,1,Japan
15725,17199,18409,1994,Solomon Islands,New Caledonia,3,1,Oceania Nations Cup qualification,Honiara,Solomon Islands,False,4,2,Solomon Islands
15726,17200,18410,1994,Vanuatu,Fiji,2,4,Oceania Nations Cup qualification,Honiara,Solomon Islands,True,6,-2,Fiji
15727,17201,18411,1994,Italy,Spain,2,1,FIFA World Cup,Foxborough,United States,True,3,1,Italy
15728,17202,18412,1994,Netherlands,Brazil,2,3,FIFA World Cup,Dallas,United States,True,5,-1,Brazil
15729,17203,18413,1994,Bulgaria,Germany,2,1,FIFA World Cup,East Rutherford,United States,True,3,1,Bulgaria
15730,17204,18414,1994,Romania,Sweden,2,2,FIFA World Cup,Palo Alto,United States,True,4,0,Draw
15731,17205,18415,1994,Bulgaria,Italy,1,2,FIFA World Cup,East Rutherford,United States,True,3,-1,Italy
15732,17206,18416,1994,Sweden,Brazil,0,1,FIFA World Cup,Pasadena,United States,True,1,-1,Brazil
15733,17207,18417,1994,Japan,Ghana,2,1,Friendly,Kobe,Japan,False,3,1,Japan
15734,17208,18418,1994,Armenia,Malta,1,0,Friendly,Yerevan,Armenia,False,1,1,Armenia
15735,17209,18419,1994,Sweden,Bulgaria,4,0,FIFA World Cup,Pasadena,United States,True,4,4,Sweden
15736,17210,18420,1994,Brazil,Italy,0,0,FIFA World Cup,Pasadena,United States,True,0,0,Draw
15737,17211,18421,1994,Georgia,Malta,1,1,Friendly,Tbilisi,Georgia,False,2,0,Draw
15738,17212,18422,1994,Lithuania,Estonia,3,0,Baltic Cup,Vilnius,Lithuania,False,3,3,Lithuania
15739,17213,18423,1994,Estonia,Latvia,0,2,Baltic Cup,Vilnius,Lithuania,True,2,-2,Latvia
15740,17214,18424,1994,Lithuania,Latvia,1,0,Baltic Cup,Vilnius,Lithuania,False,1,1,Lithuania
15741,17215,18425,1994,Ivory Coast,Mali,2,1,Friendly,Abidjan,Ivory Coast,False,3,1,Ivory Coast
15742,17216,18426,1994,Burma,Thailand,2,2,Friendly,Surabaya,Indonesia,True,4,0,Draw
15743,17217,18427,1994,Iceland,Estonia,4,0,Friendly,Akureyri,Iceland,False,4,4,Iceland
15744,17218,18428,1994,Niger,Togo,3,2,Friendly,Niamey,Niger,False,5,1,Niger
15745,17219,18429,1994,Slovakia,Malta,1,1,Friendly,Bratislava,Slovakia,False,2,0,Draw
15746,17220,18430,1994,Austria,Russia,0,3,Friendly,Klagenfurt,Austria,False,3,-3,Russia
15747,17221,18431,1994,Denmark,Finland,2,1,Friendly,Copenhagen,Denmark,False,3,1,Denmark
15748,17222,18432,1994,France,Czech Republic,2,2,Friendly,Bordeaux,France,False,4,0,Draw
15749,17223,18433,1994,Israel,Croatia,0,4,Friendly,Ramat-Gan,Israel,False,4,-4,Croatia
15750,17224,18434,1994,Peru,Ecuador,2,0,Friendly,Lima,Peru,False,2,2,Peru
15751,17225,18435,1994,Poland,Belarus,1,1,Friendly,Radom,Poland,False,2,0,Draw
15752,17226,18436,1994,Sweden,Lithuania,4,2,Friendly,Örebro,Sweden,False,6,2,Sweden
15753,17227,18437,1994,Congo,DR Congo,2,0,Friendly,Brazzaville,Congo,False,2,2,Congo
15754,17228,18438,1994,Egypt,Mali,2,1,Friendly,Cairo,Egypt,False,3,1,Egypt
15755,17229,18439,1994,Egypt,Mali,0,1,Friendly,Cairo,Egypt,False,1,-1,Mali
15756,17230,18440,1994,Burkina Faso,Niger,0,0,Friendly,Ouagadougou,Burkina Faso,False,0,0,Draw
15757,17231,18441,1994,Egypt,Ghana,2,0,Friendly,Cairo,Egypt,False,2,2,Egypt
15758,17232,18442,1994,DR Congo,Congo,2,0,Friendly,Kinshasa,Zaïre,False,2,2,DR Congo
15759,17233,18443,1994,Ghana,Zambia,1,0,Friendly,Cairo,Egypt,True,1,1,Ghana
15760,17234,18444,1994,Namibia,Botswana,2,3,Friendly,Windhoek,Namibia,False,5,-1,Botswana
15761,17235,18445,1994,DR Congo,Congo,1,1,Friendly,Kinshasa,Zaïre,False,2,0,Draw
15762,17236,18446,1994,Ukraine,United Arab Emirates,1,1,Friendly,Grassau,Austria,True,2,0,Draw
15763,17237,18447,1994,Egypt,Zambia,0,4,Friendly,Cairo,Egypt,False,4,-4,Zambia
15764,17238,18448,1994,Iceland,United Arab Emirates,1,0,Friendly,Reykjavík,Iceland,False,1,1,Iceland
15765,17239,18450,1994,Solomon Islands,Fiji,1,0,Friendly,Honiara,Solomon Islands,False,1,1,Solomon Islands
15766,17240,18451,1994,Tanzania,Uganda,4,0,African Cup of Nations qualification,Dar es Salaam,Tanzania,False,4,4,Tanzania
15767,17241,18452,1994,Angola,Namibia,2,0,African Cup of Nations qualification,Luanda,Angola,False,2,2,Angola
15768,17242,18453,1994,Botswana,Guinea,0,1,African Cup of Nations qualification,Gaborone,Botswana,False,1,-1,Guinea
15769,17243,18454,1994,Burkina Faso,Morocco,2,1,African Cup of Nations qualification,Ouagadougou,Burkina Faso,False,3,1,Burkina Faso
15770,17244,18455,1994,Congo,Gambia,1,1,African Cup of Nations qualification,Pointe-Noire,Congo,False,2,0,Draw
15771,17245,18456,1994,DR Congo,Malawi,1,1,African Cup of Nations qualification,Kinshasa,Zaïre,False,2,0,Draw
15772,17246,18457,1994,Estonia,Croatia,0,2,UEFA Euro qualification,Tallinn,Estonia,False,2,-2,Croatia
15773,17247,18458,1994,Ethiopia,Algeria,0,0,African Cup of Nations qualification,Addis Abeba,Ethiopia,False,0,0,Draw
15774,17248,18459,1994,Guinea-Bissau,Tunisia,1,3,African Cup of Nations qualification,Bissau,Guinea-Bissau,False,4,-2,Tunisia
15775,17249,18460,1994,Israel,Poland,2,1,UEFA Euro qualification,Ramat-Gan,Israel,False,3,1,Israel
15776,17250,18461,1994,Liberia,Togo,1,0,African Cup of Nations qualification,Monrovia,Liberia,False,1,1,Liberia
15777,17251,18462,1994,Madagascar,South Africa,0,1,African Cup of Nations qualification,Antananarivo,Madagascar,False,1,-1,South Africa
15778,17252,18463,1994,Mali,Mozambique,2,1,African Cup of Nations qualification,Bamako,Mali,False,3,1,Mali
15779,17253,18464,1994,Sudan,Egypt,0,0,African Cup of Nations qualification,Khartoum,Sudan,False,0,0,Draw
15780,17254,18465,1994,Czech Republic,Malta,6,1,UEFA Euro qualification,Ostrava,Czech Republic,False,7,5,Czech Republic
15781,17255,18466,1994,Liberia,Togo,1,1,Friendly,Monrovia,Liberia,False,2,0,Draw
15782,17256,18467,1994,Switzerland,United Arab Emirates,1,0,Friendly,Sion,Switzerland,False,1,1,Switzerland
15783,17257,18468,1994,Belgium,Armenia,2,0,UEFA Euro qualification,Brussels,Belgium,False,2,2,Belgium
15784,17258,18469,1994,Cyprus,Spain,1,2,UEFA Euro qualification,Limassol,Cyprus,False,3,-1,Spain
15785,17259,18470,1994,England,United States,2,0,Friendly,London,England,False,2,2,England
15786,17260,18471,1994,Faroe Islands,Greece,1,5,UEFA Euro qualification,Toftir,Faroe Islands,False,6,-4,Greece
15787,17261,18472,1994,Finland,Scotland,0,2,UEFA Euro qualification,Helsinki,Finland,False,2,-2,Scotland
15788,17262,18473,1994,Georgia,Moldova,0,1,UEFA Euro qualification,Tbilisi,Georgia,False,1,-1,Moldova
15789,17263,18474,1994,Hungary,Turkey,2,2,UEFA Euro qualification,Budapest,Hungary,False,4,0,Draw
15790,17264,18475,1994,Iceland,Sweden,0,1,UEFA Euro qualification,Reykjavík,Iceland,False,1,-1,Sweden
15791,17265,18476,1994,Latvia,Republic of Ireland,0,3,UEFA Euro qualification,Riga,Latvia,False,3,-3,Republic of Ireland
15792,17266,18477,1994,Liechtenstein,Austria,0,4,UEFA Euro qualification,Eschen,Liechtenstein,False,4,-4,Austria
15793,17267,18478,1994,Luxembourg,Netherlands,0,4,UEFA Euro qualification,Luxembourg,Luxembourg,False,4,-4,Netherlands
15794,17268,18480,1994,Northern Ireland,Portugal,1,2,UEFA Euro qualification,Belfast,Northern Ireland,False,3,-1,Portugal
15795,17269,18481,1994,Norway,Belarus,1,0,UEFA Euro qualification,Oslo,Norway,False,1,1,Norway
15796,17270,18482,1994,Romania,Azerbaijan,3,0,UEFA Euro qualification,Bucharest,Romania,False,3,3,Romania
15797,17271,18483,1994,Russia,Germany,0,1,Friendly,Moscow,Russia,False,1,-1,Germany
15798,17272,18484,1994,Slovakia,France,0,0,UEFA Euro qualification,Bratislava,Slovakia,False,0,0,Draw
15799,17273,18485,1994,Slovenia,Italy,1,1,UEFA Euro qualification,Maribor,Slovenia,False,2,0,Draw
15800,17274,18486,1994,Ukraine,Lithuania,0,2,UEFA Euro qualification,Kyïv,Ukraine,False,2,-2,Lithuania
15801,17275,18487,1994,Wales,Albania,2,0,UEFA Euro qualification,Cardiff,Wales,False,2,2,Wales
15802,17276,18488,1994,Qatar,Oman,0,2,Friendly,Doha,Qatar,False,2,-2,Oman
15803,17277,18490,1994,Bangladesh,India,2,4,Friendly,Doha,Qatar,True,6,-2,India
15804,17278,18492,1994,India,Yemen,0,1,Friendly,Doha,Qatar,True,1,-1,Yemen
15805,17279,18493,1994,Oman,Sudan,1,1,Friendly,Doha,Qatar,True,2,0,Draw
15806,17280,18494,1994,India,Oman,1,4,Friendly,Doha,Qatar,True,5,-3,Oman
15807,17281,18495,1994,Qatar,Yemen,2,0,Friendly,Doha,Qatar,False,2,2,Qatar
15808,17282,18496,1994,India,Yemen,0,2,Friendly,Doha,Qatar,True,2,-2,Yemen
15809,17283,18498,1994,Chile,Bolivia,1,2,Friendly,Santiago,Chile,False,3,-1,Bolivia
15810,17284,18499,1994,Ecuador,Peru,0,0,Friendly,Machala,Ecuador,False,0,0,Draw
15811,17285,18500,1994,Malaysia,Kuwait,0,2,Friendly,Kuala Lumpur,Malaysia,False,2,-2,Kuwait
15812,17286,18501,1994,Australia,Kuwait,0,0,Friendly,Kuala Lumpur,Malaysia,True,0,0,Draw
15813,17287,18502,1994,Zambia,Ghana,3,0,Friendly,Lusaka,Zambia,False,3,3,Zambia
15814,17288,18503,1994,Japan,Australia,0,0,Friendly,Tokyo,Japan,False,0,0,Draw
15815,17289,18504,1994,Armenia,Cyprus,0,0,UEFA Euro qualification,Yerevan,Armenia,False,0,0,Draw
15816,17290,18505,1994,Estonia,Italy,0,2,UEFA Euro qualification,Tallinn,Estonia,False,2,-2,Italy
15817,17291,18506,1994,France,Romania,0,0,UEFA Euro qualification,Saint-Étienne,France,False,0,0,Draw
15818,17292,18507,1994,Croatia,Lithuania,2,0,UEFA Euro qualification,Zagreb,Croatia,False,2,2,Croatia
15819,17293,18508,1994,Latvia,Portugal,1,3,UEFA Euro qualification,Riga,Latvia,False,4,-2,Portugal
15820,17294,18509,1994,Senegal,Niger,3,1,Friendly,Dakar,Senegal,False,4,2,Senegal
15821,17295,18510,1994,Zambia,Malawi,2,1,Friendly,Lusaka,Zambia,False,3,1,Zambia
15822,17296,18511,1994,Austria,Northern Ireland,1,2,UEFA Euro qualification,Vienna,Austria,False,3,-1,Northern Ireland
15823,17297,18512,1994,Belarus,Luxembourg,2,0,UEFA Euro qualification,Minsk,Belarus,False,2,2,Belarus
15824,17298,18513,1994,Bulgaria,Georgia,2,0,UEFA Euro qualification,Sofia,Bulgaria,False,2,2,Bulgaria
15825,17299,18514,1994,Denmark,Belgium,3,1,UEFA Euro qualification,Copenhagen,Denmark,False,4,2,Denmark
15826,17300,18515,1994,England,Romania,1,1,Friendly,London,England,False,2,0,Draw
15827,17301,18516,1994,Greece,Finland,4,0,UEFA Euro qualification,Salonica,Greece,False,4,4,Greece
15828,17302,18517,1994,Hungary,Germany,0,0,Friendly,Budapest,Hungary,False,0,0,Draw
15829,17303,18518,1994,Republic of Ireland,Liechtenstein,4,0,UEFA Euro qualification,Dublin,Republic of Ireland,False,4,4,Republic of Ireland
15830,17304,18519,1994,Israel,Slovakia,2,2,UEFA Euro qualification,Ramat-Gan,Israel,False,4,0,Draw
15831,17305,18521,1994,Malta,Czech Republic,0,0,UEFA Euro qualification,Attard,Malta,False,0,0,Draw
15832,17306,18522,1994,Moldova,Wales,3,2,UEFA Euro qualification,Chişinău,Moldova,False,5,1,Moldova
15833,17307,18523,1994,Norway,Netherlands,1,1,UEFA Euro qualification,Oslo,Norway,False,2,0,Draw
15834,17308,18524,1994,Poland,Azerbaijan,1,0,UEFA Euro qualification,Mielec,Poland,False,1,1,Poland
15835,17309,18525,1994,Russia,San Marino,4,0,UEFA Euro qualification,Moscow,Russia,False,4,4,Russia
15836,17310,18526,1994,Scotland,Faroe Islands,5,1,UEFA Euro qualification,Glasgow,Scotland,False,6,4,Scotland
15837,17311,18527,1994,Switzerland,Sweden,4,2,UEFA Euro qualification,Berne,Switzerland,False,6,2,Switzerland
15838,17312,18528,1994,Turkey,Iceland,5,0,UEFA Euro qualification,Istanbul,Turkey,False,5,5,Turkey
15839,17313,18529,1994,Ukraine,Slovenia,0,0,UEFA Euro qualification,Kyïv,Ukraine,False,0,0,Draw
15840,17314,18530,1994,Algeria,Sudan,1,1,African Cup of Nations qualification,Algiers,Algeria,False,2,0,Draw
15841,17315,18531,1994,Egypt,Tanzania,5,1,African Cup of Nations qualification,Cairo,Egypt,False,6,4,Egypt
15842,17316,18532,1994,Mauritania,Guinea-Bissau,1,1,African Cup of Nations qualification,Nouakchott,Mauritania,False,2,0,Draw
15843,17317,18533,1994,Malawi,Zimbabwe,3,1,African Cup of Nations qualification,Blantyre,Malawi,False,4,2,Malawi
15844,17318,18534,1994,Namibia,Mali,2,1,African Cup of Nations qualification,Windhoek,Namibia,False,3,1,Namibia
15845,17319,18535,1994,Uganda,Ethiopia,4,1,African Cup of Nations qualification,Kampala,Uganda,False,5,3,Uganda
15846,17320,18536,1994,Cameroon,DR Congo,1,0,African Cup of Nations qualification,Douala,Cameroon,False,1,1,Cameroon
15847,17321,18537,1994,Guinea,Angola,3,1,African Cup of Nations qualification,Conakry,Guinea,False,4,2,Guinea
15848,17322,18538,1994,Mozambique,Botswana,3,1,African Cup of Nations qualification,Maputo,Mozambique,False,4,2,Mozambique
15849,17323,18539,1994,Niger,Ghana,1,5,African Cup of Nations qualification,Niamey,Niger,False,6,-4,Ghana
15850,17324,18540,1994,Togo,Senegal,2,0,African Cup of Nations qualification,Lomé,Togo,False,2,2,Togo
15851,17325,18541,1994,Peru,Uruguay,0,1,Friendly,Lima,Peru,False,1,-1,Uruguay
15852,17326,18542,1994,Saudi Arabia,United States,2,1,Friendly,Khobar,Saudi Arabia,False,3,1,Saudi Arabia
15853,17327,18543,1994,Oman,Senegal,0,1,Friendly,Muscat,Oman,False,1,-1,Senegal
15854,17328,18544,1994,Oman,Senegal,2,1,Friendly,Muscat,Oman,False,3,1,Oman
15855,17329,18545,1994,Estonia,Finland,0,7,Friendly,Tallinn,Estonia,False,7,-7,Finland
15856,17330,18546,1994,Saudi Arabia,Trinidad and Tobago,1,0,Friendly,Riyadh,Saudi Arabia,False,1,1,Saudi Arabia
15857,17331,18547,1994,United Arab Emirates,Senegal,3,2,Friendly,Abu Dhabi,United Arab Emirates,False,5,1,United Arab Emirates
15858,17332,18548,1994,Kuwait,Iceland,0,1,Friendly,al-Ain,United Arab Emirates,True,1,-1,Iceland
15859,17333,18549,1994,United Arab Emirates,Qatar,2,0,Gulf Cup,Abu Dhabi,United Arab Emirates,False,2,2,United Arab Emirates
15860,17334,18550,1994,Bahrain,Kuwait,2,1,Gulf Cup,Abu Dhabi,United Arab Emirates,True,3,1,Bahrain
15861,17335,18551,1994,Oman,Saudi Arabia,1,2,Gulf Cup,Abu Dhabi,United Arab Emirates,True,3,-1,Saudi Arabia
15862,17336,18552,1994,Latvia,Estonia,0,0,Friendly,Ozolnieki,Latvia,False,0,0,Draw
15863,17337,18553,1994,United Arab Emirates,Saudi Arabia,1,1,Gulf Cup,Abu Dhabi,United Arab Emirates,False,2,0,Draw
15864,17338,18554,1994,Kuwait,Qatar,1,0,Gulf Cup,Abu Dhabi,United Arab Emirates,True,1,1,Kuwait
15865,17339,18555,1994,Morocco,Cameroon,1,1,Friendly,Casablanca,Morocco,False,2,0,Draw
15866,17340,18556,1994,Tunisia,Ivory Coast,2,0,Friendly,Tunis,Tunisia,False,2,2,Tunisia
15867,17341,18557,1994,Qatar,Oman,4,2,Gulf Cup,Abu Dhabi,United Arab Emirates,True,6,2,Qatar
15868,17342,18558,1994,United Arab Emirates,Kuwait,2,0,Gulf Cup,Abu Dhabi,United Arab Emirates,False,2,2,United Arab Emirates
15869,17343,18559,1994,Saudi Arabia,Bahrain,3,1,Gulf Cup,Abu Dhabi,United Arab Emirates,True,4,2,Saudi Arabia
15870,17344,18560,1994,Egypt,Ethiopia,5,0,African Cup of Nations qualification,Cairo,Egypt,False,5,5,Egypt
15871,17345,18561,1994,Mauritania,Liberia,1,1,African Cup of Nations qualification,Nouakchott,Mauritania,False,2,0,Draw
15872,17346,18562,1994,Gambia,Ghana,1,2,African Cup of Nations qualification,Banjul,Gambia,False,3,-1,Ghana
15873,17347,18563,1994,Qatar,Saudi Arabia,1,2,Gulf Cup,Abu Dhabi,United Arab Emirates,True,3,-1,Saudi Arabia
15874,17348,18564,1994,Romania,Slovakia,3,2,UEFA Euro qualification,Bucharest,Romania,False,5,1,Romania
15875,17349,18565,1994,Tanzania,Sudan,2,0,African Cup of Nations qualification,Dar es Salaam,Tanzania,False,2,2,Tanzania
15876,17350,18566,1994,Uganda,Algeria,1,1,African Cup of Nations qualification,Kampala,Uganda,False,2,0,Draw
15877,17351,18567,1994,United Arab Emirates,Bahrain,0,0,Gulf Cup,Abu Dhabi,United Arab Emirates,False,0,0,Draw
15878,17352,18568,1994,Gabon,Mauritius,3,0,African Cup of Nations qualification,Libreville,Gabon,False,3,3,Gabon
15879,17353,18569,1994,Guinea-Bissau,Senegal,1,4,African Cup of Nations qualification,Bissau,Guinea-Bissau,False,5,-3,Senegal
15880,17354,18570,1994,Lesotho,Cameroon,2,0,African Cup of Nations qualification,Maseru,Lesotho,False,2,2,Lesotho
15881,17355,18571,1994,Mali,Angola,0,0,African Cup of Nations qualification,Bamako,Mali,False,0,0,Draw
15882,17356,18572,1994,Morocco,Ivory Coast,1,0,African Cup of Nations qualification,Casablanca,Morocco,False,1,1,Morocco
15883,17357,18573,1994,Mozambique,Guinea,2,1,African Cup of Nations qualification,Maputo,Mozambique,False,3,1,Mozambique
15884,17358,18574,1994,Niger,Sierra Leone,4,2,African Cup of Nations qualification,Niamey,Niger,False,6,2,Niger
15885,17359,18575,1994,Oman,Kuwait,0,0,Gulf Cup,Abu Dhabi,United Arab Emirates,True,0,0,Draw
15886,17360,18576,1994,Portugal,Austria,1,0,UEFA Euro qualification,Lisbon,Portugal,False,1,1,Portugal
15887,17361,18577,1994,Ukraine,Estonia,3,0,UEFA Euro qualification,Kyïv,Ukraine,False,3,3,Ukraine
15888,17362,18578,1994,Zambia,South Africa,1,1,African Cup of Nations qualification,Lusaka,Zambia,False,2,0,Draw
15889,17363,18579,1994,Zimbabwe,DR Congo,2,1,African Cup of Nations qualification,Harare,Zimbabwe,False,3,1,Zimbabwe
15890,17364,18580,1994,Bahrain,Qatar,1,1,Gulf Cup,Abu Dhabi,United Arab Emirates,True,2,0,Draw
15891,17365,18581,1994,Grenada,Trinidad and Tobago,1,2,Friendly,St. George's,Grenada,False,3,-1,Trinidad and Tobago
15892,17366,18582,1994,Liechtenstein,Latvia,0,1,UEFA Euro qualification,Eschen,Liechtenstein,False,1,-1,Latvia
15893,17367,18583,1994,Albania,Germany,1,2,UEFA Euro qualification,Tirana,Albania,False,3,-1,Germany
15894,17368,18584,1994,Azerbaijan,Israel,0,2,UEFA Euro qualification,Trabzon,Turkey,True,2,-2,Israel
15895,17369,18585,1994,Belarus,Norway,0,4,UEFA Euro qualification,Minsk,Belarus,False,4,-4,Norway
15896,17371,18587,1994,Bulgaria,Moldova,4,1,UEFA Euro qualification,Sofia,Bulgaria,False,5,3,Bulgaria
15897,17372,18588,1994,Chile,Argentina,0,3,Friendly,Santiago,Chile,False,3,-3,Argentina
15898,17373,18589,1994,Cyprus,Armenia,2,0,UEFA Euro qualification,Limassol,Cyprus,False,2,2,Cyprus
15899,17374,18590,1994,England,Nigeria,1,0,Friendly,London,England,False,1,1,England
15900,17375,18591,1994,Finland,Faroe Islands,5,0,UEFA Euro qualification,Helsinki,Finland,False,5,5,Finland
15901,17376,18592,1994,Georgia,Wales,5,0,UEFA Euro qualification,Tbilisi,Georgia,False,5,5,Georgia
15902,17377,18593,1994,Greece,San Marino,2,0,UEFA Euro qualification,Athens,Greece,False,2,2,Greece
15903,17378,18594,1994,Italy,Croatia,1,2,UEFA Euro qualification,Palermo,Italy,False,3,-1,Croatia
15904,17379,18595,1994,Kuwait,Saudi Arabia,0,2,Gulf Cup,Abu Dhabi,United Arab Emirates,True,2,-2,Saudi Arabia
15905,17380,18596,1994,Netherlands,Czech Republic,0,0,UEFA Euro qualification,Rotterdam,Netherlands,False,0,0,Draw
15906,17381,18597,1994,Northern Ireland,Republic of Ireland,0,4,UEFA Euro qualification,Belfast,Northern Ireland,False,4,-4,Republic of Ireland
15907,17382,18598,1994,Poland,France,0,0,UEFA Euro qualification,Zabrze,Poland,False,0,0,Draw
15908,17383,18599,1994,Scotland,Russia,1,1,UEFA Euro qualification,Glasgow,Scotland,False,2,0,Draw
15909,17384,18600,1994,Slovenia,Lithuania,1,2,UEFA Euro qualification,Maribor,Slovenia,False,3,-1,Lithuania
15910,17385,18601,1994,Spain,Denmark,3,0,UEFA Euro qualification,Seville,Spain,False,3,3,Spain
15911,17386,18602,1994,Sweden,Hungary,2,0,UEFA Euro qualification,Solna,Sweden,False,2,2,Sweden
15912,17387,18603,1994,Switzerland,Iceland,1,0,UEFA Euro qualification,Lausanne,Switzerland,False,1,1,Switzerland
15913,17388,18604,1994,United Arab Emirates,Oman,2,0,Gulf Cup,Abu Dhabi,United Arab Emirates,False,2,2,United Arab Emirates
15914,17389,18605,1994,Trinidad and Tobago,United States,1,0,Friendly,Port of Spain,Trinidad and Tobago,False,1,1,Trinidad and Tobago
15915,17390,18606,1994,Gabon,Zambia,2,1,African Cup of Nations qualification,Libreville,Gabon,False,3,1,Gabon
15916,17391,18607,1994,Jamaica,United States,0,3,Friendly,Kingston,Jamaica,False,3,-3,United States
15917,17392,18608,1994,Samoa,American Samoa,3,1,Oceania Nations Cup qualification,Apia,Western Samoa,False,4,2,Samoa
15918,17393,18610,1994,Samoa,Tonga,2,2,Oceania Nations Cup qualification,Apia,Western Samoa,False,4,0,Draw
15919,17394,18612,1994,Cameroon,Ivory Coast,1,2,Simba Tournament,Pretoria,South Africa,True,3,-1,Ivory Coast
15920,17395,18613,1994,Kenya,Somalia,3,1,CECAFA Cup,Nairobi,Kenya,False,4,2,Kenya
15921,17396,18614,1994,Kenya,Djibouti,4,1,CECAFA Cup,Nairobi,Kenya,False,5,3,Kenya
15922,17398,18616,1994,Tonga,American Samoa,2,1,Oceania Nations Cup qualification,Apia,Western Samoa,True,3,1,Tonga
15923,17399,18617,1994,Israel,Cyprus,4,3,Friendly,Jerusalem,Israel,False,7,1,Israel
15924,17400,18618,1994,Tanzania,Somalia,4,0,CECAFA Cup,Nairobi,Kenya,True,4,4,Tanzania
15925,17401,18619,1994,Cameroon,Ghana,0,1,Simba Tournament,Port Elizabeth,South Africa,True,1,-1,Ghana
15926,17402,18620,1994,South Africa,Ivory Coast,0,0,Simba Tournament,Port Elizabeth,South Africa,False,0,0,Draw
15927,17403,18621,1994,Spain,Finland,2,0,Friendly,Málaga,Spain,False,2,2,Spain
15928,17404,18622,1994,Kenya,Tanzania,0,1,CECAFA Cup,Nairobi,Kenya,False,1,-1,Tanzania
15929,17405,18623,1994,Somalia,Djibouti,2,1,CECAFA Cup,Nairobi,Kenya,True,3,1,Somalia
15930,17406,18624,1994,Uganda,Seychelles,2,0,CECAFA Cup,Nairobi,Kenya,True,2,2,Uganda
15931,17407,18625,1994,Tanzania,Djibouti,3,0,CECAFA Cup,Nairobi,Kenya,True,3,3,Tanzania
15932,17408,18626,1994,Uganda,Eritrea,0,0,CECAFA Cup,Nairobi,Kenya,True,0,0,Draw
15933,17409,18627,1994,Ghana,Ivory Coast,1,1,Simba Tournament,Johannesburg,South Africa,True,2,0,Draw
15934,17410,18628,1994,South Africa,Cameroon,1,1,Simba Tournament,Johannesburg,South Africa,False,2,0,Draw
15935,17411,18629,1994,Togo,Burkina Faso,2,0,Friendly,Lomé,Togo,False,2,2,Togo
15936,17412,18630,1994,Kenya,Uganda,0,1,CECAFA Cup,Nairobi,Kenya,False,1,-1,Uganda
15937,17413,18631,1994,Tanzania,Eritrea,1,0,CECAFA Cup,Nairobi,Kenya,True,1,1,Tanzania
15938,17414,18632,1994,Kenya,Eritrea,1,0,CECAFA Cup,Nairobi,Kenya,False,1,1,Kenya
15939,17415,18633,1994,Saudi Arabia,Poland,0,2,Friendly,Riyadh,Saudi Arabia,False,2,-2,Poland
15940,17416,18634,1994,Tanzania,Uganda,2,2,Friendly,Nairobi,Kenya,True,4,0,Draw
15941,17417,18635,1994,Namibia,Ivory Coast,2,1,Friendly,Windhoek,Namibia,False,3,1,Namibia
15942,17418,18636,1994,Saudi Arabia,Poland,1,2,Friendly,Riyadh,Saudi Arabia,False,3,-1,Poland
15943,17419,18637,1994,United States,Honduras,1,1,Friendly,Fullerton,United States,False,2,0,Draw
15944,17420,18638,1994,Albania,Georgia,0,1,UEFA Euro qualification,Tirana,Albania,False,1,-1,Georgia
15945,17421,18639,1994,Finland,San Marino,4,1,UEFA Euro qualification,Helsinki,Finland,False,5,3,Finland
15946,17422,18640,1994,Israel,Romania,1,1,UEFA Euro qualification,Ramat-Gan,Israel,False,2,0,Draw
15947,17423,18641,1994,Malta,Norway,0,1,UEFA Euro qualification,Attard,Malta,False,1,-1,Norway
15948,17424,18642,1994,Mexico,Hungary,5,1,Friendly,Mexico City,Mexico,False,6,4,Mexico
15949,17425,18643,1994,Moldova,Germany,0,3,UEFA Euro qualification,Chişinău,Moldova,False,3,-3,Germany
15950,17426,18644,1994,Netherlands,Luxembourg,5,0,UEFA Euro qualification,Rotterdam,Netherlands,False,5,5,Netherlands
15951,17427,18645,1994,Turkey,Switzerland,1,2,UEFA Euro qualification,Istanbul,Turkey,False,3,-1,Switzerland
15952,17428,18646,1994,Wales,Bulgaria,0,3,UEFA Euro qualification,Cardiff,Wales,False,3,-3,Bulgaria
15953,17429,18647,1994,Tunisia,Algeria,1,0,Friendly,Sfax,Tunisia,False,1,1,Tunisia
15954,17430,18648,1994,Belgium,Spain,1,4,UEFA Euro qualification,Brussels,Belgium,False,5,-3,Spain
15955,17431,18650,1994,Saudi Arabia,Costa Rica,1,3,Friendly,Riyadh,Saudi Arabia,False,4,-2,Costa Rica
15956,17432,18651,1994,Cameroon,Togo,1,1,Friendly,Douala,Cameroon,False,2,0,Draw
15957,17433,18652,1994,Germany,Albania,2,1,UEFA Euro qualification,Kaiserslautern,Germany,False,3,1,Germany
15958,17434,18653,1994,Greece,Scotland,1,0,UEFA Euro qualification,Athens,Greece,False,1,1,Greece
15959,17435,18654,1994,Portugal,Liechtenstein,8,0,UEFA Euro qualification,Lisbon,Portugal,False,8,8,Portugal
15960,17436,18655,1994,Italy,Turkey,3,1,Friendly,Pescara,Italy,False,4,2,Italy
15961,17437,18656,1994,Brazil,Serbia,2,0,Friendly,Porto Alegre,Brazil,False,2,2,Brazil
15962,17438,18658,1994,Mali,Mauritania,0,0,Friendly,Bamako,Mali,False,0,0,Draw
15963,17439,18659,1994,Argentina,Serbia,1,0,Friendly,Buenos Aires,Argentina,False,1,1,Argentina
15964,17440,18660,1994,Liberia,Guinea,0,0,Friendly,Monrovia,Liberia,False,0,0,Draw
15965,17441,18661,1994,Mali,Mauritania,0,0,Friendly,Bamako,Mali,False,0,0,Draw
15966,17442,18662,1994,Saudi Arabia,Zambia,1,0,Friendly,Riyadh,Saudi Arabia,False,1,1,Saudi Arabia
15967,17443,18663,1995,Guinea,Sierra Leone,3,1,Friendly,Conakry,Guinea,False,4,2,Guinea
15968,17444,18664,1995,Mali,Mauritania,0,1,Friendly,Bamako,Mali,False,1,-1,Mauritania
15969,17445,18665,1995,Tunisia,Egypt,2,0,Friendly,Sousse,Tunisia,False,2,2,Tunisia
15970,17446,18666,1995,Vietnam,Estonia,1,0,Friendly,Ho Chi Minh City,Vietnam,False,1,1,Vietnam
15971,17447,18667,1995,Japan,Nigeria,0,3,Confederations Cup,Riyadh,Saudi Arabia,True,3,-3,Nigeria
15972,17448,18668,1995,Saudi Arabia,Mexico,0,2,Confederations Cup,Riyadh,Saudi Arabia,False,2,-2,Mexico
15973,17449,18669,1995,Senegal,Tunisia,0,0,African Cup of Nations qualification,Ziguinchor,Senegal,False,0,0,Draw
15974,17450,18670,1995,Sierra Leone,Gambia,2,0,African Cup of Nations qualification,Freetown,Sierra Leone,False,2,2,Sierra Leone
15975,17451,18671,1995,Angola,Mozambique,1,0,African Cup of Nations qualification,Luanda,Angola,False,1,1,Angola
15976,17452,18672,1995,Cameroon,Malawi,0,0,African Cup of Nations qualification,Yaoundé,Cameroon,False,0,0,Draw
15977,17453,18673,1995,Congo,Niger,3,1,African Cup of Nations qualification,Brazzaville,Congo,False,4,2,Congo
15978,17454,18674,1995,DR Congo,Lesotho,3,0,African Cup of Nations qualification,Kinshasa,Zaïre,False,3,3,DR Congo
15979,17455,18675,1995,Ethiopia,Tanzania,1,0,African Cup of Nations qualification,Addis Abeba,Ethiopia,False,1,1,Ethiopia
15980,17456,18676,1995,Guinea,Namibia,3,0,African Cup of Nations qualification,Conakry,Guinea,False,3,3,Guinea
15981,17457,18677,1995,Japan,Argentina,1,5,Confederations Cup,Riyadh,Saudi Arabia,True,6,-4,Argentina
15982,17458,18678,1995,Saudi Arabia,Denmark,0,2,Confederations Cup,Riyadh,Saudi Arabia,False,2,-2,Denmark
15983,17459,18679,1995,Togo,Mauritania,0,0,African Cup of Nations qualification,Lomé,Togo,False,0,0,Draw
15984,17460,18680,1995,Mauritius,Zambia,0,3,African Cup of Nations qualification,Port Louis,Mauritius,False,3,-3,Zambia
15985,17461,18681,1995,Denmark,Mexico,1,1,Confederations Cup,Riyadh,Saudi Arabia,True,2,0,Draw
15986,17462,18682,1995,Nigeria,Argentina,0,0,Confederations Cup,Riyadh,Saudi Arabia,True,0,0,Draw
15987,17463,18683,1995,Denmark,Argentina,2,0,Confederations Cup,Riyadh,Saudi Arabia,True,2,2,Denmark
15988,17464,18684,1995,Mexico,Nigeria,1,1,Confederations Cup,Riyadh,Saudi Arabia,True,2,0,Draw
15989,17465,18685,1995,Ivory Coast,Togo,0,0,Friendly,Bouaké,Ivory Coast,False,0,0,Draw
15990,17466,18686,1995,Netherlands,France,0,1,Friendly,Utrecht,Netherlands,False,1,-1,France
15991,17467,18687,1995,Spain,Uruguay,2,2,Friendly,La Coruña,Spain,False,4,0,Draw
15992,17468,18688,1995,Tanzania,Algeria,2,1,African Cup of Nations qualification,Dar es Salaam,Tanzania,False,3,1,Tanzania
15993,17469,18689,1995,Uganda,Egypt,0,0,African Cup of Nations qualification,Kampala,Uganda,False,0,0,Draw
15994,17470,18690,1995,Botswana,Angola,1,2,African Cup of Nations qualification,Gaborone,Botswana,False,3,-1,Angola
15995,17471,18691,1995,Ethiopia,Sudan,2,0,African Cup of Nations qualification,Addis Abeba,Ethiopia,False,2,2,Ethiopia
15996,17472,18692,1995,Ghana,Congo,3,1,African Cup of Nations qualification,Accra,Ghana,False,4,2,Ghana
15997,17473,18693,1995,Ivory Coast,Burkina Faso,2,2,African Cup of Nations qualification,Abidjan,Ivory Coast,False,4,0,Draw
15998,17474,18694,1995,Lesotho,Malawi,0,2,African Cup of Nations qualification,Maseru,Lesotho,False,2,-2,Malawi
15999,17475,18695,1995,Liberia,Senegal,1,1,African Cup of Nations qualification,Monrovia,Liberia,False,2,0,Draw
16000,17476,18696,1995,Mozambique,Namibia,4,2,African Cup of Nations qualification,Maputo,Mozambique,False,6,2,Mozambique
16001,17477,18697,1995,Niger,Gambia,1,1,African Cup of Nations qualification,Niamey,Niger,False,2,0,Draw
16002,17478,18698,1995,Zimbabwe,Cameroon,4,1,African Cup of Nations qualification,Harare,Zimbabwe,False,5,3,Zimbabwe
16003,17479,18699,1995,Cyprus,Greece,2,3,Friendly,Larnaca,Cyprus,False,5,-1,Greece
16004,17480,18700,1995,Canada,Portugal,1,1,Friendly,Toronto,Canada,False,2,0,Draw
16005,17481,18701,1995,Tunisia,Mauritania,1,0,African Cup of Nations qualification,Tunis,Tunisia,False,1,1,Tunisia
16006,17482,18703,1995,Mexico,Uruguay,1,0,Friendly,San Diego,United States,True,1,1,Mexico
16007,17483,18705,1995,Estonia,Norway,0,7,Friendly,Larnaca,Cyprus,True,7,-7,Norway
16008,17484,18706,1995,Cyprus,Norway,0,2,Friendly,Nicosia,Cyprus,False,2,-2,Norway
16009,17485,18707,1995,Greece,Romania,1,0,Friendly,Kalamáta,Greece,False,1,1,Greece
16010,17486,18708,1995,Tunisia,Liberia,0,0,African Cup of Nations qualification,Tunis,Tunisia,False,0,0,Draw
16011,17487,18709,1995,Australia,Colombia,0,1,Friendly,Sydney,Australia,False,1,-1,Colombia
16012,17488,18710,1995,Argentina,Bulgaria,4,1,Friendly,Mendoza,Argentina,False,5,3,Argentina
16013,17489,18711,1995,Israel,Luxembourg,4,2,Friendly,Ashdod,Israel,False,6,2,Israel
16014,17490,18712,1995,Australia,Japan,2,1,Friendly,Sydney,Australia,False,3,1,Australia
16015,17491,18713,1995,Cyprus,Estonia,3,1,Friendly,Limassol,Cyprus,False,4,2,Cyprus
16016,17492,18714,1995,Republic of Ireland,England,1,0,Friendly,Dublin,Republic of Ireland,False,1,1,Republic of Ireland
16017,17493,18715,1995,Trinidad and Tobago,Finland,2,1,Friendly,Port of Spain,Trinidad and Tobago,False,3,1,Trinidad and Tobago
16018,17494,18716,1995,Turkey,Romania,1,1,Friendly,Izmir,Turkey,False,2,0,Draw
16019,17495,18717,1995,Trinidad and Tobago,Finland,2,2,Friendly,Port of Spain,Trinidad and Tobago,False,4,0,Draw
16020,17496,18719,1995,Hong Kong,Japan,0,3,Dynasty Cup,Victoria,Hong Kong,False,3,-3,Japan
16021,17499,18722,1995,New Zealand,Singapore,3,0,Friendly,Tauranga,New Zealand,False,3,3,New Zealand
16022,17500,18723,1995,Brazil,Slovakia,5,0,Friendly,Fortaleza,Brazil,False,5,5,Brazil
16023,17501,18724,1995,Malta,Luxembourg,0,1,UEFA Euro qualification,Attard,Malta,False,1,-1,Luxembourg
16024,17502,18725,1995,Netherlands,Portugal,0,1,Friendly,Eindhoven,Netherlands,False,1,-1,Portugal
16025,17503,18726,1995,Spain,Germany,0,0,Friendly,Jerez de la Frontera,Spain,False,0,0,Draw
16026,17504,18727,1995,Thailand,Japan,3,2,King's Cup,Bangkok,Thailand,False,5,1,Thailand
16027,17508,18732,1995,Morocco,Senegal,2,0,Friendly,Casablanca,Morocco,False,2,2,Morocco
16028,17509,18733,1995,Cyprus,Sweden,3,3,Friendly,Limassol,Cyprus,False,6,0,Draw
16029,17510,18734,1995,Czech Republic,Finland,4,1,Friendly,Brno,Czech Republic,False,5,3,Czech Republic
16030,17511,18735,1995,Greece,Switzerland,1,1,Friendly,Athens,Greece,False,2,0,Draw
16031,17512,18736,1995,Hungary,Latvia,3,1,Friendly,Budapest,Hungary,False,4,2,Hungary
16032,17513,18737,1995,Iraq,Uzbekistan,3,1,Nehru Cup,Calcutta,India,True,4,2,Iraq
16033,17514,18738,1995,Slovakia,Russia,2,1,Friendly,Košice,Slovakia,False,3,1,Slovakia
16034,17515,18739,1995,Turkey,Israel,2,1,Friendly,Istanbul,Turkey,False,3,1,Turkey
16035,17516,18740,1995,India,Thailand,0,5,Nehru Cup,Calcutta,India,False,5,-5,Thailand
16036,17517,18741,1995,Barbados,Saint Kitts and Nevis,0,1,Friendly,Bridgetown,Barbados,False,1,-1,Saint Kitts and Nevis
16037,17518,18742,1995,India,Iraq,1,1,Nehru Cup,Calcutta,India,False,2,0,Draw
16038,17519,18743,1995,Jamaica,Cuba,0,0,Friendly,Kingston,Jamaica,False,0,0,Draw
16039,17520,18744,1995,India,Uzbekistan,1,0,Nehru Cup,Calcutta,India,False,1,1,India
16040,17521,18745,1995,Iraq,Thailand,3,1,Nehru Cup,Calcutta,India,True,4,2,Iraq
16041,17522,18746,1995,Poland,Lithuania,4,1,Friendly,Ostrowiec Świętokrzyski,Poland,False,5,3,Poland
16042,17523,18747,1995,Thailand,Uzbekistan,0,1,Nehru Cup,Calcutta,India,True,1,-1,Uzbekistan
16043,17524,18748,1995,Sint Maarten,Saint Kitts and Nevis,0,2,CFU Caribbean Cup qualification,Philipsburg,Sint Maarten,False,2,-2,Saint Kitts and Nevis
16044,17525,18749,1995,Grenada,Saint Lucia,2,0,CFU Caribbean Cup qualification,St. George's,Grenada,False,2,2,Grenada
16045,17526,18750,1995,Colombia,Uruguay,2,1,Friendly,Medellín,Colombia,False,3,1,Colombia
16046,17527,18751,1995,Morocco,Mali,3,0,Friendly,Casablanca,Morocco,False,3,3,Morocco
16047,17528,18753,1995,Croatia,Ukraine,4,0,UEFA Euro qualification,Zagreb,Croatia,False,4,4,Croatia
16048,17529,18754,1995,Italy,Estonia,4,1,UEFA Euro qualification,Salerno,Italy,False,5,3,Italy
16049,17530,18755,1995,Nepal,Bangladesh,0,2,SAFF Cup,Colombo,Sri Lanka,True,2,-2,Bangladesh
16050,17531,18756,1995,Pakistan,Bangladesh,1,0,SAFF Cup,Colombo,Sri Lanka,True,1,1,Pakistan
16051,17532,18757,1995,United States,Uruguay,2,2,Friendly,Dallas,United States,False,4,0,Draw
16052,17533,18758,1995,Barbados,Guyana,3,0,CFU Caribbean Cup qualification,Bridgetown,Barbados,False,3,3,Barbados
16053,17534,18759,1995,Lebanon,Egypt,1,1,Friendly,Beirut,Lebanon,False,2,0,Draw
16054,17535,18760,1995,Montserrat,Anguilla,3,2,CFU Caribbean Cup qualification,Plymouth,Montserrat,False,5,1,Montserrat
16055,17536,18761,1995,Saint Kitts and Nevis,Sint Maarten,0,1,CFU Caribbean Cup qualification,Basseterre,Saint Kitts and Nevis,False,1,-1,Sint Maarten
16056,17537,18762,1995,Albania,Moldova,3,0,UEFA Euro qualification,Tirana,Albania,False,3,3,Albania
16057,17538,18763,1995,Austria,Latvia,5,0,UEFA Euro qualification,Salzburg,Austria,False,5,5,Austria
16058,17539,18764,1995,Brazil,Honduras,1,1,Friendly,Goiânia,Brazil,False,2,0,Draw
16059,17540,18765,1995,Bulgaria,Wales,3,1,UEFA Euro qualification,Sofia,Bulgaria,False,4,2,Bulgaria
16060,17541,18766,1995,Cyprus,Denmark,1,1,UEFA Euro qualification,Limassol,Cyprus,False,2,0,Draw
16061,17542,18767,1995,Czech Republic,Belarus,4,2,UEFA Euro qualification,Ostrava,Czech Republic,False,6,2,Czech Republic
16062,17543,18768,1995,England,Uruguay,0,0,Friendly,London,England,False,0,0,Draw
16063,17544,18769,1995,Georgia,Germany,0,2,UEFA Euro qualification,Tbilisi,Georgia,False,2,-2,Germany
16064,17545,18770,1995,Hungary,Switzerland,2,2,UEFA Euro qualification,Budapest,Hungary,False,4,0,Draw
16065,17546,18771,1995,Republic of Ireland,Northern Ireland,1,1,UEFA Euro qualification,Dublin,Republic of Ireland,False,2,0,Draw
16066,17547,18772,1995,Israel,France,0,0,UEFA Euro qualification,Ramat-Gan,Israel,False,0,0,Draw
16067,17548,18773,1995,Lithuania,Croatia,0,0,UEFA Euro qualification,Vilnius,Lithuania,False,0,0,Draw
16068,17549,18774,1995,Luxembourg,Norway,0,2,UEFA Euro qualification,Luxembourg,Luxembourg,False,2,-2,Norway
16069,17550,18775,1995,Mexico,Chile,1,2,Friendly,Los Angeles,United States,True,3,-1,Chile
16070,17551,18776,1995,Nepal,Pakistan,2,0,SAFF Cup,Colombo,Sri Lanka,True,2,2,Nepal
16071,17552,18777,1995,Netherlands,Malta,4,0,UEFA Euro qualification,Rotterdam,Netherlands,False,4,4,Netherlands
16072,17553,18778,1995,Romania,Poland,2,1,UEFA Euro qualification,Bucharest,Romania,False,3,1,Romania
16073,17554,18779,1995,Russia,Scotland,0,0,UEFA Euro qualification,Moscow,Russia,False,0,0,Draw
16074,17555,18780,1995,San Marino,Finland,0,2,UEFA Euro qualification,Serravalle,San Marino,False,2,-2,Finland
16075,17556,18781,1995,Slovakia,Azerbaijan,4,1,UEFA Euro qualification,Košice,Slovakia,False,5,3,Slovakia
16076,17557,18782,1995,Slovenia,Estonia,3,0,UEFA Euro qualification,Maribor,Slovenia,False,3,3,Slovenia
16077,17558,18783,1995,Spain,Belgium,1,1,UEFA Euro qualification,Seville,Spain,False,2,0,Draw
16078,17559,18784,1995,Sri Lanka,India,2,2,SAFF Cup,Colombo,Sri Lanka,False,4,0,Draw
16079,17560,18785,1995,Turkey,Sweden,2,1,UEFA Euro qualification,Istanbul,Turkey,False,3,1,Turkey
16080,17561,18786,1995,Ukraine,Italy,0,2,UEFA Euro qualification,Kyïv,Ukraine,False,2,-2,Italy
16081,17562,18788,1995,India,Bangladesh,0,0,SAFF Cup,Colombo,Sri Lanka,True,0,0,Draw
16082,17563,18789,1995,Serbia,Uruguay,1,0,Friendly,Belgrade,Yugoslavia,False,1,1,Serbia
16083,17564,18790,1995,Sri Lanka,Nepal,2,1,SAFF Cup,Colombo,Sri Lanka,False,3,1,Sri Lanka
16084,17565,18791,1995,Syria,Egypt,1,2,Friendly,Damascus,Syria,False,3,-1,Egypt
16085,17566,18792,1995,Anguilla,Montserrat,0,1,CFU Caribbean Cup qualification,The Valley,Anguilla,False,1,-1,Montserrat
16086,17567,18793,1995,Gabon,Benin,7,0,Friendly,Libreville,Gabon,False,7,7,Gabon
16087,17568,18794,1995,Guyana,Barbados,0,4,CFU Caribbean Cup qualification,Georgetown,Guyana,False,4,-4,Barbados
16088,17569,18795,1995,Sri Lanka,India,1,0,SAFF Cup,Colombo,Sri Lanka,False,1,1,Sri Lanka
16089,17570,18796,1995,Bolivia,Venezuela,0,0,Friendly,Sucre,Bolivia,False,0,0,Draw
16090,17571,18797,1995,Uruguay,Peru,1,0,Friendly,Montevideo,Uruguay,False,1,1,Uruguay
16091,17572,18798,1995,Mauritania,Senegal,0,1,African Cup of Nations qualification,Nouakchott,Mauritania,False,1,-1,Senegal
16092,17573,18799,1995,Sierra Leone,Ghana,1,0,African Cup of Nations qualification,Freetown,Sierra Leone,False,1,1,Sierra Leone
16093,17574,18800,1995,Uganda,Tanzania,2,0,African Cup of Nations qualification,Kampala,Uganda,False,2,2,Uganda
16094,17575,18801,1995,Zambia,Gabon,1,0,African Cup of Nations qualification,Lusaka,Zambia,False,1,1,Zambia
16095,17576,18802,1995,Gambia,Congo,1,1,African Cup of Nations qualification,Banjul,Gambia,False,2,0,Draw
16096,17577,18803,1995,Guinea,Botswana,5,0,African Cup of Nations qualification,Conakry,Guinea,False,5,5,Guinea
16097,17578,18804,1995,Lesotho,Zimbabwe,0,2,African Cup of Nations qualification,Maseru,Lesotho,False,2,-2,Zimbabwe
16098,17579,18805,1995,Malawi,DR Congo,0,1,African Cup of Nations qualification,Lilongwe,Malawi,False,1,-1,DR Congo
16099,17580,18806,1995,Morocco,Burkina Faso,0,0,African Cup of Nations qualification,Casablanca,Morocco,False,0,0,Draw
16100,17581,18807,1995,Mozambique,Mali,1,0,African Cup of Nations qualification,Maputo,Mozambique,False,1,1,Mozambique
16101,17582,18808,1995,Saint Lucia,Grenada,4,0,CFU Caribbean Cup qualification,Castries,Saint Lucia,False,4,4,Saint Lucia
16102,17583,18809,1995,Togo,Liberia,0,0,African Cup of Nations qualification,Lomé,Togo,False,0,0,Draw
16103,17584,18811,1995,Egypt,Tunisia,1,0,Friendly,Port Said,Egypt,False,1,1,Egypt
16104,17585,18812,1995,Peru,Chile,6,0,Friendly,Lima,Peru,False,6,6,Peru
16105,17586,18813,1995,Belgium,United States,1,0,Friendly,Brussels,Belgium,False,1,1,Belgium
16106,17587,18814,1995,Chile,Iceland,1,1,Friendly,Temuco,Chile,False,2,0,Draw
16107,17588,18815,1995,Congo,Sierra Leone,0,2,African Cup of Nations qualification,Brazzaville,Congo,False,2,-2,Sierra Leone
16108,17589,18816,1995,Senegal,Togo,5,1,African Cup of Nations qualification,Dakar,Senegal,False,6,4,Senegal
16109,17590,18817,1995,Tanzania,Egypt,1,2,African Cup of Nations qualification,Dar es Salaam,Tanzania,False,3,-1,Egypt
16110,17591,18818,1995,Angola,Guinea,3,0,African Cup of Nations qualification,Luanda,Angola,False,3,3,Angola
16111,17592,18819,1995,Botswana,Mozambique,0,3,African Cup of Nations qualification,Gaborone,Botswana,False,3,-3,Mozambique
16112,17593,18820,1995,DR Congo,Cameroon,2,1,African Cup of Nations qualification,Kinshasa,Zaïre,False,3,1,DR Congo
16113,17594,18821,1995,Ethiopia,Uganda,0,0,African Cup of Nations qualification,Addis Abeba,Ethiopia,False,0,0,Draw
16114,17595,18822,1995,Ghana,Niger,1,0,African Cup of Nations qualification,Accra,Ghana,False,1,1,Ghana
16115,17596,18823,1995,Liberia,Tunisia,1,0,African Cup of Nations qualification,Monrovia,Liberia,False,1,1,Liberia
16116,17597,18824,1995,Mali,Namibia,2,0,African Cup of Nations qualification,Bamako,Mali,False,2,2,Mali
16117,17598,18825,1995,Zimbabwe,Malawi,1,1,African Cup of Nations qualification,Harare,Zimbabwe,False,2,0,Draw
16118,17599,18826,1995,Sudan,Algeria,2,0,African Cup of Nations qualification,Khartoum,Sudan,False,2,2,Sudan
16119,17600,18827,1995,Poland,Israel,4,3,UEFA Euro qualification,Zabrze,Poland,False,7,1,Poland
16120,17601,18828,1995,Armenia,Spain,0,2,UEFA Euro qualification,Yerevan,Armenia,False,2,-2,Spain
16121,17602,18829,1995,Austria,Liechtenstein,7,0,UEFA Euro qualification,Salzburg,Austria,False,7,7,Austria
16122,17603,18830,1995,Azerbaijan,Romania,1,4,UEFA Euro qualification,Trabzon,Turkey,True,5,-3,Romania
16123,17604,18831,1995,Belarus,Malta,1,1,UEFA Euro qualification,Minsk,Belarus,False,2,0,Draw
16124,17605,18832,1995,Belgium,Cyprus,2,0,UEFA Euro qualification,Brussels,Belgium,False,2,2,Belgium
16125,17606,18833,1995,Croatia,Slovenia,2,0,UEFA Euro qualification,Zagreb,Croatia,False,2,2,Croatia
16126,17607,18834,1995,Czech Republic,Netherlands,3,1,UEFA Euro qualification,Prague,Czech Republic,False,4,2,Czech Republic
16127,17609,18836,1995,Estonia,Ukraine,0,1,UEFA Euro qualification,Tallinn,Estonia,False,1,-1,Ukraine
16128,17610,18837,1995,Faroe Islands,Finland,0,4,UEFA Euro qualification,Toftir,Faroe Islands,False,4,-4,Finland
16129,17611,18838,1995,France,Slovakia,4,0,UEFA Euro qualification,Nantes,France,False,4,4,France
16130,17612,18839,1995,Georgia,Albania,2,0,UEFA Euro qualification,Tbilisi,Georgia,False,2,2,Georgia
16131,17613,18840,1995,Germany,Wales,1,1,UEFA Euro qualification,Düsseldorf,Germany,False,2,0,Draw
16132,17614,18841,1995,Greece,Russia,0,3,UEFA Euro qualification,Salonica,Greece,False,3,-3,Russia
16133,17615,18842,1995,Hungary,Sweden,1,0,UEFA Euro qualification,Budapest,Hungary,False,1,1,Hungary
16134,17616,18843,1995,Republic of Ireland,Portugal,1,0,UEFA Euro qualification,Dublin,Republic of Ireland,False,1,1,Republic of Ireland
16135,17617,18844,1995,Ivory Coast,Sierra Leone,4,0,Friendly,Abidjan,Ivory Coast,False,4,4,Ivory Coast
16136,17618,18845,1995,Latvia,Northern Ireland,0,1,UEFA Euro qualification,Riga,Latvia,False,1,-1,Northern Ireland
16137,17619,18846,1995,Lithuania,Italy,0,1,UEFA Euro qualification,Vilnius,Lithuania,False,1,-1,Italy
16138,17620,18847,1995,Moldova,Bulgaria,0,3,UEFA Euro qualification,Chişinău,Moldova,False,3,-3,Bulgaria
16139,17621,18848,1995,Norway,Luxembourg,5,0,UEFA Euro qualification,Oslo,Norway,False,5,5,Norway
16140,17622,18849,1995,San Marino,Scotland,0,2,UEFA Euro qualification,Serravalle,San Marino,False,2,-2,Scotland
16141,17623,18850,1995,Switzerland,Turkey,1,2,UEFA Euro qualification,Berne,Switzerland,False,3,-1,Turkey
16142,17624,18851,1995,Barbados,Saint Lucia,1,1,CFU Caribbean Cup qualification,Bridgetown,Barbados,False,2,0,Draw
16143,17625,18852,1995,Guernsey,Jersey,1,2,Friendly,St. Sampson,Guernsey,False,3,-1,Jersey
16144,17626,18853,1995,Saint Kitts and Nevis,Antigua and Barbuda,1,1,CFU Caribbean Cup qualification,Basseterre,Saint Kitts and Nevis,False,2,0,Draw
16145,17627,18854,1995,Kuwait,Mali,2,1,Friendly,Kuwait City,Kuwait,False,3,1,Kuwait
16146,17628,18855,1995,Russia,Faroe Islands,3,0,UEFA Euro qualification,Moscow,Russia,False,3,3,Russia
16147,17629,18856,1995,Aruba,Curaçao,3,4,CFU Caribbean Cup qualification,Oranjestad,Aruba,False,7,-1,Curaçao
16148,17630,18857,1995,Saint Lucia,Barbados,2,1,CFU Caribbean Cup qualification,Castries,Saint Lucia,False,3,1,Saint Lucia
16149,17631,18858,1995,Slovakia,Czech Republic,1,1,Friendly,Bratislava,Slovakia,False,2,0,Draw
16150,17632,18859,1995,French Guiana,Martinique,1,3,CFU Caribbean Cup qualification,Cayenne,French Guiana,False,4,-2,Martinique
16151,17633,18860,1995,Guadeloupe,Suriname,1,2,CFU Caribbean Cup qualification,Cayenne,French Guiana,True,3,-1,Suriname
16152,17635,18862,1995,French Guiana,Guadeloupe,2,2,CFU Caribbean Cup qualification,Cayenne,French Guiana,False,4,0,Draw
16153,17636,18863,1995,Martinique,Suriname,1,1,CFU Caribbean Cup qualification,Cayenne,French Guiana,True,2,0,Draw
16154,17637,18864,1995,French Guiana,Suriname,4,0,CFU Caribbean Cup qualification,Cayenne,French Guiana,False,4,4,French Guiana
16155,17638,18865,1995,Guadeloupe,Martinique,2,1,CFU Caribbean Cup qualification,Cayenne,French Guiana,True,3,1,Guadeloupe
16156,17639,18866,1995,Ivory Coast,Mali,0,1,Friendly,Abidjan,Ivory Coast,False,1,-1,Mali
16157,17640,18867,1995,South Africa,Argentina,1,1,Friendly,Johannesburg,South Africa,False,2,0,Draw
16158,17641,18868,1995,Togo,Benin,3,0,Friendly,Lomé,Togo,False,3,3,Togo
16159,17642,18869,1995,Bolivia,Paraguay,1,1,Copa Paz del Chaco,Cochabamba,Bolivia,False,2,0,Draw
16160,17643,18870,1995,Curaçao,Aruba,3,2,CFU Caribbean Cup qualification,Willemstad,Netherlands Antilles,True,5,1,Curaçao
16161,17644,18871,1995,Israel,Brazil,1,2,Friendly,Ramat-Gan,Israel,False,3,-1,Brazil
16162,17645,18872,1995,Lithuania,Greece,2,1,Friendly,Vilnius,Lithuania,False,3,1,Lithuania
16163,17646,18873,1995,Morocco,Egypt,0,0,Friendly,Marrakech,Morocco,False,0,0,Draw
16164,17647,18874,1995,Latvia,Estonia,2,0,Baltic Cup,Riga,Latvia,False,2,2,Latvia
16165,17648,18875,1995,Estonia,Lithuania,0,7,Baltic Cup,Riga,Latvia,True,7,-7,Lithuania
16166,17649,18876,1995,Antigua and Barbuda,Saint Kitts and Nevis,2,2,CFU Caribbean Cup qualification,St. John's,Antigua and Barbuda,False,4,0,Draw
16167,17650,18877,1995,Japan,Scotland,0,0,Kirin Cup,Hiroshima,Japan,False,0,0,Draw
16168,17651,18878,1995,Latvia,Lithuania,2,0,Baltic Cup,Riga,Latvia,False,2,2,Latvia
16169,17652,18879,1995,Canada,Northern Ireland,2,0,Friendly,Edmonton,Canada,False,2,2,Canada
16170,17653,18880,1995,Cuba,Curaçao,3,0,CFU Caribbean Cup qualification,Santo Domingo,Dominican Republic,True,3,3,Cuba
16171,17654,18881,1995,Dominican Republic,Puerto Rico,3,1,CFU Caribbean Cup qualification,Santo Domingo,Dominican Republic,False,4,2,Dominican Republic
16172,17655,18882,1995,Ecuador,Scotland,1,2,Kirin Cup,Toyama,Japan,True,3,-1,Scotland
16173,17656,18883,1995,Chile,Northern Ireland,2,1,Friendly,Edmonton,Canada,True,3,1,Chile
16174,17657,18884,1995,Curaçao,Puerto Rico,2,2,CFU Caribbean Cup qualification,Santo Domingo,Dominican Republic,True,4,0,Draw
16175,17658,18885,1995,Dominican Republic,Cuba,0,3,CFU Caribbean Cup qualification,Santo Domingo,Dominican Republic,False,3,-3,Cuba
16176,17659,18886,1995,Faroe Islands,San Marino,3,0,UEFA Euro qualification,Toftir,Faroe Islands,False,3,3,Faroe Islands
16177,17660,18887,1995,Liberia,Mali,3,2,Friendly,Abidjan,Ivory Coast,True,5,1,Liberia
16178,17661,18888,1995,Norway,Ghana,3,2,Friendly,Oslo,Norway,False,5,1,Norway
16179,17662,18889,1995,Cuba,Puerto Rico,9,0,CFU Caribbean Cup qualification,Santo Domingo,Dominican Republic,True,9,9,Cuba
16180,17663,18890,1995,Dominican Republic,Curaçao,1,2,CFU Caribbean Cup qualification,Santo Domingo,Dominican Republic,False,3,-1,Curaçao
16181,17664,18891,1995,Canada,Chile,1,2,Friendly,Edmonton,Canada,False,3,-1,Chile
16182,17665,18892,1995,Ivory Coast,Liberia,1,1,Friendly,Abidjan,Ivory Coast,False,2,0,Draw
16183,17666,18893,1995,Japan,Ecuador,3,0,Kirin Cup,Tokyo,Japan,False,3,3,Japan
16184,17667,18894,1995,United States,Costa Rica,1,2,Friendly,Tampa,United States,False,3,-1,Costa Rica
16185,17668,18895,1995,Argentina,Peru,1,0,Friendly,Córdoba,Argentina,False,1,1,Argentina
16186,17669,18896,1995,Finland,Denmark,0,1,Friendly,Helsinki,Finland,False,1,-1,Denmark
16187,17670,18897,1995,Serbia,Russia,1,2,Friendly,Belgrade,Yugoslavia,False,3,-1,Russia
16188,17671,18898,1995,Sweden,Iceland,1,1,UEFA Euro qualification,Solna,Sweden,False,2,0,Draw
16189,17672,18899,1995,Algeria,Uganda,1,1,African Cup of Nations qualification,Algiers,Algeria,False,2,0,Draw
16190,17673,18900,1995,England,Japan,2,1,Friendly,London,England,False,3,1,England
16191,17674,18901,1995,Liechtenstein,Republic of Ireland,0,0,UEFA Euro qualification,Eschen,Liechtenstein,False,0,0,Draw
16192,17675,18902,1995,Portugal,Latvia,3,2,UEFA Euro qualification,Porto,Portugal,False,5,1,Portugal
16193,17676,18903,1995,Sierra Leone,Niger,5,1,African Cup of Nations qualification,Freetown,Sierra Leone,False,6,4,Sierra Leone
16194,17677,18904,1995,Sudan,Tanzania,2,1,African Cup of Nations qualification,Khartoum,Sudan,False,3,1,Sudan
16195,17678,18905,1995,Angola,Mali,1,0,African Cup of Nations qualification,Luanda,Angola,False,1,1,Angola
16196,17679,18906,1995,Botswana,Namibia,1,1,African Cup of Nations qualification,Gaborone,Botswana,False,2,0,Draw
16197,17680,18907,1995,Brazil,Sweden,1,0,Friendly,Birmingham,England,True,1,1,Brazil
16198,17681,18908,1995,Cameroon,Lesotho,4,1,African Cup of Nations qualification,Yaoundé,Cameroon,False,5,3,Cameroon
16199,17682,18909,1995,Canada,Turkey,1,3,Friendly,Toronto,Canada,False,4,-2,Turkey
16200,17683,18910,1995,DR Congo,Zimbabwe,5,0,African Cup of Nations qualification,Kinshasa,Zaïre,False,5,5,DR Congo
16201,17684,18911,1995,Ecuador,Zambia,4,1,Korea Cup,Changwon,South Korea,True,5,3,Ecuador
16202,17685,18912,1995,Ethiopia,Egypt,0,2,African Cup of Nations qualification,Addis Abeba,Ethiopia,False,2,-2,Egypt
16203,17686,18913,1995,Guinea,Mozambique,0,0,African Cup of Nations qualification,Conakry,Guinea,False,0,0,Draw
16204,17687,18914,1995,Ivory Coast,Morocco,2,0,African Cup of Nations qualification,Abidjan,Ivory Coast,False,2,2,Ivory Coast
16205,17688,18915,1995,Liberia,Mauritania,2,0,African Cup of Nations qualification,Monrovia,Liberia,False,2,2,Liberia
16206,17689,18916,1995,Mauritius,Gabon,0,3,African Cup of Nations qualification,Port Louis,Mauritius,False,3,-3,Gabon
16207,17690,18917,1995,Togo,Tunisia,0,1,African Cup of Nations qualification,Lomé,Togo,False,1,-1,Tunisia
16208,17691,18919,1995,Brazil,Japan,3,0,Friendly,Liverpool,England,True,3,3,Brazil
16209,17692,18920,1995,Belarus,Netherlands,1,0,UEFA Euro qualification,Minsk,Belarus,False,1,1,Belarus
16210,17693,18921,1995,Bulgaria,Germany,3,2,UEFA Euro qualification,Sofia,Bulgaria,False,5,1,Bulgaria
16211,17694,18922,1995,Canada,Turkey,0,3,Friendly,Montréal,Canada,False,3,-3,Turkey
16212,17695,18923,1995,Denmark,Cyprus,4,0,UEFA Euro qualification,Copenhagen,Denmark,False,4,4,Denmark
16213,17696,18924,1995,Faroe Islands,Scotland,0,2,UEFA Euro qualification,Toftir,Faroe Islands,False,2,-2,Scotland
16214,17697,18925,1995,Lithuania,Slovenia,2,1,UEFA Euro qualification,Vilnius,Lithuania,False,3,1,Lithuania
16215,17698,18926,1995,Luxembourg,Czech Republic,1,0,UEFA Euro qualification,Luxembourg,Luxembourg,False,1,1,Luxembourg
16216,17699,18928,1995,Moldova,Albania,2,3,UEFA Euro qualification,Chişinău,Moldova,False,5,-1,Albania
16217,17700,18929,1995,Northern Ireland,Latvia,1,2,UEFA Euro qualification,Belfast,Northern Ireland,False,3,-1,Latvia
16218,17701,18930,1995,Norway,Malta,2,0,UEFA Euro qualification,Oslo,Norway,False,2,2,Norway
16219,17702,18931,1995,Romania,Israel,2,1,UEFA Euro qualification,Bucharest,Romania,False,3,1,Romania
16220,17703,18932,1995,San Marino,Russia,0,7,UEFA Euro qualification,Serravalle,San Marino,False,7,-7,Russia
16221,17704,18933,1995,Spain,Armenia,1,0,UEFA Euro qualification,Seville,Spain,False,1,1,Spain
16222,17705,18934,1995,Wales,Georgia,0,1,UEFA Euro qualification,Cardiff,Wales,False,1,-1,Georgia
16223,17706,18935,1995,England,Sweden,3,3,Friendly,Leeds,England,False,6,0,Draw
16224,17707,18936,1995,Paraguay,Bolivia,0,0,Copa Paz del Chaco,Asunción,Paraguay,False,0,0,Draw
16225,17708,18938,1995,Costa Rica,Ecuador,1,2,Korea Cup,Seoul,South Korea,True,3,-1,Ecuador
16226,17709,18940,1995,Sweden,Japan,2,2,Friendly,Nottingham,England,True,4,0,Draw
16227,17710,18941,1995,England,Brazil,1,3,Friendly,London,England,False,4,-2,Brazil
16228,17711,18942,1995,Estonia,Slovenia,1,3,UEFA Euro qualification,Tallinn,Estonia,False,4,-2,Slovenia
16229,17712,18943,1995,Finland,Greece,2,1,UEFA Euro qualification,Helsinki,Finland,False,3,1,Finland
16230,17713,18944,1995,Honduras,Turkey,0,1,Friendly,Toronto,Canada,True,1,-1,Turkey
16231,17714,18945,1995,Iceland,Hungary,2,1,UEFA Euro qualification,Reykjavík,Iceland,False,3,1,Iceland
16232,17715,18946,1995,Republic of Ireland,Austria,1,3,UEFA Euro qualification,Dublin,Republic of Ireland,False,4,-2,Austria
16233,17716,18947,1995,Ukraine,Croatia,1,0,UEFA Euro qualification,Kyïv,Ukraine,False,1,1,Ukraine
16234,17717,18948,1995,United States,Nigeria,3,2,USA Cup,Foxborough,United States,False,5,1,United States
16235,17718,18949,1995,Ecuador,Zambia,1,0,Korea Cup,Seoul,South Korea,True,1,1,Ecuador
16236,17719,18950,1995,Argentina,Paraguay,2,1,Friendly,Rosario,Argentina,False,3,1,Argentina
16237,17720,18951,1995,Colombia,Nigeria,1,0,USA Cup,Piscataway,United States,True,1,1,Colombia
16238,17721,18952,1995,Australia,Ghana,2,1,Friendly,Sydney,Australia,False,3,1,Australia
16239,17722,18953,1995,United States,Mexico,4,0,USA Cup,Washington,United States,False,4,4,United States
16240,17723,18954,1995,Venezuela,Bolivia,1,3,Friendly,Valera,Venezuela,False,4,-2,Bolivia
16241,17724,18955,1995,Chile,Paraguay,0,1,Friendly,La Serena,Chile,False,1,-1,Paraguay
16242,17725,18956,1995,Switzerland,Italy,0,1,Friendly,Lausanne,Switzerland,False,1,-1,Italy
16243,17726,18957,1995,New Zealand,Turkey,1,2,Friendly,Coquimbo,Chile,True,3,-1,Turkey
16244,17727,18958,1995,Australia,Ghana,1,0,Friendly,Adelaide,Australia,False,1,1,Australia
16245,17728,18959,1995,Germany,Italy,2,0,Friendly,Zürich,Switzerland,True,2,2,Germany
16246,17729,18960,1995,Mexico,Colombia,0,0,USA Cup,Washington,United States,True,0,0,Draw
16247,17730,18961,1995,Chile,Turkey,0,0,Friendly,Santiago,Chile,False,0,0,Draw
16248,17731,18962,1995,Paraguay,New Zealand,3,2,Friendly,Santiago,Chile,True,5,1,Paraguay
16249,17732,18963,1995,Switzerland,Germany,1,2,Friendly,Berne,Switzerland,False,3,-1,Germany
16250,17733,18964,1995,Australia,Ghana,0,1,Friendly,Perth,Australia,False,1,-1,Ghana
16251,17734,18965,1995,Mexico,Nigeria,2,1,USA Cup,Dallas,United States,True,3,1,Mexico
16252,17735,18966,1995,Mozambique,Zimbabwe,3,1,Friendly,Beira,Mozambique,False,4,2,Mozambique
16253,17736,18967,1995,Uruguay,New Zealand,7,0,Friendly,Paysandú,Uruguay,False,7,7,Uruguay
16254,17737,18968,1995,United States,Colombia,0,0,USA Cup,Piscataway,United States,False,0,0,Draw
16255,17738,18969,1995,Uruguay,New Zealand,2,2,Friendly,Rivera,Uruguay,False,4,0,Draw
16256,17739,18970,1995,Argentina,Australia,2,0,Friendly,Quilmes,Argentina,False,2,2,Argentina
16257,17740,18971,1995,Paraguay,Ecuador,1,0,Friendly,Asunción,Paraguay,False,1,1,Paraguay
16258,17741,18972,1995,Ivory Coast,Ghana,2,0,Friendly,Abidjan,Ivory Coast,False,2,2,Ivory Coast
16259,17742,18973,1995,Peru,Bolivia,4,1,Friendly,Lima,Peru,False,5,3,Peru
16260,17743,18974,1995,Iceland,Faroe Islands,2,0,Friendly,Neskaupstaður,Iceland,False,2,2,Iceland
16261,17744,18975,1995,Uruguay,Venezuela,4,1,Copa América,Montevideo,Uruguay,False,5,3,Uruguay
16262,17745,18976,1995,Mexico,Paraguay,1,2,Copa América,Maldonado,Uruguay,True,3,-1,Paraguay
16263,17746,18977,1995,Brazil,Ecuador,1,0,Copa América,Rivera,Uruguay,True,1,1,Brazil
16264,17747,18978,1995,Colombia,Peru,1,1,Copa América,Rivera,Uruguay,True,2,0,Draw
16265,17748,18979,1995,Argentina,Bolivia,2,1,Copa América,Paysandú,Uruguay,True,3,1,Argentina
16266,17749,18980,1995,United States,Chile,2,1,Copa América,Paysandú,Uruguay,True,3,1,United States
16267,17750,18981,1995,Mexico,Venezuela,3,1,Copa América,Maldonado,Uruguay,True,4,2,Mexico
16268,17751,18982,1995,Syria,Egypt,0,0,Friendly,Damascus,Syria,False,0,0,Draw
16269,17752,18983,1995,Uruguay,Paraguay,1,0,Copa América,Montevideo,Uruguay,False,1,1,Uruguay
16270,17753,18984,1995,Brazil,Peru,2,0,Copa América,Rivera,Uruguay,True,2,2,Brazil
16271,17754,18985,1995,Colombia,Ecuador,1,0,Copa América,Rivera,Uruguay,True,1,1,Colombia
16272,17755,18986,1995,Argentina,Chile,4,0,Copa América,Paysandú,Uruguay,True,4,4,Argentina
16273,17756,18987,1995,United States,Bolivia,0,1,Copa América,Paysandú,Uruguay,True,1,-1,Bolivia
16274,17757,18988,1995,Paraguay,Venezuela,3,2,Copa América,Maldonado,Uruguay,True,5,1,Paraguay
16275,17758,18989,1995,Brazil,Colombia,3,0,Copa América,Rivera,Uruguay,True,3,3,Brazil
16276,17759,18990,1995,Peru,Ecuador,1,2,Copa América,Rivera,Uruguay,True,3,-1,Ecuador
16277,17760,18991,1995,Uruguay,Mexico,1,1,Copa América,Montevideo,Uruguay,False,2,0,Draw
16278,17761,18992,1995,Argentina,United States,0,3,Copa América,Paysandú,Uruguay,True,3,-3,United States
16279,17762,18993,1995,Chile,Bolivia,2,2,Copa América,Paysandú,Uruguay,True,4,0,Draw
16280,17763,18994,1995,Egypt,Algeria,1,1,African Cup of Nations qualification,Cairo,Egypt,False,2,0,Draw
16281,17764,18995,1995,Mauritania,Togo,2,1,African Cup of Nations qualification,Nouakchott,Mauritania,False,3,1,Mauritania
16282,17765,18996,1995,Tanzania,Ethiopia,2,0,African Cup of Nations qualification,Dar es Salaam,Tanzania,False,2,2,Tanzania
16283,17766,18997,1995,Tunisia,Senegal,4,0,African Cup of Nations qualification,Tunis,Tunisia,False,4,4,Tunisia
16284,17767,18998,1995,Uganda,Sudan,2,0,African Cup of Nations qualification,Kampala,Uganda,False,2,2,Uganda
16285,17768,18999,1995,Zambia,Mauritius,2,0,African Cup of Nations qualification,Lusaka,Zambia,False,2,2,Zambia
16286,17769,19000,1995,Malawi,Cameroon,1,3,African Cup of Nations qualification,Blantyre,Malawi,False,4,-2,Cameroon
16287,17770,19001,1995,Mali,Botswana,4,0,African Cup of Nations qualification,Bamako,Mali,False,4,4,Mali
16288,17771,19002,1995,Mozambique,Angola,2,1,African Cup of Nations qualification,Maputo,Mozambique,False,3,1,Mozambique
16289,17772,19003,1995,Paraguay,Colombia,1,1,Copa América,Montevideo,Uruguay,True,2,0,Draw
16290,17773,19004,1995,Uruguay,Bolivia,2,1,Copa América,Montevideo,Uruguay,False,3,1,Uruguay
16291,17775,19006,1995,Gibraltar,Greenland,0,1,Island Games,Gibraltar,Gibraltar,False,1,-1,Greenland
16292,17777,19008,1995,Åland Islands,Guernsey,2,2,Island Games,Gibraltar,Gibraltar,True,4,0,Draw
16293,17778,19009,1995,Brazil,Argentina,2,2,Copa América,Rivera,Uruguay,True,4,0,Draw
16294,17779,19010,1995,United States,Mexico,0,0,Copa América,Paysandú,Uruguay,True,0,0,Draw
16295,17780,19011,1995,Gibraltar,Isle of Man,2,1,Island Games,Gibraltar,Gibraltar,False,3,1,Gibraltar
16296,17783,19014,1995,Jersey,Guernsey,1,0,Island Games,Gibraltar,Gibraltar,True,1,1,Jersey
16297,17784,19015,1995,Uzbekistan,Hungary,2,3,Merdeka Tournament,Kuala Lumpur,Malaysia,True,5,-1,Hungary
16298,17786,19017,1995,Greenland,Isle of Man,4,0,Island Games,Gibraltar,Gibraltar,True,4,4,Greenland
16299,17787,19018,1995,Jersey,Åland Islands,3,1,Island Games,Gibraltar,Gibraltar,True,4,2,Jersey
16300,17788,19020,1995,Jamaica,Saint Lucia,2,1,CFU Caribbean Cup,Kingston,Jamaica,False,3,1,Jamaica
16301,17789,19021,1995,Trinidad and Tobago,Cuba,2,0,CFU Caribbean Cup,Kingston,Jamaica,True,2,2,Trinidad and Tobago
16302,17790,19022,1995,Uruguay,Colombia,2,0,Copa América,Montevideo,Uruguay,False,2,2,Uruguay
16303,17791,19023,1995,Bulgaria,Uzbekistan,0,0,Merdeka Tournament,Kuala Lumpur,Malaysia,True,0,0,Draw
16304,17792,19024,1995,United States,Brazil,0,1,Copa América,Maldonado,Uruguay,True,1,-1,Brazil
16305,17794,19026,1995,Gibraltar,Jersey,1,0,Island Games,Gibraltar,Gibraltar,False,1,1,Gibraltar
16306,17795,19027,1995,Cayman Islands,Antigua and Barbuda,2,0,CFU Caribbean Cup,George Town,Cayman Islands,False,2,2,Cayman Islands
16307,17796,19028,1995,French Guiana,Saint Vincent and the Grenadines,1,3,CFU Caribbean Cup,George Town,Cayman Islands,True,4,-2,Saint Vincent and the Grenadines
16308,17797,19029,1995,Jamaica,Cuba,1,2,CFU Caribbean Cup,Montego Bay,Jamaica,False,3,-1,Cuba
16309,17798,19030,1995,Malaysia,Iraq,1,2,Merdeka Tournament,Kuala Lumpur,Malaysia,False,3,-1,Iraq
16310,17799,19031,1995,Saint Lucia,Trinidad and Tobago,0,5,CFU Caribbean Cup,Montego Bay,Jamaica,True,5,-5,Trinidad and Tobago
16311,17800,19032,1995,Åland Islands,Isle of Man,4,1,Island Games,Gibraltar,Gibraltar,True,5,3,Åland Islands
16312,17802,19034,1995,Gibraltar,Jersey,1,0,Island Games,Gibraltar,Gibraltar,False,1,1,Gibraltar
16313,17803,19035,1995,Algeria,Tunisia,2,1,Friendly,Algiers,Algeria,False,3,1,Algeria
16314,17804,19036,1995,Bulgaria,Hungary,0,0,Merdeka Tournament,Kuala Lumpur,Malaysia,True,0,0,Draw
16315,17805,19037,1995,Colombia,United States,4,1,Copa América,Maldonado,Uruguay,True,5,3,Colombia
16316,17806,19038,1995,Norway,France,0,0,Friendly,Oslo,Norway,False,0,0,Draw
16317,17808,19040,1995,Cayman Islands,French Guiana,1,0,CFU Caribbean Cup,George Town,Cayman Islands,False,1,1,Cayman Islands
16318,17809,19041,1995,Cuba,Saint Lucia,2,0,CFU Caribbean Cup,Kingston,Jamaica,True,2,2,Cuba
16319,17810,19042,1995,Jamaica,Trinidad and Tobago,1,0,CFU Caribbean Cup,Kingston,Jamaica,False,1,1,Jamaica
16320,17811,19043,1995,Mali,Ivory Coast,2,2,Friendly,Bamako,Mali,False,4,0,Draw
16321,17812,19044,1995,Saint Vincent and the Grenadines,Antigua and Barbuda,5,1,CFU Caribbean Cup,George Town,Cayman Islands,True,6,4,Saint Vincent and the Grenadines
16322,17813,19045,1995,Uruguay,Brazil,1,1,Copa América,Montevideo,Uruguay,False,2,0,Draw
16323,17814,19046,1995,Antigua and Barbuda,French Guiana,2,1,CFU Caribbean Cup,George Town,Cayman Islands,True,3,1,Antigua and Barbuda
16324,17815,19047,1995,Iraq,Bulgaria,1,0,Merdeka Tournament,Kuala Lumpur,Malaysia,True,1,1,Iraq
16325,17816,19048,1995,Cayman Islands,Trinidad and Tobago,2,9,CFU Caribbean Cup,George Town,Cayman Islands,False,11,-7,Trinidad and Tobago
16326,17817,19049,1995,Lithuania,Belarus,1,1,Friendly,Vilnius,Lithuania,False,2,0,Draw
16327,17818,19050,1995,Malaysia,Bulgaria,0,2,Merdeka Tournament,Kuala Lumpur,Malaysia,False,2,-2,Bulgaria
16328,17819,19051,1995,Algeria,Tanzania,2,1,African Cup of Nations qualification,Algiers,Algeria,False,3,1,Algeria
16329,17820,19052,1995,Angola,Botswana,4,0,African Cup of Nations qualification,Luanda,Angola,False,4,4,Angola
16330,17821,19053,1995,Burkina Faso,Ivory Coast,1,1,African Cup of Nations qualification,Ouagadougou,Burkina Faso,False,2,0,Draw
16331,17822,19054,1995,Cameroon,Zimbabwe,1,0,African Cup of Nations qualification,Yaoundé,Cameroon,False,1,1,Cameroon
16332,17823,19055,1995,Cayman Islands,Cuba,0,3,CFU Caribbean Cup,George Town,Cayman Islands,False,3,-3,Cuba
16333,17824,19056,1995,Congo,Ghana,0,2,African Cup of Nations qualification,Brazzaville,Congo,False,2,-2,Ghana
16334,17825,19057,1995,Egypt,Uganda,6,0,African Cup of Nations qualification,Cairo,Egypt,False,6,6,Egypt
16335,17826,19058,1995,Guinea,Mali,4,1,African Cup of Nations qualification,Conakry,Guinea,False,5,3,Guinea
16336,17827,19059,1995,Mauritania,Tunisia,0,0,African Cup of Nations qualification,Nouakchott,Mauritania,False,0,0,Draw
16337,17828,19060,1995,Namibia,Mozambique,0,0,African Cup of Nations qualification,Windhoek,Namibia,False,0,0,Draw
16338,17829,19061,1995,Senegal,Liberia,3,0,African Cup of Nations qualification,Dakar,Senegal,False,3,3,Senegal
16339,17830,19062,1995,Sudan,Ethiopia,3,0,African Cup of Nations qualification,Khartoum,Sudan,False,3,3,Sudan
16340,17831,19063,1995,Canada,Jamaica,3,1,Friendly,Toronto,Canada,False,4,2,Canada
16341,17832,19064,1995,Indonesia,Singapore,0,0,Friendly,Jakarta,Indonesia,False,0,0,Draw
16342,17833,19065,1995,Canada,Trinidad and Tobago,3,1,Friendly,Toronto,Canada,False,4,2,Canada
16343,17834,19066,1995,Jamaica,Trinidad and Tobago,1,0,Friendly,Toronto,Canada,True,1,1,Jamaica
16344,17835,19067,1995,Japan,Costa Rica,3,0,Friendly,Kyoto,Japan,False,3,3,Japan
16345,17836,19068,1995,Japan,Brazil,1,5,Friendly,Tokyo,Japan,False,6,-4,Brazil
16346,17837,19070,1995,Liechtenstein,Portugal,0,7,UEFA Euro qualification,Eschen,Liechtenstein,False,7,-7,Portugal
16347,17838,19071,1995,Armenia,Denmark,0,2,UEFA Euro qualification,Yerevan,Armenia,False,2,-2,Denmark
16348,17839,19072,1995,Azerbaijan,Slovakia,0,1,UEFA Euro qualification,Trabzon,Turkey,True,1,-1,Slovakia
16349,17840,19073,1995,Cook Islands,New Caledonia,0,9,South Pacific Games,Papeete,French Polynesia,True,9,-9,New Caledonia
16350,17841,19074,1995,Estonia,Lithuania,0,1,UEFA Euro qualification,Tallinn,Estonia,False,1,-1,Lithuania
16351,17842,19075,1995,Fiji,Papua New Guinea,2,2,South Pacific Games,Papeete,French Polynesia,True,4,0,Draw
16352,17843,19076,1995,Finland,Russia,0,6,UEFA Euro qualification,Helsinki,Finland,False,6,-6,Russia
16353,17844,19077,1995,France,Poland,1,1,UEFA Euro qualification,Paris,France,False,2,0,Draw
16354,17845,19078,1995,Guam,Vanuatu,0,6,South Pacific Games,Papeete,French Polynesia,True,6,-6,Vanuatu
16355,17846,19079,1995,Hungary,Israel,0,2,Friendly,Siófok,Hungary,False,2,-2,Israel
16356,17847,19080,1995,Iceland,Switzerland,0,2,UEFA Euro qualification,Reykjavík,Iceland,False,2,-2,Switzerland
16357,17848,19081,1995,Latvia,Austria,3,2,UEFA Euro qualification,Riga,Latvia,False,5,1,Latvia
16358,17849,19082,1995,Malta,Albania,2,1,Friendly,Attard,Malta,False,3,1,Malta
16359,17850,19083,1995,Norway,Czech Republic,1,1,UEFA Euro qualification,Oslo,Norway,False,2,0,Draw
16360,17851,19084,1995,Scotland,Greece,1,0,UEFA Euro qualification,Glasgow,Scotland,False,1,1,Scotland
16361,17853,19086,1995,Sweden,United States,1,0,Friendly,Norrköping,Sweden,False,1,1,Sweden
16362,17854,19088,1995,Jamaica,Zambia,1,1,Friendly,Montego Bay,Jamaica,False,2,0,Draw
16363,17855,19089,1995,New Caledonia,Solomon Islands,0,1,South Pacific Games,Papeete,French Polynesia,True,1,-1,Solomon Islands
16364,17857,19092,1995,Fiji,Guam,8,0,South Pacific Games,Papeete,French Polynesia,True,8,8,Fiji
16365,17858,19093,1995,Jamaica,Zambia,3,1,Friendly,Kingston,Jamaica,False,4,2,Jamaica
16366,17860,19095,1995,Papua New Guinea,Vanuatu,0,3,South Pacific Games,Papeete,French Polynesia,True,3,-3,Vanuatu
16367,17861,19096,1995,Cook Islands,Solomon Islands,0,16,South Pacific Games,Papeete,French Polynesia,True,16,-16,Solomon Islands
16368,17862,19098,1995,Fiji,Vanuatu,3,1,South Pacific Games,Papeete,French Polynesia,True,4,2,Fiji
16369,17863,19099,1995,Guam,Papua New Guinea,0,9,South Pacific Games,Papeete,French Polynesia,True,9,-9,Papua New Guinea
16370,17864,19101,1995,Belgium,Germany,1,2,Friendly,Brussels,Belgium,False,3,-1,Germany
16371,17865,19102,1995,Fiji,Solomon Islands,3,3,South Pacific Games,Papeete,French Polynesia,True,6,0,Draw
16372,17866,19104,1995,Fiji,Vanuatu,3,0,South Pacific Games,Papeete,French Polynesia,True,3,3,Fiji
16373,17868,19107,1995,Croatia,Estonia,7,1,UEFA Euro qualification,Zagreb,Croatia,False,8,6,Croatia
16374,17869,19108,1995,Portugal,Northern Ireland,1,1,UEFA Euro qualification,Porto,Portugal,False,2,0,Draw
16375,17870,19109,1995,Albania,Bulgaria,1,1,UEFA Euro qualification,Tirana,Albania,False,2,0,Draw
16376,17871,19110,1995,Austria,Republic of Ireland,3,1,UEFA Euro qualification,Vienna,Austria,False,4,2,Austria
16377,17872,19111,1995,Belgium,Denmark,1,3,UEFA Euro qualification,Brussels,Belgium,False,4,-2,Denmark
16378,17873,19112,1995,Czech Republic,Norway,2,0,UEFA Euro qualification,Prague,Czech Republic,False,2,2,Czech Republic
16379,17874,19113,1995,England,Colombia,0,0,Friendly,London,England,False,0,0,Draw
16380,17875,19114,1995,Faroe Islands,Russia,2,5,UEFA Euro qualification,Toftir,Faroe Islands,False,7,-3,Russia
16381,17876,19115,1995,France,Azerbaijan,10,0,UEFA Euro qualification,Auxerre,France,False,10,10,France
16382,17877,19116,1995,Germany,Georgia,4,1,UEFA Euro qualification,Nuremberg,Germany,False,5,3,Germany
16383,17878,19117,1995,Italy,Slovenia,1,0,UEFA Euro qualification,Udine,Italy,False,1,1,Italy
16384,17879,19118,1995,Latvia,Liechtenstein,1,0,UEFA Euro qualification,Riga,Latvia,False,1,1,Latvia
16385,17880,19119,1995,Lithuania,Ukraine,1,3,UEFA Euro qualification,Vilnius,Lithuania,False,4,-2,Ukraine
16386,17881,19120,1995,Luxembourg,Malta,1,0,UEFA Euro qualification,Luxembourg,Luxembourg,False,1,1,Luxembourg
16387,17882,19122,1995,Netherlands,Belarus,1,0,UEFA Euro qualification,Rotterdam,Netherlands,False,1,1,Netherlands
16388,17883,19123,1995,Poland,Romania,0,0,UEFA Euro qualification,Zabrze,Poland,False,0,0,Draw
16389,17884,19124,1995,San Marino,Greece,0,4,UEFA Euro qualification,Serravalle,San Marino,False,4,-4,Greece
16390,17885,19125,1995,Scotland,Finland,1,0,UEFA Euro qualification,Glasgow,Scotland,False,1,1,Scotland
16391,17886,19126,1995,Slovakia,Israel,1,0,UEFA Euro qualification,Košice,Slovakia,False,1,1,Slovakia
16392,17887,19127,1995,Spain,Cyprus,6,0,UEFA Euro qualification,Granada,Spain,False,6,6,Spain
16393,17888,19128,1995,Sweden,Switzerland,0,0,UEFA Euro qualification,Gothenburg,Sweden,False,0,0,Draw
16394,17889,19129,1995,Turkey,Hungary,2,0,UEFA Euro qualification,Istanbul,Turkey,False,2,2,Turkey
16395,17890,19130,1995,Wales,Moldova,1,0,UEFA Euro qualification,Cardiff,Wales,False,1,1,Wales
16396,17891,19131,1995,Greece,Serbia,0,2,Friendly,Salonica,Greece,False,2,-2,Serbia
16397,17892,19132,1995,Israel,Uruguay,3,1,Friendly,Jerusalem,Israel,False,4,2,Israel
16398,17893,19133,1995,Japan,Paraguay,1,2,Friendly,Tokyo,Japan,False,3,-1,Paraguay
16399,17894,19134,1995,Spain,Argentina,2,1,Friendly,Madrid,Spain,False,3,1,Spain
16400,17895,19135,1995,Trinidad and Tobago,Jamaica,1,0,Friendly,Port of Spain,Trinidad and Tobago,False,1,1,Trinidad and Tobago
16401,17896,19136,1995,Jamaica,Costa Rica,2,0,Friendly,Kingston,Jamaica,False,2,2,Jamaica
16402,17897,19137,1995,South Africa,Mozambique,3,2,Friendly,Johannesburg,South Africa,False,5,1,South Africa
16403,17898,19138,1995,Finland,Turkey,0,0,Friendly,Helsinki,Finland,False,0,0,Draw
16404,17899,19139,1995,Armenia,Belgium,0,2,UEFA Euro qualification,Yerevan,Armenia,False,2,-2,Belgium
16405,17900,19140,1995,Belarus,Czech Republic,0,2,UEFA Euro qualification,Minsk,Belarus,False,2,-2,Czech Republic
16406,17901,19141,1995,Bulgaria,Albania,3,0,UEFA Euro qualification,Sofia,Bulgaria,False,3,3,Bulgaria
16407,17902,19142,1995,Croatia,Italy,1,1,UEFA Euro qualification,Split,Croatia,False,2,0,Draw
16408,17903,19143,1995,Germany,Moldova,6,1,UEFA Euro qualification,Leverkusen,Germany,False,7,5,Germany
16409,17904,19144,1995,United States,Saudi Arabia,4,3,Friendly,Washington,United States,False,7,1,United States
16410,17905,19145,1995,Argentina,Colombia,0,0,Friendly,Buenos Aires,Argentina,False,0,0,Draw
16411,17906,19146,1995,Austria,Portugal,1,1,UEFA Euro qualification,Vienna,Austria,False,2,0,Draw
16412,17907,19147,1995,Brazil,Uruguay,2,0,Friendly,Salvador,Brazil,False,2,2,Brazil
16413,17908,19148,1995,Chile,Canada,2,0,Friendly,Concepción,Chile,False,2,2,Chile
16414,17910,19150,1995,Denmark,Spain,1,1,UEFA Euro qualification,Copenhagen,Denmark,False,2,0,Draw
16415,17911,19151,1995,Georgia,Bulgaria,2,1,UEFA Euro qualification,Tbilisi,Georgia,False,3,1,Georgia
16416,17912,19152,1995,Iceland,Turkey,0,0,UEFA Euro qualification,Reykjavík,Iceland,False,0,0,Draw
16417,17913,19153,1995,Republic of Ireland,Latvia,2,1,UEFA Euro qualification,Dublin,Republic of Ireland,False,3,1,Republic of Ireland
16418,17914,19154,1995,Israel,Azerbaijan,2,0,UEFA Euro qualification,Jaffa,Israel,False,2,2,Israel
16419,17915,19155,1995,Liechtenstein,Northern Ireland,0,4,UEFA Euro qualification,Eschen,Liechtenstein,False,4,-4,Northern Ireland
16420,17916,19156,1995,Lithuania,Estonia,5,0,UEFA Euro qualification,Vilnius,Lithuania,False,5,5,Lithuania
16421,17917,19157,1995,Luxembourg,Belarus,0,0,UEFA Euro qualification,Luxembourg,Luxembourg,False,0,0,Draw
16422,17918,19158,1995,Malta,Netherlands,0,4,UEFA Euro qualification,Attard,Malta,False,4,-4,Netherlands
16423,17919,19159,1995,Mexico,Saudi Arabia,2,1,Friendly,Los Angeles,United States,True,3,1,Mexico
16424,17920,19160,1995,Norway,England,0,0,Friendly,Oslo,Norway,False,0,0,Draw
16425,17921,19161,1995,Romania,France,1,3,UEFA Euro qualification,Bucharest,Romania,False,4,-2,France
16426,17922,19162,1995,Russia,Greece,2,1,UEFA Euro qualification,Moscow,Russia,False,3,1,Russia
16427,17923,19163,1995,San Marino,Faroe Islands,1,3,UEFA Euro qualification,Serravalle,San Marino,False,4,-2,Faroe Islands
16428,17924,19164,1995,Slovakia,Poland,4,1,UEFA Euro qualification,Bratislava,Slovakia,False,5,3,Slovakia
16429,17925,19165,1995,Slovenia,Ukraine,3,2,UEFA Euro qualification,Ljubljana,Slovenia,False,5,1,Slovenia
16430,17926,19166,1995,Sweden,Scotland,2,0,Friendly,Solna,Sweden,False,2,2,Sweden
16431,17927,19167,1995,Switzerland,Hungary,3,0,UEFA Euro qualification,Zürich,Switzerland,False,3,3,Switzerland
16432,17928,19168,1995,Wales,Germany,1,2,UEFA Euro qualification,Cardiff,Wales,False,3,-1,Germany
16433,17929,19169,1995,Jamaica,Honduras,1,0,Friendly,Kingston,Jamaica,False,1,1,Jamaica
16434,17930,19170,1995,Jamaica,Trinidad and Tobago,1,0,Friendly,George Town,Cayman Islands,True,1,1,Jamaica
16435,17931,19171,1995,Mali,Algeria,0,2,Friendly,Bamako,Mali,False,2,-2,Algeria
16436,17932,19172,1995,Uzbekistan,Nigeria,2,3,Friendly,Tashkent,Uzbekistan,False,5,-1,Nigeria
16437,17933,19173,1995,Burkina Faso,Tunisia,2,2,Friendly,Ouagadougou,Burkina Faso,False,4,0,Draw
16438,17934,19174,1995,Cayman Islands,Jamaica,1,5,Friendly,George Town,Cayman Islands,False,6,-4,Jamaica
16439,17935,19175,1995,Gabon,Sierra Leone,1,0,Friendly,Libreville,Gabon,False,1,1,Gabon
16440,17936,19176,1995,Panama,Nicaragua,2,0,UNCAF Cup,Panama City,Panama,False,2,2,Panama
16441,17937,19177,1995,Cayman Islands,Trinidad and Tobago,0,7,Friendly,George Town,Cayman Islands,False,7,-7,Trinidad and Tobago
16442,17938,19178,1995,Japan,Saudi Arabia,2,1,Friendly,Tokyo,Japan,False,3,1,Japan
16443,17939,19179,1995,Bolivia,Ecuador,2,2,Friendly,Santa Cruz,Bolivia,False,4,0,Draw
16444,17940,19180,1995,Burma,Bangladesh,4,0,Friendly,Rangoon,Burma,False,4,4,Burma
16445,17941,19182,1995,Japan,Saudi Arabia,2,1,Friendly,Matsuyama,Japan,False,3,1,Japan
16446,17942,19183,1995,Burma,Sri Lanka,2,0,Friendly,Rangoon,Burma,False,2,2,Burma
16447,17943,19184,1995,Nicaragua,Panama,0,5,UNCAF Cup,Diriamba,Nicaragua,False,5,-5,Panama
16448,17944,19186,1995,Bangladesh,Sri Lanka,1,0,Friendly,Rangoon,Burma,True,1,1,Bangladesh
16449,17945,19187,1995,Algeria,Mauritania,4,0,Friendly,Tunis,Tunisia,True,4,4,Algeria
16450,17946,19188,1995,Burma,Bangladesh,1,2,Friendly,Rangoon,Burma,False,3,-1,Bangladesh
16451,17947,19189,1995,Tunisia,Algeria,2,0,Friendly,Tunis,Tunisia,False,2,2,Tunisia
16452,17948,19190,1995,Zambia,Jamaica,4,2,Friendly,Lusaka,Zambia,False,6,2,Zambia
16453,17949,19191,1995,Tunisia,Mauritania,2,1,Friendly,Tunis,Tunisia,False,3,1,Tunisia
16454,17950,19192,1995,Argentina,Brazil,0,1,Friendly,Buenos Aires,Argentina,False,1,-1,Brazil
16455,17951,19193,1995,New Zealand,Australia,0,0,Oceania Nations Cup,Christchurch,New Zealand,False,0,0,Draw
16456,17952,19194,1995,Nigeria,Uzbekistan,1,0,Friendly,Lagos,Nigeria,False,1,1,Nigeria
16457,17953,19195,1995,Hungary,Iceland,1,0,UEFA Euro qualification,Budapest,Hungary,False,1,1,Hungary
16458,17954,19196,1995,Italy,Ukraine,3,1,UEFA Euro qualification,Bari,Italy,False,4,2,Italy
16459,17955,19197,1995,El Salvador,Serbia,1,4,Friendly,San Salvador,El Salvador,False,5,-3,Serbia
16460,17956,19198,1995,Malta,Belarus,0,2,UEFA Euro qualification,Attard,Malta,False,2,-2,Belarus
16461,17957,19199,1995,Albania,Wales,1,1,UEFA Euro qualification,Tirana,Albania,False,2,0,Draw
16462,17958,19200,1995,Australia,New Zealand,3,0,Oceania Nations Cup,Newcastle,Australia,False,3,3,Australia
16463,17959,19201,1995,Azerbaijan,Poland,0,0,UEFA Euro qualification,Trabzon,Turkey,True,0,0,Draw
16464,17960,19202,1995,Cyprus,Belgium,1,1,UEFA Euro qualification,Limassol,Cyprus,False,2,0,Draw
16465,17961,19203,1995,Czech Republic,Luxembourg,3,0,UEFA Euro qualification,Prague,Czech Republic,False,3,3,Czech Republic
16466,17962,19204,1995,Denmark,Armenia,3,1,UEFA Euro qualification,Copenhagen,Denmark,False,4,2,Denmark
16467,17963,19205,1995,England,Switzerland,3,1,Friendly,London,England,False,4,2,England
16468,17964,19206,1995,France,Israel,2,0,UEFA Euro qualification,Caen,France,False,2,2,France
16469,17965,19207,1995,Germany,Bulgaria,3,1,UEFA Euro qualification,Berlin,Germany,False,4,2,Germany
16470,17966,19208,1995,Greece,Faroe Islands,5,0,UEFA Euro qualification,Heraklion,Greece,False,5,5,Greece
16471,17967,19209,1995,Italy,Lithuania,4,0,UEFA Euro qualification,Reggio Emilia,Italy,False,4,4,Italy
16472,17968,19210,1995,Moldova,Georgia,3,2,UEFA Euro qualification,Chişinău,Moldova,False,5,1,Moldova
16473,17969,19211,1995,Morocco,Mali,2,0,Friendly,Rabat,Morocco,False,2,2,Morocco
16474,17970,19212,1995,Netherlands,Norway,3,0,UEFA Euro qualification,Rotterdam,Netherlands,False,3,3,Netherlands
16475,17971,19213,1995,Northern Ireland,Austria,5,3,UEFA Euro qualification,Belfast,Northern Ireland,False,8,2,Northern Ireland
16476,17972,19214,1995,Portugal,Republic of Ireland,3,0,UEFA Euro qualification,Lisbon,Portugal,False,3,3,Portugal
16477,17973,19215,1995,Russia,Finland,3,1,UEFA Euro qualification,Moscow,Russia,False,4,2,Russia
16478,17974,19216,1995,Scotland,San Marino,5,0,UEFA Euro qualification,Glasgow,Scotland,False,5,5,Scotland
16479,17975,19217,1995,Slovakia,Romania,0,2,UEFA Euro qualification,Košice,Slovakia,False,2,-2,Romania
16480,17976,19218,1995,Slovenia,Croatia,1,2,UEFA Euro qualification,Ljubljana,Slovenia,False,3,-1,Croatia
16481,17978,19220,1995,Sweden,Turkey,2,2,UEFA Euro qualification,Solna,Sweden,False,4,0,Draw
16482,17979,19221,1995,Mexico,Serbia,1,4,Friendly,Monterrey,Mexico,False,5,-3,Serbia
16483,17980,19223,1995,Mauritania,Gambia,2,1,Amílcar Cabral Cup,Nouakchott,Mauritania,False,3,1,Mauritania
16484,17982,19225,1995,Guinea-Bissau,Senegal,2,1,Amílcar Cabral Cup,Nouakchott,Mauritania,True,3,1,Guinea-Bissau
16485,17983,19226,1995,Sierra Leone,Guinea,2,0,Amílcar Cabral Cup,Nouakchott,Mauritania,True,2,2,Sierra Leone
16486,17984,19227,1995,Dominica,Saint Lucia,2,1,Windward Islands Tournament,Roseau,Dominica,False,3,1,Dominica
16487,17985,19228,1995,Mali,Gambia,1,0,Amílcar Cabral Cup,Nouakchott,Mauritania,True,1,1,Mali
16488,17987,19230,1995,Saint Vincent and the Grenadines,Barbados,2,0,Windward Islands Tournament,Roseau,Dominica,True,2,2,Saint Vincent and the Grenadines
16489,17988,19231,1995,Senegal,Guinea,3,0,Amílcar Cabral Cup,Nouakchott,Mauritania,True,3,3,Senegal
16490,17989,19232,1995,Sierra Leone,Guinea-Bissau,2,0,Amílcar Cabral Cup,Nouakchott,Mauritania,True,2,2,Sierra Leone
16491,17990,19233,1995,Egypt,Zimbabwe,2,2,Simba Tournament,Pretoria,South Africa,True,4,0,Draw
16492,17991,19234,1995,Guinea-Bissau,Guinea,2,1,Amílcar Cabral Cup,Nouakchott,Mauritania,True,3,1,Guinea-Bissau
16493,17992,19235,1995,Senegal,Sierra Leone,1,1,Amílcar Cabral Cup,Nouakchott,Mauritania,True,2,0,Draw
16494,17993,19236,1995,South Africa,Zambia,2,2,Simba Tournament,Pretoria,South Africa,False,4,0,Draw
16495,17994,19237,1995,Grenada,Barbados,1,0,Windward Islands Tournament,Roseau,Dominica,True,1,1,Grenada
16496,17995,19238,1995,Saint Lucia,Saint Vincent and the Grenadines,2,1,Windward Islands Tournament,Roseau,Dominica,True,3,1,Saint Lucia
16497,17996,19239,1995,South Africa,Egypt,2,0,Simba Tournament,Mafikeng,South Africa,False,2,2,South Africa
16498,17997,19240,1995,Zambia,Zimbabwe,1,1,Simba Tournament,Mmabatho,South Africa,True,2,0,Draw
16499,17998,19241,1995,Mauritania,Guinea-Bissau,1,0,Amílcar Cabral Cup,Nouakchott,Mauritania,False,1,1,Mauritania
16500,18000,19243,1995,Algeria,Ivory Coast,0,0,Friendly,Libreville,Gabon,True,0,0,Draw
16501,18001,19244,1995,Egypt,Zambia,3,1,Simba Tournament,Johannesburg,South Africa,True,4,2,Egypt
16502,18002,19245,1995,Gabon,Cameroon,1,2,Friendly,Libreville,Gabon,False,3,-1,Cameroon
16503,18003,19246,1995,Jamaica,Norway,1,1,Friendly,Kingston,Jamaica,False,2,0,Draw
16504,18004,19247,1995,South Africa,Zimbabwe,2,0,Simba Tournament,Johannesburg,South Africa,False,2,2,South Africa
16505,18005,19248,1995,Uganda,Rwanda,0,0,CECAFA Cup,Kampala,Uganda,False,0,0,Draw
16506,18007,19251,1995,Tanzania,Ethiopia,2,2,CECAFA Cup,Jinja,Uganda,True,4,0,Draw
16507,18008,19252,1995,Algeria,Cameroon,4,0,Friendly,Libreville,Gabon,True,4,4,Algeria
16508,18009,19253,1995,Dominica,Saint Vincent and the Grenadines,1,0,Windward Islands Tournament,Roseau,Dominica,False,1,1,Dominica
16509,18010,19254,1995,Gabon,Ivory Coast,0,2,Friendly,Libreville,Gabon,False,2,-2,Ivory Coast
16510,18011,19255,1995,Mauritania,Sierra Leone,0,0,Amílcar Cabral Cup,Nouakchott,Mauritania,False,0,0,Draw
16511,18012,19256,1995,El Salvador,Belize,3,0,UNCAF Cup,San Salvador,El Salvador,False,3,3,El Salvador
16512,18013,19257,1995,Honduras,Panama,2,0,UNCAF Cup,Santa Ana,El Salvador,True,2,2,Honduras
16513,18014,19258,1995,Mexico,Colombia,2,2,Friendly,Los Angeles,United States,True,4,0,Draw
16514,18015,19259,1995,Trinidad and Tobago,Norway,3,2,Friendly,Port of Spain,Trinidad and Tobago,False,5,1,Trinidad and Tobago
16515,18016,19260,1995,Tunisia,Burkina Faso,3,0,Friendly,Tunis,Tunisia,False,3,3,Tunisia
16516,18017,19262,1995,Albania,Bosnia and Herzegovina,2,0,Friendly,Tirana,Albania,False,2,2,Albania
16517,18018,19263,1995,Gabon,Algeria,2,1,Friendly,Libreville,Gabon,False,3,1,Gabon
16518,18019,19264,1995,Ivory Coast,Cameroon,2,1,Friendly,Libreville,Gabon,True,3,1,Ivory Coast
16519,18020,19265,1995,Kenya,Rwanda,1,0,CECAFA Cup,Kampala,Uganda,True,1,1,Kenya
16520,18022,19267,1995,Costa Rica,Belize,2,1,UNCAF Cup,San Salvador,El Salvador,True,3,1,Costa Rica
16521,18023,19268,1995,Guatemala,Panama,1,0,UNCAF Cup,Santa Ana,El Salvador,True,1,1,Guatemala
16522,18024,19269,1995,Tanzania,Somalia,7,0,CECAFA Cup,Jinja,Uganda,True,7,7,Tanzania
16523,18025,19270,1995,Algeria,Ivory Coast,0,0,Friendly,Libreville,Gabon,True,0,0,Draw
16524,18026,19271,1995,Gabon,Cameroon,0,0,Friendly,Libreville,Gabon,False,0,0,Draw
16525,18027,19272,1995,Uganda,Kenya,0,0,CECAFA Cup,Kampala,Uganda,False,0,0,Draw
16526,18028,19273,1995,Antigua and Barbuda,Jamaica,1,2,Friendly,St. John's,Antigua and Barbuda,False,3,-1,Jamaica
16527,18029,19274,1995,El Salvador,Costa Rica,2,1,UNCAF Cup,San Salvador,El Salvador,False,3,1,El Salvador
16528,18030,19275,1995,Ethiopia,Somalia,5,0,CECAFA Cup,Jinja,Uganda,True,5,5,Ethiopia
16529,18031,19276,1995,Grenada,Saint Vincent and the Grenadines,1,0,Windward Islands Tournament,Roseau,Dominica,True,1,1,Grenada
16530,18032,19277,1995,Honduras,Guatemala,2,0,UNCAF Cup,Santa Ana,El Salvador,True,2,2,Honduras
16531,18034,19279,1995,Mexico,Slovenia,1,2,Friendly,Hermosillo,Mexico,False,3,-1,Slovenia
16532,18035,19280,1995,Saint Kitts and Nevis,Jamaica,0,3,Friendly,Basseterre,Saint Kitts and Nevis,False,3,-3,Jamaica
16533,18036,19281,1995,El Salvador,Guatemala,0,1,UNCAF Cup,San Salvador,El Salvador,False,1,-1,Guatemala
16534,18037,19282,1995,Honduras,Costa Rica,1,1,UNCAF Cup,San Salvador,El Salvador,True,2,0,Draw
16535,18038,19283,1995,Ivory Coast,Mali,2,1,Friendly,Bouaké,Ivory Coast,False,3,1,Ivory Coast
16536,18039,19284,1995,Kenya,Ethiopia,2,1,CECAFA Cup,Kampala,Uganda,True,3,1,Kenya
16537,18040,19285,1995,El Salvador,Costa Rica,2,1,UNCAF Cup,San Salvador,El Salvador,False,3,1,El Salvador
16538,18041,19286,1995,Honduras,Guatemala,3,0,UNCAF Cup,San Salvador,El Salvador,True,3,3,Honduras
16539,18042,19287,1995,DR Congo,Congo,2,2,Friendly,Kinshasa,Zaïre,False,4,0,Draw
16540,18043,19288,1995,England,Portugal,1,1,Friendly,London,England,False,2,0,Draw
16541,18044,19289,1995,Republic of Ireland,Netherlands,0,2,UEFA Euro qualification,Liverpool,England,True,2,-2,Netherlands
16542,18045,19290,1995,Kuwait,Czech Republic,1,2,Friendly,Kuwait City,Kuwait,False,3,-1,Czech Republic
16543,18046,19291,1995,South Africa,Germany,0,0,Friendly,Johannesburg,South Africa,False,0,0,Draw
16544,18047,19292,1995,Sierra Leone,Liberia,1,0,Friendly,Freetown,Sierra Leone,False,1,1,Sierra Leone
16545,18048,19293,1995,Brazil,Colombia,3,1,Friendly,Manaus,Brazil,False,4,2,Brazil
16546,18049,19294,1995,Jamaica,Mexico,2,1,Friendly,Kingston,Jamaica,False,3,1,Jamaica
16547,18050,19295,1995,Argentina,Venezuela,6,0,Friendly,Mendoza,Argentina,False,6,6,Argentina
16548,18051,19296,1995,Burkina Faso,Gabon,2,5,Friendly,Ouagadougou,Burkina Faso,False,7,-3,Gabon
16549,18052,19298,1995,Zambia,Tunisia,2,0,Friendly,Lusaka,Zambia,False,2,2,Zambia
16550,18053,19299,1995,Cameroon,Liberia,1,0,Friendly,Yaoundé,Cameroon,False,1,1,Cameroon
16551,18054,19300,1995,Kuwait,Kazakhstan,0,0,Friendly,Kuwait City,Kuwait,False,0,0,Draw
16552,18055,19301,1995,Mali,Gabon,1,2,Friendly,Bamako,Mali,False,3,-1,Gabon
16553,18056,19302,1995,Egypt,Ghana,1,2,Friendly,Cairo,Egypt,False,3,-1,Ghana
16554,18057,19303,1995,Saudi Arabia,Kazakhstan,3,0,Friendly,Jeddah,Saudi Arabia,False,3,3,Saudi Arabia
16555,18058,19304,1996,Lebanon,Kazakhstan,2,1,Friendly,Beirut,Lebanon,False,3,1,Lebanon
16556,18059,19305,1996,Morocco,Tunisia,3,1,Friendly,Rabat,Morocco,False,4,2,Morocco
16557,18060,19306,1996,Saudi Arabia,Ghana,1,1,Friendly,Jeddah,Saudi Arabia,False,2,0,Draw
16558,18061,19307,1996,Trinidad and Tobago,Venezuela,0,0,Friendly,Palo Seco,Trinidad and Tobago,False,0,0,Draw
16559,18062,19308,1996,Sierra Leone,Liberia,2,1,Friendly,Freetown,Sierra Leone,False,3,1,Sierra Leone
16560,18063,19309,1996,Trinidad and Tobago,Venezuela,0,0,Friendly,Port of Spain,Trinidad and Tobago,False,0,0,Draw
16561,18064,19310,1996,Zimbabwe,Gabon,1,2,Friendly,Harare,Zimbabwe,False,3,-1,Gabon
16562,18065,19311,1996,Egypt,Tunisia,2,1,Friendly,Ismailia,Egypt,False,3,1,Egypt
16563,18066,19312,1996,Zimbabwe,Ghana,1,1,Friendly,Harare,Zimbabwe,False,2,0,Draw
16564,18067,19313,1996,Canada,Honduras,3,1,Gold Cup,Anaheim,United States,True,4,2,Canada
16565,18068,19314,1996,Trinidad and Tobago,El Salvador,2,3,Gold Cup,Anaheim,United States,True,5,-1,El Salvador
16566,18069,19315,1996,Mexico,Saint Vincent and the Grenadines,5,0,Gold Cup,San Diego,United States,True,5,5,Mexico
16567,18070,19316,1996,Mozambique,Gabon,1,0,Friendly,Maputo,Mozambique,False,1,1,Mozambique
16568,18071,19317,1996,Brazil,Canada,4,1,Gold Cup,Los Angeles,United States,True,5,3,Brazil
16569,18072,19318,1996,South Africa,Cameroon,3,0,African Cup of Nations,Johannesburg,South Africa,False,3,3,South Africa
16570,18073,19319,1996,United States,Trinidad and Tobago,3,2,Gold Cup,Anaheim,United States,False,5,1,United States
16571,18074,19320,1996,Guatemala,Mexico,0,1,Gold Cup,San Diego,United States,True,1,-1,Mexico
16572,18075,19321,1996,Honduras,Brazil,0,5,Gold Cup,Los Angeles,United States,True,5,-5,Brazil
16573,18076,19322,1996,Ivory Coast,Ghana,0,2,African Cup of Nations,Port Elizabeth,South Africa,True,2,-2,Ghana
16574,18077,19323,1996,Jamaica,Cuba,1,1,Friendly,Kingston,Jamaica,False,2,0,Draw
16575,18078,19324,1996,Zambia,Algeria,0,0,African Cup of Nations,Bloemfontein,South Africa,True,0,0,Draw
16576,18079,19325,1996,Egypt,Angola,2,1,African Cup of Nations,Johannesburg,South Africa,True,3,1,Egypt
16577,18080,19326,1996,Sierra Leone,Burkina Faso,2,1,African Cup of Nations,Bloemfontein,South Africa,True,3,1,Sierra Leone
16578,18081,19327,1996,Gabon,Liberia,1,2,African Cup of Nations,Durban,South Africa,True,3,-1,Liberia
16579,18082,19328,1996,Guatemala,Saint Vincent and the Grenadines,3,0,Gold Cup,Anaheim,United States,True,3,3,Guatemala
16580,18083,19329,1996,Lebanon,Cyprus,1,0,Friendly,Beirut,Lebanon,False,1,1,Lebanon
16581,18084,19330,1996,Tunisia,Mozambique,1,1,African Cup of Nations,Port Elizabeth,South Africa,True,2,0,Draw
16582,18085,19331,1996,United States,El Salvador,2,0,Gold Cup,Anaheim,United States,False,2,2,United States
16583,18086,19332,1996,Armenia,Morocco,0,6,Friendly,Vitrolles,France,True,6,-6,Morocco
16584,18087,19333,1996,Algeria,Sierra Leone,2,0,African Cup of Nations,Bloemfontein,South Africa,True,2,2,Algeria
16585,18088,19334,1996,Cameroon,Egypt,2,1,African Cup of Nations,Johannesburg,South Africa,True,3,1,Cameroon
16586,18089,19335,1996,United States,Brazil,0,1,Gold Cup,Los Angeles,United States,False,1,-1,Brazil
16587,18090,19336,1996,DR Congo,Gabon,0,2,African Cup of Nations,Durban,South Africa,True,2,-2,Gabon
16588,18091,19337,1996,Ghana,Tunisia,2,1,African Cup of Nations,Port Elizabeth,South Africa,True,3,1,Ghana
16589,18092,19338,1996,Mexico,Guatemala,1,0,Gold Cup,San Diego,United States,True,1,1,Mexico
16590,18093,19339,1996,Burkina Faso,Zambia,1,5,African Cup of Nations,Bloemfontein,South Africa,True,6,-4,Zambia
16591,18094,19340,1996,South Africa,Angola,1,0,African Cup of Nations,Johannesburg,South Africa,False,1,1,South Africa
16592,18095,19341,1996,Mexico,Brazil,2,0,Gold Cup,Los Angeles,United States,True,2,2,Mexico
16593,18096,19342,1996,Mozambique,Ivory Coast,0,1,African Cup of Nations,Port Elizabeth,South Africa,True,1,-1,Ivory Coast
16594,18097,19343,1996,United States,Guatemala,3,0,Gold Cup,Los Angeles,United States,False,3,3,United States
16595,18098,19344,1996,Angola,Cameroon,3,3,African Cup of Nations,Durban,South Africa,True,6,0,Draw
16596,18099,19345,1996,Burkina Faso,Algeria,1,2,African Cup of Nations,Port Elizabeth,South Africa,True,3,-1,Algeria
16597,18100,19346,1996,Greece,Israel,2,1,Friendly,Chalcis,Greece,False,3,1,Greece
16598,18101,19347,1996,Saudi Arabia,Kyrgyzstan,3,0,AFC Asian Cup qualification,Riyadh,Saudi Arabia,False,3,3,Saudi Arabia
16599,18102,19348,1996,Sierra Leone,Zambia,0,4,African Cup of Nations,Bloemfontein,South Africa,True,4,-4,Zambia
16600,18103,19349,1996,South Africa,Egypt,0,1,African Cup of Nations,Johannesburg,South Africa,False,1,-1,Egypt
16601,18104,19350,1996,Liberia,DR Congo,0,2,African Cup of Nations,Johannesburg,South Africa,True,2,-2,DR Congo
16602,18105,19351,1996,Mozambique,Ghana,0,2,African Cup of Nations,Bloemfontein,South Africa,True,2,-2,Ghana
16603,18106,19352,1996,Tunisia,Ivory Coast,3,1,African Cup of Nations,Port Elizabeth,South Africa,True,4,2,Tunisia
16604,18107,19353,1996,Yemen,Kyrgyzstan,1,0,AFC Asian Cup qualification,Riyadh,Saudi Arabia,True,1,1,Yemen
16605,18108,19354,1996,South Africa,Algeria,2,1,African Cup of Nations,Johannesburg,South Africa,False,3,1,South Africa
16606,18109,19355,1996,Zambia,Egypt,3,1,African Cup of Nations,Bloemfontein,South Africa,True,4,2,Zambia
16607,18110,19356,1996,Gabon,Tunisia,1,1,African Cup of Nations,Durban,South Africa,True,2,0,Draw
16608,18111,19357,1996,Ghana,DR Congo,1,0,African Cup of Nations,Port Elizabeth,South Africa,True,1,1,Ghana
16609,18112,19358,1996,Saudi Arabia,Yemen,4,0,AFC Asian Cup qualification,Riyadh,Saudi Arabia,False,4,4,Saudi Arabia
16610,18113,19360,1996,Hong Kong,Philippines,8,0,AFC Asian Cup qualification,Victoria,Hong Kong,False,8,8,Hong Kong
16611,18114,19361,1996,Saudi Arabia,Kyrgyzstan,2,0,AFC Asian Cup qualification,Riyadh,Saudi Arabia,False,2,2,Saudi Arabia
16612,18115,19362,1996,South Africa,Ghana,3,0,African Cup of Nations,Johannesburg,South Africa,False,3,3,South Africa
16613,18116,19363,1996,Zambia,Tunisia,2,4,African Cup of Nations,Durban,South Africa,True,6,-2,Tunisia
16614,18117,19364,1996,Hong Kong,Macau,4,1,AFC Asian Cup qualification,Victoria,Hong Kong,False,5,3,Hong Kong
16615,18119,19366,1996,Kyrgyzstan,Yemen,3,1,AFC Asian Cup qualification,Riyadh,Saudi Arabia,True,4,2,Kyrgyzstan
16616,18120,19367,1996,Venezuela,Ecuador,0,1,Friendly,Caracas,Venezuela,False,1,-1,Ecuador
16617,18121,19368,1996,South Africa,Tunisia,2,0,African Cup of Nations,Johannesburg,South Africa,False,2,2,South Africa
16618,18122,19369,1996,Zambia,Ghana,1,0,African Cup of Nations,Johannesburg,South Africa,True,1,1,Zambia
16619,18123,19370,1996,Bolivia,Chile,1,1,Friendly,Cochabamba,Bolivia,False,2,0,Draw
16620,18125,19372,1996,Macau,Philippines,5,1,AFC Asian Cup qualification,Victoria,Hong Kong,True,6,4,Macau
16621,18126,19373,1996,Saudi Arabia,Yemen,1,0,AFC Asian Cup qualification,Riyadh,Saudi Arabia,False,1,1,Saudi Arabia
16622,18127,19375,1996,Chile,Mexico,2,1,Friendly,Viña del Mar,Chile,False,3,1,Chile
16623,18128,19376,1996,Iceland,Slovenia,1,7,Malta International Tournament,Attard,Malta,True,8,-6,Slovenia
16624,18129,19377,1996,Malta,Russia,0,2,Malta International Tournament,Attard,Malta,False,2,-2,Russia
16625,18130,19378,1996,Morocco,Luxembourg,2,0,Friendly,Rabat,Morocco,False,2,2,Morocco
16626,18131,19379,1996,Spain,Norway,1,0,Friendly,Las Palmas,Spain,False,1,1,Spain
16627,18132,19380,1996,Iceland,Russia,0,3,Malta International Tournament,Attard,Malta,True,3,-3,Russia
16628,18133,19381,1996,Malta,Slovenia,0,0,Malta International Tournament,Attard,Malta,False,0,0,Draw
16629,18134,19382,1996,Thailand,Finland,1,0,King's Cup,Bangkok,Thailand,False,1,1,Thailand
16630,18135,19383,1996,Australia,Japan,1,4,Friendly,Wollongong,Australia,False,5,-3,Japan
16631,18136,19384,1996,Lebanon,Ecuador,1,0,Friendly,Bourj Hammoud,Lebanon,False,1,1,Lebanon
16632,18137,19385,1996,Malta,Iceland,1,4,Malta International Tournament,Attard,Malta,False,5,-3,Iceland
16633,18138,19386,1996,Peru,Bolivia,1,3,Friendly,Lima,Peru,False,4,-2,Bolivia
16634,18139,19387,1996,Russia,Slovenia,3,1,Malta International Tournament,Attard,Malta,True,4,2,Russia
16635,18140,19388,1996,Australia,Japan,3,0,Friendly,Melbourne,Australia,False,3,3,Australia
16636,18141,19389,1996,Bolivia,Paraguay,4,1,Friendly,Sucre,Bolivia,False,5,3,Bolivia
16637,18142,19390,1996,Chile,Peru,4,0,Friendly,Coquimbo,Chile,False,4,4,Chile
16638,18143,19391,1996,Turkey,Belarus,3,2,Friendly,Izmir,Turkey,False,5,1,Turkey
16639,18144,19392,1996,Azerbaijan,Estonia,0,0,Friendly,Larnaca,Cyprus,True,0,0,Draw
16640,18145,19393,1996,Oman,Ecuador,0,2,Friendly,Doha,Qatar,True,2,-2,Ecuador
16641,18146,19394,1996,Thailand,Finland,5,2,King's Cup,Bangkok,Thailand,False,7,3,Thailand
16642,18147,19395,1996,Qatar,Ecuador,1,1,Friendly,Doha,Qatar,False,2,0,Draw
16643,18148,19396,1996,Japan,Poland,5,0,Lunar New Year Cup,So Kon Po,Hong Kong,True,5,5,Japan
16644,18149,19397,1996,Cyprus,Estonia,1,0,Friendly,Limassol,Cyprus,False,1,1,Cyprus
16645,18150,19398,1996,France,Greece,3,1,Friendly,Nîmes,France,False,4,2,France
16646,18151,19399,1996,Israel,Lithuania,4,2,Friendly,Haifa,Israel,False,6,2,Israel
16647,18152,19400,1996,Portugal,Germany,1,2,Friendly,Porto,Portugal,False,3,-1,Germany
16648,18153,19401,1996,Japan,Sweden,1,1,Lunar New Year Cup,So Kon Po,Hong Kong,True,2,0,Draw
16649,18154,19402,1996,Kuwait,Ecuador,0,3,Friendly,Kuwait City,Kuwait,False,3,-3,Ecuador
16650,18155,19403,1996,Thailand,Indonesia,4,1,Friendly,Bangkok,Thailand,False,5,3,Thailand
16651,18156,19404,1996,Estonia,Faroe Islands,2,2,Friendly,Púla,Cyprus,True,4,0,Draw
16652,18157,19405,1996,Kuwait,Oman,1,0,Friendly,Kuwait City,Kuwait,False,1,1,Kuwait
16653,18158,19406,1996,Australia,Sweden,0,2,Friendly,Brisbane,Australia,False,2,-2,Sweden
16654,18159,19407,1996,Qatar,Ecuador,1,2,Friendly,Doha,Qatar,False,3,-1,Ecuador
16655,18160,19408,1996,Azerbaijan,Faroe Islands,3,0,Friendly,Larnaca,Cyprus,True,3,3,Azerbaijan
16656,18161,19409,1996,Australia,Sweden,0,0,Friendly,Sydney,Australia,False,0,0,Draw
16657,18162,19410,1996,Croatia,Poland,2,1,Friendly,Rijeka,Croatia,False,3,1,Croatia
16658,18163,19411,1996,Malaysia,Indonesia,1,1,AFC Asian Cup qualification,Kuala Lumpur,Malaysia,False,2,0,Draw
16659,18164,19412,1996,Oman,Kuwait,0,3,Friendly,Muscat,Oman,False,3,-3,Kuwait
16660,18165,19413,1996,Jamaica,Guatemala,2,0,Friendly,Kingston,Jamaica,False,2,2,Jamaica
16661,18166,19414,1996,Indonesia,India,7,1,AFC Asian Cup qualification,Kuala Lumpur,Malaysia,True,8,6,Indonesia
16662,18167,19415,1996,Syria,Kuwait,0,2,Friendly,Damascus,Syria,False,2,-2,Kuwait
16663,18168,19416,1996,Colombia,Honduras,2,1,Friendly,Miami,United States,True,3,1,Colombia
16664,18169,19417,1996,Malaysia,India,5,2,AFC Asian Cup qualification,Kuala Lumpur,Malaysia,False,7,3,Malaysia
16665,18170,19418,1996,Trinidad and Tobago,Haiti,2,0,Friendly,Miami,United States,True,2,2,Trinidad and Tobago
16666,18171,19419,1996,Bolivia,Peru,2,0,Friendly,Santa Cruz,Bolivia,False,2,2,Bolivia
16667,18172,19420,1996,Dominica,Antigua and Barbuda,3,3,FIFA World Cup qualification,Roseau,Dominica,False,6,0,Draw
16668,18173,19421,1996,Turkmenistan,Kuwait,2,2,AFC Asian Cup qualification,Ashgabat,Turkmenistan,False,4,0,Draw
16669,18174,19422,1996,Cyprus,Latvia,1,0,Friendly,Larnaca,Cyprus,False,1,1,Cyprus
16670,18176,19424,1996,Luxembourg,Switzerland,1,1,Friendly,Luxembourg,Luxembourg,False,2,0,Draw
16671,18177,19425,1996,Kuwait,Finland,0,1,Friendly,Kuwait City,Kuwait,False,1,-1,Finland
16672,18178,19426,1996,Dominica,Saint Lucia,0,1,CFU Caribbean Cup qualification,Roseau,Dominica,False,1,-1,Saint Lucia
16673,18180,19428,1996,Egypt,Morocco,0,2,United Arab Emirates Friendship Tournament,Dubai,United Arab Emirates,True,2,-2,Morocco
16674,18181,19429,1996,Colombia,Trinidad and Tobago,3,0,Friendly,Neiva,Colombia,False,3,3,Colombia
16675,18182,19430,1996,Kuwait,Turkmenistan,2,0,AFC Asian Cup qualification,Kuwait City,Kuwait,False,2,2,Kuwait
16676,18183,19431,1996,United Arab Emirates,Egypt,0,0,United Arab Emirates Friendship Tournament,Dubai,United Arab Emirates,False,0,0,Draw
16677,18184,19432,1996,Curaçao,Grenada,0,1,CFU Caribbean Cup qualification,Willemstad,Netherlands Antilles,True,1,-1,Grenada
16678,18185,19434,1996,Dominican Republic,Aruba,3,2,FIFA World Cup qualification,Santo Domingo,Dominican Republic,False,5,1,Dominican Republic
16679,18186,19435,1996,French Guiana,Suriname,1,2,CFU Caribbean Cup qualification,Cayenne,French Guiana,False,3,-1,Suriname
16680,18188,19437,1996,Croatia,Israel,2,0,Friendly,Varaždin,Croatia,False,2,2,Croatia
16681,18189,19438,1996,Czech Republic,Turkey,3,0,Friendly,Ostrava,Czech Republic,False,3,3,Czech Republic
16682,18190,19439,1996,United Arab Emirates,Morocco,1,0,United Arab Emirates Friendship Tournament,Dubai,United Arab Emirates,False,1,1,United Arab Emirates
16683,18191,19440,1996,Austria,Switzerland,1,0,Friendly,Vienna,Austria,False,1,1,Austria
16684,18192,19441,1996,Belgium,France,0,2,Friendly,Brussels,Belgium,False,2,-2,France
16685,18193,19442,1996,Brazil,Ghana,8,2,Friendly,São José do Rio Preto,Brazil,False,10,6,Brazil
16686,18194,19443,1996,Cyprus,Georgia,0,2,Friendly,Limassol,Cyprus,False,2,-2,Georgia
16687,18195,19444,1996,Germany,Denmark,2,0,Friendly,Munich,Germany,False,2,2,Germany
16688,18196,19445,1996,Guatemala,Venezuela,3,0,Friendly,Guatemala,Guatemala,False,3,3,Guatemala
16689,18197,19446,1996,Honduras,Nicaragua,1,0,Friendly,Danlí,Honduras,False,1,1,Honduras
16690,18198,19447,1996,Republic of Ireland,Russia,0,2,Friendly,Dublin,Republic of Ireland,False,2,-2,Russia
16691,18199,19449,1996,Northern Ireland,Norway,0,2,Friendly,Belfast,Northern Ireland,False,2,-2,Norway
16692,18200,19450,1996,Poland,Slovenia,0,0,Friendly,Łódź,Poland,False,0,0,Draw
16693,18201,19451,1996,Portugal,Greece,1,0,Friendly,Lisbon,Portugal,False,1,1,Portugal
16694,18202,19452,1996,Scotland,Australia,1,0,Friendly,Glasgow,Scotland,False,1,1,Scotland
16695,18203,19453,1996,Serbia,Romania,1,0,Friendly,Belgrade,Yugoslavia,False,1,1,Serbia
16696,18204,19454,1996,Slovakia,Belarus,4,0,Friendly,Nitra,Slovakia,False,4,4,Slovakia
16697,18205,19455,1996,Saint Kitts and Nevis,Anguilla,8,0,CFU Caribbean Cup qualification,Basseterre,Saint Kitts and Nevis,False,8,8,Saint Kitts and Nevis
16698,18206,19456,1996,Colombia,Bolivia,4,1,Friendly,Medellín,Colombia,False,5,3,Colombia
16699,18207,19457,1996,Guyana,Grenada,1,2,FIFA World Cup qualification,Georgetown,Guyana,False,3,-1,Grenada
16700,18208,19458,1996,Sint Maarten,Anguilla,4,0,CFU Caribbean Cup qualification,Basseterre,Saint Kitts and Nevis,True,4,4,Sint Maarten
16701,18209,19459,1996,Antigua and Barbuda,Dominica,1,3,FIFA World Cup qualification,St. John's,Antigua and Barbuda,False,4,-2,Dominica
16702,18210,19460,1996,Aruba,Dominican Republic,1,3,FIFA World Cup qualification,Oranjestad,Aruba,False,4,-2,Dominican Republic
16703,18211,19461,1996,Saint Kitts and Nevis,Sint Maarten,3,0,CFU Caribbean Cup qualification,Basseterre,Saint Kitts and Nevis,False,3,3,Saint Kitts and Nevis
16704,18212,19462,1996,Suriname,Jamaica,0,1,FIFA World Cup qualification,Paramaribo,Suriname,False,1,-1,Jamaica
16705,18213,19463,1996,Congo,DR Congo,2,1,Friendly,Brazzaville,Congo,False,3,1,Congo
16706,18214,19464,1996,Grenada,Guyana,6,0,FIFA World Cup qualification,St. George's,Grenada,False,6,6,Grenada
16707,18215,19465,1996,Azerbaijan,Turkey,0,1,Friendly,Baku,Azerbaijan,False,1,-1,Turkey
16708,18216,19466,1996,Moldova,Ukraine,2,2,Friendly,Chişinău,Moldova,False,4,0,Draw
16709,18217,19467,1996,Croatia,Hungary,4,1,Friendly,Osijek,Croatia,False,5,3,Croatia
16710,18218,19468,1996,Suriname,French Guiana,1,1,CFU Caribbean Cup qualification,Paramaribo,Suriname,False,2,0,Draw
16711,18219,19469,1996,Ethiopia,Ghana,2,0,Friendly,Addis Abeba,Ethiopia,False,2,2,Ethiopia
16712,18220,19470,1996,Gambia,Senegal,1,2,Friendly,Banjul,Gambia,False,3,-1,Senegal
16713,18221,19471,1996,Jamaica,Suriname,1,0,FIFA World Cup qualification,Kingston,Jamaica,False,1,1,Jamaica
16714,18222,19472,1996,Paraguay,Bosnia and Herzegovina,3,0,Friendly,Asunción,Paraguay,False,3,3,Paraguay
16715,18223,19473,1996,Qatar,Kuwait,3,1,Friendly,Doha,Qatar,False,4,2,Qatar
16716,18224,19474,1996,Saint Lucia,Dominica,1,1,CFU Caribbean Cup qualification,Castries,Saint Lucia,False,2,0,Draw
16717,18225,19475,1996,Argentina,Bolivia,3,1,FIFA World Cup qualification,Buenos Aires,Argentina,False,4,2,Argentina
16718,18226,19476,1996,Belgium,Russia,0,0,Friendly,Brussels,Belgium,False,0,0,Draw
16719,18227,19477,1996,Bosnia and Herzegovina,Albania,0,0,Friendly,Zenica,Bosnia and Herzegovina,False,0,0,Draw
16720,18228,19478,1996,Colombia,Paraguay,1,0,FIFA World Cup qualification,Barranquilla,Colombia,False,1,1,Colombia
16721,18229,19479,1996,Czech Republic,Republic of Ireland,2,0,Friendly,Prague,Czech Republic,False,2,2,Czech Republic
16722,18230,19480,1996,Denmark,Scotland,2,0,Friendly,Copenhagen,Denmark,False,2,2,Denmark
16723,18231,19481,1996,Ecuador,Peru,4,1,FIFA World Cup qualification,Guayaquil,Ecuador,False,5,3,Ecuador
16724,18232,19482,1996,England,Croatia,0,0,Friendly,London,England,False,0,0,Draw
16725,18233,19483,1996,Estonia,Iceland,0,3,Friendly,Tallinn,Estonia,False,3,-3,Iceland
16726,18234,19484,1996,Greece,Slovenia,2,0,FIFA World Cup qualification,Athens,Greece,False,2,2,Greece
16727,18235,19485,1996,Hungary,Austria,0,2,Friendly,Budapest,Hungary,False,2,-2,Austria
16728,18236,19486,1996,Jamaica,Barbados,2,0,CFU Caribbean Cup qualification,Kingston,Jamaica,False,2,2,Jamaica
16729,18237,19488,1996,Martinique,Saint Lucia,1,0,CFU Caribbean Cup qualification,Fort-de-France,Martinique,False,1,1,Martinique
16730,18238,19489,1996,Netherlands,Germany,0,1,Friendly,Rotterdam,Netherlands,False,1,-1,Germany
16731,18239,19490,1996,Northern Ireland,Sweden,1,2,Friendly,Belfast,Northern Ireland,False,3,-1,Sweden
16732,18240,19491,1996,Norway,Spain,0,0,Friendly,Oslo,Norway,False,0,0,Draw
16733,18241,19492,1996,Romania,Georgia,5,0,Friendly,Bucharest,Romania,False,5,5,Romania
16734,18242,19493,1996,Serbia,Faroe Islands,3,1,FIFA World Cup qualification,Belgrade,Yugoslavia,True,4,2,Serbia
16735,18243,19494,1996,Slovakia,Bulgaria,0,0,Friendly,Trnava,Slovakia,False,0,0,Draw
16736,18244,19495,1996,South Africa,Brazil,2,3,Friendly,Johannesburg,South Africa,False,5,-1,Brazil
16737,18245,19496,1996,Switzerland,Wales,2,0,Friendly,Lugano,Switzerland,False,2,2,Switzerland
16738,18246,19497,1996,Venezuela,Uruguay,0,2,FIFA World Cup qualification,Caracas,Venezuela,False,2,-2,Uruguay
16739,18247,19498,1996,Cayman Islands,Cuba,0,4,CFU Caribbean Cup qualification,George Town,Cayman Islands,False,4,-4,Cuba
16740,18248,19499,1996,Haiti,Dominican Republic,6,0,CFU Caribbean Cup qualification,Port-au-Prince,Haiti,False,6,6,Haiti
16741,18249,19500,1996,Turkmenistan,Iran,1,1,Friendly,Ashgabat,Turkmenistan,False,2,0,Draw
16742,18250,19501,1996,Barbados,Jamaica,2,0,CFU Caribbean Cup qualification,Bridgetown,Barbados,False,2,2,Barbados
16743,18251,19502,1996,DR Congo,Congo,3,1,Friendly,Kinshasa,Zaïre,False,4,2,DR Congo
16744,18252,19503,1996,Haiti,Dominican Republic,1,1,CFU Caribbean Cup qualification,Port-au-Prince,Haiti,False,2,0,Draw
16745,18253,19504,1996,Saint Lucia,Martinique,0,1,CFU Caribbean Cup qualification,Castries,Saint Lucia,False,1,-1,Martinique
16746,18254,19505,1996,Suriname,Guyana,2,1,CFU Caribbean Cup qualification,Paramaribo,Suriname,False,3,1,Suriname
16747,18255,19506,1996,Turkmenistan,Iran,0,1,Friendly,Ashgabat,Turkmenistan,False,1,-1,Iran
16748,18257,19508,1996,Poland,Belarus,1,1,Friendly,Mielec,Poland,False,2,0,Draw
16749,18258,19509,1996,Turkey,Ukraine,3,2,Friendly,Samsun,Turkey,False,5,1,Turkey
16750,18259,19510,1996,Dominican Republic,Curaçao,2,1,FIFA World Cup qualification,Santo Domingo,Dominican Republic,False,3,1,Dominican Republic
16751,18260,19511,1996,El Salvador,Bolivia,1,1,Friendly,Washington,United States,True,2,0,Draw
16752,18261,19512,1996,Guyana,Suriname,2,1,CFU Caribbean Cup qualification,Georgetown,Guyana,False,3,1,Guyana
16753,18262,19513,1996,Nicaragua,Guatemala,0,1,FIFA World Cup qualification,Diriamba,Nicaragua,False,1,-1,Guatemala
16754,18263,19514,1996,Saint Kitts and Nevis,Saint Lucia,5,1,FIFA World Cup qualification,Basseterre,Saint Kitts and Nevis,False,6,4,Saint Kitts and Nevis
16755,18264,19515,1996,Jersey,Guernsey,0,0,Friendly,St. Helier,Jersey,False,0,0,Draw
16756,18265,19516,1996,Greece,Georgia,2,1,Friendly,Ioannina,Greece,False,3,1,Greece
16757,18266,19517,1996,Tajikistan,Uzbekistan,4,0,AFC Asian Cup qualification,Dushanbe,Tajikistan,False,4,4,Tajikistan
16758,18267,19518,1996,Sweden,Slovakia,2,1,Friendly,Helsingborg,Sweden,False,3,1,Sweden
16759,18268,19519,1996,Guatemala,Nicaragua,2,1,FIFA World Cup qualification,Guatemala,Guatemala,False,3,1,Guatemala
16760,18269,19520,1996,Curaçao,Dominican Republic,0,0,FIFA World Cup qualification,Willemstad,Netherlands Antilles,True,0,0,Draw
16761,18270,19521,1996,Malawi,Zambia,0,1,Friendly,Blantyre,Malawi,False,1,-1,Zambia
16762,18271,19523,1996,Burkina Faso,Niger,0,0,Friendly,Ouagadougou,Burkina Faso,False,0,0,Draw
16763,18272,19524,1996,Cayman Islands,Cuba,0,1,FIFA World Cup qualification,George Town,Cayman Islands,False,1,-1,Cuba
16764,18273,19525,1996,Haiti,Grenada,6,1,FIFA World Cup qualification,Port-au-Prince,Haiti,False,7,5,Haiti
16765,18274,19526,1996,Lebanon,Turkmenistan,3,1,AFC Asian Cup qualification,Beirut,Lebanon,False,4,2,Lebanon
16766,18275,19527,1996,Malawi,Zambia,1,1,Friendly,Blantyre,Malawi,False,2,0,Draw
16767,18276,19528,1996,Eswatini,Mozambique,0,1,Friendly,Mbabane,Eswatini,False,1,-1,Mozambique
16768,18277,19529,1996,Cayman Islands,Cuba,0,5,FIFA World Cup qualification,George Town,Cayman Islands,False,5,-5,Cuba
16769,18278,19530,1996,Dominica,Barbados,0,1,FIFA World Cup qualification,Roseau,Dominica,False,1,-1,Barbados
16770,18279,19532,1996,Iran,Qatar,2,0,Friendly,Tabriz,Iran,False,2,2,Iran
16771,18280,19533,1996,Mauritania,Senegal,0,0,Friendly,Nouakchott,Mauritania,False,0,0,Draw
16772,18281,19534,1996,England,Hungary,3,0,Friendly,London,England,False,3,3,England
16773,18282,19535,1996,Grenada,Haiti,0,1,FIFA World Cup qualification,St. George's,Grenada,False,1,-1,Haiti
16774,18283,19536,1996,Mexico,Slovakia,5,2,Friendly,Chicago,United States,True,7,3,Mexico
16775,18284,19537,1996,Barbados,Dominica,1,0,FIFA World Cup qualification,Bridgetown,Barbados,False,1,1,Barbados
16776,18285,19538,1996,Gambia,Guinea,1,1,Friendly,Banjul,Gambia,False,2,0,Draw
16777,18286,19539,1996,Guernsey,Jersey,0,1,Friendly,St. Sampson,Guernsey,False,1,-1,Jersey
16778,18287,19540,1996,Saint Lucia,Saint Kitts and Nevis,0,1,FIFA World Cup qualification,Castries,Saint Lucia,False,1,-1,Saint Kitts and Nevis
16779,18288,19541,1996,Zambia,Tanzania,1,0,Friendly,Lusaka,Zambia,False,1,1,Zambia
16780,18289,19542,1996,Slovenia,United Arab Emirates,2,2,Friendly,Ljubljana,Slovenia,False,4,0,Draw
16781,18290,19543,1996,Zambia,Tanzania,0,0,Friendly,Kitwe,Zambia,False,0,0,Draw
16782,18291,19545,1996,Kuwait,Syria,3,1,Friendly,Kuwait City,Kuwait,False,4,2,Kuwait
16783,18292,19546,1996,Mexico,Serbia,0,0,Kirin Cup,Shizuoka,Japan,True,0,0,Draw
16784,18293,19547,1996,Trinidad and Tobago,Jamaica,1,0,CFU Caribbean Cup,Port of Spain,Trinidad and Tobago,False,1,1,Trinidad and Tobago
16785,18294,19548,1996,Cuba,Saint Vincent and the Grenadines,2,0,CFU Caribbean Cup,San Fernando,Trinidad and Tobago,True,2,2,Cuba
16786,18295,19549,1996,Martinique,Haiti,1,0,CFU Caribbean Cup,San Fernando,Trinidad and Tobago,True,1,1,Martinique
16787,18296,19550,1996,Mauritius,Madagascar,0,0,Friendly,Rose Hill,Mauritius,False,0,0,Draw
16788,18297,19551,1996,Qatar,Russia,2,5,Friendly,Doha,Qatar,False,7,-3,Russia
16789,18298,19552,1996,Uganda,Kenya,1,1,Friendly,Kampala,Uganda,False,2,0,Draw
16790,18299,19553,1996,Chile,Bolivia,2,0,Friendly,Santiago,Chile,False,2,2,Chile
16791,18300,19554,1996,Gabon,Ivory Coast,0,1,Friendly,Libreville,Gabon,False,1,-1,Ivory Coast
16792,18301,19555,1996,Ghana,Egypt,0,2,Friendly,Accra,Ghana,False,2,-2,Egypt
16793,18302,19556,1996,Jamaica,Saint Kitts and Nevis,4,1,CFU Caribbean Cup,Palo Seco,Trinidad and Tobago,True,5,3,Jamaica
16794,18303,19557,1996,Japan,Serbia,1,0,Kirin Cup,Tokyo,Japan,False,1,1,Japan
16795,18304,19558,1996,Malawi,Mozambique,1,0,Friendly,Blantyre,Malawi,False,1,1,Malawi
16796,18305,19559,1996,Trinidad and Tobago,Suriname,3,0,CFU Caribbean Cup,Palo Seco,Trinidad and Tobago,False,3,3,Trinidad and Tobago
16797,18306,19560,1996,Tunisia,Senegal,2,0,Friendly,Tunis,Tunisia,False,2,2,Tunisia
16798,18307,19561,1996,Turkmenistan,Lebanon,0,1,AFC Asian Cup qualification,Ashgabat,Turkmenistan,False,1,-1,Lebanon
16799,18308,19562,1996,Uganda,Kenya,1,2,Friendly,Kampala,Uganda,False,3,-1,Kenya
16800,18309,19563,1996,United States,Scotland,2,1,Friendly,New Britain,United States,False,3,1,United States
16801,18310,19564,1996,Belarus,Azerbaijan,2,2,Friendly,Maladzečna,Belarus,False,4,0,Draw
16802,18311,19565,1996,Cuba,Martinique,1,0,CFU Caribbean Cup,Port of Spain,Trinidad and Tobago,True,1,1,Cuba
16803,18313,19567,1996,Suriname,Jamaica,3,1,CFU Caribbean Cup,Port of Spain,Trinidad and Tobago,True,4,2,Suriname
16804,18314,19568,1996,Trinidad and Tobago,Saint Kitts and Nevis,5,1,CFU Caribbean Cup,Port of Spain,Trinidad and Tobago,False,6,4,Trinidad and Tobago
16805,18315,19569,1996,Austria,Czech Republic,1,0,Friendly,Salzburg,Austria,False,1,1,Austria
16806,18316,19570,1996,Colombia,Scotland,1,0,Friendly,Miami,United States,True,1,1,Colombia
16807,18317,19571,1996,Cuba,Haiti,0,0,CFU Caribbean Cup,Arima,Trinidad and Tobago,True,0,0,Draw
16808,18318,19572,1996,Estonia,Turkey,0,0,Friendly,Tallinn,Estonia,False,0,0,Draw
16809,18319,19573,1996,France,Finland,2,0,Friendly,Strasbourg,France,False,2,2,France
16810,18320,19574,1996,Republic of Ireland,Portugal,0,1,Friendly,Dublin,Republic of Ireland,False,1,-1,Portugal
16811,18321,19575,1996,Italy,Belgium,2,2,Friendly,Cremona,Italy,False,4,0,Draw
16812,18322,19576,1996,Japan,Mexico,3,2,Kirin Cup,Fukuoka,Japan,False,5,1,Japan
16813,18324,19578,1996,Northern Ireland,Germany,1,1,Friendly,Belfast,Northern Ireland,False,2,0,Draw
16814,18325,19579,1996,Russia,United Arab Emirates,1,0,Friendly,Moscow,Russia,False,1,1,Russia
16815,18326,19580,1996,Saint Kitts and Nevis,Suriname,1,1,CFU Caribbean Cup,Port of Spain,Trinidad and Tobago,True,2,0,Draw
16816,18327,19581,1996,Mauritania,Burkina Faso,0,0,FIFA World Cup qualification,Nouakchott,Mauritania,False,0,0,Draw
16817,18328,19582,1996,Gambia,Liberia,2,1,FIFA World Cup qualification,Banjul,Gambia,False,3,1,Gambia
16818,18329,19583,1996,Germany,France,0,1,Friendly,Stuttgart,Germany,False,1,-1,France
16819,18330,19584,1996,Guinea-Bissau,Guinea,3,2,FIFA World Cup qualification,Bissau,Guinea-Bissau,False,5,1,Guinea-Bissau
16820,18331,19585,1996,Hungary,Italy,0,2,Friendly,Budapest,Hungary,False,2,-2,Italy
16821,18333,19587,1996,Malawi,South Africa,0,1,FIFA World Cup qualification,Blantyre,Malawi,False,1,-1,South Africa
16822,18334,19588,1996,Namibia,Mozambique,2,0,FIFA World Cup qualification,Windhoek,Namibia,False,2,2,Namibia
16823,18335,19589,1996,Qatar,Iran,0,1,Friendly,Doha,Qatar,False,1,-1,Iran
16824,18336,19590,1996,Romania,Moldova,3,1,Friendly,Bucharest,Romania,False,4,2,Romania
16825,18337,19591,1996,Sudan,Zambia,2,0,FIFA World Cup qualification,Khartoum,Sudan,False,2,2,Sudan
16826,18338,19592,1996,Sweden,Belarus,5,1,FIFA World Cup qualification,Solna,Sweden,False,6,4,Sweden
16827,18339,19593,1996,Switzerland,Czech Republic,1,2,Friendly,Basel,Switzerland,False,3,-1,Czech Republic
16828,18340,19594,1996,Uganda,Angola,0,2,FIFA World Cup qualification,Kampala,Uganda,False,2,-2,Angola
16829,18341,19595,1996,Belize,Panama,1,2,FIFA World Cup qualification,Belize City,Belize,False,3,-1,Panama
16830,18342,19596,1996,Bulgaria,United Arab Emirates,4,1,Friendly,Sofia,Bulgaria,False,5,3,Bulgaria
16831,18343,19597,1996,Burundi,Sierra Leone,1,0,FIFA World Cup qualification,Bujumbura,Burundi,False,1,1,Burundi
16832,18344,19598,1996,Congo,Ivory Coast,2,0,FIFA World Cup qualification,Brazzaville,Congo,False,2,2,Congo
16833,18345,19599,1996,Denmark,Ghana,1,0,Friendly,Copenhagen,Denmark,False,1,1,Denmark
16834,18346,19600,1996,Ecuador,Argentina,2,0,FIFA World Cup qualification,Quito,Ecuador,False,2,2,Ecuador
16835,18347,19601,1996,Finland,Turkey,1,2,Friendly,Helsinki,Finland,False,3,-1,Turkey
16836,18348,19602,1996,Republic of Ireland,Croatia,2,2,Friendly,Dublin,Republic of Ireland,False,4,0,Draw
16837,18349,19603,1996,Kenya,Algeria,3,1,FIFA World Cup qualification,Nairobi,Kenya,False,4,2,Kenya
16838,18350,19604,1996,Madagascar,Zimbabwe,1,2,FIFA World Cup qualification,Antananarivo,Madagascar,False,3,-1,Zimbabwe
16839,18351,19605,1996,Mauritius,DR Congo,1,5,FIFA World Cup qualification,Curepipe,Mauritius,False,6,-4,DR Congo
16840,18352,19606,1996,Norway,Azerbaijan,5,0,FIFA World Cup qualification,Oslo,Norway,False,5,5,Norway
16841,18353,19607,1996,Peru,Colombia,1,1,FIFA World Cup qualification,Lima,Peru,False,2,0,Draw
16842,18354,19608,1996,Russia,Poland,2,0,Friendly,Moscow,Russia,False,2,2,Russia
16843,18355,19609,1996,Rwanda,Tunisia,1,3,FIFA World Cup qualification,Kigali,Rwanda,False,4,-2,Tunisia
16844,18356,19610,1996,San Marino,Wales,0,5,FIFA World Cup qualification,Serravalle,San Marino,False,5,-5,Wales
16845,18357,19611,1996,Serbia,Malta,6,0,FIFA World Cup qualification,Belgrade,Yugoslavia,True,6,6,Serbia
16846,18358,19612,1996,Eswatini,Gabon,0,1,FIFA World Cup qualification,Mbabane,Eswatini,False,1,-1,Gabon
16847,18359,19613,1996,Togo,Senegal,2,1,FIFA World Cup qualification,Lomé,Togo,False,3,1,Togo
16848,18360,19614,1996,Trinidad and Tobago,Martinique,2,1,CFU Caribbean Cup,Port of Spain,Trinidad and Tobago,False,3,1,Trinidad and Tobago
16849,18361,19615,1996,Uruguay,Paraguay,0,2,FIFA World Cup qualification,Montevideo,Uruguay,False,2,-2,Paraguay
16850,18362,19616,1996,Venezuela,Chile,1,1,FIFA World Cup qualification,Barinas,Venezuela,False,2,0,Draw
16851,18363,19617,1996,Cuba,Suriname,4,0,CFU Caribbean Cup,Port of Spain,Trinidad and Tobago,True,4,4,Cuba
16852,18364,19618,1996,Oman,Bahrain,3,0,Friendly,Muscat,Oman,False,3,3,Oman
16853,18365,19619,1996,Germany,Liechtenstein,9,1,Friendly,Mannheim,Germany,False,10,8,Germany
16854,18366,19620,1996,Netherlands,Republic of Ireland,3,1,Friendly,Rotterdam,Netherlands,False,4,2,Netherlands
16855,18367,19621,1996,Canada,Costa Rica,0,1,Friendly,Toronto,Canada,False,1,-1,Costa Rica
16856,18368,19622,1996,France,Armenia,2,0,Friendly,Villeneuve-d'Ascq,France,False,2,2,France
16857,18369,19623,1996,Iceland,Cyprus,2,1,Friendly,Akranes,Iceland,False,3,1,Iceland
16858,18370,19624,1996,Martinique,Suriname,1,1,CFU Caribbean Cup,Port of Spain,Trinidad and Tobago,True,2,0,Draw
16859,18371,19625,1996,Trinidad and Tobago,Cuba,2,0,CFU Caribbean Cup,Port of Spain,Trinidad and Tobago,False,2,2,Trinidad and Tobago
16860,18372,19626,1996,England,Switzerland,1,1,UEFA Euro,London,England,False,2,0,Draw
16861,18373,19627,1996,Mexico,Bolivia,1,0,USA Cup,Dallas,United States,True,1,1,Mexico
16862,18374,19628,1996,Tanzania,Ghana,0,0,FIFA World Cup qualification,Dar es Salaam,Tanzania,False,0,0,Draw
16863,18375,19629,1996,Denmark,Portugal,1,1,UEFA Euro,Sheffield,England,True,2,0,Draw
16864,18376,19630,1996,Germany,Czech Republic,2,0,UEFA Euro,Manchester,England,True,2,2,Germany
16865,18377,19631,1996,Ivory Coast,Burkina Faso,1,1,Friendly,Abidjan,Ivory Coast,False,2,0,Draw
16866,18378,19632,1996,Lebanon,Kuwait,3,5,AFC Asian Cup qualification,Beirut,Lebanon,False,8,-2,Kuwait
16867,18379,19633,1996,Nigeria,Togo,1,3,Friendly,Lagos,Nigeria,False,4,-2,Togo
16868,18380,19634,1996,Panama,Belize,4,1,FIFA World Cup qualification,Panama City,Panama,False,5,3,Panama
16869,18381,19635,1996,Spain,Bulgaria,1,1,UEFA Euro,Leeds,England,True,2,0,Draw
16870,18382,19636,1996,United States,Republic of Ireland,2,1,USA Cup,Foxborough,United States,False,3,1,United States
16871,18383,19637,1996,Cuba,Haiti,6,1,FIFA World Cup qualification,Port of Spain,Trinidad and Tobago,True,7,5,Cuba
16872,18384,19638,1996,Iran,Nepal,8,0,AFC Asian Cup qualification,Teheran,Iran,False,8,8,Iran
16873,18385,19639,1996,Netherlands,Scotland,0,0,UEFA Euro,Birmingham,England,True,0,0,Draw
16874,18386,19640,1996,Romania,France,0,1,UEFA Euro,Newcastle,England,True,1,-1,France
16875,18387,19641,1996,Sri Lanka,Oman,0,3,AFC Asian Cup qualification,Teheran,Iran,True,3,-3,Oman
16876,18388,19642,1996,Italy,Russia,2,1,UEFA Euro,Liverpool,England,True,3,1,Italy
16877,18389,19643,1996,Turkey,Croatia,0,1,UEFA Euro,Nottingham,England,True,1,-1,Croatia
16878,18390,19644,1996,Iran,Sri Lanka,7,0,AFC Asian Cup qualification,Teheran,Iran,False,7,7,Iran
16879,18391,19645,1996,Mexico,Republic of Ireland,2,2,USA Cup,East Rutherford,United States,True,4,0,Draw
16880,18392,19646,1996,Nepal,Oman,0,7,AFC Asian Cup qualification,Teheran,Iran,True,7,-7,Oman
16881,18393,19647,1996,Tanzania,Sudan,0,0,Friendly,Dar es Salaam,Tanzania,False,0,0,Draw
16882,18394,19648,1996,United States,Bolivia,0,2,USA Cup,Washington,United States,False,2,-2,Bolivia
16883,18395,19649,1996,Barbados,Trinidad and Tobago,0,4,Friendly,Bridgetown,Barbados,False,4,-4,Trinidad and Tobago
16884,18396,19650,1996,Bulgaria,Romania,1,0,UEFA Euro,Newcastle,England,True,1,1,Bulgaria
16885,18397,19651,1996,Switzerland,Netherlands,0,2,UEFA Euro,Birmingham,England,True,2,-2,Netherlands
16886,18398,19652,1996,Algeria,Kenya,1,0,FIFA World Cup qualification,Algiers,Algeria,False,1,1,Algeria
16887,18399,19653,1996,Czech Republic,Italy,2,1,UEFA Euro,Liverpool,England,True,3,1,Czech Republic
16888,18400,19654,1996,Iran,Oman,2,0,AFC Asian Cup qualification,Teheran,Iran,False,2,2,Iran
16889,18401,19655,1996,Kazakhstan,Qatar,1,0,AFC Asian Cup qualification,Almaty,Kazakhstan,False,1,1,Kazakhstan
16890,18402,19656,1996,Portugal,Turkey,1,0,UEFA Euro,Nottingham,England,True,1,1,Portugal
16891,18403,19657,1996,Sri Lanka,Nepal,3,1,AFC Asian Cup qualification,Teheran,Iran,True,4,2,Sri Lanka
16892,18404,19658,1996,Bolivia,Republic of Ireland,0,3,USA Cup,East Rutherford,United States,True,3,-3,Republic of Ireland
16893,18405,19659,1996,Dominican Republic,Trinidad and Tobago,1,4,FIFA World Cup qualification,Santo Domingo,Dominican Republic,False,5,-3,Trinidad and Tobago
16894,18406,19660,1996,England,Scotland,2,0,UEFA Euro,London,England,False,2,2,England
16895,18407,19661,1996,France,Spain,1,1,UEFA Euro,Leeds,England,True,2,0,Draw
16896,18408,19662,1996,Senegal,Togo,1,1,FIFA World Cup qualification,Dakar,Senegal,False,2,0,Draw
16897,18409,19663,1996,South Africa,Malawi,3,0,FIFA World Cup qualification,Johannesburg,South Africa,False,3,3,South Africa
16898,18410,19664,1996,Angola,Uganda,3,1,FIFA World Cup qualification,Luanda,Angola,False,4,2,Angola
16899,18411,19665,1996,Burkina Faso,Mauritania,2,0,FIFA World Cup qualification,Ouagadougou,Burkina Faso,False,2,2,Burkina Faso
16900,18412,19666,1996,DR Congo,Mauritius,2,0,FIFA World Cup qualification,Kinshasa,Zaïre,False,2,2,DR Congo
16901,18413,19667,1996,Croatia,Denmark,3,0,UEFA Euro,Sheffield,England,True,3,3,Croatia
16902,18414,19668,1996,Gabon,Eswatini,2,0,FIFA World Cup qualification,Libreville,Gabon,False,2,2,Gabon
16903,18415,19669,1996,Guinea,Guinea-Bissau,3,1,FIFA World Cup qualification,Conakry,Guinea,False,4,2,Guinea
16904,18416,19670,1996,Ivory Coast,Congo,1,1,FIFA World Cup qualification,Abidjan,Ivory Coast,False,2,0,Draw
16905,18417,19671,1996,Mozambique,Namibia,1,1,FIFA World Cup qualification,Maputo,Mozambique,False,2,0,Draw
16906,18418,19672,1996,Russia,Germany,0,3,UEFA Euro,Manchester,England,True,3,-3,Germany
16907,18419,19673,1996,Sierra Leone,Burundi,0,1,FIFA World Cup qualification,Freetown,Sierra Leone,False,1,-1,Burundi
16908,18420,19674,1996,Tunisia,Rwanda,2,0,FIFA World Cup qualification,Tunis,Tunisia,False,2,2,Tunisia
16909,18421,19675,1996,United States,Mexico,2,2,USA Cup,Pasadena,United States,False,4,0,Draw
16910,18422,19676,1996,Zambia,Sudan,3,0,FIFA World Cup qualification,Lusaka,Zambia,False,3,3,Zambia
16911,18423,19677,1996,Zimbabwe,Madagascar,2,2,FIFA World Cup qualification,Harare,Zimbabwe,False,4,0,Draw
16912,18424,19678,1996,Ghana,Tanzania,2,1,FIFA World Cup qualification,Kumasi,Ghana,False,3,1,Ghana
16913,18425,19679,1996,Oman,Nepal,2,1,AFC Asian Cup qualification,Muscat,Oman,False,3,1,Oman
16914,18426,19680,1996,Sri Lanka,Iran,0,4,AFC Asian Cup qualification,Muscat,Oman,True,4,-4,Iran
16915,18427,19681,1996,England,Netherlands,4,1,UEFA Euro,London,England,False,5,3,England
16916,18428,19682,1996,France,Bulgaria,3,1,UEFA Euro,Newcastle,England,True,4,2,France
16917,18429,19683,1996,Romania,Spain,1,2,UEFA Euro,Leeds,England,True,3,-1,Spain
16918,18430,19684,1996,Scotland,Switzerland,1,0,UEFA Euro,Birmingham,England,True,1,1,Scotland
16919,18431,19685,1996,Croatia,Portugal,0,3,UEFA Euro,Nottingham,England,True,3,-3,Portugal
16920,18432,19686,1996,Italy,Germany,0,0,UEFA Euro,Manchester,England,True,0,0,Draw
16921,18433,19687,1996,Nepal,Iran,0,4,AFC Asian Cup qualification,Muscat,Oman,True,4,-4,Iran
16922,18434,19688,1996,Oman,Sri Lanka,10,0,AFC Asian Cup qualification,Muscat,Oman,False,10,10,Oman
16923,18435,19689,1996,Russia,Czech Republic,3,3,UEFA Euro,Liverpool,England,True,6,0,Draw
16924,18436,19690,1996,Turkey,Denmark,0,3,UEFA Euro,Sheffield,England,True,3,-3,Denmark
16925,18437,19691,1996,Uzbekistan,Tajikistan,5,0,AFC Asian Cup qualification,Tashkent,Uzbekistan,False,5,5,Uzbekistan
16926,18438,19692,1996,Kuwait,Lebanon,0,0,AFC Asian Cup qualification,Kuwait City,Kuwait,False,0,0,Draw
16927,18439,19693,1996,Peru,Armenia,4,0,Friendly,Lima,Peru,False,4,4,Peru
16928,18440,19694,1996,Nepal,Sri Lanka,0,2,AFC Asian Cup qualification,Muscat,Oman,True,2,-2,Sri Lanka
16929,18441,19695,1996,Oman,Iran,1,2,AFC Asian Cup qualification,Muscat,Oman,False,3,-1,Iran
16930,18442,19696,1996,Syria,Kazakhstan,2,0,AFC Asian Cup qualification,Damascus,Syria,False,2,2,Syria
16931,18443,19697,1996,England,Spain,0,0,UEFA Euro,London,England,False,0,0,Draw
16932,18444,19698,1996,France,Netherlands,0,0,UEFA Euro,Liverpool,England,True,0,0,Draw
16933,18445,19699,1996,Honduras,Venezuela,1,0,Friendly,San Pedro Sula,Honduras,False,1,1,Honduras
16934,18446,19700,1996,Barbados,Jamaica,0,1,FIFA World Cup qualification,Bridgetown,Barbados,False,1,-1,Jamaica
16935,18447,19701,1996,Czech Republic,Portugal,1,0,UEFA Euro,Birmingham,England,True,1,1,Czech Republic
16936,18448,19702,1996,Germany,Croatia,2,1,UEFA Euro,Manchester,England,True,3,1,Germany
16937,18449,19703,1996,Liberia,Gambia,4,0,FIFA World Cup qualification,Accra,Ghana,True,4,4,Liberia
16938,18450,19704,1996,Saint Kitts and Nevis,Saint Vincent and the Grenadines,2,2,FIFA World Cup qualification,Basseterre,Saint Kitts and Nevis,False,4,0,Draw
16939,18451,19705,1996,Trinidad and Tobago,Dominican Republic,8,0,FIFA World Cup qualification,Port of Spain,Trinidad and Tobago,False,8,8,Trinidad and Tobago
16940,18452,19706,1996,Paraguay,Armenia,1,2,Friendly,Asunción,Paraguay,False,3,-1,Armenia
16941,18453,19707,1996,England,Germany,1,1,UEFA Euro,London,England,False,2,0,Draw
16942,18454,19708,1996,France,Czech Republic,0,0,UEFA Euro,Manchester,England,True,0,0,Draw
16943,18455,19709,1996,Burma,Singapore,0,4,AFC Asian Cup qualification,Bangkok,Thailand,True,4,-4,Singapore
16944,18456,19710,1996,Thailand,Maldives,8,0,AFC Asian Cup qualification,Bangkok,Thailand,False,8,8,Thailand
16945,18457,19712,1996,Qatar,Syria,1,0,AFC Asian Cup qualification,Doha,Qatar,False,1,1,Qatar
16946,18458,19713,1996,Maldives,Singapore,0,2,AFC Asian Cup qualification,Bangkok,Thailand,True,2,-2,Singapore
16947,18459,19714,1996,Thailand,Burma,5,1,AFC Asian Cup qualification,Bangkok,Thailand,False,6,4,Thailand
16948,18460,19715,1996,Czech Republic,Germany,1,2,UEFA Euro,London,England,True,3,-1,Germany
16949,18461,19716,1996,Ecuador,Armenia,3,0,Friendly,Portoviejo,Ecuador,False,3,3,Ecuador
16950,18462,19717,1996,Haiti,Cuba,1,1,FIFA World Cup qualification,Cap-Haïtien,Haiti,False,2,0,Draw
16951,18463,19718,1996,Jamaica,Barbados,2,0,FIFA World Cup qualification,Kingston,Jamaica,False,2,2,Jamaica
16952,18464,19719,1996,Saint Vincent and the Grenadines,Saint Kitts and Nevis,0,0,FIFA World Cup qualification,Kingstown,Saint Vincent and the Grenadines,False,0,0,Draw
16953,18465,19720,1996,Burma,Maldives,3,1,AFC Asian Cup qualification,Bangkok,Thailand,True,4,2,Burma
16954,18466,19721,1996,Thailand,Singapore,1,1,AFC Asian Cup qualification,Bangkok,Thailand,False,2,0,Draw
16955,18467,19722,1996,Maldives,Thailand,0,8,AFC Asian Cup qualification,Singapore,Singapore,True,8,-8,Thailand
16956,18468,19723,1996,Singapore,Burma,2,2,AFC Asian Cup qualification,Singapore,Singapore,False,4,0,Draw
16957,18469,19724,1996,Qatar,Kazakhstan,3,0,AFC Asian Cup qualification,Doha,Qatar,False,3,3,Qatar
16958,18470,19725,1996,Chile,Ecuador,4,1,FIFA World Cup qualification,Santiago,Chile,False,5,3,Chile
16959,18471,19726,1996,Malawi,Tanzania,3,2,Friendly,Blantyre,Malawi,False,5,1,Malawi
16960,18472,19727,1996,Bolivia,Venezuela,6,1,FIFA World Cup qualification,La Paz,Bolivia,False,7,5,Bolivia
16961,18473,19728,1996,Burma,Thailand,1,7,AFC Asian Cup qualification,Singapore,Singapore,True,8,-6,Thailand
16962,18474,19729,1996,Colombia,Uruguay,3,1,FIFA World Cup qualification,Barranquilla,Colombia,False,4,2,Colombia
16963,18475,19730,1996,Estonia,Latvia,1,1,Baltic Cup,Narva,Estonia,False,2,0,Draw
16964,18476,19731,1996,Peru,Argentina,0,0,FIFA World Cup qualification,Lima,Peru,False,0,0,Draw
16965,18477,19732,1996,Singapore,Maldives,5,2,AFC Asian Cup qualification,Singapore,Singapore,False,7,3,Singapore
16966,18478,19733,1996,Latvia,Lithuania,1,2,Baltic Cup,Narva,Estonia,True,3,-1,Lithuania
16967,18479,19734,1996,Malawi,Tanzania,1,0,Friendly,Lilongwe,Malawi,False,1,1,Malawi
16968,18480,19735,1996,Burma,Maldives,4,1,AFC Asian Cup qualification,Singapore,Singapore,True,5,3,Burma
16969,18481,19736,1996,Estonia,Lithuania,1,1,Baltic Cup,Narva,Estonia,False,2,0,Draw
16970,18482,19737,1996,Singapore,Thailand,2,2,AFC Asian Cup qualification,Singapore,Singapore,False,4,0,Draw
16971,18483,19738,1996,Malawi,Tanzania,1,1,Friendly,Mzuzu,Malawi,False,2,0,Draw
16972,18484,19739,1996,Kazakhstan,Syria,0,1,AFC Asian Cup qualification,Almaty,Kazakhstan,False,1,-1,Syria
16973,18485,19741,1996,Syria,Qatar,3,1,AFC Asian Cup qualification,Damascus,Syria,False,4,2,Syria
16974,18486,19742,1996,Panama,Venezuela,0,2,Friendly,Panama City,Panama,False,2,-2,Venezuela
16975,18487,19743,1996,Honduras,Panama,1,1,Friendly,Tegucigalpa,Honduras,False,2,0,Draw
16976,18488,19744,1996,Paraguay,Bolivia,2,0,Friendly,Asunción,Paraguay,False,2,2,Paraguay
16977,18489,19745,1996,Honduras,Trinidad and Tobago,0,0,Friendly,Tegucigalpa,Honduras,False,0,0,Draw
16978,18490,19746,1996,Jamaica,Panama,0,0,Friendly,Kingston,Jamaica,False,0,0,Draw
16979,18491,19747,1996,Panama,Trinidad and Tobago,1,0,Friendly,Panama City,Panama,False,1,1,Panama
16980,18492,19748,1996,Belarus,Lithuania,2,2,Friendly,Minsk,Belarus,False,4,0,Draw
16981,18493,19749,1996,Costa Rica,Honduras,1,1,Friendly,San José,Costa Rica,False,2,0,Draw
16982,18494,19750,1996,Guatemala,Panama,1,0,Friendly,Guatemala,Guatemala,False,1,1,Guatemala
16983,18496,19753,1996,Panama,Honduras,2,1,Friendly,Panama City,Panama,False,3,1,Panama
16984,18497,19754,1996,Vietnam,Guam,9,0,AFC Asian Cup qualification,Ho Chi Minh City,Vietnam,False,9,9,Vietnam
16985,18498,19755,1996,Benin,Mauritania,4,1,African Cup of Nations qualification,Cotonou,Benin,False,5,3,Benin
16986,18499,19758,1996,Jordan,Pakistan,4,0,AFC Asian Cup qualification,Amman,Jordan,False,4,4,Jordan
16987,18500,19759,1996,Botswana,Namibia,0,0,African Cup of Nations qualification,Gaborone,Botswana,False,0,0,Draw
16988,18501,19760,1996,Congo,Togo,0,0,African Cup of Nations qualification,Pointe-Noire,Congo,False,0,0,Draw
16989,18502,19761,1996,Honduras,Costa Rica,0,0,Friendly,Tegucigalpa,Honduras,False,0,0,Draw
16990,18503,19762,1996,Iraq,Pakistan,3,0,AFC Asian Cup qualification,Amman,Jordan,True,3,3,Iraq
16991,18504,19763,1996,Mauritius,Seychelles,1,0,African Cup of Nations qualification,Port Louis,Mauritius,False,1,1,Mauritius
16992,18505,19764,1996,Uganda,Ethiopia,1,1,African Cup of Nations qualification,Kampala,Uganda,False,2,0,Draw
16993,18507,19766,1996,Jordan,Iraq,0,1,AFC Asian Cup qualification,Amman,Jordan,False,1,-1,Iraq
16994,18508,19767,1996,Ukraine,Lithuania,5,2,Friendly,Kyïv,Ukraine,False,7,3,Ukraine
16995,18509,19768,1996,Greece,Albania,2,1,Friendly,Athens,Greece,False,3,1,Greece
16996,18510,19769,1996,Honduras,El Salvador,2,1,Friendly,San Pedro Sula,Honduras,False,3,1,Honduras
16997,18511,19770,1996,Hungary,United Arab Emirates,3,1,Friendly,Siófok,Hungary,False,4,2,Hungary
16998,18512,19771,1996,Iceland,Malta,2,1,Friendly,Reykjavík,Iceland,False,3,1,Iceland
16999,18513,19772,1996,Latvia,Finland,0,0,Friendly,Riga,Latvia,False,0,0,Draw
17000,18514,19773,1996,Panama,Guatemala,1,0,Friendly,Panama City,Panama,False,1,1,Panama
17001,18515,19774,1996,Peru,Costa Rica,3,0,Friendly,Arequipa,Peru,False,3,3,Peru
17002,18516,19775,1996,Romania,Israel,2,0,Friendly,Bucharest,Romania,False,2,2,Romania
17003,18517,19776,1996,Sweden,Denmark,0,1,Friendly,Gothenburg,Sweden,False,1,-1,Denmark
17004,18518,19777,1996,Turkey,Moldova,2,0,Friendly,Istanbul,Turkey,False,2,2,Turkey
17005,18519,19778,1996,Ecuador,Costa Rica,1,1,Friendly,Cuenca,Ecuador,False,2,0,Draw
17006,18520,19779,1996,Rwanda,Uganda,0,0,Friendly,Kigali,Rwanda,False,0,0,Draw
17007,18521,19780,1996,Guatemala,Honduras,1,1,Friendly,Monterey Park,United States,True,2,0,Draw
17008,18522,19781,1996,Belarus,United Arab Emirates,0,1,Friendly,Fürth,Germany,True,1,-1,United Arab Emirates
17009,18523,19782,1996,Oman,Mali,1,0,Friendly,Muscat,Oman,False,1,1,Oman
17010,18524,19783,1996,Togo,Benin,2,0,Friendly,Lomé,Togo,False,2,2,Togo
17011,18525,19784,1996,El Salvador,Honduras,1,2,Friendly,San Salvador,El Salvador,False,3,-1,Honduras
17012,18526,19785,1996,Oman,Mali,1,1,Friendly,Muscat,Oman,False,2,0,Draw
17013,18527,19786,1996,Panama,Jamaica,2,0,Friendly,Panama City,Panama,False,2,2,Panama
17014,18528,19787,1996,Seychelles,Mauritius,1,1,African Cup of Nations qualification,Victoria,Seychelles,False,2,0,Draw
17015,18529,19788,1996,Ethiopia,Uganda,1,1,African Cup of Nations qualification,Addis Abeba,Ethiopia,False,2,0,Draw
17016,18530,19789,1996,Honduras,Cuba,4,0,Friendly,Tegucigalpa,Honduras,False,4,4,Honduras
17017,18531,19790,1996,Japan,Uruguay,5,3,Friendly,Osaka,Japan,False,8,2,Japan
17018,18532,19791,1996,Namibia,Botswana,6,0,African Cup of Nations qualification,Windhoek,Namibia,False,6,6,Namibia
17019,18533,19792,1996,Togo,Congo,1,0,African Cup of Nations qualification,Lomé,Togo,False,1,1,Togo
17020,18534,19793,1996,Guatemala,Jamaica,2,1,Friendly,Guatemala,Guatemala,False,3,1,Guatemala
17021,18535,19794,1996,Poland,Cyprus,2,2,Friendly,Bełchatów,Poland,False,4,0,Draw
17022,18536,19795,1996,Honduras,Cuba,2,2,Friendly,San Pedro Sula,Honduras,False,4,0,Draw
17023,18537,19796,1996,Oman,Sudan,0,0,Friendly,Muscat,Oman,False,0,0,Draw
17024,18538,19797,1996,Russia,Brazil,2,2,Friendly,Moscow,Russia,False,4,0,Draw
17025,18539,19798,1996,Morocco,DR Congo,7,0,Friendly,Settat,Morocco,False,7,7,Morocco
17026,18540,19799,1996,Canada,Panama,3,1,FIFA World Cup qualification,Edmonton,Canada,False,4,2,Canada
17027,18541,19800,1996,Guatemala,Cuba,1,1,Friendly,Guatemala,Guatemala,False,2,0,Draw
17028,18542,19801,1996,Mauritania,Benin,0,0,African Cup of Nations qualification,Nouakchott,Mauritania,False,0,0,Draw
17029,18543,19802,1996,United States,El Salvador,3,1,Friendly,Los Angeles,United States,False,4,2,United States
17030,18544,19803,1996,Armenia,Portugal,0,0,FIFA World Cup qualification,Yerevan,Armenia,False,0,0,Draw
17031,18545,19804,1996,Austria,Scotland,0,0,FIFA World Cup qualification,Vienna,Austria,False,0,0,Draw
17032,18546,19805,1996,Azerbaijan,Switzerland,1,0,FIFA World Cup qualification,Baku,Azerbaijan,False,1,1,Azerbaijan
17033,18547,19806,1996,Belarus,Estonia,1,0,FIFA World Cup qualification,Minsk,Belarus,False,1,1,Belarus
17034,18548,19807,1996,Belgium,Turkey,2,1,FIFA World Cup qualification,Brussels,Belgium,False,3,1,Belgium
17035,18549,19808,1996,Faroe Islands,Slovakia,1,2,FIFA World Cup qualification,Toftir,Faroe Islands,False,3,-1,Slovakia
17036,18550,19809,1996,France,Mexico,2,0,Friendly,Paris,France,False,2,2,France
17037,18551,19810,1996,Liechtenstein,Republic of Ireland,0,5,FIFA World Cup qualification,Eschen,Liechtenstein,False,5,-5,Republic of Ireland
17038,18552,19811,1996,Netherlands,Brazil,2,2,Friendly,Amsterdam,Netherlands,False,4,0,Draw
17039,18553,19812,1996,Northern Ireland,Ukraine,0,1,FIFA World Cup qualification,Belfast,Northern Ireland,False,1,-1,Ukraine
17040,18554,19813,1996,Oman,Sudan,0,1,Friendly,Muscat,Oman,False,1,-1,Sudan
17041,18555,19814,1996,Romania,Lithuania,3,0,FIFA World Cup qualification,Bucharest,Romania,False,3,3,Romania
17042,18556,19815,1996,Wales,San Marino,6,0,FIFA World Cup qualification,Cardiff,Wales,False,6,6,Wales
17043,18557,19816,1996,Argentina,Paraguay,1,1,FIFA World Cup qualification,Buenos Aires,Argentina,False,2,0,Draw
17044,18558,19817,1996,Bolivia,Peru,0,0,FIFA World Cup qualification,La Paz,Bolivia,False,0,0,Draw
17045,18559,19818,1996,Colombia,Chile,4,1,FIFA World Cup qualification,Barranquilla,Colombia,False,5,3,Colombia
17046,18560,19819,1996,Ecuador,Venezuela,1,0,FIFA World Cup qualification,Quito,Ecuador,False,1,1,Ecuador
17047,18561,19820,1996,Greece,Bosnia and Herzegovina,3,0,FIFA World Cup qualification,Kalamáta,Greece,False,3,3,Greece
17048,18562,19821,1996,Hungary,Finland,1,0,FIFA World Cup qualification,Budapest,Hungary,False,1,1,Hungary
17049,18563,19822,1996,Israel,Bulgaria,2,1,FIFA World Cup qualification,Ramat-Gan,Israel,False,3,1,Israel
17050,18564,19823,1996,Latvia,Sweden,1,2,FIFA World Cup qualification,Riga,Latvia,False,3,-1,Sweden
17051,18565,19824,1996,Moldova,England,0,3,FIFA World Cup qualification,Chişinău,Moldova,False,3,-3,England
17052,18566,19825,1996,Norway,Georgia,1,0,Friendly,Oslo,Norway,False,1,1,Norway
17053,18567,19826,1996,Russia,Cyprus,4,0,FIFA World Cup qualification,Moscow,Russia,False,4,4,Russia
17054,18568,19827,1996,Singapore,Malaysia,1,1,AFF Championship,Singapore,Singapore,False,2,0,Draw
17055,18569,19828,1996,Slovenia,Denmark,0,2,FIFA World Cup qualification,Ljubljana,Slovenia,False,2,-2,Denmark
17056,18570,19829,1996,Trinidad and Tobago,Costa Rica,0,1,FIFA World Cup qualification,Port of Spain,Trinidad and Tobago,False,1,-1,Costa Rica
17057,18571,19830,1996,Cambodia,Vietnam,1,3,AFF Championship,Singapore,Singapore,True,4,-2,Vietnam
17058,18572,19831,1996,Laos,Indonesia,1,5,AFF Championship,Singapore,Singapore,True,6,-4,Indonesia
17059,18573,19832,1996,Philippines,Thailand,0,5,AFF Championship,Singapore,Singapore,True,5,-5,Thailand
17060,18574,19833,1996,Czech Republic,Iceland,2,1,Friendly,Jablonec nad Nisou nad Nisou,Czech Republic,False,3,1,Czech Republic
17061,18575,19834,1996,Faroe Islands,Spain,2,6,FIFA World Cup qualification,Toftir,Faroe Islands,False,8,-4,Spain
17062,18576,19835,1996,Jamaica,Costa Rica,2,0,Friendly,Kingston,Jamaica,False,2,2,Jamaica
17063,18577,19836,1996,Malaysia,Philippines,7,0,AFF Championship,Singapore,Singapore,True,7,7,Malaysia
17064,18578,19837,1996,Poland,Germany,0,2,Friendly,Zabrze,Poland,False,2,-2,Germany
17065,18579,19838,1996,Singapore,Brunei,3,0,AFF Championship,Singapore,Singapore,False,3,3,Singapore
17066,18580,19839,1996,Burma,Cambodia,5,0,AFF Championship,Singapore,Singapore,True,5,5,Burma
17067,18581,19840,1996,Laos,Vietnam,1,1,AFF Championship,Singapore,Singapore,True,2,0,Draw
17068,18582,19841,1996,Lebanon,Oman,1,2,Friendly,Beirut,Lebanon,False,3,-1,Oman
17069,18583,19842,1996,Singapore,Philippines,3,0,AFF Championship,Singapore,Singapore,False,3,3,Singapore
17070,18584,19843,1996,Thailand,Brunei,6,0,AFF Championship,Singapore,Singapore,True,6,6,Thailand
17071,18585,19844,1996,Burma,Vietnam,1,4,AFF Championship,Singapore,Singapore,True,5,-3,Vietnam
17072,18586,19845,1996,Indonesia,Cambodia,3,0,AFF Championship,Singapore,Singapore,True,3,3,Indonesia
17073,18587,19846,1996,Brunei,Philippines,1,0,AFF Championship,Singapore,Singapore,True,1,1,Brunei
17074,18588,19847,1996,El Salvador,Cuba,5,0,FIFA World Cup qualification,San Salvador,El Salvador,False,5,5,El Salvador
17075,18589,19848,1996,Thailand,Malaysia,1,1,AFF Championship,Singapore,Singapore,True,2,0,Draw
17076,18590,19849,1996,Indonesia,Burma,6,1,AFF Championship,Singapore,Singapore,True,7,5,Indonesia
17077,18591,19850,1996,Laos,Cambodia,1,0,AFF Championship,Singapore,Singapore,True,1,1,Laos
17078,18592,19851,1996,Brunei,Malaysia,0,6,AFF Championship,Singapore,Singapore,True,6,-6,Malaysia
17079,18593,19852,1996,Singapore,Thailand,0,1,AFF Championship,Singapore,Singapore,False,1,-1,Thailand
17080,18594,19853,1996,Japan,Uzbekistan,1,0,Friendly,Tokyo,Japan,False,1,1,Japan
17081,18595,19854,1996,Laos,Burma,2,4,AFF Championship,Singapore,Singapore,True,6,-2,Burma
17082,18596,19855,1996,Vietnam,Indonesia,1,1,AFF Championship,Singapore,Singapore,True,2,0,Draw
17083,18597,19856,1996,Malaysia,Indonesia,3,1,AFF Championship,Singapore,Singapore,True,4,2,Malaysia
17084,18598,19857,1996,Thailand,Vietnam,4,2,AFF Championship,Singapore,Singapore,True,6,2,Thailand
17085,18599,19858,1996,Australia,Ghana,2,0,Simba Tournament,Durban,South Africa,True,2,2,Australia
17086,18600,19859,1996,South Africa,Kenya,1,0,Simba Tournament,Durban,South Africa,False,1,1,South Africa
17087,18601,19860,1996,Indonesia,Vietnam,2,3,AFF Championship,Singapore,Singapore,True,5,-1,Vietnam
17088,18602,19861,1996,Jamaica,Honduras,3,0,FIFA World Cup qualification,Kingston,Jamaica,False,3,3,Jamaica
17089,18603,19862,1996,Senegal,Mali,1,0,Friendly,Saint-Louis,Senegal,False,1,1,Senegal
17090,18604,19863,1996,Thailand,Malaysia,1,0,AFF Championship,Singapore,Singapore,True,1,1,Thailand
17091,18605,19864,1996,Papua New Guinea,Solomon Islands,1,1,FIFA World Cup qualification,Lae,Papua New Guinea,False,2,0,Draw
17092,18606,19865,1996,Oman,Zambia,0,0,Friendly,Muscat,Oman,False,0,0,Draw
17093,18607,19866,1996,Czech Republic,Malta,6,0,FIFA World Cup qualification,Teplice,Czech Republic,False,6,6,Czech Republic
17094,18608,19867,1996,Ghana,Kenya,1,0,Simba Tournament,Johannesburg,South Africa,True,1,1,Ghana
17095,18609,19868,1996,Romania,United Arab Emirates,1,2,Friendly,Bucharest,Romania,False,3,-1,United Arab Emirates
17096,18610,19869,1996,Solomon Islands,Vanuatu,1,1,FIFA World Cup qualification,Lae,Papua New Guinea,True,2,0,Draw
17097,18611,19870,1996,South Africa,Australia,2,0,Simba Tournament,Johannesburg,South Africa,False,2,2,South Africa
17098,18612,19871,1996,El Salvador,Venezuela,0,1,Friendly,San Salvador,El Salvador,False,1,-1,Venezuela
17099,18613,19872,1996,Papua New Guinea,Vanuatu,2,1,FIFA World Cup qualification,Lae,Papua New Guinea,False,3,1,Papua New Guinea
17100,18614,19873,1996,Qatar,Sri Lanka,3,0,FIFA World Cup qualification,Doha,Qatar,False,3,3,Qatar
17101,18615,19874,1996,Australia,Kenya,4,0,Simba Tournament,Pretoria,South Africa,True,4,4,Australia
17102,18616,19875,1996,Honduras,Mexico,2,1,FIFA World Cup qualification,San Pedro Sula,Honduras,False,3,1,Honduras
17103,18617,19876,1996,India,Philippines,2,0,FIFA World Cup qualification,Doha,Qatar,True,2,2,India
17104,18618,19877,1996,South Africa,Ghana,0,0,Simba Tournament,Pretoria,South Africa,False,0,0,Draw
17105,18619,19878,1996,Guinea,Gabon,0,1,Friendly,Conakry,Guinea,False,1,-1,Gabon
17106,18620,19879,1996,Panama,Cuba,1,3,FIFA World Cup qualification,Panama City,Panama,False,4,-2,Cuba
17107,18621,19880,1996,Saudi Arabia,Zambia,2,1,Friendly,Riyadh,Saudi Arabia,False,3,1,Saudi Arabia
17108,18622,19881,1996,Slovakia,Malta,6,0,FIFA World Cup qualification,Bratislava,Slovakia,False,6,6,Slovakia
17109,18623,19882,1996,Mali,Guinea,0,0,Friendly,Bamako,Mali,False,0,0,Draw
17110,18624,19883,1996,Qatar,Philippines,5,0,FIFA World Cup qualification,Doha,Qatar,False,5,5,Qatar
17111,18625,19884,1996,Sri Lanka,India,1,1,FIFA World Cup qualification,Doha,Qatar,True,2,0,Draw
17112,18626,19885,1996,El Salvador,Guatemala,2,1,Friendly,Los Angeles,United States,True,3,1,El Salvador
17113,18627,19887,1996,Oman,Mozambique,0,2,Friendly,Muscat,Oman,False,2,-2,Mozambique
17114,18628,19888,1996,Poland,United Arab Emirates,1,0,Friendly,Wodzisław Śląski,Poland,False,1,1,Poland
17115,18629,19889,1996,Saudi Arabia,Zambia,1,3,Friendly,Dammam,Saudi Arabia,False,4,-2,Zambia
17116,18630,19890,1996,Syria,Sudan,1,2,Friendly,Damascus,Syria,False,3,-1,Sudan
17117,18631,19891,1996,Philippines,Sri Lanka,0,3,FIFA World Cup qualification,Doha,Qatar,True,3,-3,Sri Lanka
17118,18632,19892,1996,Qatar,India,6,0,FIFA World Cup qualification,Doha,Qatar,False,6,6,Qatar
17119,18633,19893,1996,Gabon,Mali,1,1,Friendly,Libreville,Gabon,False,2,0,Draw
17120,18634,19894,1996,Oman,New Zealand,0,1,Friendly,Muscat,Oman,False,1,-1,New Zealand
17121,18635,19895,1996,Syria,Sudan,1,0,Friendly,Damascus,Syria,False,1,1,Syria
17122,18636,19896,1996,Zimbabwe,Tanzania,1,0,Friendly,Harare,Zimbabwe,False,1,1,Zimbabwe
17123,18637,19897,1996,Oman,New Zealand,1,2,Friendly,Muscat,Oman,False,3,-1,New Zealand
17124,18638,19898,1996,Lebanon,Bahrain,2,3,Friendly,Tripoli,Lebanon,False,5,-1,Bahrain
17125,18639,19899,1996,Saudi Arabia,New Zealand,3,0,Friendly,Dhahran,Saudi Arabia,False,3,3,Saudi Arabia
17126,18640,19900,1996,Ecuador,Jamaica,2,1,Friendly,Ambato,Ecuador,False,3,1,Ecuador
17127,18641,19901,1996,Kuwait,Iran,0,1,Friendly,Kuwait City,Kuwait,False,1,-1,Iran
17128,18642,19902,1996,Estonia,Belarus,1,0,FIFA World Cup qualification,Tallinn,Estonia,False,1,1,Estonia
17129,18643,19903,1996,Latvia,Scotland,0,2,FIFA World Cup qualification,Riga,Latvia,False,2,-2,Scotland
17130,18644,19904,1996,Lithuania,Iceland,2,0,FIFA World Cup qualification,Vilnius,Lithuania,False,2,2,Lithuania
17131,18645,19905,1996,Moldova,Italy,1,3,FIFA World Cup qualification,Chişinău,Moldova,False,4,-2,Italy
17132,18646,19906,1996,Northern Ireland,Armenia,1,1,FIFA World Cup qualification,Belfast,Northern Ireland,False,2,0,Draw
17133,18647,19907,1996,Qatar,New Zealand,3,2,Friendly,Doha,Qatar,False,5,1,Qatar
17134,18648,19908,1996,Togo,Tanzania,2,1,African Cup of Nations qualification,Lomé,Togo,False,3,1,Togo
17135,18649,19909,1996,Ukraine,Portugal,2,1,FIFA World Cup qualification,Kyïv,Ukraine,False,3,1,Ukraine
17136,18650,19910,1996,Wales,Netherlands,1,3,FIFA World Cup qualification,Cardiff,Wales,False,4,-2,Netherlands
17137,18651,19911,1996,Algeria,Ivory Coast,4,1,African Cup of Nations qualification,Algiers,Algeria,False,5,3,Algeria
17138,18652,19912,1996,Benin,Mali,1,2,African Cup of Nations qualification,Cotonou,Benin,False,3,-1,Mali
17139,18653,19913,1996,Central African Republic,Guinea,2,3,African Cup of Nations qualification,Bangui,Central African Republic,False,5,-1,Guinea
17140,18654,19914,1996,DR Congo,Liberia,0,0,African Cup of Nations qualification,Kinshasa,Zaïre,False,0,0,Draw
17141,18655,19915,1996,Ethiopia,Senegal,1,2,African Cup of Nations qualification,Addis Abeba,Ethiopia,False,3,-1,Senegal
17142,18656,19916,1996,Faroe Islands,Serbia,1,8,FIFA World Cup qualification,Toftir,Faroe Islands,False,9,-7,Serbia
17143,18657,19917,1996,Finland,Switzerland,2,3,FIFA World Cup qualification,Helsinki,Finland,False,5,-1,Switzerland
17144,18658,19918,1996,Gabon,Cameroon,0,0,African Cup of Nations qualification,Libreville,Gabon,False,0,0,Draw
17145,18659,19919,1996,Ghana,Angola,2,1,African Cup of Nations qualification,Kumasi,Ghana,False,3,1,Ghana
17146,18660,19920,1996,Mauritius,Malawi,1,2,African Cup of Nations qualification,Curepipe,Mauritius,False,3,-1,Malawi
17147,18661,19921,1996,Panama,El Salvador,1,1,FIFA World Cup qualification,Panama City,Panama,False,2,0,Draw
17148,18662,19922,1996,Sudan,Zimbabwe,0,3,African Cup of Nations qualification,Khartoum,Sudan,False,3,-3,Zimbabwe
17149,18663,19923,1996,Trinidad and Tobago,Guatemala,1,1,FIFA World Cup qualification,Port of Spain,Trinidad and Tobago,False,2,0,Draw
17150,18664,19924,1996,Tunisia,Sierra Leone,2,0,African Cup of Nations qualification,Tunis,Tunisia,False,2,2,Tunisia
17151,18665,19925,1996,Zambia,Mozambique,1,0,African Cup of Nations qualification,Lusaka,Zambia,False,1,1,Zambia
17152,18666,19926,1996,Oman,Azerbaijan,2,0,Friendly,Muscat,Oman,False,2,2,Oman
17153,18667,19927,1996,Bosnia and Herzegovina,Croatia,1,4,FIFA World Cup qualification,Bologna,Italy,True,5,-3,Croatia
17154,18668,19928,1996,Kuwait,Cyprus,1,1,Friendly,al-Ain,United Arab Emirates,True,2,0,Draw
17155,18669,19929,1996,Luxembourg,Bulgaria,1,2,FIFA World Cup qualification,Luxembourg,Luxembourg,False,3,-1,Bulgaria
17156,18670,19930,1996,Uruguay,Bolivia,1,0,FIFA World Cup qualification,Montevideo,Uruguay,False,1,1,Uruguay
17157,18671,19931,1996,Albania,Portugal,0,3,FIFA World Cup qualification,Tirana,Albania,False,3,-3,Portugal
17158,18672,19932,1996,Armenia,Germany,1,5,FIFA World Cup qualification,Yerevan,Armenia,False,6,-4,Germany
17159,18673,19933,1996,Belarus,Latvia,1,1,FIFA World Cup qualification,Minsk,Belarus,False,2,0,Draw
17160,18674,19934,1996,Costa Rica,Jamaica,0,0,Friendly,San José,Costa Rica,False,0,0,Draw
17161,18675,19935,1996,Czech Republic,Spain,0,0,FIFA World Cup qualification,Prague,Czech Republic,False,0,0,Draw
17162,18676,19936,1996,Denmark,Greece,2,1,FIFA World Cup qualification,Copenhagen,Denmark,False,3,1,Denmark
17163,18677,19937,1996,Ecuador,Colombia,0,1,FIFA World Cup qualification,Quito,Ecuador,False,1,-1,Colombia
17164,18678,19938,1996,England,Poland,2,1,FIFA World Cup qualification,London,England,False,3,1,England
17165,18679,19939,1996,France,Turkey,4,0,Friendly,Paris,France,False,4,4,France
17166,18680,19940,1996,Iceland,Romania,0,4,FIFA World Cup qualification,Reykjavík,Iceland,False,4,-4,Romania
17167,18682,19942,1996,Israel,Russia,1,1,FIFA World Cup qualification,Ramat-Gan,Israel,False,2,0,Draw
17168,18683,19943,1996,Italy,Georgia,1,0,FIFA World Cup qualification,Perugia,Italy,False,1,1,Italy
17169,18684,19944,1996,Lebanon,New Zealand,1,1,Friendly,Beirut,Lebanon,False,2,0,Draw
17170,18685,19945,1996,Lithuania,Liechtenstein,2,1,FIFA World Cup qualification,Vilnius,Lithuania,False,3,1,Lithuania
17171,18686,19946,1996,Norway,Hungary,3,0,FIFA World Cup qualification,Oslo,Norway,False,3,3,Norway
17172,18687,19947,1996,Paraguay,Chile,2,1,FIFA World Cup qualification,Asunción,Paraguay,False,3,1,Paraguay
17173,18688,19948,1996,San Marino,Belgium,0,3,FIFA World Cup qualification,Serravalle,San Marino,False,3,-3,Belgium
17174,18689,19949,1996,Saudi Arabia,Australia,0,0,Friendly,Dammam,Saudi Arabia,False,0,0,Draw
17175,18690,19950,1996,Sweden,Austria,0,1,FIFA World Cup qualification,Solna,Sweden,False,1,-1,Austria
17176,18691,19951,1996,Venezuela,Argentina,2,5,FIFA World Cup qualification,San Cristóbal,Venezuela,False,7,-3,Argentina
17177,18692,19952,1996,Canada,Cuba,2,0,FIFA World Cup qualification,Edmonton,Canada,False,2,2,Canada
17178,18693,19953,1996,Canada,Cuba,2,0,FIFA World Cup qualification,Edmonton,Canada,False,2,2,Canada
17179,18694,19954,1996,Japan,Tunisia,1,0,Friendly,Kobe,Japan,False,1,1,Japan
17180,18695,19955,1996,Oman,Saudi Arabia,0,1,Gulf Cup,Muscat,Oman,False,1,-1,Saudi Arabia
17181,18696,19956,1996,Brazil,Lithuania,3,1,Friendly,Teresina,Brazil,False,4,2,Brazil
17182,18697,19957,1996,Kuwait,Bahrain,1,0,Gulf Cup,Muscat,Oman,True,1,1,Kuwait
17183,18698,19958,1996,Mexico,Jamaica,2,1,FIFA World Cup qualification,Mexico City,Mexico,False,3,1,Mexico
17184,18699,19959,1996,Peru,United States,4,1,Friendly,Lima,Peru,False,5,3,Peru
17185,18700,19960,1996,United Arab Emirates,Qatar,0,1,Gulf Cup,Muscat,Oman,True,1,-1,Qatar
17186,18701,19961,1996,Oman,Kuwait,1,2,Gulf Cup,Muscat,Oman,False,3,-1,Kuwait
17187,18702,19962,1996,United Arab Emirates,Bahrain,1,1,Gulf Cup,Muscat,Oman,True,2,0,Draw
17188,18703,19963,1996,Gabon,Burkina Faso,2,0,Friendly,Libreville,Gabon,False,2,2,Gabon
17189,18704,19964,1996,Qatar,Saudi Arabia,2,2,Gulf Cup,Muscat,Oman,True,4,0,Draw
17190,18705,19965,1996,Honduras,El Salvador,1,1,Friendly,Tegucigalpa,Honduras,False,2,0,Draw
17191,18706,19966,1996,Oman,Qatar,0,3,Gulf Cup,Muscat,Oman,False,3,-3,Qatar
17192,18707,19967,1996,Saudi Arabia,Bahrain,3,1,Gulf Cup,Muscat,Oman,True,4,2,Saudi Arabia
17193,18708,19968,1996,Kuwait,United Arab Emirates,1,2,Gulf Cup,Muscat,Oman,True,3,-1,United Arab Emirates
17194,18709,19969,1996,Mexico,Ecuador,0,1,Friendly,Oakland,United States,True,1,-1,Ecuador
17195,18710,19970,1996,Slovakia,Faroe Islands,3,0,FIFA World Cup qualification,Bratislava,Slovakia,False,3,3,Slovakia
17196,18711,19971,1996,Kuwait,Saudi Arabia,1,0,Gulf Cup,Muscat,Oman,True,1,1,Kuwait
17197,18712,19972,1996,Oman,United Arab Emirates,0,0,Gulf Cup,Muscat,Oman,False,0,0,Draw
17198,18713,19973,1996,Bahrain,Qatar,1,2,Gulf Cup,Muscat,Oman,True,3,-1,Qatar
17199,18714,19974,1996,Honduras,Jamaica,0,0,FIFA World Cup qualification,San Pedro Sula,Honduras,False,0,0,Draw
17200,18715,19975,1996,Panama,Canada,0,0,FIFA World Cup qualification,Panama City,Panama,False,0,0,Draw
17201,18716,19977,1996,United Arab Emirates,Saudi Arabia,2,2,Gulf Cup,Muscat,Oman,True,4,0,Draw
17202,18717,19978,1996,Oman,Bahrain,1,1,Gulf Cup,Muscat,Oman,False,2,0,Draw
17203,18718,19979,1996,Qatar,Kuwait,1,2,Gulf Cup,Muscat,Oman,True,3,-1,Kuwait
17204,18719,19980,1996,Finland,Estonia,2,2,Friendly,Kotka,Finland,False,4,0,Draw
17205,18720,19981,1996,Indonesia,Moldova,1,2,Friendly,Genoa,Italy,True,3,-1,Moldova
17206,18722,19983,1996,Honduras,Colombia,1,2,Friendly,New York,United States,True,3,-1,Colombia
17207,18723,19984,1996,Canada,El Salvador,1,0,FIFA World Cup qualification,Burnaby,Canada,False,1,1,Canada
17208,18724,19985,1996,Lithuania,Indonesia,4,0,Friendly,Vilnius,Lithuania,False,4,4,Lithuania
17209,18725,19986,1996,Togo,Gabon,0,1,Friendly,Lomé,Togo,False,1,-1,Gabon
17210,18726,19987,1996,United States,Guatemala,2,0,FIFA World Cup qualification,Washington,United States,False,2,2,United States
17211,18727,19988,1996,Bosnia and Herzegovina,Italy,2,1,Friendly,Sarajevo,Bosnia and Herzegovina,False,3,1,Bosnia and Herzegovina
17212,18728,19989,1996,Mexico,Honduras,3,1,FIFA World Cup qualification,Mexico City,Mexico,False,4,2,Mexico
17213,18729,19990,1996,Saudi Arabia,Bulgaria,1,0,Friendly,Riyadh,Saudi Arabia,False,1,1,Saudi Arabia
17214,18730,19991,1996,Costa Rica,Panama,2,0,Friendly,San Isidro de El General,Costa Rica,False,2,2,Costa Rica
17215,18731,19992,1996,Uganda,Rwanda,3,2,Friendly,Kampala,Uganda,False,5,1,Uganda
17216,18732,19993,1996,Egypt,Namibia,7,1,FIFA World Cup qualification,Cairo,Egypt,False,8,6,Egypt
17217,18733,19994,1996,Thailand,Bulgaria,0,4,Friendly,Bangkok,Thailand,False,4,-4,Bulgaria
17218,18734,19995,1996,Uganda,Rwanda,1,1,Friendly,Kampala,Uganda,False,2,0,Draw
17219,18735,19996,1996,Albania,Armenia,1,1,FIFA World Cup qualification,Tirana,Albania,False,2,0,Draw
17220,18736,19997,1996,Austria,Latvia,2,1,FIFA World Cup qualification,Vienna,Austria,False,3,1,Austria
17221,18737,19998,1996,Denmark,France,1,0,Friendly,Copenhagen,Denmark,False,1,1,Denmark
17222,18738,19999,1996,Georgia,England,0,2,FIFA World Cup qualification,Tbilisi,Georgia,False,2,-2,England
17223,18739,20000,1996,Germany,Northern Ireland,1,1,FIFA World Cup qualification,Nuremberg,Germany,False,2,0,Draw
17224,18741,20002,1996,Morocco,Sierra Leone,4,0,FIFA World Cup qualification,Rabat,Morocco,False,4,4,Morocco
17225,18742,20003,1996,Netherlands,Wales,7,1,FIFA World Cup qualification,Eindhoven,Netherlands,False,8,6,Netherlands
17226,18743,20004,1996,Nigeria,Burkina Faso,2,0,FIFA World Cup qualification,Lagos,Nigeria,False,2,2,Nigeria
17227,18744,20005,1996,Portugal,Ukraine,1,0,FIFA World Cup qualification,Porto,Portugal,False,1,1,Portugal
17228,18745,20006,1996,South Africa,DR Congo,1,0,FIFA World Cup qualification,Johannesburg,South Africa,False,1,1,South Africa
17229,18746,20007,1996,Angola,Zimbabwe,2,1,FIFA World Cup qualification,Luanda,Angola,False,3,1,Angola
17230,18747,20008,1996,Azerbaijan,Hungary,0,3,FIFA World Cup qualification,Baku,Azerbaijan,False,3,-3,Hungary
17231,18748,20009,1996,Bolivia,Colombia,2,2,FIFA World Cup qualification,La Paz,Bolivia,False,4,0,Draw
17232,18749,20010,1996,Congo,Zambia,1,0,FIFA World Cup qualification,Pointe-Noire,Congo,False,1,1,Congo
17233,18750,20011,1996,Croatia,Greece,1,1,FIFA World Cup qualification,Zagreb,Croatia,False,2,0,Draw
17234,18751,20012,1996,Cyprus,Israel,2,0,FIFA World Cup qualification,Limassol,Cyprus,False,2,2,Cyprus
17235,18752,20013,1996,El Salvador,Panama,3,2,FIFA World Cup qualification,San Salvador,El Salvador,False,5,1,El Salvador
17236,18753,20014,1996,Gabon,Ghana,1,1,FIFA World Cup qualification,Libreville,Gabon,False,2,0,Draw
17237,18754,20015,1996,Guinea,Kenya,3,1,FIFA World Cup qualification,Conakry,Guinea,False,4,2,Guinea
17238,18755,20016,1996,Republic of Ireland,Iceland,0,0,FIFA World Cup qualification,Dublin,Republic of Ireland,False,0,0,Draw
17239,18756,20017,1996,Liberia,Tunisia,0,1,FIFA World Cup qualification,Accra,Ghana,True,1,-1,Tunisia
17240,18757,20018,1996,Luxembourg,Russia,0,4,FIFA World Cup qualification,Luxembourg,Luxembourg,False,4,-4,Russia
17241,18758,20019,1996,Paraguay,Ecuador,1,0,FIFA World Cup qualification,Asunción,Paraguay,False,1,1,Paraguay
17242,18759,20020,1996,Peru,Venezuela,4,1,FIFA World Cup qualification,Lima,Peru,False,5,3,Peru
17243,18760,20021,1996,Poland,Moldova,2,1,FIFA World Cup qualification,Katowice,Poland,False,3,1,Poland
17244,18761,20022,1996,Scotland,Sweden,1,0,FIFA World Cup qualification,Glasgow,Scotland,False,1,1,Scotland
17245,18762,20023,1996,Serbia,Czech Republic,1,0,FIFA World Cup qualification,Belgrade,Yugoslavia,True,1,1,Serbia
17246,18763,20024,1996,Slovenia,Bosnia and Herzegovina,1,2,FIFA World Cup qualification,Ljubljana,Slovenia,False,3,-1,Bosnia and Herzegovina
17247,18764,20025,1996,Switzerland,Norway,0,1,FIFA World Cup qualification,Berne,Switzerland,False,1,-1,Norway
17248,18765,20026,1996,Togo,Cameroon,2,4,FIFA World Cup qualification,Lomé,Togo,False,6,-2,Cameroon
17249,18766,20027,1996,Turkey,San Marino,7,0,FIFA World Cup qualification,Istanbul,Turkey,False,7,7,Turkey
17250,18767,20028,1996,United States,Trinidad and Tobago,2,0,FIFA World Cup qualification,Richmond,United States,False,2,2,United States
17251,18768,20029,1996,Tonga,Cook Islands,2,0,FIFA World Cup qualification,Nuku'alofa,Tonga,False,2,2,Tonga
17252,18769,20030,1996,Chile,Uruguay,1,0,FIFA World Cup qualification,Santiago,Chile,False,1,1,Chile
17253,18770,20031,1996,Andorra,Estonia,1,6,Friendly,Sant Julià de Lòria,Andorra,False,7,-5,Estonia
17254,18771,20032,1996,Brazil,Cameroon,2,0,Friendly,Curitiba,Brazil,False,2,2,Brazil
17255,18772,20033,1996,Lebanon,Iran,0,0,Friendly,Beirut,Lebanon,False,0,0,Draw
17256,18773,20034,1996,Samoa,Cook Islands,2,1,FIFA World Cup qualification,Nuku'alofa,Tonga,True,3,1,Samoa
17257,18774,20035,1996,Spain,Slovakia,4,1,FIFA World Cup qualification,Santa Cruz de Tenerife,Spain,False,5,3,Spain
17258,18775,20036,1996,Tonga,Samoa,1,0,FIFA World Cup qualification,Nuku'alofa,Tonga,False,1,1,Tonga
17259,18776,20037,1996,United Arab Emirates,Malta,0,0,Friendly,Abu Dhabi,United Arab Emirates,False,0,0,Draw
17260,18777,20038,1996,Estonia,Indonesia,3,0,Friendly,Celle Ligure,Italy,True,3,3,Estonia
17261,18778,20039,1996,Saudi Arabia,Syria,3,1,Friendly,Jeddah,Saudi Arabia,False,4,2,Saudi Arabia
17262,18779,20040,1996,Costa Rica,Guatemala,3,0,FIFA World Cup qualification,San José,Costa Rica,False,3,3,Costa Rica
17263,18780,20041,1996,Jamaica,Mexico,1,0,FIFA World Cup qualification,Kingston,Jamaica,False,1,1,Jamaica
17264,18781,20042,1996,Sudan,Uganda,1,1,CECAFA Cup,Khartoum,Sudan,False,2,0,Draw
17265,18782,20043,1996,Kenya,Rwanda,2,1,CECAFA Cup,Kassala,Sudan,True,3,1,Kenya
17266,18783,20044,1996,Kuwait,Syria,2,2,Friendly,Kuwait City,Kuwait,False,4,0,Draw
17267,18784,20045,1996,Saudi Arabia,Mali,1,3,Friendly,Riyadh,Saudi Arabia,False,4,-2,Mali
17268,18785,20046,1996,United Arab Emirates,Uzbekistan,4,2,Friendly,Abu Dhabi,United Arab Emirates,False,6,2,United Arab Emirates
17269,18786,20047,1996,El Salvador,Mexico,1,3,Friendly,Los Angeles,United States,True,4,-2,Mexico
17270,18787,20048,1996,Kuwait,Mali,4,2,Friendly,Kuwait City,Kuwait,False,6,2,Kuwait
17271,18789,20050,1996,Tanzania,Uganda,0,1,CECAFA Cup,Khartoum,Sudan,True,1,-1,Uganda
17272,18790,20051,1996,United Arab Emirates,Uzbekistan,2,0,Friendly,Abu Dhabi,United Arab Emirates,False,2,2,United Arab Emirates
17273,18791,20053,1996,Guatemala,Costa Rica,1,0,FIFA World Cup qualification,Los Angeles,United States,True,1,1,Guatemala
17274,18792,20054,1996,Indonesia,Iraq,0,4,Friendly,Genoa,Italy,True,4,-4,Iraq
17275,18794,20056,1996,Mali,Burkina Faso,2,0,Friendly,Bamako,Mali,False,2,2,Mali
17276,18795,20057,1996,Sudan,Tanzania,3,2,CECAFA Cup,Khartoum,Sudan,False,5,1,Sudan
17277,18796,20058,1996,Trinidad and Tobago,United States,0,1,FIFA World Cup qualification,Port of Spain,Trinidad and Tobago,False,1,-1,United States
17278,18797,20059,1996,Iran,Turkmenistan,0,1,Friendly,Teheran,Iran,False,1,-1,Turkmenistan
17279,18798,20061,1996,United Arab Emirates,Syria,1,1,Friendly,Abu Dhabi,United Arab Emirates,False,2,0,Draw
17280,18800,20063,1996,Uganda,Kenya,2,0,CECAFA Cup,Khartoum,Sudan,True,2,2,Uganda
17281,18801,20064,1996,United Arab Emirates,Syria,1,0,Friendly,Abu Dhabi,United Arab Emirates,False,1,1,United Arab Emirates
17282,18802,20065,1996,Saudi Arabia,Indonesia,4,1,Friendly,Dammam,Saudi Arabia,False,5,3,Saudi Arabia
17283,18803,20066,1996,Sudan,Kenya,1,1,Friendly,Khartoum,Sudan,False,2,0,Draw
17284,18804,20067,1996,Costa Rica,United States,2,1,FIFA World Cup qualification,San José,Costa Rica,False,3,1,Costa Rica
17285,18805,20068,1996,El Salvador,Cuba,3,0,FIFA World Cup qualification,San Salvador,El Salvador,False,3,3,El Salvador
17286,18806,20069,1996,Indonesia,Kuwait,2,2,AFC Asian Cup,Abu Dhabi,United Arab Emirates,True,4,0,Draw
17287,18808,20071,1996,Iran,Iraq,1,2,AFC Asian Cup,Dubai,United Arab Emirates,True,3,-1,Iraq
17288,18809,20072,1996,Lebanon,Georgia,4,2,Friendly,Beirut,Lebanon,False,6,2,Lebanon
17289,18810,20073,1996,Saudi Arabia,Thailand,6,0,AFC Asian Cup,Dubai,United Arab Emirates,True,6,6,Saudi Arabia
17290,18811,20075,1996,Japan,Syria,2,1,AFC Asian Cup,Al Ain,United Arab Emirates,True,3,1,Japan
17291,18812,20077,1996,United Arab Emirates,Kuwait,3,2,AFC Asian Cup,Abu Dhabi,United Arab Emirates,False,5,1,United Arab Emirates
17292,18813,20078,1996,Guatemala,Trinidad and Tobago,2,1,FIFA World Cup qualification,Los Angeles,United States,True,3,1,Guatemala
17293,18814,20079,1996,Lebanon,Georgia,3,2,Friendly,Beirut,Lebanon,False,5,1,Lebanon
17294,18815,20080,1996,Saudi Arabia,Iraq,1,0,AFC Asian Cup,Dubai,United Arab Emirates,True,1,1,Saudi Arabia
17295,18816,20081,1996,Thailand,Iran,1,3,AFC Asian Cup,Dubai,United Arab Emirates,True,4,-2,Iran
17296,18817,20082,1996,Japan,Uzbekistan,4,0,AFC Asian Cup,Al Ain,United Arab Emirates,True,4,4,Japan
17297,18820,20085,1996,United Arab Emirates,Indonesia,2,0,AFC Asian Cup,Abu Dhabi,United Arab Emirates,False,2,2,United Arab Emirates
17298,18821,20086,1996,Czech Republic,Nigeria,2,1,King Hassan II Tournament,Casablanca,Morocco,True,3,1,Czech Republic
17299,18822,20087,1996,Iraq,Thailand,4,1,AFC Asian Cup,Dubai,United Arab Emirates,True,5,3,Iraq
17300,18823,20088,1996,Morocco,Croatia,2,2,King Hassan II Tournament,Casablanca,Morocco,False,4,0,Draw
17301,18824,20089,1996,Saudi Arabia,Iran,0,3,AFC Asian Cup,Dubai,United Arab Emirates,True,3,-3,Iran
17302,18825,20090,1996,Croatia,Czech Republic,1,1,King Hassan II Tournament,Casablanca,Morocco,True,2,0,Draw
17303,18827,20092,1996,Morocco,Nigeria,2,0,King Hassan II Tournament,Casablanca,Morocco,False,2,2,Morocco
17304,18828,20093,1996,Uzbekistan,Syria,1,2,AFC Asian Cup,Al Ain,United Arab Emirates,True,3,-1,Syria
17305,18829,20094,1996,Belgium,Netherlands,0,3,FIFA World Cup qualification,Brussels,Belgium,False,3,-3,Netherlands
17306,18830,20095,1996,Cyprus,Bulgaria,1,3,FIFA World Cup qualification,Limassol,Cyprus,False,4,-2,Bulgaria
17307,18831,20096,1996,Kenya,Zambia,1,0,Friendly,Nairobi,Kenya,False,1,1,Kenya
17308,18832,20098,1996,Northern Ireland,Albania,2,0,FIFA World Cup qualification,Belfast,Northern Ireland,False,2,2,Northern Ireland
17309,18833,20099,1996,Portugal,Germany,0,0,FIFA World Cup qualification,Lisbon,Portugal,False,0,0,Draw
17310,18834,20100,1996,Spain,Serbia,2,0,FIFA World Cup qualification,Valencia,Spain,False,2,2,Spain
17311,18835,20101,1996,United States,Costa Rica,2,1,FIFA World Cup qualification,Palo Alto,United States,False,3,1,United States
17312,18836,20102,1996,Wales,Turkey,0,0,FIFA World Cup qualification,Cardiff,Wales,False,0,0,Draw
17313,18837,20103,1996,Argentina,Chile,1,1,FIFA World Cup qualification,Buenos Aires,Argentina,False,2,0,Draw
17314,18838,20104,1996,Bolivia,Paraguay,0,0,FIFA World Cup qualification,La Paz,Bolivia,False,0,0,Draw
17315,18839,20105,1996,El Salvador,Canada,0,2,FIFA World Cup qualification,San Salvador,El Salvador,False,2,-2,Canada
17316,18840,20106,1996,Israel,Luxembourg,1,0,FIFA World Cup qualification,Ramat-Gan,Israel,False,1,1,Israel
17317,18841,20107,1996,Kenya,Zambia,0,2,Friendly,Mombasa,Kenya,False,2,-2,Zambia
17318,18842,20108,1996,Kuwait,Japan,2,0,AFC Asian Cup,Al Ain,United Arab Emirates,True,2,2,Kuwait
17319,18843,20109,1996,Panama,Cuba,3,1,FIFA World Cup qualification,Panama City,Panama,False,4,2,Panama
17320,18844,20110,1996,United Arab Emirates,Iraq,1,0,AFC Asian Cup,Abu Dhabi,United Arab Emirates,False,1,1,United Arab Emirates
17321,18845,20111,1996,Uruguay,Peru,2,0,FIFA World Cup qualification,Montevideo,Uruguay,False,2,2,Uruguay
17322,18846,20112,1996,Venezuela,Colombia,0,2,FIFA World Cup qualification,San Cristóbal,Venezuela,False,2,-2,Colombia
17323,18848,20115,1996,Brazil,Bosnia and Herzegovina,1,0,Friendly,Manaus,Brazil,False,1,1,Brazil
17324,18849,20116,1996,Malta,Spain,0,3,FIFA World Cup qualification,Attard,Malta,False,3,-3,Spain
17325,18850,20117,1996,Iran,Saudi Arabia,0,0,AFC Asian Cup,Abu Dhabi,United Arab Emirates,True,0,0,Draw
17326,18851,20118,1996,United Arab Emirates,Kuwait,1,0,AFC Asian Cup,Abu Dhabi,United Arab Emirates,False,1,1,United Arab Emirates
17327,18852,20119,1996,Burkina Faso,Gabon,1,1,Friendly,Cotonou,Benin,True,2,0,Draw
17328,18853,20120,1996,Costa Rica,Trinidad and Tobago,2,1,FIFA World Cup qualification,Cartago,Costa Rica,False,3,1,Costa Rica
17329,18854,20121,1996,Guatemala,United States,2,2,FIFA World Cup qualification,San Salvador,El Salvador,True,4,0,Draw
17330,18855,20122,1996,Iran,Kuwait,1,1,AFC Asian Cup,Abu Dhabi,United Arab Emirates,True,2,0,Draw
17331,18856,20123,1996,United Arab Emirates,Saudi Arabia,0,0,AFC Asian Cup,Abu Dhabi,United Arab Emirates,False,0,0,Draw
17332,18857,20124,1996,Zimbabwe,Tanzania,2,2,Friendly,Harare,Zimbabwe,False,4,0,Draw
17333,18858,20125,1996,Benin,Gabon,3,3,Friendly,Cotonou,Benin,False,6,0,Draw
17334,18859,20126,1996,Burkina Faso,Ghana,2,1,Friendly,Cotonou,Benin,True,3,1,Burkina Faso
17335,18860,20127,1996,Benin,Ghana,1,1,Friendly,Cotonou,Benin,False,2,0,Draw
17336,18861,20128,1996,Benin,Burkina Faso,1,1,Friendly,Cotonou,Benin,False,2,0,Draw
17337,18862,20129,1996,Gabon,Ghana,1,1,Friendly,Cotonou,Benin,True,2,0,Draw
17338,18863,20131,1996,Benin,Burkina Faso,0,0,Friendly,Cotonou,Benin,False,0,0,Draw
17339,18864,20132,1996,Argentina,Serbia,2,3,Friendly,Mar del Plata,Argentina,False,5,-1,Serbia
17340,18865,20133,1997,Chile,Armenia,7,0,Friendly,Viña del Mar,Chile,False,7,7,Chile
17341,18866,20134,1997,Tunisia,Algeria,0,0,Friendly,Sfax,Tunisia,False,0,0,Draw
17342,18867,20135,1997,Egypt,Belarus,2,0,Friendly,Alexandria,Egypt,False,2,2,Egypt
17343,18868,20136,1997,Paraguay,Armenia,2,0,Friendly,Asunción,Paraguay,False,2,2,Paraguay
17344,18869,20137,1997,Togo,Ghana,4,0,Friendly,Lomé,Togo,False,4,4,Togo
17345,18870,20138,1997,Ivory Coast,Guinea,2,1,Friendly,Bouaké,Ivory Coast,False,3,1,Ivory Coast
17346,18871,20139,1997,Namibia,Liberia,0,0,FIFA World Cup qualification,Windhoek,Namibia,False,0,0,Draw
17347,18872,20140,1997,Sierra Leone,Gabon,1,0,FIFA World Cup qualification,Freetown,Sierra Leone,False,1,1,Sierra Leone
17348,18873,20141,1997,Zambia,South Africa,0,0,FIFA World Cup qualification,Lusaka,Zambia,False,0,0,Draw
17349,18874,20142,1997,Bolivia,Ecuador,2,0,FIFA World Cup qualification,La Paz,Bolivia,False,2,2,Bolivia
17350,18875,20143,1997,Burkina Faso,Guinea,0,2,FIFA World Cup qualification,Ouagadougou,Burkina Faso,False,2,-2,Guinea
17351,18876,20144,1997,Cameroon,Angola,0,0,FIFA World Cup qualification,Yaoundé,Cameroon,False,0,0,Draw
17352,18877,20145,1997,DR Congo,Congo,1,1,FIFA World Cup qualification,Kinshasa,Zaïre,False,2,0,Draw
17353,18878,20146,1997,Ghana,Morocco,2,2,FIFA World Cup qualification,Kumasi,Ghana,False,4,0,Draw
17354,18879,20147,1997,Kenya,Nigeria,1,1,FIFA World Cup qualification,Nairobi,Kenya,False,2,0,Draw
17355,18880,20148,1997,Lebanon,Algeria,2,2,Friendly,Beirut,Lebanon,False,4,0,Draw
17356,18881,20149,1997,Peru,Chile,2,1,FIFA World Cup qualification,Lima,Peru,False,3,1,Peru
17357,18882,20150,1997,Tunisia,Egypt,1,0,FIFA World Cup qualification,Tunis,Tunisia,False,1,1,Tunisia
17358,18883,20151,1997,Uruguay,Argentina,0,0,FIFA World Cup qualification,Montevideo,Uruguay,False,0,0,Draw
17359,18884,20152,1997,Venezuela,Paraguay,0,2,FIFA World Cup qualification,Mérida,Venezuela,False,2,-2,Paraguay
17360,18885,20153,1997,Zimbabwe,Togo,3,0,FIFA World Cup qualification,Harare,Zimbabwe,False,3,3,Zimbabwe
17361,18886,20154,1997,United States,Peru,0,1,USA Cup,San Diego,United States,False,1,-1,Peru
17362,18887,20155,1997,Australia,New Zealand,1,0,Friendly,Melbourne,Australia,False,1,1,Australia
17363,18888,20157,1997,Benin,Togo,1,1,Friendly,Cotonou,Benin,False,2,0,Draw
17364,18889,20158,1997,Mozambique,Zimbabwe,1,2,Friendly,Maputo,Mozambique,False,3,-1,Zimbabwe
17365,18890,20159,1997,United States,Mexico,0,2,USA Cup,Pasadena,United States,False,2,-2,Mexico
17366,18892,20161,1997,Israel,Greece,1,1,Friendly,Jerusalem,Israel,False,2,0,Draw
17367,18893,20162,1997,Italy,Northern Ireland,2,0,Friendly,Palermo,Italy,False,2,2,Italy
17368,18894,20163,1997,Mexico,Peru,0,0,USA Cup,Pasadena,United States,True,0,0,Draw
17369,18895,20164,1997,New Zealand,Norway,0,3,Friendly,Brisbane,Australia,True,3,-3,Norway
17370,18896,20165,1997,Portugal,France,0,2,Friendly,Braga,Portugal,False,2,-2,France
17371,18897,20166,1997,Australia,Norway,1,0,Friendly,Sydney,Australia,False,1,1,Australia
17372,18898,20168,1997,Malawi,Zambia,0,2,African Cup of Nations qualification,Blantyre,Malawi,False,2,-2,Zambia
17373,18899,20169,1997,Cameroon,Namibia,4,0,African Cup of Nations qualification,Yaoundé,Cameroon,False,4,4,Cameroon
17374,18900,20170,1997,Chile,Honduras,3,2,Friendly,Santiago,Chile,False,5,1,Chile
17375,18901,20171,1997,Guinea,Tunisia,1,0,African Cup of Nations qualification,Conakry,Guinea,False,1,1,Guinea
17376,18902,20172,1997,Ivory Coast,Benin,1,0,African Cup of Nations qualification,Bouaké,Ivory Coast,False,1,1,Ivory Coast
17377,18903,20173,1997,Lebanon,Estonia,2,0,Friendly,Beirut,Lebanon,False,2,2,Lebanon
17378,18904,20174,1997,Liberia,Togo,1,2,African Cup of Nations qualification,Accra,Ghana,True,3,-1,Togo
17379,18905,20175,1997,Mali,Algeria,1,0,African Cup of Nations qualification,Bamako,Mali,False,1,1,Mali
17380,18906,20176,1997,Mozambique,Mauritius,3,0,African Cup of Nations qualification,Maputo,Mozambique,False,3,3,Mozambique
17381,18907,20177,1997,Eswatini,Lesotho,3,1,Friendly,Lobamba,Eswatini,False,4,2,Eswatini
17382,18908,20178,1997,Tanzania,DR Congo,1,2,African Cup of Nations qualification,Dar es Salaam,Tanzania,False,3,-1,DR Congo
17383,18909,20179,1997,Zimbabwe,Ghana,0,0,African Cup of Nations qualification,Harare,Zimbabwe,False,0,0,Draw
17384,18910,20182,1997,Bolivia,Slovakia,0,1,Friendly,Cochabamba,Bolivia,False,1,-1,Slovakia
17385,18911,20183,1997,Lebanon,Jordan,1,0,Friendly,Beirut,Lebanon,False,1,1,Lebanon
17386,18912,20184,1997,Costa Rica,Slovakia,2,2,Friendly,Alajuela,Costa Rica,False,4,0,Draw
17387,18913,20185,1997,Mexico,Ecuador,3,1,Friendly,Mexico City,Mexico,False,4,2,Mexico
17388,18914,20186,1997,Jordan,Lebanon,0,0,Friendly,Amman,Jordan,False,0,0,Draw
17389,18915,20187,1997,Russia,Serbia,1,1,Lunar New Year Cup,So Kon Po,Hong Kong,True,2,0,Draw
17390,18916,20188,1997,Colombia,Slovakia,1,0,Friendly,Pereira,Colombia,False,1,1,Colombia
17391,18917,20189,1997,Lebanon,Jordan,0,0,Friendly,Beirut,Lebanon,False,0,0,Draw
17392,18918,20190,1997,Thailand,Japan,1,1,King's Cup,Bangkok,Thailand,False,2,0,Draw
17393,18919,20191,1997,Russia,Switzerland,2,1,Lunar New Year Cup,So Kon Po,Hong Kong,True,3,1,Russia
17394,18920,20192,1997,Estonia,Scotland,0,0,FIFA World Cup qualification,Monaco,Monaco,True,0,0,Draw
17395,18921,20193,1997,Northern Ireland,Belgium,3,0,Friendly,Belfast,Northern Ireland,False,3,3,Northern Ireland
17396,18922,20194,1997,Thailand,Sweden,0,0,King's Cup,Bangkok,Thailand,False,0,0,Draw
17397,18923,20195,1997,Wales,Republic of Ireland,0,0,Friendly,Cardiff,Wales,False,0,0,Draw
17398,18924,20196,1997,Bolivia,Chile,1,1,FIFA World Cup qualification,La Paz,Bolivia,False,2,0,Draw
17399,18925,20197,1997,Colombia,Argentina,0,1,FIFA World Cup qualification,Barranquilla,Colombia,False,1,-1,Argentina
17400,18926,20198,1997,Ecuador,Uruguay,4,0,FIFA World Cup qualification,Quito,Ecuador,False,4,4,Ecuador
17401,18927,20199,1997,England,Italy,0,1,FIFA World Cup qualification,London,England,False,1,-1,Italy
17402,18928,20200,1997,Jamaica,Venezuela,0,0,Friendly,Kingston,Jamaica,False,0,0,Draw
17403,18929,20201,1997,Paraguay,Peru,2,1,FIFA World Cup qualification,Asunción,Paraguay,False,3,1,Paraguay
17404,18930,20202,1997,Spain,Malta,4,0,FIFA World Cup qualification,Alicante,Spain,False,4,4,Spain
17405,18931,20203,1997,Turkey,Finland,1,1,Friendly,Denizli,Turkey,False,2,0,Draw
17406,18932,20204,1997,Japan,Sweden,0,1,King's Cup,Bangkok,Thailand,True,1,-1,Sweden
17407,18933,20205,1997,Cyprus,Latvia,2,0,Cyprus International Tournament,Paralímni,Cyprus,False,2,2,Cyprus
17408,18934,20206,1997,Lithuania,Poland,0,0,Cyprus International Tournament,Agía Nápa,Cyprus,True,0,0,Draw
17409,18935,20207,1997,Cyprus,Poland,2,3,Cyprus International Tournament,Agía Nápa,Cyprus,False,5,-1,Poland
17410,18936,20208,1997,Latvia,Lithuania,1,0,Cyprus International Tournament,Dherynia,Cyprus,True,1,1,Latvia
17411,18937,20209,1997,Tonga,Solomon Islands,0,4,FIFA World Cup qualification,Nuku'alofa,Tonga,False,4,-4,Solomon Islands
17412,18938,20210,1997,Iraq,Jordan,1,0,Friendly,Baghdad,Iraq,False,1,1,Iraq
17413,18939,20211,1997,Senegal,Mali,1,1,Friendly,Dakar,Senegal,False,2,0,Draw
17414,18940,20212,1997,Thailand,Sweden,1,3,King's Cup,Bangkok,Thailand,False,4,-2,Sweden
17415,18941,20213,1997,Cyprus,Lithuania,1,0,Cyprus International Tournament,Paralímni,Cyprus,False,1,1,Cyprus
17416,18942,20214,1997,Fiji,Solomon Islands,1,2,Friendly,Suva,Fiji,False,3,-1,Solomon Islands
17417,18943,20215,1997,Latvia,Poland,2,3,Cyprus International Tournament,Dherynia,Cyprus,True,5,-1,Poland
17418,18944,20216,1997,Kuwait,Egypt,2,0,Friendly,Kuwait City,Kuwait,False,2,2,Kuwait
17419,18945,20217,1997,Costa Rica,Venezuela,5,2,Friendly,Heredia,Costa Rica,False,7,3,Costa Rica
17420,18946,20218,1997,Greece,Portugal,0,0,Friendly,Athens,Greece,False,0,0,Draw
17421,18947,20219,1997,Guyana,French Guiana,2,0,CFU Caribbean Cup qualification,Georgetown,Guyana,False,2,2,Guyana
17422,18948,20220,1997,Botswana,Eswatini,0,0,Friendly,Gaborone,Botswana,False,0,0,Draw
17423,18949,20222,1997,Fiji,Solomon Islands,3,2,Friendly,Nadi,Fiji,False,5,1,Fiji
17424,18950,20223,1997,Jamaica,Bermuda,1,0,CFU Caribbean Cup qualification,Kingston,Jamaica,False,1,1,Jamaica
17425,18951,20224,1997,Malaysia,Finland,2,1,Dunhill Cup,Kuala Lumpur,Malaysia,False,3,1,Malaysia
17426,18952,20225,1997,Bosnia and Herzegovina,Vietnam,4,0,Dunhill Cup,Kuala Lumpur,Malaysia,True,4,4,Bosnia and Herzegovina
17427,18954,20227,1997,Indonesia,Zimbabwe,0,0,Dunhill Cup,Kuala Lumpur,Malaysia,True,0,0,Draw
17428,18955,20228,1997,Benin,Algeria,1,1,African Cup of Nations qualification,Cotonou,Benin,False,2,0,Draw
17429,18956,20229,1997,Botswana,Lesotho,1,4,Friendly,Jwaneng,Botswana,False,5,-3,Lesotho
17430,18957,20231,1997,Ethiopia,Egypt,1,1,African Cup of Nations qualification,Addis Abeba,Ethiopia,False,2,0,Draw
17431,18958,20232,1997,Guyana,French Guiana,2,2,CFU Caribbean Cup qualification,Georgetown,Guyana,False,4,0,Draw
17432,18959,20233,1997,Jamaica,Bermuda,3,2,CFU Caribbean Cup qualification,Kingston,Jamaica,False,5,1,Jamaica
17433,18960,20234,1997,Malaysia,Singapore,0,0,Dunhill Cup,Kuala Lumpur,Malaysia,False,0,0,Draw
17434,18961,20235,1997,Mali,Ivory Coast,1,2,African Cup of Nations qualification,Bamako,Mali,False,3,-1,Ivory Coast
17435,18962,20236,1997,Mauritius,Zambia,0,0,African Cup of Nations qualification,Curepipe,Mauritius,False,0,0,Draw
17436,18963,20237,1997,Tanzania,Liberia,1,1,African Cup of Nations qualification,Dar es Salaam,Tanzania,False,2,0,Draw
17437,18964,20238,1997,Togo,DR Congo,1,1,African Cup of Nations qualification,Lomé,Togo,False,2,0,Draw
17438,18965,20239,1997,Zimbabwe,Angola,1,0,African Cup of Nations qualification,Harare,Zimbabwe,False,1,1,Zimbabwe
17439,18966,20240,1997,Bosnia and Herzegovina,Zimbabwe,2,2,Dunhill Cup,Kuala Lumpur,Malaysia,True,4,0,Draw
17440,18967,20241,1997,Indonesia,Vietnam,1,0,Dunhill Cup,Kuala Lumpur,Malaysia,True,1,1,Indonesia
17441,18969,20243,1997,Singapore,Finland,0,1,Dunhill Cup,Kuala Lumpur,Malaysia,True,1,-1,Finland
17442,18970,20244,1997,Bosnia and Herzegovina,Indonesia,2,0,Dunhill Cup,Kuala Lumpur,Malaysia,True,2,2,Bosnia and Herzegovina
17443,18971,20245,1997,Brazil,Poland,4,2,Friendly,Goiânia,Brazil,False,6,2,Brazil
17444,18972,20246,1997,France,Netherlands,2,1,Friendly,Paris,France,False,3,1,France
17445,18973,20247,1997,Israel,Germany,0,1,Friendly,Ramat-Gan,Israel,False,1,-1,Germany
17446,18974,20248,1997,Vietnam,Zimbabwe,0,6,Dunhill Cup,Kuala Lumpur,Malaysia,True,6,-6,Zimbabwe
17447,18975,20250,1997,Malaysia,Bosnia and Herzegovina,0,1,Dunhill Cup,Kuala Lumpur,Malaysia,False,1,-1,Bosnia and Herzegovina
17448,18976,20251,1997,Azerbaijan,Estonia,0,2,Friendly,Larnaca,Cyprus,True,2,-2,Estonia
17449,18977,20252,1997,Botswana,Malawi,1,4,COSAFA Cup,Gaborone,Botswana,False,5,-3,Malawi
17450,18978,20253,1997,Solomon Islands,Tonga,9,0,FIFA World Cup qualification,Honiara,Solomon Islands,False,9,9,Solomon Islands
17451,18980,20255,1997,Jamaica,United States,0,0,FIFA World Cup qualification,Kingston,Jamaica,False,0,0,Draw
17452,18981,20256,1997,Lesotho,Zambia,0,2,COSAFA Cup,Maseru,Lesotho,False,2,-2,Zambia
17453,18982,20257,1997,Mexico,Canada,4,0,FIFA World Cup qualification,Mexico City,Mexico,False,4,4,Mexico
17454,18983,20258,1997,Saudi Arabia,Syria,3,0,Friendly,Riyadh,Saudi Arabia,False,3,3,Saudi Arabia
17455,18985,20260,1997,Eswatini,Mozambique,0,4,COSAFA Cup,Lobamba,Eswatini,False,4,-4,Mozambique
17456,18986,20261,1997,Aruba,Curaçao,2,1,CFU Caribbean Cup qualification,Oranjestad,Aruba,False,3,1,Aruba
17457,18987,20262,1997,Bahrain,Oman,1,0,Friendly,Muharraq,Bahrain,False,1,1,Bahrain
17458,18988,20263,1997,Costa Rica,Cameroon,5,0,Friendly,San José,Costa Rica,False,5,5,Costa Rica
17459,18989,20264,1997,Saudi Arabia,Indonesia,2,0,Friendly,Dammam,Saudi Arabia,False,2,2,Saudi Arabia
17460,18990,20265,1997,Thailand,Hong Kong,2,0,FIFA World Cup qualification,Bangkok,Thailand,False,2,2,Thailand
17461,18991,20266,1997,Cyprus,Greece,0,4,Friendly,Paralímni,Cyprus,False,4,-4,Greece
17462,18992,20267,1997,Czech Republic,Poland,2,1,Friendly,Ostrava,Czech Republic,False,3,1,Czech Republic
17463,18993,20268,1997,Israel,Sweden,0,1,Friendly,Ramat-Gan,Israel,False,1,-1,Sweden
17464,18994,20270,1997,Martinique,Saint Lucia,1,0,CFU Caribbean Cup qualification,Fort-de-France,Martinique,False,1,1,Martinique
17465,18995,20271,1997,Saudi Arabia,Indonesia,3,1,Friendly,Dammam,Saudi Arabia,False,4,2,Saudi Arabia
17466,18996,20272,1997,Serbia,Russia,0,0,Friendly,Belgrade,Yugoslavia,False,0,0,Draw
17467,18997,20273,1997,El Salvador,Guatemala,0,0,Friendly,San Salvador,El Salvador,False,0,0,Draw
17468,18998,20274,1997,Saint Lucia,Saint Vincent and the Grenadines,3,2,CFU Caribbean Cup qualification,Fort-de-France,Martinique,True,5,1,Saint Lucia
17469,18999,20275,1997,Thailand,Japan,3,1,Friendly,Bangkok,Thailand,False,4,2,Thailand
17470,19000,20276,1997,Costa Rica,Mexico,0,0,FIFA World Cup qualification,San José,Costa Rica,False,0,0,Draw
17471,19001,20277,1997,Malaysia,Bangladesh,2,0,FIFA World Cup qualification,Kuala Lumpur,Malaysia,False,2,2,Malaysia
17472,19002,20278,1997,Namibia,Zimbabwe,2,1,COSAFA Cup,Windhoek,Namibia,False,3,1,Namibia
17473,19003,20279,1997,United States,Canada,3,0,FIFA World Cup qualification,Palo Alto,United States,False,3,3,United States
17474,19004,20280,1997,Austria,Slovenia,0,2,Friendly,Linz,Austria,False,2,-2,Slovenia
17475,19006,20282,1997,Kuwait,Bahrain,3,1,Friendly,Kuwait City,Kuwait,False,4,2,Kuwait
17476,19007,20283,1997,Malaysia,Saudi Arabia,0,0,FIFA World Cup qualification,Kuala Lumpur,Malaysia,False,0,0,Draw
17477,19008,20284,1997,Malta,Hungary,1,4,Friendly,Attard,Malta,False,5,-3,Hungary
17478,19009,20285,1997,United Arab Emirates,Lebanon,2,1,Friendly,Abu Dhabi,United Arab Emirates,False,3,1,United Arab Emirates
17479,19010,20286,1997,Bangladesh,Saudi Arabia,1,4,FIFA World Cup qualification,Kuala Lumpur,Malaysia,True,5,-3,Saudi Arabia
17480,19012,20288,1997,Azerbaijan,Turkmenistan,3,0,Friendly,Baku,Azerbaijan,False,3,3,Azerbaijan
17481,19013,20289,1997,Bolivia,Jamaica,6,0,Friendly,Oruro,Bolivia,False,6,6,Bolivia
17482,19014,20290,1997,Costa Rica,United States,3,2,FIFA World Cup qualification,San José,Costa Rica,False,5,1,Costa Rica
17483,19015,20291,1997,Nepal,Macau,1,1,FIFA World Cup qualification,Muscat,Oman,True,2,0,Draw
17484,19016,20292,1997,Oman,Japan,0,1,FIFA World Cup qualification,Muscat,Oman,False,1,-1,Japan
17485,19017,20293,1997,Panama,Belize,1,1,UNCAF Cup,Panama City,Panama,False,2,0,Draw
17486,19018,20294,1997,Guatemala,Ecuador,0,0,Friendly,Guatemala,Guatemala,False,0,0,Draw
17487,19019,20295,1997,Macau,Japan,0,10,FIFA World Cup qualification,Muscat,Oman,True,10,-10,Japan
17488,19020,20296,1997,Oman,Nepal,1,0,FIFA World Cup qualification,Muscat,Oman,False,1,1,Oman
17489,19021,20297,1997,Nepal,Japan,0,6,FIFA World Cup qualification,Muscat,Oman,True,6,-6,Japan
17490,19022,20298,1997,Oman,Macau,4,0,FIFA World Cup qualification,Muscat,Oman,False,4,4,Oman
17491,19023,20299,1997,Saudi Arabia,Bangladesh,3,0,FIFA World Cup qualification,Jeddah,Saudi Arabia,False,3,3,Saudi Arabia
17492,19024,20300,1997,Albania,Ukraine,0,1,FIFA World Cup qualification,Granada,Spain,True,1,-1,Ukraine
17493,19025,20301,1997,Croatia,Denmark,1,1,FIFA World Cup qualification,Split,Croatia,False,2,0,Draw
17494,19026,20302,1997,Cyprus,Russia,1,1,FIFA World Cup qualification,Paralímni,Cyprus,False,2,0,Draw
17495,19027,20303,1997,England,Mexico,2,0,Friendly,London,England,False,2,2,England
17496,19028,20304,1997,Italy,Moldova,3,0,FIFA World Cup qualification,Trieste,Italy,False,3,3,Italy
17497,19029,20305,1997,Netherlands,San Marino,4,0,FIFA World Cup qualification,Amsterdam,Netherlands,False,4,4,Netherlands
17498,19030,20306,1997,Northern Ireland,Portugal,0,0,FIFA World Cup qualification,Belfast,Northern Ireland,False,0,0,Draw
17499,19031,20307,1997,Romania,Liechtenstein,8,0,FIFA World Cup qualification,Bucharest,Romania,False,8,8,Romania
17500,19032,20308,1997,Saudi Arabia,Malaysia,3,0,FIFA World Cup qualification,Jeddah,Saudi Arabia,False,3,3,Saudi Arabia
17501,19033,20309,1997,Scotland,Estonia,2,0,FIFA World Cup qualification,Kilmarnock,Scotland,False,2,2,Scotland
17502,19034,20310,1997,Sierra Leone,Senegal,2,1,Friendly,Freetown,Sierra Leone,False,3,1,Sierra Leone
17503,19035,20311,1997,Tanzania,Burkina Faso,3,2,Friendly,Arusha,Tanzania,False,5,1,Tanzania
17504,19036,20312,1997,United Arab Emirates,Norway,1,4,Friendly,Sharjah,United Arab Emirates,False,5,-3,Norway
17505,19037,20313,1997,Wales,Belgium,1,2,FIFA World Cup qualification,Cardiff,Wales,False,3,-1,Belgium
17506,19038,20314,1997,Belize,Panama,0,1,UNCAF Cup,San Ignacio,Belize,False,1,-1,Panama
17507,19039,20316,1997,Gabon,Togo,2,1,Friendly,Libreville,Gabon,False,3,1,Gabon
17508,19040,20317,1997,Georgia,Armenia,7,0,Friendly,Tbilisi,Georgia,False,7,7,Georgia
17509,19041,20318,1997,Hong Kong,Thailand,3,2,FIFA World Cup qualification,Victoria,Hong Kong,False,5,1,Hong Kong
17510,19042,20319,1997,Bangladesh,Malaysia,0,1,FIFA World Cup qualification,Jeddah,Saudi Arabia,True,1,-1,Malaysia
17511,19043,20320,1997,Luxembourg,Israel,0,3,FIFA World Cup qualification,Luxembourg,Luxembourg,False,3,-3,Israel
17512,19044,20321,1997,Malta,Slovakia,0,2,FIFA World Cup qualification,Attard,Malta,False,2,-2,Slovakia
17513,19047,20324,1997,Albania,Germany,2,3,FIFA World Cup qualification,Granada,Spain,True,5,-1,Germany
17514,19048,20325,1997,Azerbaijan,Finland,1,2,FIFA World Cup qualification,Baku,Azerbaijan,False,3,-1,Finland
17515,19049,20326,1997,Barbados,Grenada,1,1,CFU Caribbean Cup qualification,Port of Spain,Trinidad and Tobago,True,2,0,Draw
17516,19050,20327,1997,Bolivia,Argentina,2,1,FIFA World Cup qualification,La Paz,Bolivia,False,3,1,Bolivia
17517,19051,20328,1997,Bosnia and Herzegovina,Greece,0,1,FIFA World Cup qualification,Sarajevo,Bosnia and Herzegovina,False,1,-1,Greece
17518,19052,20329,1997,Brazil,Chile,4,0,Friendly,Brasília,Brazil,False,4,4,Brazil
17519,19053,20330,1997,Bulgaria,Cyprus,4,1,FIFA World Cup qualification,Sofia,Bulgaria,False,5,3,Bulgaria
17520,19054,20331,1997,Croatia,Slovenia,3,3,FIFA World Cup qualification,Split,Croatia,False,6,0,Draw
17521,19055,20332,1997,Czech Republic,Serbia,1,2,FIFA World Cup qualification,Prague,Czech Republic,False,3,-1,Serbia
17522,19057,20334,1997,France,Sweden,1,0,Friendly,Paris,France,False,1,1,France
17523,19058,20335,1997,Hungary,Australia,1,3,Friendly,Budapest,Hungary,False,4,-2,Australia
17524,19059,20336,1997,Lithuania,Romania,0,1,FIFA World Cup qualification,Vilnius,Lithuania,False,1,-1,Romania
17525,19060,20338,1997,Paraguay,Colombia,2,1,FIFA World Cup qualification,Asunción,Paraguay,False,3,1,Paraguay
17526,19061,20339,1997,Peru,Ecuador,1,1,FIFA World Cup qualification,Lima,Peru,False,2,0,Draw
17527,19062,20340,1997,Poland,Italy,0,0,FIFA World Cup qualification,Chorzów,Poland,False,0,0,Draw
17528,19063,20341,1997,Scotland,Austria,2,0,FIFA World Cup qualification,Glasgow,Scotland,False,2,2,Scotland
17529,19064,20342,1997,Sint Maarten,Anguilla,3,0,CFU Caribbean Cup qualification,Roseau,Dominica,True,3,3,Sint Maarten
17530,19065,20343,1997,Switzerland,Latvia,1,0,Friendly,Lucerne,Switzerland,False,1,1,Switzerland
17531,19066,20344,1997,Trinidad and Tobago,Guyana,3,0,Friendly,Port of Spain,Trinidad and Tobago,False,3,3,Trinidad and Tobago
17532,19067,20345,1997,Turkey,Netherlands,1,0,FIFA World Cup qualification,Bursa,Turkey,False,1,1,Turkey
17533,19068,20346,1997,Ukraine,Northern Ireland,2,1,FIFA World Cup qualification,Kyïv,Ukraine,False,3,1,Ukraine
17534,19069,20347,1997,Uruguay,Venezuela,3,1,FIFA World Cup qualification,Montevideo,Uruguay,False,4,2,Uruguay
17535,19070,20350,1997,Dominica,Sint Maarten,1,0,CFU Caribbean Cup qualification,Roseau,Dominica,False,1,1,Dominica
17536,19071,20351,1997,Grenada,Guyana,5,1,CFU Caribbean Cup qualification,Palo Seco,Trinidad and Tobago,True,6,4,Grenada
17537,19072,20352,1997,Trinidad and Tobago,Barbados,0,1,Friendly,Palo Seco,Trinidad and Tobago,False,1,-1,Barbados
17538,19073,20353,1997,Nigeria,Guinea,2,1,FIFA World Cup qualification,Lagos,Nigeria,False,3,1,Nigeria
17539,19074,20354,1997,Sierra Leone,Ghana,1,1,FIFA World Cup qualification,Freetown,Sierra Leone,False,2,0,Draw
17540,19075,20355,1997,Angola,Togo,3,1,FIFA World Cup qualification,Luanda,Angola,False,4,2,Angola
17541,19076,20356,1997,Cameroon,Zimbabwe,1,0,FIFA World Cup qualification,Yaoundé,Cameroon,False,1,1,Cameroon
17542,19077,20357,1997,Canada,El Salvador,0,0,FIFA World Cup qualification,Burnaby,Canada,False,0,0,Draw
17543,19078,20358,1997,Congo,South Africa,2,0,FIFA World Cup qualification,Pointe-Noire,Congo,False,2,2,Congo
17544,19079,20359,1997,Dominica,Anguilla,5,0,CFU Caribbean Cup qualification,Roseau,Dominica,False,5,5,Dominica
17545,19080,20360,1997,Gabon,Morocco,0,4,FIFA World Cup qualification,Libreville,Gabon,False,4,-4,Morocco
17546,19081,20361,1997,Guyana,Barbados,0,2,CFU Caribbean Cup qualification,Arima,Trinidad and Tobago,True,2,-2,Barbados
17547,19082,20362,1997,India,Iraq,0,1,Nehru Cup,Cochin,India,False,1,-1,Iraq
17548,19083,20363,1997,Indonesia,Cambodia,8,0,FIFA World Cup qualification,Jakarta,Indonesia,False,8,8,Indonesia
17549,19084,20364,1997,Kenya,Burkina Faso,4,3,FIFA World Cup qualification,Nairobi,Kenya,False,7,1,Kenya
17550,19085,20365,1997,Liberia,Egypt,1,0,FIFA World Cup qualification,Accra,Ghana,True,1,1,Liberia
17551,19086,20366,1997,Namibia,Tunisia,1,2,FIFA World Cup qualification,Windhoek,Namibia,False,3,-1,Tunisia
17552,19088,20368,1997,Trinidad and Tobago,Grenada,2,3,Friendly,Arima,Trinidad and Tobago,False,5,-1,Grenada
17553,19089,20369,1997,India,Ghana,2,2,Nehru Cup,Cochin,India,False,4,0,Draw
17554,19090,20370,1997,Jordan,United Arab Emirates,0,0,FIFA World Cup qualification,Manama,Bahrain,True,0,0,Draw
17555,19091,20371,1997,DR Congo,Zambia,2,2,FIFA World Cup qualification,Harare,Zimbabwe,True,4,0,Draw
17556,19092,20372,1997,India,Iraq,1,1,Nehru Cup,Cochin,India,False,2,0,Draw
17557,19093,20373,1997,Bahrain,United Arab Emirates,1,2,FIFA World Cup qualification,Manama,Bahrain,False,3,-1,United Arab Emirates
17558,19095,20375,1997,Kuwait,Iran,0,2,Friendly,Kuwait City,Kuwait,False,2,-2,Iran
17559,19096,20376,1997,Malawi,Mozambique,2,2,COSAFA Cup,Lilongwe,Malawi,False,4,0,Draw
17560,19097,20377,1997,El Salvador,Guatemala,1,1,Friendly,Washington,United States,True,2,0,Draw
17561,19098,20378,1997,Indonesia,Yemen,0,0,FIFA World Cup qualification,Jakarta,Indonesia,False,0,0,Draw
17562,19099,20379,1997,Lebanon,Singapore,1,1,FIFA World Cup qualification,Beirut,Lebanon,False,2,0,Draw
17563,19100,20380,1997,Mexico,Jamaica,6,0,FIFA World Cup qualification,Mexico City,Mexico,False,6,6,Mexico
17564,19101,20381,1997,Bahrain,Jordan,1,0,FIFA World Cup qualification,Manama,Bahrain,False,1,1,Bahrain
17565,19102,20382,1997,Guatemala,Costa Rica,1,1,UNCAF Cup,Guatemala,Guatemala,False,2,0,Draw
17566,19103,20383,1997,Honduras,Panama,5,0,UNCAF Cup,Guatemala,Guatemala,True,5,5,Honduras
17567,19104,20384,1997,Thailand,Kuwait,3,1,Friendly,Bangkok,Thailand,False,4,2,Thailand
17568,19105,20385,1997,Costa Rica,Nicaragua,5,1,UNCAF Cup,Guatemala,Guatemala,True,6,4,Costa Rica
17569,19106,20386,1997,Honduras,El Salvador,3,0,UNCAF Cup,Guatemala,Guatemala,True,3,3,Honduras
17570,19107,20387,1997,Jordan,Bahrain,4,1,FIFA World Cup qualification,Sharjah,United Arab Emirates,True,5,3,Jordan
17571,19108,20388,1997,Cambodia,Yemen,0,1,FIFA World Cup qualification,Phnom Penh,Cambodia,False,1,-1,Yemen
17572,19109,20389,1997,Cameroon,Congo,2,0,Friendly,Yaoundé,Cameroon,False,2,2,Cameroon
17573,19110,20390,1997,El Salvador,Panama,2,0,UNCAF Cup,Guatemala,Guatemala,True,2,2,El Salvador
17574,19111,20391,1997,Guatemala,Nicaragua,6,1,UNCAF Cup,Guatemala,Guatemala,False,7,5,Guatemala
17575,19112,20392,1997,United States,Mexico,2,2,FIFA World Cup qualification,Foxborough,United States,False,4,0,Draw
17576,19113,20394,1997,Iran,Kenya,3,0,Friendly,Tabriz,Iran,False,3,3,Iran
17577,19114,20395,1997,United Arab Emirates,Bahrain,3,0,FIFA World Cup qualification,Sharjah,United Arab Emirates,False,3,3,United Arab Emirates
17578,19115,20397,1997,Guatemala,El Salvador,1,0,UNCAF Cup,Guatemala,Guatemala,False,1,1,Guatemala
17579,19116,20398,1997,Honduras,Costa Rica,0,4,UNCAF Cup,Guatemala,Guatemala,True,4,-4,Costa Rica
17580,19117,20399,1997,Costa Rica,El Salvador,1,0,UNCAF Cup,Guatemala,Guatemala,True,1,1,Costa Rica
17581,19118,20400,1997,Guatemala,Honduras,1,0,UNCAF Cup,Guatemala,Guatemala,False,1,1,Guatemala
17582,19119,20401,1997,Turkmenistan,Azerbaijan,2,0,Friendly,Ashgabat,Turkmenistan,False,2,2,Turkmenistan
17583,19120,20402,1997,Namibia,Egypt,2,3,FIFA World Cup qualification,Windhoek,Namibia,False,5,-1,Egypt
17584,19121,20403,1997,Sierra Leone,Morocco,0,1,FIFA World Cup qualification,Freetown,Sierra Leone,False,1,-1,Morocco
17585,19122,20404,1997,Singapore,Kuwait,0,1,FIFA World Cup qualification,Singapore,Singapore,False,1,-1,Kuwait
17586,19123,20405,1997,United Arab Emirates,Jordan,2,0,FIFA World Cup qualification,Sharjah,United Arab Emirates,False,2,2,United Arab Emirates
17587,19124,20406,1997,Burkina Faso,Nigeria,1,2,FIFA World Cup qualification,Ouagadougou,Burkina Faso,False,3,-1,Nigeria
17588,19125,20407,1997,Cambodia,Indonesia,1,1,FIFA World Cup qualification,Phnom Penh,Cambodia,False,2,0,Draw
17589,19126,20408,1997,Cameroon,Togo,2,0,FIFA World Cup qualification,Yaoundé,Cameroon,False,2,2,Cameroon
17590,19127,20409,1997,Canada,Jamaica,0,0,FIFA World Cup qualification,Burnaby,Canada,False,0,0,Draw
17591,19128,20411,1997,DR Congo,South Africa,1,2,FIFA World Cup qualification,Lomé,Togo,True,3,-1,South Africa
17592,19129,20412,1997,Dominica,Martinique,1,2,CFU Caribbean Cup qualification,Roseau,Dominica,False,3,-1,Martinique
17593,19130,20413,1997,Ghana,Gabon,3,0,FIFA World Cup qualification,Accra,Ghana,False,3,3,Ghana
17594,19131,20414,1997,Guatemala,Costa Rica,1,1,UNCAF Cup,Guatemala,Guatemala,False,2,0,Draw
17595,19132,20415,1997,Honduras,El Salvador,0,0,UNCAF Cup,Guatemala,Guatemala,True,0,0,Draw
17596,19133,20416,1997,Kenya,Guinea,1,0,FIFA World Cup qualification,Nairobi,Kenya,False,1,1,Kenya
17597,19134,20417,1997,Lebanon,Libya,2,0,Friendly,Beirut,Lebanon,False,2,2,Lebanon
17598,19135,20418,1997,Tunisia,Liberia,2,0,FIFA World Cup qualification,Tunis,Tunisia,False,2,2,Tunisia
17599,19136,20419,1997,Zambia,Congo,3,0,FIFA World Cup qualification,Lusaka,Zambia,False,3,3,Zambia
17600,19137,20420,1997,Zimbabwe,Angola,0,0,FIFA World Cup qualification,Harare,Zimbabwe,False,0,0,Draw
17601,19138,20421,1997,Bermuda,Saint Martin,2,1,Friendly,Hamilton,Bermuda,False,3,1,Bermuda
17602,19139,20422,1997,Chile,Venezuela,6,0,FIFA World Cup qualification,Santiago,Chile,False,6,6,Chile
17603,19140,20423,1997,Slovakia,Iceland,3,1,Friendly,Trnava,Slovakia,False,4,2,Slovakia
17604,19141,20424,1997,Argentina,Ecuador,2,1,FIFA World Cup qualification,Buenos Aires,Argentina,False,3,1,Argentina
17605,19142,20425,1997,Armenia,Northern Ireland,0,0,FIFA World Cup qualification,Yerevan,Armenia,False,0,0,Draw
17606,19143,20426,1997,Austria,Estonia,2,0,FIFA World Cup qualification,Vienna,Austria,False,2,2,Austria
17607,19144,20427,1997,Brazil,Mexico,4,0,Friendly,Miami,United States,True,4,4,Brazil
17608,19145,20428,1997,Colombia,Peru,0,1,FIFA World Cup qualification,Barranquilla,Colombia,False,1,-1,Peru
17609,19146,20429,1997,Denmark,Slovenia,4,0,FIFA World Cup qualification,Copenhagen,Denmark,False,4,4,Denmark
17610,19147,20430,1997,England,Georgia,2,0,FIFA World Cup qualification,London,England,False,2,2,England
17611,19148,20431,1997,Germany,Ukraine,2,0,FIFA World Cup qualification,Bremen,Germany,False,2,2,Germany
17612,19149,20432,1997,Greece,Croatia,0,1,FIFA World Cup qualification,Salonica,Greece,False,1,-1,Croatia
17613,19150,20433,1997,Israel,Cyprus,2,0,FIFA World Cup qualification,Ramat-Gan,Israel,False,2,2,Israel
17614,19151,20434,1997,Italy,Poland,3,0,FIFA World Cup qualification,Naples,Italy,False,3,3,Italy
17615,19152,20435,1997,Latvia,Belarus,2,0,FIFA World Cup qualification,Riga,Latvia,False,2,2,Latvia
17616,19153,20436,1997,Liechtenstein,Lithuania,0,2,FIFA World Cup qualification,Eschen,Liechtenstein,False,2,-2,Lithuania
17617,19154,20437,1997,Malta,Faroe Islands,1,2,FIFA World Cup qualification,Attard,Malta,False,3,-1,Faroe Islands
17618,19155,20438,1997,Norway,Finland,1,1,FIFA World Cup qualification,Oslo,Norway,False,2,0,Draw
17619,19156,20439,1997,Paraguay,Uruguay,3,1,FIFA World Cup qualification,Asunción,Paraguay,False,4,2,Paraguay
17620,19157,20440,1997,Romania,Republic of Ireland,1,0,FIFA World Cup qualification,Bucharest,Romania,False,1,1,Romania
17621,19158,20441,1997,Russia,Luxembourg,3,0,FIFA World Cup qualification,Moscow,Russia,False,3,3,Russia
17622,19159,20442,1997,San Marino,Netherlands,0,6,FIFA World Cup qualification,Serravalle,San Marino,False,6,-6,Netherlands
17623,19160,20443,1997,Serbia,Spain,1,1,FIFA World Cup qualification,Belgrade,Yugoslavia,True,2,0,Draw
17624,19161,20444,1997,Sweden,Scotland,2,1,FIFA World Cup qualification,Gothenburg,Sweden,False,3,1,Sweden
17625,19162,20445,1997,Switzerland,Hungary,1,0,FIFA World Cup qualification,Zürich,Switzerland,False,1,1,Switzerland
17626,19163,20446,1997,Syria,Libya,1,1,Friendly,Damascus,Syria,False,2,0,Draw
17627,19164,20447,1997,Turkey,Belgium,1,3,FIFA World Cup qualification,Istanbul,Turkey,False,4,-2,Belgium
17628,19165,20448,1997,Fiji,New Caledonia,5,1,Friendly,Suva,Fiji,False,6,4,Fiji
17629,19166,20449,1997,Trinidad and Tobago,Jamaica,1,1,Friendly,Palo Seco,Trinidad and Tobago,False,2,0,Draw
17630,19167,20450,1997,Aruba,Jamaica,0,6,CFU Caribbean Cup qualification,Oranjestad,Aruba,False,6,-6,Jamaica
17631,19168,20451,1997,El Salvador,Costa Rica,2,1,FIFA World Cup qualification,San Salvador,El Salvador,False,3,1,El Salvador
17632,19169,20452,1997,Martinique,Dominica,7,0,CFU Caribbean Cup qualification,Fort-de-France,Martinique,False,7,7,Martinique
17633,19170,20453,1997,Tajikistan,Vietnam,4,0,FIFA World Cup qualification,Dushanbe,Tajikistan,False,4,4,Tajikistan
17634,19172,20455,1997,Guernsey,Jersey,2,1,Friendly,St. Sampson,Guernsey,False,3,1,Guernsey
17635,19173,20456,1997,Ukraine,Armenia,1,1,FIFA World Cup qualification,Kyïv,Ukraine,False,2,0,Draw
17636,19174,20457,1997,Ivory Coast,Senegal,4,1,Friendly,Bouaké,Ivory Coast,False,5,3,Ivory Coast
17637,19175,20458,1997,Kuwait,Lebanon,2,0,FIFA World Cup qualification,Kuwait City,Kuwait,False,2,2,Kuwait
17638,19176,20459,1997,Yemen,Uzbekistan,0,1,FIFA World Cup qualification,Sana'a,Yemen,False,1,-1,Uzbekistan
17639,19177,20460,1997,Costa Rica,Jamaica,3,1,FIFA World Cup qualification,San José,Costa Rica,False,4,2,Costa Rica
17640,19178,20461,1997,Kazakhstan,Pakistan,3,0,FIFA World Cup qualification,Almaty,Kazakhstan,False,3,3,Kazakhstan
17641,19180,20463,1997,Turkmenistan,Vietnam,2,1,FIFA World Cup qualification,Ashgabat,Turkmenistan,False,3,1,Turkmenistan
17642,19181,20464,1997,Yemen,Cambodia,7,0,FIFA World Cup qualification,Sana'a,Yemen,False,7,7,Yemen
17643,19182,20465,1997,Estonia,Latvia,1,3,FIFA World Cup qualification,Tallinn,Estonia,False,4,-2,Latvia
17644,19183,20466,1997,Jamaica,El Salvador,1,0,FIFA World Cup qualification,Kingston,Jamaica,False,1,1,Jamaica
17645,19184,20467,1997,Republic of Ireland,Liechtenstein,5,0,FIFA World Cup qualification,Dublin,Republic of Ireland,False,5,5,Republic of Ireland
17646,19186,20469,1997,Thailand,Northern Ireland,0,0,Friendly,Bangkok,Thailand,False,0,0,Draw
17647,19187,20470,1997,Sweden,Poland,2,2,Friendly,Solna,Sweden,False,4,0,Draw
17648,19188,20471,1997,Pakistan,Iraq,2,6,FIFA World Cup qualification,Lahore,Pakistan,False,8,-4,Iraq
17649,19189,20472,1997,England,South Africa,2,1,Friendly,Manchester,England,False,3,1,England
17650,19190,20473,1997,Singapore,Lebanon,1,2,FIFA World Cup qualification,Singapore,Singapore,False,3,-1,Lebanon
17651,19191,20474,1997,Turkmenistan,Tajikistan,1,2,FIFA World Cup qualification,Ashgabat,Turkmenistan,False,3,-1,Tajikistan
17652,19192,20475,1997,Uzbekistan,Cambodia,6,0,FIFA World Cup qualification,Tashkent,Uzbekistan,False,6,6,Uzbekistan
17653,19194,20477,1997,Kuwait,Zambia,2,1,Friendly,Kuwait City,Kuwait,False,3,1,Kuwait
17654,19195,20478,1997,Scotland,Wales,0,1,Friendly,Kilmarnock,Scotland,False,1,-1,Wales
17655,19196,20479,1997,El Salvador,Ecuador,0,2,Friendly,San Salvador,El Salvador,False,2,-2,Ecuador
17656,19197,20481,1997,Norway,Brazil,4,2,Friendly,Oslo,Norway,False,6,2,Norway
17657,19198,20482,1997,Burkina Faso,Mali,2,0,Friendly,Bobo Dioulasso,Burkina Faso,False,2,2,Burkina Faso
17658,19199,20483,1997,Morocco,Ethiopia,4,0,African Cup of Nations qualification,Rabat,Morocco,False,4,4,Morocco
17659,19200,20484,1997,Papua New Guinea,New Zealand,1,0,FIFA World Cup qualification,Port Moresby,Papua New Guinea,False,1,1,Papua New Guinea
17660,19201,20485,1997,Poland,England,0,2,FIFA World Cup qualification,Chorzów,Poland,False,2,-2,England
17661,19202,20486,1997,Tanzania,Namibia,0,0,COSAFA Cup,Mwanza,Tanzania,False,0,0,Draw
17662,19203,20487,1997,Tunisia,Algeria,0,1,Friendly,Tunis,Tunisia,False,1,-1,Algeria
17663,19204,20488,1997,Canada,Costa Rica,1,0,FIFA World Cup qualification,Edmonton,Canada,False,1,1,Canada
17664,19205,20490,1997,Indonesia,Uzbekistan,1,1,FIFA World Cup qualification,Jakarta,Indonesia,False,2,0,Draw
17665,19206,20492,1997,Malta,Scotland,2,3,Friendly,Attard,Malta,False,5,-1,Scotland
17666,19207,20493,1997,Vietnam,Tajikistan,0,4,FIFA World Cup qualification,Ho Chi Minh City,Vietnam,False,4,-4,Tajikistan
17667,19208,20494,1997,Zambia,Cameroon,3,0,Friendly,Lusaka,Zambia,False,3,3,Zambia
17668,19209,20495,1997,Maldives,Iran,0,17,FIFA World Cup qualification,Damascus,Syria,True,17,-17,Iran
17669,19210,20496,1997,France,Brazil,1,1,Tournoi de France,Lyon,France,False,2,0,Draw
17670,19211,20497,1997,England,Italy,2,0,Tournoi de France,Nantes,France,True,2,2,England
17671,19212,20498,1997,Estonia,Azerbaijan,1,0,Friendly,Viljandi,Estonia,False,1,1,Estonia
17672,19213,20499,1997,Kyrgyzstan,Iran,0,7,FIFA World Cup qualification,Damascus,Syria,True,7,-7,Iran
17673,19214,20500,1997,South Africa,Netherlands,0,2,Friendly,Johannesburg,South Africa,False,2,-2,Netherlands
17674,19215,20501,1997,Syria,Maldives,12,0,FIFA World Cup qualification,Damascus,Syria,False,12,12,Syria
17675,19216,20502,1997,Togo,Burkina Faso,0,0,Friendly,Lomé,Togo,False,0,0,Draw
17676,19217,20503,1997,United States,Paraguay,0,0,Friendly,St. Louis,United States,False,0,0,Draw
17677,19218,20504,1997,Kuwait,Singapore,4,0,FIFA World Cup qualification,Kuwait City,Kuwait,False,4,4,Kuwait
17678,19219,20505,1997,Senegal,Algeria,0,0,Friendly,Dakar,Senegal,False,0,0,Draw
17679,19220,20506,1997,Iraq,Kazakhstan,1,2,FIFA World Cup qualification,Baghdad,Iraq,False,3,-1,Kazakhstan
17680,19221,20507,1997,Kyrgyzstan,Maldives,3,0,FIFA World Cup qualification,Damascus,Syria,True,3,3,Kyrgyzstan
17681,19222,20508,1997,Palestine,Jordan,0,0,Friendly,Jericho,Palestine,False,0,0,Draw
17682,19223,20509,1997,Syria,Iran,0,1,FIFA World Cup qualification,Damascus,Syria,False,1,-1,Iran
17683,19224,20510,1997,Belgium,San Marino,6,0,FIFA World Cup qualification,Brussels,Belgium,False,6,6,Belgium
17684,19225,20511,1997,Fiji,New Zealand,0,1,FIFA World Cup qualification,Ba,Fiji,False,1,-1,New Zealand
17685,19226,20512,1997,France,England,0,1,Tournoi de France,Montpellier,France,False,1,-1,England
17686,19227,20513,1997,Georgia,Moldova,2,0,FIFA World Cup qualification,Batumi,Georgia,False,2,2,Georgia
17687,19228,20515,1997,Morocco,Ghana,1,0,FIFA World Cup qualification,Casablanca,Morocco,False,1,1,Morocco
17688,19229,20516,1997,Nigeria,Kenya,3,0,FIFA World Cup qualification,Lagos,Nigeria,False,3,3,Nigeria
17689,19230,20517,1997,Portugal,Albania,2,0,FIFA World Cup qualification,Porto,Portugal,False,2,2,Portugal
17690,19231,20518,1997,Ukraine,Germany,0,0,FIFA World Cup qualification,Kyïv,Ukraine,False,0,0,Draw
17691,19232,20519,1997,Angola,Cameroon,1,1,FIFA World Cup qualification,Luanda,Angola,False,2,0,Draw
17692,19233,20520,1997,Argentina,Peru,2,0,FIFA World Cup qualification,Buenos Aires,Argentina,False,2,2,Argentina
17693,19234,20521,1997,Belarus,Scotland,0,1,FIFA World Cup qualification,Minsk,Belarus,False,1,-1,Scotland
17694,19235,20522,1997,Bulgaria,Luxembourg,4,0,FIFA World Cup qualification,Burgas,Bulgaria,False,4,4,Bulgaria
17695,19236,20524,1997,Congo,DR Congo,1,0,FIFA World Cup qualification,Pointe-Noire,Congo,False,1,1,Congo
17696,19237,20525,1997,Denmark,Bosnia and Herzegovina,2,0,FIFA World Cup qualification,Copenhagen,Denmark,False,2,2,Denmark
17697,19238,20526,1997,Ecuador,Chile,1,1,FIFA World Cup qualification,Quito,Ecuador,False,2,0,Draw
17698,19239,20527,1997,Egypt,Tunisia,0,0,FIFA World Cup qualification,Cairo,Egypt,False,0,0,Draw
17699,19240,20528,1997,El Salvador,Mexico,0,1,FIFA World Cup qualification,San Salvador,El Salvador,False,1,-1,Mexico
17700,19241,20529,1997,Estonia,Sweden,2,3,FIFA World Cup qualification,Tallinn,Estonia,False,5,-1,Sweden
17701,19242,20530,1997,Faroe Islands,Malta,2,1,FIFA World Cup qualification,Toftir,Faroe Islands,False,3,1,Faroe Islands
17702,19243,20531,1997,Finland,Azerbaijan,3,0,FIFA World Cup qualification,Helsinki,Finland,False,3,3,Finland
17703,19244,20532,1997,Guinea,Burkina Faso,3,1,FIFA World Cup qualification,Conakry,Guinea,False,4,2,Guinea
17704,19245,20533,1997,Hungary,Norway,1,1,FIFA World Cup qualification,Budapest,Hungary,False,2,0,Draw
17705,19246,20534,1997,Italy,Brazil,3,3,Tournoi de France,Lyon,France,True,6,0,Draw
17706,19247,20535,1997,Japan,Croatia,4,3,Kirin Cup,Tokyo,Japan,False,7,1,Japan
17707,19248,20536,1997,Latvia,Austria,1,3,FIFA World Cup qualification,Riga,Latvia,False,4,-2,Austria
17708,19249,20537,1997,Liberia,Namibia,1,2,FIFA World Cup qualification,Monrovia,Liberia,False,3,-1,Namibia
17709,19250,20538,1997,Russia,Israel,2,0,FIFA World Cup qualification,Moscow,Russia,False,2,2,Russia
17710,19251,20539,1997,Serbia,Slovakia,2,0,FIFA World Cup qualification,Belgrade,Yugoslavia,True,2,2,Serbia
17711,19252,20540,1997,South Africa,Zambia,3,0,FIFA World Cup qualification,Johannesburg,South Africa,False,3,3,South Africa
17712,19253,20541,1997,Spain,Czech Republic,1,0,FIFA World Cup qualification,Valladolid,Spain,False,1,1,Spain
17713,19254,20542,1997,Togo,Zimbabwe,2,1,FIFA World Cup qualification,Lomé,Togo,False,3,1,Togo
17714,19255,20543,1997,Uruguay,Colombia,1,1,FIFA World Cup qualification,Montevideo,Uruguay,False,2,0,Draw
17715,19256,20544,1997,Venezuela,Bolivia,1,1,FIFA World Cup qualification,Valera,Venezuela,False,2,0,Draw
17716,19257,20545,1997,Vietnam,Turkmenistan,0,4,FIFA World Cup qualification,Ho Chi Minh City,Vietnam,False,4,-4,Turkmenistan
17717,19258,20546,1997,Iran,Kyrgyzstan,3,1,FIFA World Cup qualification,Teheran,Iran,False,4,2,Iran
17718,19259,20547,1997,Maldives,Syria,0,12,FIFA World Cup qualification,Teheran,Iran,True,12,-12,Syria
17719,19260,20548,1997,England,Brazil,0,1,Tournoi de France,Paris,France,True,1,-1,Brazil
17720,19261,20549,1997,Argentina,Ecuador,0,0,Copa América,Cochabamba,Bolivia,True,0,0,Draw
17721,19262,20550,1997,Australia,Solomon Islands,13,0,FIFA World Cup qualification,Sydney,Australia,False,13,13,Australia
17722,19263,20551,1997,Chile,Paraguay,0,1,Copa América,Cochabamba,Bolivia,True,1,-1,Paraguay
17723,19264,20552,1997,France,Italy,2,2,Tournoi de France,Paris,France,False,4,0,Draw
17724,19265,20553,1997,Iceland,Lithuania,0,0,FIFA World Cup qualification,Reykjavík,Iceland,False,0,0,Draw
17725,19266,20554,1997,Iran,Maldives,9,0,FIFA World Cup qualification,Teheran,Iran,False,9,9,Iran
17726,19267,20555,1997,Kyrgyzstan,Syria,2,1,FIFA World Cup qualification,Teheran,Iran,True,3,1,Kyrgyzstan
17727,19268,20556,1997,New Zealand,Papua New Guinea,7,0,FIFA World Cup qualification,Auckland,New Zealand,False,7,7,New Zealand
17728,19269,20557,1997,Pakistan,Kazakhstan,0,7,FIFA World Cup qualification,Lahore,Pakistan,False,7,-7,Kazakhstan
17729,19270,20558,1997,Bolivia,Venezuela,1,0,Copa América,La Paz,Bolivia,False,1,1,Bolivia
17730,19271,20559,1997,Croatia,Turkey,1,1,Kirin Cup,Sendai,Japan,True,2,0,Draw
17731,19272,20560,1997,Ghana,Serbia,1,3,Korea Cup,Seoul,South Korea,True,4,-2,Serbia
17732,19273,20562,1997,Peru,Uruguay,1,0,Copa América,Sucre,Bolivia,True,1,1,Peru
17733,19275,20564,1997,Brazil,Costa Rica,5,0,Copa América,Santa Cruz,Bolivia,True,5,5,Brazil
17734,19276,20565,1997,Iran,Syria,2,2,FIFA World Cup qualification,Teheran,Iran,False,4,0,Draw
17735,19277,20566,1997,Maldives,Kyrgyzstan,0,6,FIFA World Cup qualification,Teheran,Iran,True,6,-6,Kyrgyzstan
17736,19278,20567,1997,Mexico,Colombia,2,1,Copa América,Santa Cruz,Bolivia,True,3,1,Mexico
17737,19279,20568,1997,Yemen,Indonesia,1,1,FIFA World Cup qualification,Sana'a,Yemen,False,2,0,Draw
17738,19280,20569,1997,Argentina,Chile,2,0,Copa América,Cochabamba,Bolivia,True,2,2,Argentina
17739,19281,20570,1997,Egypt,Serbia,0,0,Korea Cup,Suwon,South Korea,True,0,0,Draw
17740,19282,20572,1997,Paraguay,Ecuador,0,2,Copa América,Cochabamba,Bolivia,True,2,-2,Ecuador
17741,19283,20573,1997,Poland,Georgia,4,1,FIFA World Cup qualification,Katowice,Poland,False,5,3,Poland
17742,19284,20574,1997,Bolivia,Peru,2,0,Copa América,La Paz,Bolivia,False,2,2,Bolivia
17743,19285,20575,1997,Fiji,Papua New Guinea,3,1,FIFA World Cup qualification,Suva,Fiji,False,4,2,Fiji
17744,19286,20576,1997,Japan,Turkey,1,0,Kirin Cup,Osaka,Japan,False,1,1,Japan
17745,19287,20577,1997,Mozambique,Tanzania,3,0,COSAFA Cup,Maputo,Mozambique,False,3,3,Mozambique
17746,19289,20579,1997,Uruguay,Venezuela,2,0,Copa América,Sucre,Bolivia,True,2,2,Uruguay
17747,19290,20580,1997,Brazil,Mexico,3,2,Copa América,Santa Cruz,Bolivia,True,5,1,Brazil
17748,19291,20581,1997,Colombia,Costa Rica,4,1,Copa América,Santa Cruz,Bolivia,True,5,3,Colombia
17749,19292,20582,1997,Egypt,Ghana,2,0,Korea Cup,Seoul,South Korea,True,2,2,Egypt
17750,19293,20584,1997,Argentina,Paraguay,1,1,Copa América,Cochabamba,Bolivia,True,2,0,Draw
17751,19294,20585,1997,Australia,Solomon Islands,6,2,FIFA World Cup qualification,Sydney,Australia,False,8,4,Australia
17752,19295,20586,1997,Chile,Ecuador,1,2,Copa América,Cochabamba,Bolivia,True,3,-1,Ecuador
17753,19296,20587,1997,United States,Israel,2,1,Friendly,Jacksonville,United States,False,3,1,United States
17754,19297,20588,1997,Bolivia,Uruguay,1,0,Copa América,La Paz,Bolivia,False,1,1,Bolivia
17755,19298,20589,1997,New Zealand,Fiji,5,0,FIFA World Cup qualification,Auckland,New Zealand,False,5,5,New Zealand
17756,19299,20590,1997,Peru,Venezuela,2,0,Copa América,Sucre,Bolivia,True,2,2,Peru
17757,19301,20592,1997,Brazil,Colombia,2,0,Copa América,Santa Cruz,Bolivia,True,2,2,Brazil
17758,19302,20593,1997,Mexico,Costa Rica,1,1,Copa América,Santa Cruz,Bolivia,True,2,0,Draw
17759,19303,20594,1997,Iraq,Pakistan,6,1,FIFA World Cup qualification,Baghdad,Iraq,False,7,5,Iraq
17760,19304,20595,1997,Uzbekistan,Indonesia,3,0,FIFA World Cup qualification,Tashkent,Uzbekistan,False,3,3,Uzbekistan
17761,19305,20596,1997,Antigua and Barbuda,Saint Lucia,1,1,Friendly,St. John's,Antigua and Barbuda,False,2,0,Draw
17762,19306,20597,1997,Bolivia,Colombia,2,1,Copa América,La Paz,Bolivia,False,3,1,Bolivia
17763,19307,20598,1997,Morocco,Egypt,1,0,African Cup of Nations qualification,Rabat,Morocco,False,1,1,Morocco
17764,19308,20599,1997,Papua New Guinea,Fiji,0,1,FIFA World Cup qualification,Port Moresby,Papua New Guinea,False,1,-1,Fiji
17765,19309,20600,1997,Peru,Argentina,2,1,Copa América,Sucre,Bolivia,True,3,1,Peru
17766,19310,20602,1997,Angola,Ghana,1,0,African Cup of Nations qualification,Luanda,Angola,False,1,1,Angola
17767,19311,20603,1997,Antigua and Barbuda,Saint Lucia,1,0,Friendly,St. John's,Antigua and Barbuda,False,1,1,Antigua and Barbuda
17768,19312,20604,1997,Brazil,Paraguay,2,0,Copa América,Santa Cruz,Bolivia,True,2,2,Brazil
17769,19313,20605,1997,Cameroon,Gabon,2,2,African Cup of Nations qualification,Yaoundé,Cameroon,False,4,0,Draw
17770,19314,20607,1997,Ecuador,Mexico,1,1,Copa América,Cochabamba,Bolivia,True,2,0,Draw
17771,19315,20608,1997,Estonia,Andorra,4,1,Friendly,Kuressaare,Estonia,False,5,3,Estonia
17772,19316,20609,1997,Ivory Coast,Algeria,2,1,African Cup of Nations qualification,Bouaké,Ivory Coast,False,3,1,Ivory Coast
17773,19317,20610,1997,Japan,Macau,10,0,FIFA World Cup qualification,Tokyo,Japan,False,10,10,Japan
17774,19318,20611,1997,Lebanon,Kuwait,1,3,FIFA World Cup qualification,Beirut,Lebanon,False,4,-2,Kuwait
17775,19319,20612,1997,Liberia,DR Congo,2,1,African Cup of Nations qualification,Monrovia,Liberia,False,3,1,Liberia
17776,19320,20613,1997,Mali,Benin,3,1,African Cup of Nations qualification,Bamako,Mali,False,4,2,Mali
17777,19321,20614,1997,Mozambique,Zambia,2,2,African Cup of Nations qualification,Maputo,Mozambique,False,4,0,Draw
17778,19322,20615,1997,Nepal,Oman,0,6,FIFA World Cup qualification,Tokyo,Japan,True,6,-6,Oman
17779,19323,20616,1997,Senegal,Ethiopia,3,0,African Cup of Nations qualification,Dakar,Senegal,False,3,3,Senegal
17780,19324,20617,1997,Tajikistan,Turkmenistan,5,0,FIFA World Cup qualification,Dushanbe,Tajikistan,False,5,5,Tajikistan
17781,19325,20618,1997,Tanzania,Togo,1,0,African Cup of Nations qualification,Arusha,Tanzania,False,1,1,Tanzania
17782,19326,20619,1997,Bolivia,Mexico,3,1,Copa América,La Paz,Bolivia,False,4,2,Bolivia
17783,19327,20620,1997,Japan,Nepal,3,0,FIFA World Cup qualification,Tokyo,Japan,False,3,3,Japan
17784,19328,20621,1997,Latvia,Andorra,4,1,Friendly,Riga,Latvia,False,5,3,Latvia
17785,19329,20622,1997,Macau,Oman,0,2,FIFA World Cup qualification,Tokyo,Japan,True,2,-2,Oman
17786,19330,20623,1997,Brazil,Peru,7,0,Copa América,Santa Cruz,Bolivia,True,7,7,Brazil
17787,19331,20624,1997,DR Congo,Uganda,0,0,Friendly,Kinshasa,DR Congo,False,0,0,Draw
17788,19332,20625,1997,Japan,Oman,1,1,FIFA World Cup qualification,Tokyo,Japan,False,2,0,Draw
17789,19333,20626,1997,Macau,Nepal,2,1,FIFA World Cup qualification,Tokyo,Japan,True,3,1,Macau
17790,19334,20627,1997,Mexico,Peru,1,0,Copa América,Oruro,Bolivia,True,1,1,Mexico
17791,19335,20628,1997,Namibia,Malawi,4,1,COSAFA Cup,Windhoek,Namibia,False,5,3,Namibia
17792,19336,20629,1997,New Zealand,Australia,0,3,FIFA World Cup qualification,Auckland,New Zealand,False,3,-3,Australia
17793,19337,20630,1997,Bolivia,Brazil,1,3,Copa América,La Paz,Bolivia,False,4,-2,Brazil
17794,19338,20631,1997,Cambodia,Uzbekistan,1,4,FIFA World Cup qualification,Phnom Penh,Cambodia,False,5,-3,Uzbekistan
17795,19339,20632,1997,El Salvador,United States,1,1,FIFA World Cup qualification,San Salvador,El Salvador,False,2,0,Draw
17796,19340,20633,1997,Jamaica,Cuba,3,0,Friendly,Kingston,Jamaica,False,3,3,Jamaica
17797,19341,20634,1997,Kazakhstan,Iraq,3,1,FIFA World Cup qualification,Almaty,Kazakhstan,False,4,2,Kazakhstan
17798,19343,20636,1997,Gibraltar,Guernsey,1,2,Island Games,Grouville,Jersey,True,3,-1,Guernsey
17799,19344,20639,1997,Jersey,Greenland,2,1,Island Games,St. Peter,Jersey,False,3,1,Jersey
17800,19345,20643,1997,Guernsey,Greenland,0,0,Island Games,St. Helier,Jersey,True,0,0,Draw
17801,19346,20645,1997,Barbados,Trinidad and Tobago,1,1,Friendly,Bridgetown,Barbados,False,2,0,Draw
17802,19347,20646,1997,Gibraltar,Greenland,5,1,Island Games,St. Lawrence,Jersey,True,6,4,Gibraltar
17803,19348,20647,1997,Jersey,Guernsey,4,0,Island Games,St. Helier,Jersey,False,4,4,Jersey
17804,19349,20649,1997,Jersey,Gibraltar,3,2,Island Games,St. Helier,Jersey,False,5,1,Jersey
17805,19351,20656,1997,Jamaica,Grenada,1,1,CFU Caribbean Cup,St. John's,Antigua and Barbuda,True,2,0,Draw
17806,19352,20657,1997,Martinique,Trinidad and Tobago,2,1,CFU Caribbean Cup,Basseterre,Saint Kitts and Nevis,True,3,1,Martinique
17807,19353,20658,1997,Chile,Colombia,4,1,FIFA World Cup qualification,Santiago,Chile,False,5,3,Chile
17808,19354,20659,1997,Tanzania,Zambia,2,2,COSAFA Cup,Arusha,Tanzania,False,4,0,Draw
17809,19355,20660,1997,Tunisia,Mali,1,0,Friendly,Tunis,Tunisia,False,1,1,Tunisia
17810,19356,20661,1997,Antigua and Barbuda,Grenada,1,3,CFU Caribbean Cup,St. John's,Antigua and Barbuda,False,4,-2,Grenada
17811,19357,20662,1997,Australia,New Zealand,2,0,FIFA World Cup qualification,Sydney,Australia,False,2,2,Australia
17812,19358,20663,1997,Malawi,Botswana,0,0,Friendly,Lilongwe,Malawi,False,0,0,Draw
17813,19359,20664,1997,Paraguay,Argentina,1,2,FIFA World Cup qualification,Asunción,Paraguay,False,3,-1,Argentina
17814,19360,20665,1997,Peru,Bolivia,2,1,FIFA World Cup qualification,Lima,Peru,False,3,1,Peru
17815,19361,20666,1997,Saint Kitts and Nevis,Martinique,2,0,CFU Caribbean Cup,Basseterre,Saint Kitts and Nevis,False,2,2,Saint Kitts and Nevis
17816,19362,20667,1997,Venezuela,Ecuador,1,1,FIFA World Cup qualification,Maracaibo,Venezuela,False,2,0,Draw
17817,19363,20668,1997,Antigua and Barbuda,Jamaica,0,2,CFU Caribbean Cup,St. John's,Antigua and Barbuda,False,2,-2,Jamaica
17818,19364,20669,1997,Saint Kitts and Nevis,Trinidad and Tobago,0,3,CFU Caribbean Cup,Basseterre,Saint Kitts and Nevis,False,3,-3,Trinidad and Tobago
17819,19365,20670,1997,Lithuania,Estonia,2,1,Baltic Cup,Vilnius,Lithuania,False,3,1,Lithuania
17820,19366,20671,1997,Estonia,Latvia,1,2,Baltic Cup,Vilnius,Lithuania,True,3,-1,Latvia
17821,19367,20672,1997,Saint Kitts and Nevis,Grenada,2,1,CFU Caribbean Cup,Basseterre,Saint Kitts and Nevis,False,3,1,Saint Kitts and Nevis
17822,19368,20673,1997,Trinidad and Tobago,Jamaica,1,1,CFU Caribbean Cup,St. John's,Antigua and Barbuda,True,2,0,Draw
17823,19369,20674,1997,Lithuania,Latvia,1,0,Baltic Cup,Vilnius,Lithuania,False,1,1,Lithuania
17824,19370,20675,1997,Benin,Ivory Coast,0,0,African Cup of Nations qualification,Cotonou,Benin,False,0,0,Draw
17825,19371,20676,1997,DR Congo,Tanzania,1,1,African Cup of Nations qualification,Kinshasa,DR Congo,False,2,0,Draw
17826,19372,20677,1997,Egypt,Senegal,2,0,African Cup of Nations qualification,Cairo,Egypt,False,2,2,Egypt
17827,19373,20678,1997,Ethiopia,Morocco,0,1,African Cup of Nations qualification,Addis Abeba,Ethiopia,False,1,-1,Morocco
17828,19374,20679,1997,Gabon,Kenya,1,0,African Cup of Nations qualification,Libreville,Gabon,False,1,1,Gabon
17829,19375,20680,1997,Ghana,Zimbabwe,2,1,African Cup of Nations qualification,Accra,Ghana,False,3,1,Ghana
17830,19376,20681,1997,Jamaica,Grenada,4,1,CFU Caribbean Cup,St. John's,Antigua and Barbuda,True,5,3,Jamaica
17831,19377,20682,1997,Mauritius,Mozambique,1,3,African Cup of Nations qualification,Port Louis,Mauritius,False,4,-2,Mozambique
17832,19378,20683,1997,Togo,Liberia,4,0,African Cup of Nations qualification,Lomé,Togo,False,4,4,Togo
17833,19379,20684,1997,Trinidad and Tobago,Saint Kitts and Nevis,4,0,CFU Caribbean Cup,St. John's,Antigua and Barbuda,True,4,4,Trinidad and Tobago
17834,19380,20685,1997,Tunisia,Guinea,1,0,African Cup of Nations qualification,Tunis,Tunisia,False,1,1,Tunisia
17835,19381,20686,1997,Argentina,Venezuela,2,0,FIFA World Cup qualification,Buenos Aires,Argentina,False,2,2,Argentina
17836,19382,20687,1997,Bolivia,Uruguay,1,0,FIFA World Cup qualification,La Paz,Bolivia,False,1,1,Bolivia
17837,19383,20688,1997,Chile,Paraguay,2,1,FIFA World Cup qualification,Santiago,Chile,False,3,1,Chile
17838,19384,20689,1997,Colombia,Ecuador,1,0,FIFA World Cup qualification,Barranquilla,Colombia,False,1,1,Colombia
17839,19385,20690,1997,Iceland,Norway,0,1,Friendly,Reykjavík,Iceland,False,1,-1,Norway
17840,19386,20691,1997,Mozambique,Namibia,1,1,COSAFA Cup,Maputo,Mozambique,False,2,0,Draw
17841,19387,20692,1997,Algeria,Benin,2,0,African Cup of Nations qualification,Algiers,Algeria,False,2,2,Algeria
17842,19388,20693,1997,Angola,Zimbabwe,2,1,African Cup of Nations qualification,Luanda,Angola,False,3,1,Angola
17843,19389,20694,1997,Cameroon,Kenya,1,1,African Cup of Nations qualification,Yaoundé,Cameroon,False,2,0,Draw
17844,19390,20695,1997,DR Congo,Togo,1,0,African Cup of Nations qualification,Kinshasa,DR Congo,False,1,1,DR Congo
17845,19391,20696,1997,Egypt,Ethiopia,8,1,African Cup of Nations qualification,Alexandria,Egypt,False,9,7,Egypt
17846,19392,20697,1997,Gabon,Namibia,1,1,African Cup of Nations qualification,Libreville,Gabon,False,2,0,Draw
17847,19393,20698,1997,Iceland,Faroe Islands,1,0,Friendly,Höfn,Iceland,False,1,1,Iceland
17848,19394,20699,1997,Ivory Coast,Mali,4,2,African Cup of Nations qualification,Bouaké,Ivory Coast,False,6,2,Ivory Coast
17849,19395,20700,1997,Liberia,Tanzania,1,0,African Cup of Nations qualification,Monrovia,Liberia,False,1,1,Liberia
17850,19396,20701,1997,Morocco,Senegal,3,0,African Cup of Nations qualification,Rabat,Morocco,False,3,3,Morocco
17851,19397,20702,1997,Mozambique,Malawi,2,1,African Cup of Nations qualification,Maputo,Mozambique,False,3,1,Mozambique
17852,19398,20703,1997,Zambia,Mauritius,1,0,African Cup of Nations qualification,Chililabombwe,Zambia,False,1,1,Zambia
17853,19399,20704,1997,Zambia,Mozambique,2,1,COSAFA Cup,Lusaka,Zambia,False,3,1,Zambia
17854,19400,20705,1997,Belarus,Israel,2,3,Friendly,Minsk,Belarus,False,5,-1,Israel
17855,19401,20706,1997,Estonia,Faroe Islands,0,2,Friendly,Tartu,Estonia,False,2,-2,Faroe Islands
17856,19402,20707,1997,Hungary,Malta,3,0,Friendly,Siófok,Hungary,False,3,3,Hungary
17857,19403,20708,1997,Jamaica,Colombia,1,0,Friendly,Kingston,Jamaica,False,1,1,Jamaica
17858,19404,20709,1997,Slovakia,Switzerland,1,0,Friendly,Bratislava,Slovakia,False,1,1,Slovakia
17859,19405,20710,1997,Sweden,Lithuania,1,0,Friendly,Malmö,Sweden,False,1,1,Sweden
17860,19406,20711,1997,Cameroon,Nigeria,0,1,Friendly,Tunis,Tunisia,True,1,-1,Nigeria
17861,19407,20712,1997,Tunisia,Zambia,3,1,Friendly,Tunis,Tunisia,False,4,2,Tunisia
17862,19408,20713,1997,United States,Ecuador,0,1,Friendly,Baltimore,United States,False,1,-1,Ecuador
17863,19409,20714,1997,Cameroon,Zambia,3,3,Friendly,Tunis,Tunisia,True,6,0,Draw
17864,19410,20715,1997,Malawi,Tanzania,2,2,COSAFA Cup,Lilongwe,Malawi,False,4,0,Draw
17865,19411,20716,1997,Tunisia,Nigeria,2,0,Friendly,Tunis,Tunisia,False,2,2,Tunisia
17866,19412,20717,1997,Costa Rica,El Salvador,0,0,FIFA World Cup qualification,San José,Costa Rica,False,0,0,Draw
17867,19413,20719,1997,Japan,Brazil,0,3,Friendly,Osaka,Japan,False,3,-3,Brazil
17868,19414,20720,1997,Burkina Faso,Kenya,2,4,FIFA World Cup qualification,Ouagadougou,Burkina Faso,False,6,-2,Kenya
17869,19415,20721,1997,Morocco,Gabon,2,0,FIFA World Cup qualification,Casablanca,Morocco,False,2,2,Morocco
17870,19416,20722,1997,South Africa,Congo,1,0,FIFA World Cup qualification,Johannesburg,South Africa,False,1,1,South Africa
17871,19417,20723,1997,Zambia,DR Congo,2,0,FIFA World Cup qualification,Lusaka,Zambia,False,2,2,Zambia
17872,19418,20724,1997,Canada,Iran,0,1,Friendly,Toronto,Canada,False,1,-1,Iran
17873,19419,20725,1997,Egypt,Liberia,5,0,FIFA World Cup qualification,Cairo,Egypt,False,5,5,Egypt
17874,19420,20726,1997,Ghana,Sierra Leone,0,2,FIFA World Cup qualification,Obuasi,Ghana,False,2,-2,Sierra Leone
17875,19421,20727,1997,Guinea,Nigeria,1,0,FIFA World Cup qualification,Conakry,Guinea,False,1,1,Guinea
17876,19422,20728,1997,Togo,Angola,1,1,FIFA World Cup qualification,Lomé,Togo,False,2,0,Draw
17877,19423,20729,1997,Tunisia,Namibia,4,0,FIFA World Cup qualification,Tunis,Tunisia,False,4,4,Tunisia
17878,19424,20730,1997,Zimbabwe,Cameroon,1,2,FIFA World Cup qualification,Harare,Zimbabwe,False,3,-1,Cameroon
17879,19425,20731,1997,Greece,Cyprus,2,1,Friendly,Heraklion,Greece,False,3,1,Greece
17880,19426,20732,1997,Latvia,Azerbaijan,0,0,Friendly,Riga,Latvia,False,0,0,Draw
17881,19427,20733,1997,Belarus,Sweden,1,2,FIFA World Cup qualification,Minsk,Belarus,False,3,-1,Sweden
17882,19428,20734,1997,Bosnia and Herzegovina,Denmark,3,0,FIFA World Cup qualification,Sarajevo,Bosnia and Herzegovina,False,3,3,Bosnia and Herzegovina
17883,19429,20735,1997,Bulgaria,Israel,1,0,FIFA World Cup qualification,Sofia,Bulgaria,False,1,1,Bulgaria
17884,19430,20736,1997,Colombia,Bolivia,3,0,FIFA World Cup qualification,Barranquilla,Colombia,False,3,3,Colombia
17885,19431,20737,1997,Czech Republic,Faroe Islands,2,0,FIFA World Cup qualification,Teplice,Czech Republic,False,2,2,Czech Republic
17886,19432,20738,1997,Ecuador,Paraguay,2,1,FIFA World Cup qualification,Quito,Ecuador,False,3,1,Ecuador
17887,19433,20739,1997,Estonia,Austria,0,3,FIFA World Cup qualification,Tallinn,Estonia,False,3,-3,Austria
17888,19434,20740,1997,Finland,Norway,0,4,FIFA World Cup qualification,Helsinki,Finland,False,4,-4,Norway
17889,19435,20741,1997,Hungary,Switzerland,1,1,FIFA World Cup qualification,Budapest,Hungary,False,2,0,Draw
17890,19436,20742,1997,Republic of Ireland,Lithuania,0,0,FIFA World Cup qualification,Dublin,Republic of Ireland,False,0,0,Draw
17891,19437,20743,1997,Liechtenstein,Iceland,0,4,FIFA World Cup qualification,Eschen,Liechtenstein,False,4,-4,Iceland
17892,19438,20744,1997,Northern Ireland,Germany,1,3,FIFA World Cup qualification,Belfast,Northern Ireland,False,4,-2,Germany
17893,19439,20745,1997,Portugal,Armenia,3,1,FIFA World Cup qualification,Setúbal,Portugal,False,4,2,Portugal
17894,19441,20747,1997,Russia,Serbia,0,1,Friendly,St. Petersburg,Russia,False,1,-1,Serbia
17895,19442,20748,1997,Turkey,Wales,6,4,FIFA World Cup qualification,Istanbul,Turkey,False,10,2,Turkey
17896,19443,20749,1997,Ukraine,Albania,1,0,FIFA World Cup qualification,Kyïv,Ukraine,False,1,1,Ukraine
17897,19444,20750,1997,Uruguay,Chile,1,0,FIFA World Cup qualification,Montevideo,Uruguay,False,1,1,Uruguay
17898,19445,20751,1997,Venezuela,Peru,0,3,FIFA World Cup qualification,Barinas,Venezuela,False,3,-3,Peru
17899,19446,20752,1997,Lebanon,Iraq,0,2,Friendly,Beirut,Lebanon,False,2,-2,Iraq
17900,19447,20754,1997,Peru,Colombia,2,1,Friendly,Lima,Peru,False,3,1,Peru
17901,19448,20755,1997,Slovakia,Czech Republic,2,1,FIFA World Cup qualification,Bratislava,Slovakia,False,3,1,Slovakia
17902,19449,20756,1997,Uzbekistan,Yemen,5,1,FIFA World Cup qualification,Tashkent,Uzbekistan,False,6,4,Uzbekistan
17903,19450,20758,1997,Jamaica,Trinidad and Tobago,6,1,Friendly,Kingston,Jamaica,False,7,5,Jamaica
17904,19451,20760,1997,United Arab Emirates,Iran,3,1,Friendly,Abu Dhabi,United Arab Emirates,False,4,2,United Arab Emirates
17905,19452,20761,1997,Nepal,Pakistan,0,2,SAFF Cup,Kathmandu,Nepal,False,2,-2,Pakistan
17906,19453,20762,1997,Maldives,Bangladesh,1,1,SAFF Cup,Kathmandu,Nepal,True,2,0,Draw
17907,19454,20763,1997,Armenia,Albania,3,0,FIFA World Cup qualification,Yerevan,Armenia,False,3,3,Armenia
17908,19455,20764,1997,Austria,Sweden,1,0,FIFA World Cup qualification,Vienna,Austria,False,1,1,Austria
17909,19456,20765,1997,Azerbaijan,Norway,0,1,FIFA World Cup qualification,Baku,Azerbaijan,False,1,-1,Norway
17910,19457,20766,1997,Croatia,Bosnia and Herzegovina,3,2,FIFA World Cup qualification,Zagreb,Croatia,False,5,1,Croatia
17911,19458,20767,1997,El Salvador,Colombia,2,2,Friendly,East Rutherford,United States,True,4,0,Draw
17912,19459,20768,1997,Faroe Islands,Czech Republic,0,2,FIFA World Cup qualification,Toftir,Faroe Islands,False,2,-2,Czech Republic
17913,19460,20769,1997,Germany,Portugal,1,1,FIFA World Cup qualification,Berlin,Germany,False,2,0,Draw
17914,19461,20770,1997,Iceland,Republic of Ireland,2,2,FIFA World Cup qualification,Reykjavík,Iceland,False,4,0,Draw
17915,19462,20772,1997,Latvia,Estonia,1,0,FIFA World Cup qualification,Riga,Latvia,False,1,1,Latvia
17916,19463,20773,1997,Liechtenstein,Romania,1,8,FIFA World Cup qualification,Eschen,Liechtenstein,False,9,-7,Romania
17917,19465,20775,1997,Netherlands,Belgium,3,1,FIFA World Cup qualification,Rotterdam,Netherlands,False,4,2,Netherlands
17918,19466,20776,1997,Poland,Hungary,1,0,Friendly,Warsaw,Poland,False,1,1,Poland
17919,19467,20777,1997,Slovenia,Greece,0,3,FIFA World Cup qualification,Ljubljana,Slovenia,False,3,-3,Greece
17920,19468,20778,1997,Sri Lanka,Pakistan,2,0,SAFF Cup,Kathmandu,Nepal,True,2,2,Sri Lanka
17921,19469,20779,1997,Switzerland,Finland,1,2,FIFA World Cup qualification,Lausanne,Switzerland,False,3,-1,Finland
17922,19470,20780,1997,India,Bangladesh,3,0,SAFF Cup,Kathmandu,Nepal,True,3,3,India
17923,19471,20781,1997,Jamaica,Canada,1,0,FIFA World Cup qualification,Kingston,Jamaica,False,1,1,Jamaica
17924,19472,20782,1997,Japan,Uzbekistan,6,3,FIFA World Cup qualification,Tokyo,Japan,False,9,3,Japan
17925,19473,20783,1997,Luxembourg,Cyprus,1,3,FIFA World Cup qualification,Luxembourg,Luxembourg,False,4,-2,Cyprus
17926,19474,20784,1997,Scotland,Belarus,4,1,FIFA World Cup qualification,Aberdeen,Scotland,False,5,3,Scotland
17927,19475,20785,1997,United States,Costa Rica,1,0,FIFA World Cup qualification,Portland,United States,False,1,1,United States
17928,19476,20786,1997,Nepal,Sri Lanka,1,3,SAFF Cup,Kathmandu,Nepal,False,4,-2,Sri Lanka
17929,19477,20787,1997,Maldives,India,2,2,SAFF Cup,Kathmandu,Nepal,True,4,0,Draw
17930,19478,20788,1997,Albania,Northern Ireland,1,0,FIFA World Cup qualification,Zürich,Switzerland,True,1,1,Albania
17931,19479,20789,1997,Belarus,Austria,0,1,FIFA World Cup qualification,Minsk,Belarus,False,1,-1,Austria
17932,19480,20790,1997,Bosnia and Herzegovina,Slovenia,1,0,FIFA World Cup qualification,Sarajevo,Bosnia and Herzegovina,False,1,1,Bosnia and Herzegovina
17933,19481,20791,1997,Brazil,Ecuador,4,2,Friendly,Salvador,Brazil,False,6,2,Brazil
17934,19482,20792,1997,Bulgaria,Russia,1,0,FIFA World Cup qualification,Sofia,Bulgaria,False,1,1,Bulgaria
17935,19483,20793,1997,Chile,Argentina,1,2,FIFA World Cup qualification,Santiago,Chile,False,3,-1,Argentina
17936,19484,20794,1997,Colombia,Venezuela,1,0,FIFA World Cup qualification,Barranquilla,Colombia,False,1,1,Colombia
17937,19485,20795,1997,Denmark,Croatia,3,1,FIFA World Cup qualification,Copenhagen,Denmark,False,4,2,Denmark
17938,19486,20796,1997,England,Moldova,4,0,FIFA World Cup qualification,London,England,False,4,4,England
17939,19487,20797,1997,Georgia,Italy,0,0,FIFA World Cup qualification,Tbilisi,Georgia,False,0,0,Draw
17940,19488,20798,1997,Germany,Armenia,4,0,FIFA World Cup qualification,Dortmund,Germany,False,4,4,Germany
17941,19489,20799,1997,Hungary,Azerbaijan,3,1,FIFA World Cup qualification,Budapest,Hungary,False,4,2,Hungary
17942,19490,20800,1997,Lithuania,Republic of Ireland,1,2,FIFA World Cup qualification,Vilnius,Lithuania,False,3,-1,Republic of Ireland
17943,19491,20801,1997,Norway,Switzerland,5,0,FIFA World Cup qualification,Oslo,Norway,False,5,5,Norway
17944,19492,20802,1997,Paraguay,Bolivia,2,1,FIFA World Cup qualification,Asunción,Paraguay,False,3,1,Paraguay
17945,19493,20803,1997,Peru,Uruguay,2,1,FIFA World Cup qualification,Lima,Peru,False,3,1,Peru
17946,19494,20804,1997,Romania,Iceland,4,0,FIFA World Cup qualification,Bucharest,Romania,False,4,4,Romania
17947,19495,20805,1997,San Marino,Turkey,0,5,FIFA World Cup qualification,Serravalle,San Marino,False,5,-5,Turkey
17948,19496,20806,1997,Slovakia,Serbia,1,1,FIFA World Cup qualification,Bratislava,Slovakia,False,2,0,Draw
17949,19497,20807,1997,Sri Lanka,Maldives,1,2,SAFF Cup,Kathmandu,Nepal,True,3,-1,Maldives
17950,19498,20808,1997,Sweden,Latvia,1,0,FIFA World Cup qualification,Solna,Sweden,False,1,1,Sweden
17951,19499,20809,1997,India,Pakistan,2,0,SAFF Cup,Kathmandu,Nepal,True,2,2,India
17952,19500,20811,1997,United Arab Emirates,Kazakhstan,4,0,FIFA World Cup qualification,Abu Dhabi,United Arab Emirates,False,4,4,United Arab Emirates
17953,19501,20813,1997,India,Maldives,5,1,SAFF Cup,Kathmandu,Nepal,True,6,4,India
17954,19502,20814,1997,Pakistan,Sri Lanka,1,0,SAFF Cup,Kathmandu,Nepal,True,1,1,Pakistan
17955,19503,20815,1997,El Salvador,Canada,4,1,FIFA World Cup qualification,San Salvador,El Salvador,False,5,3,El Salvador
17956,19504,20816,1997,Indonesia,Tanzania,3,1,Friendly,Bandung,Indonesia,False,4,2,Indonesia
17957,19505,20817,1997,Jamaica,Costa Rica,1,0,FIFA World Cup qualification,Kingston,Jamaica,False,1,1,Jamaica
17958,19506,20818,1997,Saudi Arabia,Kuwait,2,1,FIFA World Cup qualification,Ta'if,Saudi Arabia,False,3,1,Saudi Arabia
17959,19507,20819,1997,Iran,Saudi Arabia,1,1,FIFA World Cup qualification,Teheran,Iran,False,2,0,Draw
17960,19508,20820,1997,Qatar,Kuwait,0,2,FIFA World Cup qualification,Doha,Qatar,False,2,-2,Kuwait
17961,19509,20821,1997,United Arab Emirates,Japan,0,0,FIFA World Cup qualification,Abu Dhabi,United Arab Emirates,False,0,0,Draw
17962,19510,20822,1997,Kazakhstan,Uzbekistan,1,1,FIFA World Cup qualification,Almaty,Kazakhstan,False,2,0,Draw
17963,19511,20823,1997,Libya,Bahrain,2,1,Friendly,Tripoli,Libya,False,3,1,Libya
17964,19512,20824,1997,Indonesia,New Zealand,5,0,Friendly,Jakarta,Indonesia,False,5,5,Indonesia
17965,19513,20825,1997,El Salvador,Guatemala,0,1,Friendly,Los Angeles,United States,True,1,-1,Guatemala
17966,19514,20826,1997,Malta,Czech Republic,0,1,FIFA World Cup qualification,Attard,Malta,False,1,-1,Czech Republic
17967,19515,20827,1997,Moldova,Georgia,0,1,FIFA World Cup qualification,Chişinău,Moldova,False,1,-1,Georgia
17968,19516,20828,1997,Poland,Lithuania,2,0,Friendly,Olsztyn,Poland,False,2,2,Poland
17969,19517,20829,1997,Slovakia,Spain,1,2,FIFA World Cup qualification,Bratislava,Slovakia,False,3,-1,Spain
17970,19518,20830,1997,Bahrain,Chad,1,1,Friendly,Tripoli,Libya,True,2,0,Draw
17971,19519,20831,1997,Libya,Jordan,1,1,Friendly,Tripoli,Libya,False,2,0,Draw
17972,19520,20832,1997,Saudi Arabia,Mali,5,1,Friendly,Riyadh,Saudi Arabia,False,6,4,Saudi Arabia
17973,19521,20833,1997,Kuwait,Iran,1,1,FIFA World Cup qualification,Kuwait City,Kuwait,False,2,0,Draw
17974,19523,20835,1997,Tanzania,Zambia,0,0,Friendly,Dar es Salaam,Tanzania,False,0,0,Draw
17975,19524,20836,1997,Uzbekistan,United Arab Emirates,2,3,FIFA World Cup qualification,Tashkent,Uzbekistan,False,5,-1,United Arab Emirates
17976,19525,20837,1997,Algeria,Kenya,0,1,Friendly,Dar es Salaam,Tanzania,True,1,-1,Kenya
17977,19527,20839,1997,Algeria,Zambia,0,1,Friendly,Dar es Salaam,Tanzania,True,1,-1,Zambia
17978,19528,20840,1997,Tanzania,Kenya,0,1,Friendly,Dar es Salaam,Tanzania,False,1,-1,Kenya
17979,19529,20842,1997,Iran,Qatar,3,0,FIFA World Cup qualification,Teheran,Iran,False,3,3,Iran
17980,19530,20843,1997,Kenya,Zambia,0,0,Friendly,Dar es Salaam,Tanzania,True,0,0,Draw
17981,19531,20844,1997,United States,Jamaica,1,1,FIFA World Cup qualification,Washington,United States,False,2,0,Draw
17982,19532,20845,1997,Kazakhstan,Japan,1,1,FIFA World Cup qualification,Almaty,Kazakhstan,False,2,0,Draw
17983,19533,20847,1997,Saint Kitts and Nevis,Cuba,0,2,Gold Cup qualification,Basseterre,Saint Kitts and Nevis,False,2,-2,Cuba
17984,19534,20848,1997,Tanzania,Algeria,0,1,Friendly,Dar es Salaam,Tanzania,False,1,-1,Algeria
17985,19535,20849,1997,Mexico,El Salvador,5,0,FIFA World Cup qualification,Mexico City,Mexico,False,5,5,Mexico
17986,19536,20850,1997,Moldova,Poland,0,3,FIFA World Cup qualification,Chişinău,Moldova,False,3,-3,Poland
17987,19537,20851,1997,Norway,Colombia,0,0,Friendly,Oslo,Norway,False,0,0,Draw
17988,19538,20852,1997,Brazil,Morocco,2,0,Friendly,Belém,Brazil,False,2,2,Brazil
17989,19540,20854,1997,Armenia,Ukraine,0,2,FIFA World Cup qualification,Yerevan,Armenia,False,2,-2,Ukraine
17990,19541,20855,1997,Austria,Belarus,4,0,FIFA World Cup qualification,Vienna,Austria,False,4,4,Austria
17991,19542,20856,1997,Belgium,Wales,3,2,FIFA World Cup qualification,Brussels,Belgium,False,5,1,Belgium
17992,19543,20857,1997,Cyprus,Luxembourg,2,0,FIFA World Cup qualification,Limassol,Cyprus,False,2,2,Cyprus
17993,19544,20858,1997,Czech Republic,Slovakia,3,0,FIFA World Cup qualification,Prague,Czech Republic,False,3,3,Czech Republic
17994,19545,20859,1997,Finland,Hungary,1,1,FIFA World Cup qualification,Helsinki,Finland,False,2,0,Draw
17995,19546,20860,1997,France,South Africa,2,1,Friendly,Lens,France,False,3,1,France
17996,19547,20861,1997,Georgia,Poland,3,0,FIFA World Cup qualification,Tbilisi,Georgia,False,3,3,Georgia
17997,19548,20862,1997,Germany,Albania,4,3,FIFA World Cup qualification,Hanover,Germany,False,7,1,Germany
17998,19549,20863,1997,Greece,Denmark,0,0,FIFA World Cup qualification,Athens,Greece,False,0,0,Draw
17999,19550,20864,1997,Iceland,Liechtenstein,4,0,FIFA World Cup qualification,Reykjavík,Iceland,False,4,4,Iceland
18000,19551,20865,1997,Republic of Ireland,Romania,1,1,FIFA World Cup qualification,Dublin,Republic of Ireland,False,2,0,Draw
18001,19552,20866,1997,Italy,England,0,0,FIFA World Cup qualification,Rome,Italy,False,0,0,Draw
18002,19554,20869,1997,Malta,Serbia,0,5,FIFA World Cup qualification,Attard,Malta,False,5,-5,Serbia
18003,19555,20870,1997,Netherlands,Turkey,0,0,FIFA World Cup qualification,Amsterdam,Netherlands,False,0,0,Draw
18004,19556,20871,1997,Portugal,Northern Ireland,1,0,FIFA World Cup qualification,Lisbon,Portugal,False,1,1,Portugal
18005,19557,20872,1997,Russia,Bulgaria,4,2,FIFA World Cup qualification,Moscow,Russia,False,6,2,Russia
18006,19558,20873,1997,Saudi Arabia,Qatar,1,0,FIFA World Cup qualification,Ta'if,Saudi Arabia,False,1,1,Saudi Arabia
18007,19559,20874,1997,Scotland,Latvia,2,0,FIFA World Cup qualification,Glasgow,Scotland,False,2,2,Scotland
18008,19560,20875,1997,Slovenia,Croatia,1,3,FIFA World Cup qualification,Ljubljana,Slovenia,False,4,-2,Croatia
18009,19561,20876,1997,Spain,Faroe Islands,3,1,FIFA World Cup qualification,Gijón,Spain,False,4,2,Spain
18010,19562,20877,1997,Sweden,Estonia,1,0,FIFA World Cup qualification,Solna,Sweden,False,1,1,Sweden
18011,19563,20878,1997,Switzerland,Azerbaijan,5,0,FIFA World Cup qualification,Zürich,Switzerland,False,5,5,Switzerland
18012,19564,20879,1997,Uzbekistan,Japan,1,1,FIFA World Cup qualification,Tashkent,Uzbekistan,False,2,0,Draw
18013,19565,20880,1997,Argentina,Uruguay,0,0,FIFA World Cup qualification,Buenos Aires,Argentina,False,0,0,Draw
18014,19566,20881,1997,Canada,Mexico,2,2,FIFA World Cup qualification,Edmonton,Canada,False,4,0,Draw
18015,19567,20882,1997,Ecuador,Bolivia,1,0,FIFA World Cup qualification,Guayaquil,Ecuador,False,1,1,Ecuador
18016,19568,20883,1997,Paraguay,Venezuela,1,0,FIFA World Cup qualification,Asunción,Paraguay,False,1,1,Paraguay
18017,19569,20884,1997,Peru,Chile,0,4,FIFA World Cup qualification,Lima,Peru,False,4,-4,Chile
18018,19571,20886,1997,Kuwait,Saudi Arabia,2,1,FIFA World Cup qualification,Kuwait City,Kuwait,False,3,1,Kuwait
18019,19572,20887,1997,Haiti,Jamaica,0,1,Friendly,Port-au-Prince,Haiti,False,1,-1,Jamaica
18020,19573,20888,1997,Kazakhstan,United Arab Emirates,3,0,FIFA World Cup qualification,Almaty,Kazakhstan,False,3,3,Kazakhstan
18021,19575,20890,1997,Haiti,Cuba,2,2,Friendly,Port-au-Prince,Haiti,False,4,0,Draw
18022,19576,20891,1997,Martinique,Cameroon,2,1,Friendly,Port-au-Prince,Haiti,True,3,1,Martinique
18023,19577,20892,1997,Cuba,Cameroon,1,1,Friendly,Port-au-Prince,Haiti,True,2,0,Draw
18024,19578,20893,1997,Haiti,Martinique,3,0,Friendly,Port-au-Prince,Haiti,False,3,3,Haiti
18025,19579,20894,1997,Kuwait,Qatar,0,1,FIFA World Cup qualification,Kuwait City,Kuwait,False,1,-1,Qatar
18026,19580,20895,1997,Saudi Arabia,Iran,1,0,FIFA World Cup qualification,Ta'if,Saudi Arabia,False,1,1,Saudi Arabia
18027,19581,20896,1997,Saint Lucia,Jamaica,1,3,Friendly,Castries,Saint Lucia,False,4,-2,Jamaica
18028,19582,20897,1997,Uzbekistan,Kazakhstan,4,0,FIFA World Cup qualification,Tashkent,Uzbekistan,False,4,4,Uzbekistan
18029,19583,20898,1997,Antigua and Barbuda,Jamaica,0,3,Friendly,St. John's,Antigua and Barbuda,False,3,-3,Jamaica
18030,19584,20899,1997,Japan,United Arab Emirates,1,1,FIFA World Cup qualification,Tokyo,Japan,False,2,0,Draw
18031,19585,20900,1997,Croatia,Ukraine,2,0,FIFA World Cup qualification,Zagreb,Croatia,False,2,2,Croatia
18032,19586,20901,1997,Hungary,Serbia,1,7,FIFA World Cup qualification,Budapest,Hungary,False,8,-6,Serbia
18033,19587,20902,1997,Republic of Ireland,Belgium,1,1,FIFA World Cup qualification,Dublin,Republic of Ireland,False,2,0,Draw
18034,19588,20903,1997,Russia,Italy,1,1,FIFA World Cup qualification,Moscow,Russia,False,2,0,Draw
18035,19589,20904,1997,Saint Kitts and Nevis,Jamaica,1,1,Friendly,Basseterre,Saint Kitts and Nevis,False,2,0,Draw
18036,19590,20906,1997,Iran,Kuwait,0,0,FIFA World Cup qualification,Teheran,Iran,False,0,0,Draw
18037,19591,20908,1997,Ivory Coast,Burkina Faso,0,0,Friendly,Bouaké,Ivory Coast,False,0,0,Draw
18038,19592,20909,1997,Mexico,United States,0,0,FIFA World Cup qualification,Mexico City,Mexico,False,0,0,Draw
18039,19593,20910,1997,Eswatini,Mauritius,0,1,Friendly,Mbabane,Eswatini,False,1,-1,Mauritius
18040,19594,20911,1997,United Arab Emirates,Uzbekistan,0,0,FIFA World Cup qualification,Abu Dhabi,United Arab Emirates,False,0,0,Draw
18041,19595,20912,1997,Tunisia,Bosnia and Herzegovina,2,1,Friendly,Tunis,Tunisia,False,3,1,Tunisia
18042,19597,20914,1997,Chile,Guatemala,4,1,Friendly,Antofagasta,Chile,False,5,3,Chile
18043,19598,20915,1997,Qatar,Iran,2,0,FIFA World Cup qualification,Doha,Qatar,False,2,2,Qatar
18044,19599,20916,1997,Japan,Kazakhstan,5,1,FIFA World Cup qualification,Tokyo,Japan,False,6,4,Japan
18045,19600,20917,1997,Canada,United States,0,3,FIFA World Cup qualification,Burnaby,Canada,False,3,-3,United States
18046,19601,20918,1997,El Salvador,Jamaica,2,2,FIFA World Cup qualification,San Salvador,El Salvador,False,4,0,Draw
18047,19602,20919,1997,Mexico,Costa Rica,3,3,FIFA World Cup qualification,Mexico City,Mexico,False,6,0,Draw
18048,19604,20921,1997,Brazil,Wales,3,0,Friendly,Brasília,Brazil,False,3,3,Brazil
18049,19605,20923,1997,France,Scotland,2,1,Friendly,Saint-Étienne,France,False,3,1,France
18050,19606,20924,1997,Qatar,Saudi Arabia,0,1,FIFA World Cup qualification,Doha,Qatar,False,1,-1,Saudi Arabia
18051,19607,20925,1997,Mali,Mauritania,3,1,Friendly,Bamako,Mali,False,4,2,Mali
18052,19608,20926,1997,Belgium,Republic of Ireland,2,1,FIFA World Cup qualification,Brussels,Belgium,False,3,1,Belgium
18053,19609,20927,1997,England,Cameroon,2,0,Friendly,London,England,False,2,2,England
18054,19610,20928,1997,Germany,South Africa,3,0,Friendly,Düsseldorf,Germany,False,3,3,Germany
18055,19611,20929,1997,Italy,Russia,1,0,FIFA World Cup qualification,Naples,Italy,False,1,1,Italy
18056,19612,20930,1997,Serbia,Hungary,5,0,FIFA World Cup qualification,Belgrade,Yugoslavia,True,5,5,Serbia
18057,19613,20931,1997,Ukraine,Croatia,1,1,FIFA World Cup qualification,Kyïv,Ukraine,False,2,0,Draw
18058,19614,20932,1997,Argentina,Colombia,1,1,FIFA World Cup qualification,Buenos Aires,Argentina,False,2,0,Draw
18059,19615,20933,1997,Chile,Bolivia,3,0,FIFA World Cup qualification,Santiago,Chile,False,3,3,Chile
18060,19616,20934,1997,Costa Rica,Canada,3,1,FIFA World Cup qualification,San José,Costa Rica,False,4,2,Costa Rica
18061,19617,20935,1997,Jamaica,Mexico,0,0,FIFA World Cup qualification,Kingston,Jamaica,False,0,0,Draw
18062,19618,20936,1997,Japan,Iran,3,2,FIFA World Cup qualification,Johor Baharu,Malaysia,True,5,1,Japan
18063,19619,20937,1997,Peru,Paraguay,1,0,FIFA World Cup qualification,Lima,Peru,False,1,1,Peru
18064,19620,20938,1997,Uruguay,Ecuador,5,3,FIFA World Cup qualification,Maldonado,Uruguay,False,8,2,Uruguay
18065,19621,20939,1997,United States,El Salvador,4,2,FIFA World Cup qualification,Foxborough,United States,False,6,2,United States
18066,19622,20940,1997,Senegal,Mali,1,2,Friendly,Dakar,Senegal,False,3,-1,Mali
18067,19623,20941,1997,Spain,Romania,1,1,Friendly,Palma de Mallorca,Spain,False,2,0,Draw
18068,19624,20942,1997,Iran,Australia,1,1,FIFA World Cup qualification,Teheran,Iran,False,2,0,Draw
18069,19625,20943,1997,Morocco,Togo,3,0,Friendly,Rabat,Morocco,False,3,3,Morocco
18070,19626,20944,1997,Philippines,Estonia,0,1,Friendly,Manila,Philippines,False,1,-1,Estonia
18071,19628,20946,1997,Mauritania,Senegal,1,1,Amílcar Cabral Cup,Banjul,Gambia,True,2,0,Draw
18072,19629,20947,1997,Australia,Iran,2,2,FIFA World Cup qualification,Melbourne,Australia,False,4,0,Draw
18073,19630,20948,1997,Guinea,Mali,0,0,Amílcar Cabral Cup,Banjul,Gambia,True,0,0,Draw
18074,19631,20949,1997,Sierra Leone,Guinea-Bissau,2,1,Amílcar Cabral Cup,Banjul,Gambia,True,3,1,Sierra Leone
18075,19632,20950,1997,Gambia,Mauritania,2,1,Amílcar Cabral Cup,Banjul,Gambia,False,3,1,Gambia
18076,19634,20952,1997,Guinea,Sierra Leone,3,0,Amílcar Cabral Cup,Banjul,Gambia,True,3,3,Guinea
18077,19635,20953,1997,Mali,Guinea-Bissau,6,1,Amílcar Cabral Cup,Banjul,Gambia,True,7,5,Mali
18078,19636,20955,1997,Gambia,Senegal,0,0,Amílcar Cabral Cup,Banjul,Gambia,False,0,0,Draw
18079,19637,20956,1997,Egypt,Ghana,3,2,Friendly,Cairo,Egypt,False,5,1,Egypt
18080,19638,20957,1997,Guinea,Guinea-Bissau,2,0,Amílcar Cabral Cup,Banjul,Gambia,True,2,2,Guinea
18081,19639,20958,1997,Mali,Sierra Leone,1,1,Amílcar Cabral Cup,Banjul,Gambia,True,2,0,Draw
18082,19640,20959,1997,Gambia,Mali,1,2,Amílcar Cabral Cup,Banjul,Gambia,False,3,-1,Mali
18083,19641,20960,1997,Guinea,Senegal,1,2,Amílcar Cabral Cup,Banjul,Gambia,True,3,-1,Senegal
18084,19642,20961,1997,Gambia,Guinea,2,2,Amílcar Cabral Cup,Banjul,Gambia,False,4,0,Draw
18085,19643,20962,1997,Mali,Senegal,1,0,Amílcar Cabral Cup,Banjul,Gambia,True,1,1,Mali
18086,19644,20963,1997,Saudi Arabia,Iceland,0,0,Friendly,Riyadh,Saudi Arabia,False,0,0,Draw
18087,19645,20964,1997,South Africa,Brazil,1,2,Friendly,Johannesburg,South Africa,False,3,-1,Brazil
18088,19646,20965,1997,Mexico,Australia,1,3,Confederations Cup,Riyadh,Saudi Arabia,True,4,-2,Australia
18089,19647,20966,1997,Saudi Arabia,Brazil,0,3,Confederations Cup,Riyadh,Saudi Arabia,False,3,-3,Brazil
18090,19648,20967,1997,South Africa,Czech Republic,2,2,Confederations Cup,Riyadh,Saudi Arabia,True,4,0,Draw
18091,19649,20968,1997,United Arab Emirates,Uruguay,0,2,Confederations Cup,Riyadh,Saudi Arabia,True,2,-2,Uruguay
18092,19650,20969,1997,Australia,Brazil,0,0,Confederations Cup,Riyadh,Saudi Arabia,True,0,0,Draw
18093,19651,20970,1997,Saudi Arabia,Mexico,0,5,Confederations Cup,Riyadh,Saudi Arabia,False,5,-5,Mexico
18094,19652,20971,1997,Czech Republic,Uruguay,1,2,Confederations Cup,Riyadh,Saudi Arabia,True,3,-1,Uruguay
18095,19653,20972,1997,United Arab Emirates,South Africa,1,0,Confederations Cup,Riyadh,Saudi Arabia,True,1,1,United Arab Emirates
18096,19654,20973,1997,Brazil,Mexico,3,2,Confederations Cup,Riyadh,Saudi Arabia,True,5,1,Brazil
18097,19655,20974,1997,Saudi Arabia,Australia,1,0,Confederations Cup,Riyadh,Saudi Arabia,False,1,1,Saudi Arabia
18098,19656,20975,1997,Martinique,Trinidad and Tobago,3,0,Friendly,Fort-de-France,Martinique,False,3,3,Martinique
18099,19657,20976,1997,United Arab Emirates,Czech Republic,1,6,Confederations Cup,Riyadh,Saudi Arabia,True,7,-5,Czech Republic
18100,19658,20977,1997,Uruguay,South Africa,4,3,Confederations Cup,Riyadh,Saudi Arabia,True,7,1,Uruguay
18101,19659,20978,1997,Zambia,Nigeria,0,0,Friendly,Lusaka,Zambia,False,0,0,Draw
18102,19660,20979,1997,Egypt,Togo,7,2,Friendly,Aswan,Egypt,False,9,5,Egypt
18103,19661,20980,1997,Lesotho,Eswatini,0,0,Friendly,Maseru,Lesotho,False,0,0,Draw
18104,19662,20981,1997,Martinique,Trinidad and Tobago,3,2,Friendly,Fort-de-France,Martinique,False,5,1,Martinique
18105,19663,20982,1997,Brazil,Czech Republic,2,0,Confederations Cup,Riyadh,Saudi Arabia,True,2,2,Brazil
18106,19664,20983,1997,Uruguay,Australia,0,1,Confederations Cup,Riyadh,Saudi Arabia,True,1,-1,Australia
18107,19665,20984,1997,Egypt,Algeria,1,2,Friendly,Aswan,Egypt,False,3,-1,Algeria
18108,19666,20985,1997,Brazil,Australia,6,0,Confederations Cup,Riyadh,Saudi Arabia,True,6,6,Brazil
18109,19667,20986,1997,Czech Republic,Uruguay,1,0,Confederations Cup,Riyadh,Saudi Arabia,True,1,1,Czech Republic
18110,19668,20987,1997,Mozambique,Lesotho,1,1,Friendly,Maputo,Mozambique,False,2,0,Draw
18111,19669,20988,1997,Algeria,Togo,0,1,Friendly,Cairo,Egypt,True,1,-1,Togo
18112,19670,20989,1997,Egypt,Cameroon,2,0,Friendly,Cairo,Egypt,False,2,2,Egypt
18113,19671,20991,1997,Cameroon,Togo,3,1,Friendly,Cairo,Egypt,True,4,2,Cameroon
18114,19672,20992,1997,Egypt,Algeria,1,2,Friendly,Cairo,Egypt,False,3,-1,Algeria
18115,19673,20994,1997,Burkina Faso,Ivory Coast,2,0,Friendly,Ouagadougou,Burkina Faso,False,2,2,Burkina Faso
18116,19674,20995,1997,Lesotho,Eswatini,0,0,Friendly,Maseru,Lesotho,False,0,0,Draw
18117,19675,20996,1998,Malawi,Zimbabwe,1,0,Friendly,Blantyre,Malawi,False,1,1,Malawi
18118,19676,20997,1998,Barbados,Trinidad and Tobago,0,1,Friendly,Bridgetown,Barbados,False,1,-1,Trinidad and Tobago
18119,19677,20998,1998,Burkina Faso,Mozambique,1,0,Friendly,Bobo Dioulasso,Burkina Faso,False,1,1,Burkina Faso
18120,19678,20999,1998,Guinea,Togo,1,0,Friendly,Conakry,Guinea,False,1,1,Guinea
18121,19679,21000,1998,Malawi,Zimbabwe,0,2,Friendly,Lilongwe,Malawi,False,2,-2,Zimbabwe
18122,19680,21001,1998,Burkina Faso,Mozambique,4,2,Friendly,Ouagadougou,Burkina Faso,False,6,2,Burkina Faso
18123,19681,21002,1998,Trinidad and Tobago,Jamaica,0,0,Friendly,Port of Spain,Trinidad and Tobago,False,0,0,Draw
18124,19682,21003,1998,Malawi,Zambia,0,1,COSAFA Cup,Blantyre,Malawi,False,1,-1,Zambia
18125,19683,21004,1998,Eswatini,Botswana,1,1,Friendly,Mbabane,Eswatini,False,2,0,Draw
18126,19684,21005,1998,Burkina Faso,Mali,0,0,Friendly,Ouagadougou,Burkina Faso,False,0,0,Draw
18127,19685,21006,1998,Togo,Mozambique,1,2,Friendly,Lomé,Togo,False,3,-1,Mozambique
18128,19686,21007,1998,Lesotho,Botswana,0,0,Friendly,Maseru,Lesotho,False,0,0,Draw
18129,19687,21008,1998,Ghana,Mozambique,0,0,Friendly,Accra,Ghana,False,0,0,Draw
18130,19688,21009,1998,Morocco,Angola,2,1,Friendly,Casablanca,Morocco,False,3,1,Morocco
18131,19689,21010,1998,Gambia,Zambia,0,2,Friendly,Banjul,Gambia,False,2,-2,Zambia
18132,19690,21011,1998,Lesotho,Zimbabwe,0,2,COSAFA Cup,Maseru,Lesotho,False,2,-2,Zimbabwe
18133,19691,21012,1998,Ghana,Mozambique,3,1,Friendly,Accra,Ghana,False,4,2,Ghana
18134,19692,21013,1998,Costa Rica,Honduras,1,4,Friendly,Nicoya,Costa Rica,False,5,-3,Honduras
18135,19693,21014,1998,El Salvador,Trinidad and Tobago,2,0,Friendly,San Salvador,El Salvador,False,2,2,El Salvador
18136,19694,21015,1998,Turkey,Albania,1,4,Friendly,Antalya,Turkey,False,5,-3,Albania
18137,19695,21016,1998,Namibia,South Africa,3,2,COSAFA Cup,Windhoek,Namibia,False,5,1,Namibia
18138,19696,21017,1998,United States,Sweden,1,0,Friendly,Orlando,United States,False,1,1,United States
18139,19697,21018,1998,Botswana,Mozambique,1,2,COSAFA Cup,Gaborone,Botswana,False,3,-1,Mozambique
18140,19698,21019,1998,Thailand,Egypt,1,1,King's Cup,Bangkok,Thailand,False,2,0,Draw
18141,19700,21021,1998,Liberia,Burkina Faso,1,2,Friendly,Monrovia,Liberia,False,3,-1,Burkina Faso
18142,19701,21022,1998,Cameroon,Angola,1,0,Friendly,Garoua,Cameroon,False,1,1,Cameroon
18143,19702,21023,1998,France,Spain,1,0,Friendly,Saint-Denis,France,False,1,1,France
18144,19703,21024,1998,Iran,Nigeria,0,1,Lunar New Year Cup,So Kon Po,Hong Kong,True,1,-1,Nigeria
18145,19704,21025,1998,Italy,Slovakia,3,0,Friendly,Catania,Italy,False,3,3,Italy
18146,19705,21026,1998,Tunisia,Serbia,0,3,Friendly,Tunis,Tunisia,False,3,-3,Serbia
18147,19706,21027,1998,Ivory Coast,Mozambique,4,1,Friendly,Bouaké,Ivory Coast,False,5,3,Ivory Coast
18148,19707,21028,1998,Jamaica,Sweden,0,0,Friendly,Kingston,Jamaica,False,0,0,Draw
18149,19709,21030,1998,Togo,Mali,2,1,Friendly,Lomé,Togo,False,3,1,Togo
18150,19710,21031,1998,Niger,Namibia,2,1,Friendly,Niamey,Niger,False,3,1,Niger
18151,19712,21033,1998,Iran,Chile,1,1,Lunar New Year Cup,So Kon Po,Hong Kong,True,2,0,Draw
18152,19713,21034,1998,Tunisia,Guinea,4,1,Friendly,Tunis,Tunisia,False,5,3,Tunisia
18153,19714,21035,1998,Burkina Faso,Namibia,3,1,Friendly,Niamey,Niger,True,4,2,Burkina Faso
18154,19715,21036,1998,Guatemala,El Salvador,0,0,Gold Cup,Los Angeles,United States,True,0,0,Draw
18155,19716,21037,1998,Honduras,Trinidad and Tobago,1,3,Gold Cup,Oakland,United States,True,4,-2,Trinidad and Tobago
18156,19717,21038,1998,Ivory Coast,Cameroon,1,0,Friendly,Bouaké,Ivory Coast,False,1,1,Ivory Coast
18157,19718,21039,1998,Togo,Mali,0,4,Friendly,Lomé,Togo,False,4,-4,Mali
18158,19719,21040,1998,United States,Cuba,3,0,Gold Cup,Oakland,United States,False,3,3,United States
18159,19720,21041,1998,Brazil,Jamaica,0,0,Gold Cup,Miami,United States,True,0,0,Draw
18160,19721,21042,1998,Cuba,Costa Rica,2,7,Gold Cup,Oakland,United States,True,9,-5,Costa Rica
18161,19722,21043,1998,Mali,Tunisia,0,1,Friendly,Bamako,Mali,False,1,-1,Tunisia
18162,19723,21044,1998,New Zealand,Chile,0,0,Friendly,Auckland,New Zealand,False,0,0,Draw
18163,19724,21045,1998,Trinidad and Tobago,Mexico,2,4,Gold Cup,Oakland,United States,True,6,-2,Mexico
18164,19725,21046,1998,Brazil,Guatemala,1,1,Gold Cup,Miami,United States,True,2,0,Draw
18165,19726,21047,1998,Cyprus,Finland,1,1,Cyprus International Tournament,Limassol,Cyprus,False,2,0,Draw
18166,19727,21048,1998,Iceland,Slovenia,2,3,Cyprus International Tournament,Limassol,Cyprus,True,5,-1,Slovenia
18167,19728,21049,1998,Morocco,Niger,3,0,Friendly,Marrakech,Morocco,False,3,3,Morocco
18168,19729,21050,1998,Georgia,Latvia,2,1,Malta International Tournament,Attard,Malta,True,3,1,Georgia
18169,19730,21051,1998,Malta,Albania,1,1,Malta International Tournament,Attard,Malta,False,2,0,Draw
18170,19731,21052,1998,Slovenia,Slovakia,1,1,Cyprus International Tournament,Limassol,Cyprus,True,2,0,Draw
18171,19732,21053,1998,Australia,Chile,0,1,Friendly,Melbourne,Australia,False,1,-1,Chile
18172,19733,21054,1998,Burkina Faso,Cameroon,0,1,African Cup of Nations,Ouagadougou,Burkina Faso,False,1,-1,Cameroon
18173,19734,21055,1998,Iceland,Slovakia,1,2,Cyprus International Tournament,Limassol,Cyprus,True,3,-1,Slovakia
18174,19735,21056,1998,Mexico,Honduras,2,0,Gold Cup,Oakland,United States,True,2,2,Mexico
18175,19737,21058,1998,United States,Costa Rica,2,1,Gold Cup,Oakland,United States,False,3,1,United States
18176,19738,21059,1998,Albania,Georgia,0,3,Malta International Tournament,Attard,Malta,True,3,-3,Georgia
18177,19739,21060,1998,Algeria,Guinea,0,1,African Cup of Nations,Ouagadougou,Burkina Faso,True,1,-1,Guinea
18178,19740,21061,1998,El Salvador,Brazil,0,4,Gold Cup,Los Angeles,United States,True,4,-4,Brazil
18179,19741,21062,1998,Guatemala,Jamaica,2,3,Gold Cup,Los Angeles,United States,True,5,-1,Jamaica
18180,19742,21063,1998,Ivory Coast,Namibia,4,3,African Cup of Nations,Bobo Dioulasso,Burkina Faso,True,7,1,Ivory Coast
18181,19743,21064,1998,Malta,Latvia,2,1,Malta International Tournament,Attard,Malta,False,3,1,Malta
18182,19744,21065,1998,Paraguay,Poland,4,0,Friendly,Asunción,Paraguay,False,4,4,Paraguay
18183,19745,21066,1998,South Africa,Angola,0,0,African Cup of Nations,Bobo Dioulasso,Burkina Faso,True,0,0,Draw
18184,19746,21067,1998,DR Congo,Togo,2,1,African Cup of Nations,Ouagadougou,Burkina Faso,True,3,1,DR Congo
18185,19747,21068,1998,Cyprus,Slovenia,1,0,Cyprus International Tournament,Limassol,Cyprus,False,1,1,Cyprus
18186,19748,21069,1998,Finland,Slovakia,0,2,Cyprus International Tournament,Larnaca,Cyprus,True,2,-2,Slovakia
18187,19749,21070,1998,Ghana,Tunisia,2,0,African Cup of Nations,Ouagadougou,Burkina Faso,True,2,2,Ghana
18188,19750,21071,1998,Jamaica,El Salvador,2,0,Gold Cup,Los Angeles,United States,True,2,2,Jamaica
18189,19751,21072,1998,Zambia,Morocco,1,1,African Cup of Nations,Bobo Dioulasso,Burkina Faso,True,2,0,Draw
18190,19752,21073,1998,Albania,Latvia,2,2,Malta International Tournament,Attard,Malta,True,4,0,Draw
18191,19753,21074,1998,Egypt,Mozambique,2,0,African Cup of Nations,Bobo Dioulasso,Burkina Faso,True,2,2,Egypt
18192,19754,21075,1998,Malta,Georgia,1,3,Malta International Tournament,Attard,Malta,False,4,-2,Georgia
18193,19755,21076,1998,United States,Brazil,1,0,Gold Cup,Los Angeles,United States,False,1,1,United States
18194,19757,21078,1998,Burkina Faso,Algeria,2,1,African Cup of Nations,Ouagadougou,Burkina Faso,False,3,1,Burkina Faso
18195,19758,21079,1998,Cameroon,Guinea,2,2,African Cup of Nations,Ouagadougou,Burkina Faso,True,4,0,Draw
18196,19759,21080,1998,England,Chile,0,2,Friendly,London,England,False,2,-2,Chile
18197,19760,21081,1998,South Africa,Ivory Coast,1,1,African Cup of Nations,Bobo Dioulasso,Burkina Faso,True,2,0,Draw
18198,19761,21082,1998,Angola,Namibia,3,3,African Cup of Nations,Bobo Dioulasso,Burkina Faso,True,6,0,Draw
18199,19762,21083,1998,Ghana,Togo,1,2,African Cup of Nations,Ouagadougou,Burkina Faso,True,3,-1,Togo
18200,19763,21084,1998,Jamaica,Mexico,0,1,Gold Cup,Los Angeles,United States,True,1,-1,Mexico
18201,19764,21085,1998,Tunisia,DR Congo,2,1,African Cup of Nations,Ouagadougou,Burkina Faso,True,3,1,Tunisia
18202,19765,21086,1998,Morocco,Mozambique,3,0,African Cup of Nations,Bobo Dioulasso,Burkina Faso,True,3,3,Morocco
18203,19766,21087,1998,Zambia,Egypt,0,4,African Cup of Nations,Bobo Dioulasso,Burkina Faso,True,4,-4,Egypt
18204,19767,21088,1998,Australia,Japan,0,3,Friendly,Adelaide,Australia,False,3,-3,Japan
18205,19768,21089,1998,Brazil,Jamaica,1,0,Gold Cup,Los Angeles,United States,True,1,1,Brazil
18206,19769,21090,1998,Burkina Faso,Guinea,1,0,African Cup of Nations,Ouagadougou,Burkina Faso,False,1,1,Burkina Faso
18207,19770,21091,1998,Cameroon,Algeria,2,1,African Cup of Nations,Ouagadougou,Burkina Faso,True,3,1,Cameroon
18208,19771,21092,1998,United States,Mexico,0,1,Gold Cup,Los Angeles,United States,False,1,-1,Mexico
18209,19772,21093,1998,Ghana,DR Congo,0,1,African Cup of Nations,Ouagadougou,Burkina Faso,True,1,-1,DR Congo
18210,19773,21094,1998,Ivory Coast,Angola,5,2,African Cup of Nations,Ouagadougou,Burkina Faso,True,7,3,Ivory Coast
18211,19774,21095,1998,South Africa,Namibia,4,1,African Cup of Nations,Bobo Dioulasso,Burkina Faso,True,5,3,South Africa
18212,19775,21096,1998,Tunisia,Togo,3,1,African Cup of Nations,Ouagadougou,Burkina Faso,True,4,2,Tunisia
18213,19776,21097,1998,Egypt,Morocco,0,1,African Cup of Nations,Ouagadougou,Burkina Faso,True,1,-1,Morocco
18214,19777,21098,1998,Zambia,Mozambique,3,1,African Cup of Nations,Bobo Dioulasso,Burkina Faso,True,4,2,Zambia
18215,19778,21099,1998,Greece,Russia,1,1,Friendly,Athens,Greece,False,2,0,Draw
18216,19779,21100,1998,Israel,Turkey,4,0,Friendly,Ramat-Gan,Israel,False,4,4,Israel
18217,19780,21101,1998,Oman,Germany,0,2,Friendly,Muscat,Oman,False,2,-2,Germany
18218,19781,21102,1998,Cameroon,DR Congo,0,1,African Cup of Nations,Bobo Dioulasso,Burkina Faso,True,1,-1,DR Congo
18219,19782,21103,1998,Burkina Faso,Tunisia,1,1,African Cup of Nations,Ouagadougou,Burkina Faso,False,2,0,Draw
18220,19783,21104,1998,Ivory Coast,Egypt,0,0,African Cup of Nations,Ouagadougou,Burkina Faso,True,0,0,Draw
18221,19784,21105,1998,United States,Netherlands,0,2,Friendly,Miami Gardens,United States,False,2,-2,Netherlands
18222,19785,21106,1998,Antigua and Barbuda,Dominica,1,1,Friendly,St. John's,Antigua and Barbuda,False,2,0,Draw
18223,19786,21107,1998,Jamaica,Nigeria,2,2,Friendly,Kingston,Jamaica,False,4,0,Draw
18224,19787,21108,1998,Morocco,South Africa,1,2,African Cup of Nations,Ouagadougou,Burkina Faso,True,3,-1,South Africa
18225,19788,21109,1998,Saudi Arabia,Germany,0,3,Friendly,Riyadh,Saudi Arabia,False,3,-3,Germany
18226,19789,21110,1998,Argentina,Serbia,3,1,Friendly,Mar del Plata,Argentina,False,4,2,Argentina
18227,19790,21111,1998,Mexico,Netherlands,2,3,Friendly,Miami Gardens,United States,True,5,-1,Netherlands
18228,19791,21112,1998,Belgium,United States,2,0,Friendly,Brussels,Belgium,False,2,2,Belgium
18229,19792,21113,1998,Burkina Faso,Egypt,0,2,African Cup of Nations,Bobo Dioulasso,Burkina Faso,False,2,-2,Egypt
18230,19793,21114,1998,DR Congo,South Africa,1,2,African Cup of Nations,Ouagadougou,Burkina Faso,True,3,-1,South Africa
18231,19794,21115,1998,France,Norway,3,3,Friendly,Marseille,France,False,6,0,Draw
18232,19795,21116,1998,Israel,Poland,2,0,Friendly,Ramat-Gan,Israel,False,2,2,Israel
18233,19796,21117,1998,Burkina Faso,DR Congo,4,4,African Cup of Nations,Ouagadougou,Burkina Faso,False,8,0,Draw
18234,19797,21118,1998,South Africa,Egypt,0,2,African Cup of Nations,Ouagadougou,Burkina Faso,True,2,-2,Egypt
18235,19798,21119,1998,Barbados,Saint Kitts and Nevis,6,2,Friendly,Bridgetown,Barbados,False,8,4,Barbados
18236,19800,21122,1998,Aruba,French Guiana,1,0,CFU Caribbean Cup qualification,Oranjestad,Aruba,False,1,1,Aruba
18237,19801,21123,1998,Saint Lucia,Saint Kitts and Nevis,2,0,Friendly,Castries,Saint Lucia,False,2,2,Saint Lucia
18238,19802,21124,1998,Suriname,Curaçao,3,3,CFU Caribbean Cup qualification,Oranjestad,Aruba,True,6,0,Draw
18239,19803,21126,1998,Japan,Hong Kong,5,1,Dynasty Cup,Yokohama,Japan,False,6,4,Japan
18240,19804,21127,1998,Aruba,Curaçao,0,1,CFU Caribbean Cup qualification,Oranjestad,Aruba,False,1,-1,Curaçao
18241,19805,21128,1998,Saint Vincent and the Grenadines,Saint Kitts and Nevis,4,2,Friendly,Kingstown,Saint Vincent and the Grenadines,False,6,2,Saint Vincent and the Grenadines
18242,19806,21129,1998,Suriname,French Guiana,2,2,CFU Caribbean Cup qualification,Oranjestad,Aruba,True,4,0,Draw
18243,19807,21130,1998,Aruba,Suriname,3,3,CFU Caribbean Cup qualification,Oranjestad,Aruba,False,6,0,Draw
18244,19808,21131,1998,Curaçao,French Guiana,2,1,CFU Caribbean Cup qualification,Oranjestad,Aruba,True,3,1,Curaçao
18245,19811,21134,1998,Eswatini,Angola,0,1,COSAFA Cup,Lobamba,Eswatini,False,1,-1,Angola
18246,19812,21135,1998,Argentina,Bulgaria,2,0,Friendly,Buenos Aires,Argentina,False,2,2,Argentina
18247,19813,21136,1998,Haiti,Puerto Rico,4,0,CFU Caribbean Cup qualification,Port-au-Prince,Haiti,False,4,4,Haiti
18248,19814,21137,1998,Dominican Republic,Puerto Rico,3,1,CFU Caribbean Cup qualification,Port-au-Prince,Haiti,True,4,2,Dominican Republic
18249,19815,21138,1998,Burma,Brunei,4,1,AFF Championship,Rangoon,Burma,False,5,3,Burma
18250,19816,21139,1998,United States,Paraguay,2,2,Friendly,San Diego,United States,False,4,0,Draw
18251,19817,21140,1998,Haiti,Dominican Republic,5,0,CFU Caribbean Cup qualification,Port-au-Prince,Haiti,False,5,5,Haiti
18252,19818,21141,1998,Laos,Brunei,2,1,AFF Championship,Rangoon,Burma,True,3,1,Laos
18253,19819,21142,1998,Burma,Laos,3,0,AFF Championship,Rangoon,Burma,False,3,3,Burma
18254,19820,21143,1998,Mexico,Paraguay,1,1,Friendly,Mexico City,Mexico,False,2,0,Draw
18255,19821,21144,1998,Romania,Israel,0,1,Friendly,Bucharest,Romania,False,1,-1,Israel
18256,19822,21145,1998,Saint Lucia,Barbados,2,1,CFU Caribbean Cup qualification,Castries,Saint Lucia,False,3,1,Saint Lucia
18257,19823,21146,1998,Martinique,Barbados,4,1,CFU Caribbean Cup qualification,Castries,Saint Lucia,True,5,3,Martinique
18258,19824,21147,1998,Saint Lucia,Saint Vincent and the Grenadines,3,2,CFU Caribbean Cup qualification,Castries,Saint Lucia,False,5,1,Saint Lucia
18259,19825,21148,1998,Azerbaijan,Moldova,1,0,Friendly,Baku,Azerbaijan,False,1,1,Azerbaijan
18260,19826,21149,1998,Saint Lucia,Martinique,1,2,CFU Caribbean Cup qualification,Castries,Saint Lucia,False,3,-1,Martinique
18261,19828,21151,1998,Singapore,Philippines,1,0,AFF Championship,Singapore,Singapore,False,1,1,Singapore
18262,19829,21152,1998,Austria,Hungary,2,3,Friendly,Vienna,Austria,False,5,-1,Hungary
18263,19830,21153,1998,Belgium,Norway,2,2,Friendly,Brussels,Belgium,False,4,0,Draw
18264,19831,21154,1998,Colombia,Serbia,0,0,Friendly,Bogotá,Colombia,False,0,0,Draw
18265,19832,21155,1998,Czech Republic,Republic of Ireland,2,1,Friendly,Olomouc,Czech Republic,False,3,1,Czech Republic
18266,19833,21156,1998,Germany,Brazil,1,2,Friendly,Stuttgart,Germany,False,3,-1,Brazil
18267,19834,21158,1998,Malta,Finland,0,2,Friendly,Attard,Malta,False,2,-2,Finland
18268,19835,21159,1998,Northern Ireland,Slovakia,1,0,Friendly,Belfast,Northern Ireland,False,1,1,Northern Ireland
18269,19836,21160,1998,Poland,Slovenia,2,0,Friendly,Warsaw,Poland,False,2,2,Poland
18270,19837,21161,1998,Russia,France,1,0,Friendly,Moscow,Russia,False,1,1,Russia
18271,19838,21162,1998,Scotland,Denmark,0,1,Friendly,Glasgow,Scotland,False,1,-1,Denmark
18272,19839,21163,1998,Spain,Sweden,4,0,Friendly,Vigo,Spain,False,4,4,Spain
18273,19840,21164,1998,Switzerland,England,1,1,Friendly,Berne,Switzerland,False,2,0,Draw
18274,19841,21165,1998,Wales,Jamaica,0,0,Friendly,Cardiff,Wales,False,0,0,Draw
18275,19842,21166,1998,Cambodia,Philippines,1,1,AFF Championship,Singapore,Singapore,True,2,0,Draw
18276,19843,21167,1998,Singapore,Cambodia,3,0,AFF Championship,Singapore,Singapore,False,3,3,Singapore
18277,19844,21168,1998,Colombia,Paraguay,1,1,Friendly,New Haven,United States,True,2,0,Draw
18278,19845,21169,1998,Antigua and Barbuda,Saint Lucia,1,1,Friendly,St. John's,Antigua and Barbuda,False,2,0,Draw
18279,19846,21170,1998,Dominica,Guadeloupe,1,1,CFU Caribbean Cup qualification,Basseterre,Saint Kitts and Nevis,True,2,0,Draw
18280,19849,21174,1998,Saint Kitts and Nevis,Dominica,1,2,CFU Caribbean Cup qualification,Basseterre,Saint Kitts and Nevis,False,3,-1,Dominica
18281,19851,21176,1998,Saint Kitts and Nevis,Guadeloupe,2,1,CFU Caribbean Cup qualification,Basseterre,Saint Kitts and Nevis,False,3,1,Saint Kitts and Nevis
18282,19852,21177,1998,Romania,Greece,2,1,Friendly,Bucharest,Romania,False,3,1,Romania
18283,19853,21178,1998,Iran,Kuwait,1,1,Friendly,Teheran,Iran,False,2,0,Draw
18284,19854,21179,1998,Grenada,Anguilla,14,1,CFU Caribbean Cup qualification,St. John's,Antigua and Barbuda,True,15,13,Grenada
18285,19855,21180,1998,Israel,Argentina,2,1,Friendly,Jerusalem,Israel,False,3,1,Israel
18286,19856,21181,1998,Mexico,Peru,1,0,Friendly,Los Angeles,United States,True,1,1,Mexico
18287,19858,21184,1998,Antigua and Barbuda,Grenada,2,1,CFU Caribbean Cup qualification,St. John's,Antigua and Barbuda,False,3,1,Antigua and Barbuda
18288,19859,21185,1998,Guyana,Anguilla,14,0,CFU Caribbean Cup qualification,St. John's,Antigua and Barbuda,True,14,14,Guyana
18289,19860,21186,1998,Zimbabwe,Namibia,5,2,COSAFA Cup,Harare,Zimbabwe,False,7,3,Zimbabwe
18290,19861,21187,1998,Iran,Hungary,0,2,Friendly,Teheran,Iran,False,2,-2,Hungary
18291,19863,21189,1998,Latvia,Lithuania,1,2,Baltic Cup,Liepāja,Latvia,False,3,-1,Lithuania
18292,19864,21190,1998,Austria,United States,0,3,Friendly,Vienna,Austria,False,3,-3,United States
18293,19865,21191,1998,Belgium,Romania,1,1,Friendly,Brussels,Belgium,False,2,0,Draw
18294,19866,21192,1998,Bulgaria,Morocco,2,1,Friendly,Sofia,Bulgaria,False,3,1,Bulgaria
18295,19867,21193,1998,Chile,Colombia,2,2,Friendly,Santiago,Chile,False,4,0,Draw
18296,19868,21194,1998,Croatia,Poland,4,1,Friendly,Osijek,Croatia,False,5,3,Croatia
18297,19869,21195,1998,Denmark,Norway,0,2,Friendly,Copenhagen,Denmark,False,2,-2,Norway
18298,19870,21196,1998,England,Portugal,3,0,Friendly,London,England,False,3,3,England
18299,19871,21197,1998,Germany,Nigeria,1,0,Friendly,Cologne,Germany,False,1,1,Germany
18300,19873,21199,1998,Iran,Jamaica,1,0,Friendly,Teheran,Iran,False,1,1,Iran
18301,19874,21200,1998,Republic of Ireland,Argentina,0,2,Friendly,Dublin,Republic of Ireland,False,2,-2,Argentina
18302,19875,21201,1998,Italy,Paraguay,3,1,Friendly,Parma,Italy,False,4,2,Italy
18303,19876,21202,1998,Northern Ireland,Switzerland,1,0,Friendly,Belfast,Northern Ireland,False,1,1,Northern Ireland
18304,19877,21203,1998,Russia,Turkey,1,0,Friendly,Moscow,Russia,False,1,1,Russia
18305,19878,21204,1998,Scotland,Finland,1,1,Friendly,Edinburgh,Scotland,False,2,0,Draw
18306,19880,21206,1998,Slovenia,Czech Republic,1,3,Friendly,Murska Sobota,Slovenia,False,4,-2,Czech Republic
18307,19881,21207,1998,Sweden,France,0,0,Friendly,Solna,Sweden,False,0,0,Draw
18308,19882,21208,1998,Azerbaijan,Uzbekistan,2,1,Friendly,Baku,Azerbaijan,False,3,1,Azerbaijan
18309,19883,21209,1998,Brazil,Argentina,0,1,Friendly,Rio de Janeiro,Brazil,False,1,-1,Argentina
18310,19884,21210,1998,Chile,Lithuania,1,0,Friendly,Santiago,Chile,False,1,1,Chile
18311,19885,21211,1998,Tunisia,Georgia,1,1,Friendly,Sousse,Tunisia,False,2,0,Draw
18312,19886,21212,1998,Angola,Zambia,1,1,COSAFA Cup,Luanda,Angola,False,2,0,Draw
18313,19887,21213,1998,Jamaica,Saudi Arabia,0,0,Friendly,Nice,France,True,0,0,Draw
18314,19888,21214,1998,Jersey,Guernsey,2,0,Friendly,St. Helier,Jersey,False,2,2,Jersey
18315,19889,21215,1998,Cayman Islands,Cuba,2,2,CFU Caribbean Cup qualification,George Town,Cayman Islands,False,4,0,Draw
18316,19890,21216,1998,Cuba,Bermuda,2,1,CFU Caribbean Cup qualification,George Town,Cayman Islands,True,3,1,Cuba
18317,19891,21217,1998,Estonia,Mexico,0,6,Friendly,Montecatini Terme,Italy,True,6,-6,Mexico
18318,19892,21218,1998,Saudi Arabia,Trinidad and Tobago,2,1,Friendly,Cannes,France,True,3,1,Saudi Arabia
18319,19893,21219,1998,Cayman Islands,Bermuda,2,0,CFU Caribbean Cup qualification,George Town,Cayman Islands,False,2,2,Cayman Islands
18320,19894,21220,1998,Iceland,Saudi Arabia,1,1,Friendly,Cannes,France,True,2,0,Draw
18321,19895,21221,1998,Argentina,Bosnia and Herzegovina,5,0,Friendly,Córdoba,Argentina,False,5,5,Argentina
18322,19896,21223,1998,Estonia,Azerbaijan,0,0,Friendly,Viljandi,Estonia,False,0,0,Draw
18323,19898,21226,1998,Zambia,Mozambique,1,0,COSAFA Cup,Lusaka,Zambia,False,1,1,Zambia
18324,19899,21227,1998,Japan,Paraguay,1,1,Kirin Cup,Tokyo,Japan,False,2,0,Draw
18325,19900,21228,1998,Latvia,Israel,1,5,Friendly,Riga,Latvia,False,6,-4,Israel
18326,19901,21229,1998,Saudi Arabia,Namibia,2,1,Friendly,Cannes,France,True,3,1,Saudi Arabia
18327,19903,21231,1998,Argentina,Chile,1,0,Friendly,Mendoza,Argentina,False,1,1,Argentina
18328,19904,21232,1998,Cameroon,Burkina Faso,2,0,Friendly,Yaoundé,Cameroon,False,2,2,Cameroon
18329,19905,21234,1998,Norway,Mexico,5,2,Friendly,Oslo,Norway,False,7,3,Norway
18330,19906,21235,1998,South Africa,Zambia,1,1,Friendly,Johannesburg,South Africa,False,2,0,Draw
18331,19907,21236,1998,Czech Republic,Paraguay,1,0,Kirin Cup,Kobe,Japan,True,1,1,Czech Republic
18332,19908,21238,1998,England,Saudi Arabia,0,0,Friendly,London,England,False,0,0,Draw
18333,19909,21239,1998,Republic of Ireland,Mexico,0,0,Friendly,Dublin,Republic of Ireland,False,0,0,Draw
18334,19910,21240,1998,Chile,Uruguay,2,2,Friendly,Santiago,Chile,False,4,0,Draw
18335,19911,21241,1998,Japan,Czech Republic,0,0,Kirin Cup,Yokohama,Japan,False,0,0,Draw
18336,19912,21242,1998,Mozambique,Zimbabwe,0,2,COSAFA Cup,Maputo,Mozambique,False,2,-2,Zimbabwe
18337,19913,21243,1998,United States,Kuwait,2,0,Friendly,Portland,United States,False,2,2,United States
18338,19914,21244,1998,Argentina,South Africa,2,0,Friendly,Buenos Aires,Argentina,False,2,2,Argentina
18339,19915,21245,1998,Austria,Tunisia,2,1,Friendly,Vienna,Austria,False,3,1,Austria
18340,19916,21246,1998,Belgium,France,0,1,King Hassan II Tournament,Casablanca,Morocco,True,1,-1,France
18341,19917,21247,1998,Finland,Germany,0,0,Friendly,Helsinki,Finland,False,0,0,Draw
18342,19918,21248,1998,Hungary,Lithuania,1,0,Friendly,Nyíregyháza,Hungary,False,1,1,Hungary
18343,19919,21250,1998,Morocco,England,0,1,King Hassan II Tournament,Casablanca,Morocco,False,1,-1,England
18344,19920,21251,1998,Netherlands,Cameroon,0,0,Friendly,Arnhem,Netherlands,False,0,0,Draw
18345,19921,21252,1998,Norway,Saudi Arabia,6,0,Friendly,Molde,Norway,False,6,6,Norway
18346,19922,21253,1998,Poland,Russia,3,1,Friendly,Chorzów,Poland,False,4,2,Poland
18347,19923,21254,1998,Saint Kitts and Nevis,Trinidad and Tobago,4,1,SKN Football Festival,Basseterre,Saint Kitts and Nevis,False,5,3,Saint Kitts and Nevis
18348,19924,21255,1998,Sweden,Denmark,3,0,Friendly,Malmö,Sweden,False,3,3,Sweden
18349,19925,21256,1998,Belgium,England,0,0,King Hassan II Tournament,Casablanca,Morocco,True,0,0,Draw
18350,19926,21257,1998,Morocco,France,2,2,King Hassan II Tournament,Casablanca,Morocco,False,4,0,Draw
18351,19927,21258,1998,Serbia,Nigeria,3,0,Friendly,Belgrade,Yugoslavia,False,3,3,Serbia
18352,19928,21259,1998,Georgia,Russia,1,1,Friendly,Tbilisi,Georgia,False,2,0,Draw
18353,19929,21260,1998,Germany,Colombia,3,1,Friendly,Frankfurt am Main,Germany,False,4,2,Germany
18354,19930,21261,1998,Namibia,Angola,1,1,COSAFA Cup,Windhoek,Namibia,False,2,0,Draw
18355,19931,21262,1998,United States,Scotland,0,0,Friendly,Washington,United States,False,0,0,Draw
18356,19932,21263,1998,Chile,Tunisia,3,2,Friendly,Montélimar,France,True,5,1,Chile
18357,19933,21264,1998,Japan,Mexico,1,2,Friendly,Lausanne,Switzerland,True,3,-1,Mexico
18358,19934,21265,1998,Luxembourg,Cameroon,0,2,Friendly,Luxembourg,Luxembourg,False,2,-2,Cameroon
18359,19935,21266,1998,Netherlands,Paraguay,5,1,Friendly,Eindhoven,Netherlands,False,6,4,Netherlands
18360,19936,21267,1998,Austria,Liechtenstein,6,0,Friendly,Vienna,Austria,False,6,6,Austria
18361,19937,21268,1998,Sweden,Italy,1,0,Friendly,Gothenburg,Sweden,False,1,1,Sweden
18362,19938,21269,1998,Andorra,Brazil,0,3,Friendly,Saint-Ouen,France,True,3,-3,Brazil
18363,19939,21270,1998,Belgium,Colombia,2,0,Friendly,Brussels,Belgium,False,2,2,Belgium
18364,19940,21271,1998,Croatia,Iran,2,0,Friendly,Rijeka,Croatia,False,2,2,Croatia
18365,19941,21273,1998,Malta,Wales,0,3,Friendly,Attard,Malta,False,3,-3,Wales
18366,19942,21274,1998,Romania,Paraguay,3,2,Friendly,Bucharest,Romania,False,5,1,Romania
18367,19943,21275,1998,Saudi Arabia,Mexico,0,0,Friendly,Créteil,France,True,0,0,Draw
18368,19944,21276,1998,Serbia,Japan,1,0,Friendly,Lausanne,Switzerland,True,1,1,Serbia
18369,19945,21277,1998,Spain,Northern Ireland,4,1,Friendly,Santander,Spain,False,5,3,Spain
18370,19946,21278,1998,Chile,Morocco,1,1,Friendly,Avignon,France,True,2,0,Draw
18371,19947,21279,1998,Estonia,Faroe Islands,5,0,UEFA Euro qualification,Tallinn,Estonia,False,5,5,Estonia
18372,19948,21281,1998,Bulgaria,Algeria,2,0,Friendly,Sofia,Bulgaria,False,2,2,Bulgaria
18373,19949,21282,1998,Denmark,Cameroon,1,2,Friendly,Copenhagen,Denmark,False,3,-1,Cameroon
18374,19950,21283,1998,Finland,France,0,1,Friendly,Helsinki,Finland,False,1,-1,France
18375,19951,21284,1998,Germany,Luxembourg,7,0,Friendly,Mannheim,Germany,False,7,7,Germany
18376,19952,21285,1998,Netherlands,Nigeria,5,1,Friendly,Amsterdam,Netherlands,False,6,4,Netherlands
18377,19953,21286,1998,Belgium,Paraguay,1,0,Friendly,Brussels,Belgium,False,1,1,Belgium
18378,19954,21287,1998,Croatia,Australia,7,0,Friendly,Zagreb,Croatia,False,7,7,Croatia
18379,19955,21288,1998,Iceland,South Africa,1,1,Friendly,Baiersbronn,Germany,True,2,0,Draw
18380,19956,21289,1998,Kenya,Seychelles,1,1,Friendly,Nairobi,Kenya,False,2,0,Draw
18381,19957,21290,1998,Romania,Moldova,5,1,Friendly,Ploieşti,Romania,False,6,4,Romania
18382,19958,21291,1998,Switzerland,Serbia,1,1,Friendly,Basel,Switzerland,False,2,0,Draw
18383,19959,21292,1998,Tunisia,Wales,4,0,Friendly,Tunis,Tunisia,False,4,4,Tunisia
18384,19960,21293,1998,Belarus,Lithuania,5,0,Friendly,Minsk,Belarus,False,5,5,Belarus
18385,19961,21294,1998,Brazil,Scotland,2,1,FIFA World Cup,Saint-Denis,France,True,3,1,Brazil
18386,19962,21295,1998,Morocco,Norway,2,2,FIFA World Cup,Montpellier,France,True,4,0,Draw
18387,19963,21296,1998,Cameroon,Austria,1,1,FIFA World Cup,Toulouse,France,True,2,0,Draw
18388,19964,21297,1998,Italy,Chile,2,2,FIFA World Cup,Bordeaux,France,True,4,0,Draw
18389,19965,21298,1998,France,South Africa,3,0,FIFA World Cup,Marseille,France,False,3,3,France
18390,19966,21299,1998,Paraguay,Bulgaria,0,0,FIFA World Cup,Montpellier,France,True,0,0,Draw
18391,19967,21300,1998,Saudi Arabia,Denmark,0,1,FIFA World Cup,Lens,France,True,1,-1,Denmark
18392,19968,21302,1998,Netherlands,Belgium,0,0,FIFA World Cup,Saint-Denis,France,True,0,0,Draw
18393,19969,21303,1998,Seychelles,Kenya,0,1,Friendly,Victoria,Seychelles,False,1,-1,Kenya
18394,19970,21304,1998,Spain,Nigeria,2,3,FIFA World Cup,Nantes,France,True,5,-1,Nigeria
18395,19971,21305,1998,Argentina,Japan,1,0,FIFA World Cup,Toulouse,France,True,1,1,Argentina
18396,19972,21306,1998,Jamaica,Croatia,1,3,FIFA World Cup,Lens,France,True,4,-2,Croatia
18397,19973,21307,1998,Serbia,Iran,1,0,FIFA World Cup,Saint-Étienne,France,True,1,1,Serbia
18398,19974,21308,1998,England,Tunisia,2,0,FIFA World Cup,Marseille,France,True,2,2,England
18399,19975,21309,1998,Germany,United States,2,0,FIFA World Cup,Paris,France,True,2,2,Germany
18400,19976,21310,1998,Romania,Colombia,1,0,FIFA World Cup,Lyon,France,True,1,1,Romania
18401,19977,21311,1998,Brazil,Morocco,3,0,FIFA World Cup,Nantes,France,True,3,3,Brazil
18402,19978,21312,1998,Scotland,Norway,1,1,FIFA World Cup,Bordeaux,France,True,2,0,Draw
18403,19979,21313,1998,Chile,Austria,1,1,FIFA World Cup,Saint-Étienne,France,True,2,0,Draw
18404,19980,21314,1998,Italy,Cameroon,3,0,FIFA World Cup,Montpellier,France,True,3,3,Italy
18405,19981,21315,1998,France,Saudi Arabia,4,0,FIFA World Cup,Saint-Denis,France,False,4,4,France
18406,19982,21316,1998,South Africa,Denmark,1,1,FIFA World Cup,Toulouse,France,True,2,0,Draw
18407,19983,21317,1998,Nigeria,Bulgaria,1,0,FIFA World Cup,Paris,France,True,1,1,Nigeria
18408,19984,21318,1998,Spain,Paraguay,0,0,FIFA World Cup,Saint-Étienne,France,True,0,0,Draw
18409,19985,21319,1998,Belgium,Mexico,2,2,FIFA World Cup,Bordeaux,France,True,4,0,Draw
18410,19986,21320,1998,Japan,Croatia,0,1,FIFA World Cup,Nantes,France,True,1,-1,Croatia
18411,19988,21322,1998,Argentina,Jamaica,5,0,FIFA World Cup,Paris,France,True,5,5,Argentina
18412,19989,21323,1998,Germany,Serbia,2,2,FIFA World Cup,Lens,France,True,4,0,Draw
18413,19990,21324,1998,United States,Iran,1,2,FIFA World Cup,Lyon,France,True,3,-1,Iran
18414,19991,21325,1998,Colombia,Tunisia,1,0,FIFA World Cup,Montpellier,France,True,1,1,Colombia
18415,19992,21326,1998,Estonia,Andorra,2,1,Friendly,Kuressaare,Estonia,False,3,1,Estonia
18416,19993,21327,1998,Romania,England,2,1,FIFA World Cup,Toulouse,France,True,3,1,Romania
18417,19994,21328,1998,Brazil,Norway,1,2,FIFA World Cup,Marseille,France,True,3,-1,Norway
18418,19995,21329,1998,Chile,Cameroon,1,1,FIFA World Cup,Nantes,France,True,2,0,Draw
18419,19996,21330,1998,Italy,Austria,2,1,FIFA World Cup,Saint-Denis,France,True,3,1,Italy
18420,19997,21331,1998,Scotland,Morocco,0,3,FIFA World Cup,Saint-Étienne,France,True,3,-3,Morocco
18421,19998,21332,1998,Andorra,Azerbaijan,0,0,Friendly,Viljandi,Estonia,True,0,0,Draw
18422,19999,21333,1998,France,Denmark,2,1,FIFA World Cup,Lyon,France,False,3,1,France
18423,20000,21334,1998,Nigeria,Paraguay,1,3,FIFA World Cup,Toulouse,France,True,4,-2,Paraguay
18424,20001,21335,1998,South Africa,Saudi Arabia,2,2,FIFA World Cup,Bordeaux,France,True,4,0,Draw
18425,20002,21336,1998,Spain,Bulgaria,6,1,FIFA World Cup,Lens,France,True,7,5,Spain
18426,20004,21338,1998,Estonia,Latvia,0,2,Baltic Cup,Valga,Estonia,False,2,-2,Latvia
18427,20005,21339,1998,Germany,Iran,2,0,FIFA World Cup,Montpellier,France,True,2,2,Germany
18428,20006,21340,1998,Netherlands,Mexico,2,2,FIFA World Cup,Saint-Étienne,France,True,4,0,Draw
18429,20007,21341,1998,United States,Serbia,0,1,FIFA World Cup,Nantes,France,True,1,-1,Serbia
18430,20008,21342,1998,Argentina,Croatia,1,0,FIFA World Cup,Bordeaux,France,True,1,1,Argentina
18431,20009,21343,1998,Azerbaijan,Lithuania,2,1,Friendly,Viljandi,Estonia,True,3,1,Azerbaijan
18432,20010,21344,1998,Colombia,England,0,2,FIFA World Cup,Lens,France,True,2,-2,England
18433,20011,21345,1998,Japan,Jamaica,1,2,FIFA World Cup,Lyon,France,True,3,-1,Jamaica
18434,20012,21346,1998,Latvia,Andorra,2,0,Friendly,Pärnu,Estonia,True,2,2,Latvia
18435,20013,21347,1998,Romania,Tunisia,1,1,FIFA World Cup,Saint-Denis,France,True,2,0,Draw
18436,20014,21348,1998,Brazil,Chile,4,1,FIFA World Cup,Paris,France,True,5,3,Brazil
18437,20015,21349,1998,Italy,Norway,1,0,FIFA World Cup,Marseille,France,True,1,1,Italy
18438,20017,21351,1998,Estonia,Lithuania,0,0,Baltic Cup,Viljandi,Estonia,False,0,0,Draw
18439,20018,21352,1998,France,Paraguay,1,0,FIFA World Cup,Lens,France,False,1,1,France
18440,20019,21353,1998,Nigeria,Denmark,1,4,FIFA World Cup,Saint-Denis,France,True,5,-3,Denmark
18441,20020,21354,1998,Germany,Mexico,2,1,FIFA World Cup,Montpellier,France,True,3,1,Germany
18442,20021,21355,1998,Lithuania,Andorra,4,0,Friendly,Karksi-Nuia,Estonia,True,4,4,Lithuania
18443,20022,21356,1998,Netherlands,Serbia,2,1,FIFA World Cup,Toulouse,France,True,3,1,Netherlands
18444,20023,21357,1998,Argentina,England,2,2,FIFA World Cup,Saint-Étienne,France,True,4,0,Draw
18445,20024,21358,1998,Romania,Croatia,0,1,FIFA World Cup,Bordeaux,France,True,1,-1,Croatia
18446,20025,21359,1998,Oman,Syria,1,2,Friendly,Muscat,Oman,False,3,-1,Syria
18447,20026,21360,1998,Brazil,Denmark,3,2,FIFA World Cup,Nantes,France,True,5,1,Brazil
18448,20027,21361,1998,France,Italy,0,0,FIFA World Cup,Saint-Denis,France,False,0,0,Draw
18449,20028,21362,1998,Germany,Croatia,0,3,FIFA World Cup,Lyon,France,True,3,-3,Croatia
18450,20029,21363,1998,Netherlands,Argentina,2,1,FIFA World Cup,Marseille,France,True,3,1,Netherlands
18451,20030,21364,1998,Rwanda,Tanzania,2,0,Friendly,Kigali,Rwanda,False,2,2,Rwanda
18452,20031,21365,1998,Malawi,Mozambique,2,1,Friendly,Mzuzu,Malawi,False,3,1,Malawi
18453,20032,21366,1998,Rwanda,Tanzania,2,2,Friendly,Kigali,Rwanda,False,4,0,Draw
18454,20033,21367,1998,Brazil,Netherlands,1,1,FIFA World Cup,Marseille,France,True,2,0,Draw
18455,20034,21368,1998,France,Croatia,2,1,FIFA World Cup,Saint-Denis,France,False,3,1,France
18456,20035,21369,1998,Malawi,Mozambique,2,2,Friendly,Lilongwe,Malawi,False,4,0,Draw
18457,20036,21370,1998,Uganda,Tanzania,3,0,Friendly,Kampala,Uganda,False,3,3,Uganda
18458,20037,21371,1998,Malawi,Mozambique,0,0,Friendly,Blantyre,Malawi,False,0,0,Draw
18459,20038,21372,1998,Netherlands,Croatia,1,2,FIFA World Cup,Paris,France,True,3,-1,Croatia
18460,20039,21373,1998,France,Brazil,3,0,FIFA World Cup,Saint-Denis,France,False,3,3,France
18461,20040,21374,1998,Ukraine,Poland,1,2,Friendly,Kyïv,Ukraine,False,3,-1,Poland
18462,20041,21375,1998,Malawi,Zimbabwe,1,0,Friendly,Blantyre,Malawi,False,1,1,Malawi
18463,20042,21376,1998,Uganda,Kenya,3,3,Friendly,Kampala,Uganda,False,6,0,Draw
18464,20043,21377,1998,Lebanon,Palestine,3,1,UAFA Cup,Beirut,Lebanon,False,4,2,Lebanon
18465,20044,21378,1998,Malawi,Zimbabwe,0,0,Friendly,Lilongwe,Malawi,False,0,0,Draw
18466,20045,21379,1998,Syria,Jordan,3,0,UAFA Cup,Beirut,Lebanon,True,3,3,Syria
18467,20046,21380,1998,Curaçao,Haiti,0,4,CFU Caribbean Cup,Kingston,Jamaica,True,4,-4,Haiti
18468,20047,21381,1998,Jamaica,Cayman Islands,4,0,CFU Caribbean Cup,Kingston,Jamaica,False,4,4,Jamaica
18469,20048,21382,1998,Martinique,Dominica,5,1,CFU Caribbean Cup,Port of Spain,Trinidad and Tobago,True,6,4,Martinique
18470,20050,21384,1998,Trinidad and Tobago,Antigua and Barbuda,3,2,CFU Caribbean Cup,Port of Spain,Trinidad and Tobago,False,5,1,Trinidad and Tobago
18471,20051,21385,1998,Lebanon,Jordan,0,2,UAFA Cup,Beirut,Lebanon,False,2,-2,Jordan
18472,20052,21386,1998,Palestine,Syria,1,2,UAFA Cup,Beirut,Lebanon,True,3,-1,Syria
18473,20053,21387,1998,Antigua and Barbuda,Dominica,2,1,CFU Caribbean Cup,Port of Spain,Trinidad and Tobago,True,3,1,Antigua and Barbuda
18474,20054,21388,1998,Burkina Faso,Niger,1,0,Friendly,Ouagadougou,Burkina Faso,False,1,1,Burkina Faso
18475,20055,21389,1998,Cayman Islands,Haiti,0,1,CFU Caribbean Cup,Kingston,Jamaica,True,1,-1,Haiti
18476,20056,21390,1998,Jamaica,Curaçao,3,2,CFU Caribbean Cup,Kingston,Jamaica,False,5,1,Jamaica
18477,20057,21391,1998,Trinidad and Tobago,Martinique,2,1,CFU Caribbean Cup,Port of Spain,Trinidad and Tobago,False,3,1,Trinidad and Tobago
18478,20058,21392,1998,Benin,Ghana,0,1,Friendly,Cotonou,Benin,False,1,-1,Ghana
18479,20059,21393,1998,Antigua and Barbuda,Martinique,5,1,CFU Caribbean Cup,Port of Spain,Trinidad and Tobago,True,6,4,Antigua and Barbuda
18480,20060,21394,1998,Curaçao,Cayman Islands,0,2,CFU Caribbean Cup,Kingston,Jamaica,True,2,-2,Cayman Islands
18481,20061,21395,1998,Jamaica,Haiti,2,1,CFU Caribbean Cup,Kingston,Jamaica,False,3,1,Jamaica
18482,20062,21396,1998,Jordan,Palestine,1,1,UAFA Cup,Beirut,Lebanon,True,2,0,Draw
18483,20063,21397,1998,Lebanon,Syria,0,1,UAFA Cup,Beirut,Lebanon,False,1,-1,Syria
18484,20064,21398,1998,Niger,Ivory Coast,1,0,Friendly,Niamey,Niger,False,1,1,Niger
18485,20065,21399,1998,Senegal,Mali,3,1,Friendly,Dakar,Senegal,False,4,2,Senegal
18486,20066,21400,1998,Trinidad and Tobago,Dominica,8,0,CFU Caribbean Cup,Port of Spain,Trinidad and Tobago,False,8,8,Trinidad and Tobago
18487,20067,21401,1998,Jamaica,Antigua and Barbuda,1,0,CFU Caribbean Cup,Port of Spain,Trinidad and Tobago,True,1,1,Jamaica
18488,20068,21402,1998,Trinidad and Tobago,Haiti,4,1,CFU Caribbean Cup,Port of Spain,Trinidad and Tobago,False,5,3,Trinidad and Tobago
18489,20069,21403,1998,Guam,Northern Mariana Islands,2,1,Friendly,Koror,Palau,True,3,1,Guam
18490,20070,21404,1998,Antigua and Barbuda,Haiti,2,3,CFU Caribbean Cup,Port of Spain,Trinidad and Tobago,True,5,-1,Haiti
18491,20071,21405,1998,Kenya,Djibouti,3,0,African Cup of Nations qualification,Nairobi,Kenya,False,3,3,Kenya
18492,20072,21406,1998,Libya,Algeria,0,2,African Cup of Nations qualification,Tripoli,Libya,False,2,-2,Algeria
18493,20073,21407,1998,Trinidad and Tobago,Jamaica,1,2,CFU Caribbean Cup,Port of Spain,Trinidad and Tobago,False,3,-1,Jamaica
18494,20074,21408,1998,Namibia,Malawi,2,1,African Cup of Nations qualification,Windhoek,Namibia,False,3,1,Namibia
18495,20075,21409,1998,Palau,Guam,2,15,Friendly,Koror,Palau,False,17,-13,Guam
18496,20076,21410,1998,Uganda,Rwanda,5,0,African Cup of Nations qualification,Kampala,Uganda,False,5,5,Uganda
18497,20077,21411,1998,Botswana,Mozambique,0,0,African Cup of Nations qualification,Gaborone,Botswana,False,0,0,Draw
18498,20078,21412,1998,Burundi,Tanzania,1,0,African Cup of Nations qualification,Bujumbura,Burundi,False,1,1,Burundi
18499,20079,21413,1998,Chad,Congo,1,1,African Cup of Nations qualification,N'Djamena,Chad,False,2,0,Draw
18500,20080,21414,1998,Equatorial Guinea,Gabon,0,2,African Cup of Nations qualification,Bata,Equatorial Guinea,False,2,-2,Gabon
18501,20081,21415,1998,Lesotho,Mauritius,1,1,African Cup of Nations qualification,Maseru,Lesotho,False,2,0,Draw
18502,20083,21417,1998,Niger,Liberia,2,1,African Cup of Nations qualification,Niamey,Niger,False,3,1,Niger
18503,20084,21418,1998,São Tomé and Príncipe,Togo,0,4,African Cup of Nations qualification,Libreville,Gabon,True,4,-4,Togo
18504,20085,21419,1998,Eswatini,Madagascar,1,2,African Cup of Nations qualification,Mbabane,Eswatini,False,3,-1,Madagascar
18505,20086,21420,1998,Guam,Northern Mariana Islands,0,3,Friendly,Koror,Palau,True,3,-3,Northern Mariana Islands
18506,20087,21421,1998,Zambia,Namibia,1,1,COSAFA Cup,Lusaka,Zambia,False,2,0,Draw
18507,20088,21422,1998,Benin,Niger,1,1,Friendly,Cotonou,Benin,False,2,0,Draw
18508,20089,21423,1998,Azerbaijan,Georgia,1,0,Friendly,Gəncə,Azerbaijan,False,1,1,Azerbaijan
18509,20090,21424,1998,Algeria,Libya,3,0,African Cup of Nations qualification,Algiers,Algeria,False,3,3,Algeria
18510,20091,21425,1998,Kenya,Djibouti,9,1,African Cup of Nations qualification,Nairobi,Kenya,False,10,8,Kenya
18511,20092,21426,1998,Malawi,Namibia,0,1,African Cup of Nations qualification,Blantyre,Malawi,False,1,-1,Namibia
18512,20093,21427,1998,Mozambique,Botswana,2,1,African Cup of Nations qualification,Maputo,Mozambique,False,3,1,Mozambique
18513,20094,21428,1998,Tanzania,Burundi,0,1,African Cup of Nations qualification,Dar es Salaam,Tanzania,False,1,-1,Burundi
18514,20095,21429,1998,Thailand,Uzbekistan,4,1,Friendly,Bangkok,Thailand,False,5,3,Thailand
18515,20096,21430,1998,Angola,Benin,2,0,African Cup of Nations qualification,Luanda,Angola,False,2,2,Angola
18516,20097,21432,1998,Congo,Chad,0,0,African Cup of Nations qualification,Pointe-Noire,Congo,False,0,0,Draw
18517,20098,21433,1998,Gabon,Equatorial Guinea,3,0,African Cup of Nations qualification,Libreville,Gabon,False,3,3,Gabon
18518,20099,21434,1998,Liberia,Niger,2,0,African Cup of Nations qualification,Monrovia,Liberia,False,2,2,Liberia
18519,20100,21435,1998,Lithuania,Moldova,1,1,Friendly,Kaunas,Lithuania,False,2,0,Draw
18520,20101,21436,1998,Rwanda,Uganda,0,0,African Cup of Nations qualification,Kigali,Rwanda,False,0,0,Draw
18521,20102,21437,1998,Armenia,Lebanon,1,0,Friendly,Abovyan,Armenia,False,1,1,Armenia
18522,20103,21438,1998,Poland,Israel,2,0,Friendly,Cracow,Poland,False,2,2,Poland
18523,20104,21439,1998,Togo,São Tomé and Príncipe,2,0,African Cup of Nations qualification,Lomé,Togo,False,2,2,Togo
18524,20105,21440,1998,Austria,France,2,2,Friendly,Vienna,Austria,False,4,0,Draw
18525,20106,21441,1998,Bosnia and Herzegovina,Faroe Islands,1,0,UEFA Euro qualification,Sarajevo,Bosnia and Herzegovina,False,1,1,Bosnia and Herzegovina
18526,20107,21442,1998,Cyprus,Albania,3,2,Friendly,Nicosia,Cyprus,False,5,1,Cyprus
18527,20108,21443,1998,Czech Republic,Denmark,1,0,Friendly,Prague,Czech Republic,False,1,1,Czech Republic
18528,20109,21444,1998,Hungary,Slovenia,2,1,Friendly,Zalaegerszeg,Hungary,False,3,1,Hungary
18529,20110,21445,1998,Iceland,Latvia,4,1,Friendly,Reykjavík,Iceland,False,5,3,Iceland
18530,20111,21446,1998,Lithuania,Belarus,0,3,Friendly,Vilnius,Lithuania,False,3,-3,Belarus
18531,20112,21447,1998,Norway,Romania,0,0,Friendly,Oslo,Norway,False,0,0,Draw
18532,20113,21448,1998,Portugal,Mozambique,2,1,Friendly,Ponta Delgada,Portugal,False,3,1,Portugal
18533,20114,21449,1998,Slovakia,Finland,0,0,Friendly,Košice,Slovakia,False,0,0,Draw
18534,20115,21450,1998,Sweden,Russia,1,0,Friendly,Örebro,Sweden,False,1,1,Sweden
18535,20116,21451,1998,Ukraine,Georgia,4,0,Friendly,Kyïv,Ukraine,False,4,4,Ukraine
18536,20117,21452,1998,Estonia,Moldova,0,1,Friendly,Kohtla-Järve,Estonia,False,1,-1,Moldova
18537,20118,21453,1998,Burkina Faso,Togo,1,1,Friendly,Ouagadougou,Burkina Faso,False,2,0,Draw
18538,20119,21454,1998,Mauritius,Lesotho,3,1,African Cup of Nations qualification,Curepipe,Mauritius,False,4,2,Mauritius
18539,20120,21455,1998,Malaysia,Singapore,0,2,AFF Championship,Hanoi,Vietnam,True,2,-2,Singapore
18540,20121,21456,1998,Vietnam,Laos,4,1,AFF Championship,Hanoi,Vietnam,False,5,3,Vietnam
18541,20122,21457,1998,Indonesia,Philippines,3,0,AFF Championship,Ho Chi Minh City,Vietnam,True,3,3,Indonesia
18542,20123,21458,1998,Thailand,Burma,1,1,AFF Championship,Ho Chi Minh City,Vietnam,True,2,0,Draw
18543,20124,21459,1998,Malaysia,Laos,0,0,AFF Championship,Hanoi,Vietnam,True,0,0,Draw
18544,20125,21460,1998,Vietnam,Singapore,0,0,AFF Championship,Hanoi,Vietnam,False,0,0,Draw
18545,20126,21461,1998,Indonesia,Burma,6,2,AFF Championship,Ho Chi Minh City,Vietnam,True,8,4,Indonesia
18546,20127,21462,1998,Thailand,Philippines,3,1,AFF Championship,Ho Chi Minh City,Vietnam,True,4,2,Thailand
18547,20128,21463,1998,Angola,Zimbabwe,2,1,COSAFA Cup,Luanda,Angola,False,3,1,Angola
18548,20129,21464,1998,Burkina Faso,Ivory Coast,1,1,Friendly,Ouagadougou,Burkina Faso,False,2,0,Draw
18549,20130,21465,1998,Singapore,Laos,4,1,AFF Championship,Hanoi,Vietnam,True,5,3,Singapore
18550,20131,21466,1998,Vietnam,Malaysia,1,0,AFF Championship,Hanoi,Vietnam,False,1,1,Vietnam
18551,20132,21467,1998,Burkina Faso,Senegal,1,1,Friendly,Ouagadougou,Burkina Faso,False,2,0,Draw
18552,20133,21468,1998,Burma,Philippines,5,2,AFF Championship,Ho Chi Minh City,Vietnam,True,7,3,Burma
18553,20134,21469,1998,Thailand,Indonesia,3,2,AFF Championship,Ho Chi Minh City,Vietnam,True,5,1,Thailand
18554,20135,21470,1998,Cook Islands,Samoa,2,1,Oceania Nations Cup qualification,Avarua,Cook Islands,False,3,1,Cook Islands
18555,20136,21471,1998,Malta,Germany,1,2,Friendly,Attard,Malta,False,3,-1,Germany
18556,20137,21472,1998,Morocco,Senegal,2,0,Friendly,Tangier,Morocco,False,2,2,Morocco
18557,20138,21473,1998,Romania,Liechtenstein,7,0,UEFA Euro qualification,Bucharest,Romania,False,7,7,Romania
18558,20139,21474,1998,Serbia,Switzerland,1,1,Friendly,Niš,Yugoslavia,False,2,0,Draw
18559,20140,21475,1998,Singapore,Indonesia,2,1,AFF Championship,Ho Chi Minh City,Vietnam,True,3,1,Singapore
18560,20141,21476,1998,Tonga,American Samoa,3,0,Oceania Nations Cup qualification,Avarua,Cook Islands,True,3,3,Tonga
18561,20142,21477,1998,Cook Islands,American Samoa,4,3,Oceania Nations Cup qualification,Avarua,Cook Islands,False,7,1,Cook Islands
18562,20143,21479,1998,Vietnam,Thailand,3,0,AFF Championship,Hanoi,Vietnam,False,3,3,Vietnam
18563,20144,21480,1998,Armenia,Andorra,3,1,UEFA Euro qualification,Yerevan,Armenia,False,4,2,Armenia
18564,20145,21481,1998,Austria,Israel,1,1,UEFA Euro qualification,Vienna,Austria,False,2,0,Draw
18565,20146,21482,1998,Belarus,Denmark,0,0,UEFA Euro qualification,Minsk,Belarus,False,0,0,Draw
18566,20147,21483,1998,Bosnia and Herzegovina,Estonia,1,1,UEFA Euro qualification,Sarajevo,Bosnia and Herzegovina,False,2,0,Draw
18567,20148,21484,1998,Cook Islands,Tonga,2,2,Oceania Nations Cup qualification,Avarua,Cook Islands,False,4,0,Draw
18568,20149,21485,1998,Cyprus,Spain,3,2,UEFA Euro qualification,Larnaca,Cyprus,False,5,1,Cyprus
18569,20150,21486,1998,Fiji,New Caledonia,3,0,Oceania Nations Cup qualification,Luganville,Vanuatu,True,3,3,Fiji
18570,20151,21487,1998,Finland,Moldova,3,2,UEFA Euro qualification,Helsinki,Finland,False,5,1,Finland
18571,20152,21488,1998,Georgia,Albania,1,0,UEFA Euro qualification,Tbilisi,Georgia,False,1,1,Georgia
18572,20153,21489,1998,Germany,Romania,1,1,Friendly,Attard,Malta,True,2,0,Draw
18573,20154,21490,1998,Iceland,France,1,1,UEFA Euro qualification,Reykjavík,Iceland,False,2,0,Draw
18574,20155,21491,1998,Indonesia,Thailand,3,3,AFF Championship,Ho Chi Minh City,Vietnam,True,6,0,Draw
18575,20156,21492,1998,Republic of Ireland,Croatia,2,0,UEFA Euro qualification,Dublin,Republic of Ireland,False,2,2,Republic of Ireland
18576,20157,21493,1998,Lithuania,Scotland,0,0,UEFA Euro qualification,Vilnius,Lithuania,False,0,0,Draw
18577,20158,21494,1998,Slovakia,Azerbaijan,3,0,UEFA Euro qualification,Košice,Slovakia,False,3,3,Slovakia
18578,20159,21495,1998,Solomon Islands,Papua New Guinea,3,1,Oceania Nations Cup qualification,Luganville,Vanuatu,True,4,2,Solomon Islands
18579,20160,21496,1998,Sweden,England,2,1,UEFA Euro qualification,Solna,Sweden,False,3,1,Sweden
18580,20161,21498,1998,Turkey,Northern Ireland,3,0,UEFA Euro qualification,Istanbul,Turkey,False,3,3,Turkey
18581,20162,21499,1998,Ukraine,Russia,3,2,UEFA Euro qualification,Kyïv,Ukraine,False,5,1,Ukraine
18582,20163,21500,1998,Vietnam,Singapore,0,1,AFF Championship,Hanoi,Vietnam,False,1,-1,Singapore
18583,20164,21501,1998,Wales,Italy,0,2,UEFA Euro qualification,Liverpool,England,True,2,-2,Italy
18584,20165,21502,1998,Bulgaria,Poland,0,3,UEFA Euro qualification,Burgas,Bulgaria,False,3,-3,Poland
18585,20166,21503,1998,Faroe Islands,Czech Republic,0,1,UEFA Euro qualification,Toftir,Faroe Islands,False,1,-1,Czech Republic
18586,20167,21504,1998,Greece,Slovenia,2,2,UEFA Euro qualification,Athens,Greece,False,4,0,Draw
18587,20168,21505,1998,Hungary,Portugal,1,3,UEFA Euro qualification,Budapest,Hungary,False,4,-2,Portugal
18588,20169,21507,1998,Norway,Latvia,1,3,UEFA Euro qualification,Oslo,Norway,False,4,-2,Latvia
18589,20170,21508,1998,Eswatini,Ghana,0,1,Friendly,Mbabane,Eswatini,False,1,-1,Ghana
18590,20171,21509,1998,Togo,Benin,0,1,Friendly,Lomé,Togo,False,1,-1,Benin
18591,20172,21510,1998,Papua New Guinea,New Caledonia,1,0,Oceania Nations Cup qualification,Luganville,Vanuatu,True,1,1,Papua New Guinea
18592,20173,21511,1998,Samoa,Tonga,2,0,Oceania Nations Cup qualification,Avarua,Cook Islands,True,2,2,Samoa
18593,20174,21513,1998,Vanuatu,Fiji,1,2,Oceania Nations Cup qualification,Luganville,Vanuatu,False,3,-1,Fiji
18594,20176,21515,1998,Samoa,American Samoa,4,0,Oceania Nations Cup qualification,Avarua,Cook Islands,True,4,4,Samoa
18595,20177,21516,1998,Solomon Islands,New Caledonia,3,2,Oceania Nations Cup qualification,Luganville,Vanuatu,True,5,1,Solomon Islands
18596,20178,21517,1998,Vanuatu,Papua New Guinea,1,1,Oceania Nations Cup qualification,Luganville,Vanuatu,False,2,0,Draw
18597,20179,21518,1998,Kuwait,Lebanon,0,0,Friendly,Kuwait City,Kuwait,False,0,0,Draw
18598,20180,21519,1998,Fiji,Papua New Guinea,2,0,Oceania Nations Cup qualification,Luganville,Vanuatu,True,2,2,Fiji
18599,20181,21520,1998,Vanuatu,Solomon Islands,3,1,Oceania Nations Cup qualification,Luganville,Vanuatu,False,4,2,Vanuatu
18600,20182,21521,1998,Saudi Arabia,Tanzania,8,0,Friendly,Dammam,Saudi Arabia,False,8,8,Saudi Arabia
18601,20183,21522,1998,Fiji,Solomon Islands,1,1,Oceania Nations Cup qualification,Luganville,Vanuatu,True,2,0,Draw
18602,20184,21523,1998,Namibia,Mozambique,2,1,COSAFA Cup,Windhoek,Namibia,False,3,1,Namibia
18603,20185,21524,1998,Syria,Oman,3,0,Friendly,Damascus,Syria,False,3,3,Syria
18604,20186,21525,1998,Vanuatu,New Caledonia,3,2,Oceania Nations Cup qualification,Luganville,Vanuatu,False,5,1,Vanuatu
18605,20187,21526,1998,Bahrain,Libya,2,2,Friendly,Doha,Qatar,True,4,0,Draw
18606,20189,21528,1998,Saudi Arabia,Sudan,2,1,Friendly,Dammam,Saudi Arabia,False,3,1,Saudi Arabia
18607,20190,21529,1998,Syria,Oman,0,0,Friendly,Damascus,Syria,False,0,0,Draw
18608,20191,21530,1998,Egypt,Ivory Coast,0,0,Friendly,Cairo,Egypt,False,0,0,Draw
18609,20192,21531,1998,Qatar,Sudan,1,1,Friendly,Doha,Qatar,False,2,0,Draw
18610,20193,21532,1998,United Arab Emirates,Libya,5,1,Friendly,Abu Dhabi,United Arab Emirates,False,6,4,United Arab Emirates
18611,20194,21533,1998,Saudi Arabia,Senegal,3,2,Friendly,Dammam,Saudi Arabia,False,5,1,Saudi Arabia
18612,20195,21534,1998,Bahrain,Syria,2,0,Friendly,Manama,Bahrain,False,2,2,Bahrain
18613,20196,21535,1998,Solomon Islands,Papua New Guinea,2,1,Friendly,Honiara,Solomon Islands,False,3,1,Solomon Islands
18614,20197,21536,1998,Togo,Mali,0,1,Friendly,Lomé,Togo,False,1,-1,Mali
18615,20198,21537,1998,Oman,Zambia,2,0,Friendly,Muscat,Oman,False,2,2,Oman
18616,20199,21538,1998,Qatar,Libya,2,1,UAFA Cup,Doha,Qatar,False,3,1,Qatar
18617,20200,21539,1998,Brazil,Serbia,1,1,Friendly,São Luís,Brazil,False,2,0,Draw
18618,20201,21540,1998,Estonia,Egypt,2,2,Friendly,Tallinn,Estonia,False,4,0,Draw
18619,20202,21541,1998,Spain,Russia,1,0,Friendly,Granada,Spain,False,1,1,Spain
18620,20203,21542,1998,Libya,Jordan,1,2,UAFA Cup,Doha,Qatar,True,3,-1,Jordan
18621,20204,21543,1998,Oman,Zambia,1,1,Friendly,Muscat,Oman,False,2,0,Draw
18622,20205,21544,1998,Australia,Fiji,3,1,Oceania Nations Cup,Brisbane,Australia,False,4,2,Australia
18623,20207,21546,1998,Kuwait,Syria,4,0,UAFA Cup,Doha,Qatar,True,4,4,Kuwait
18624,20208,21547,1998,Qatar,Jordan,2,0,UAFA Cup,Doha,Qatar,False,2,2,Qatar
18625,20209,21548,1998,Mali,Burkina Faso,1,0,Friendly,Bamako,Mali,False,1,1,Mali
18626,20210,21549,1998,Saudi Arabia,Lebanon,4,1,UAFA Cup,Doha,Qatar,True,5,3,Saudi Arabia
18627,20211,21550,1998,United Arab Emirates,Sudan,4,1,UAFA Cup,Doha,Qatar,True,5,3,United Arab Emirates
18628,20212,21551,1998,Zimbabwe,Zambia,0,1,COSAFA Cup,Harare,Zimbabwe,False,1,-1,Zambia
18629,20213,21552,1998,Australia,Cook Islands,16,0,Oceania Nations Cup,Brisbane,Australia,False,16,16,Australia
18630,20214,21553,1998,New Zealand,Vanuatu,8,1,Oceania Nations Cup,Brisbane,Australia,True,9,7,New Zealand
18631,20215,21555,1998,Qatar,United Arab Emirates,2,1,UAFA Cup,Doha,Qatar,False,3,1,Qatar
18632,20216,21556,1998,Saudi Arabia,Kuwait,2,1,UAFA Cup,Doha,Qatar,True,3,1,Saudi Arabia
18633,20217,21557,1998,Fiji,Cook Islands,3,0,Oceania Nations Cup,Brisbane,Australia,True,3,3,Fiji
18634,20218,21559,1998,Kuwait,United Arab Emirates,4,1,UAFA Cup,Doha,Qatar,True,5,3,Kuwait
18635,20219,21560,1998,Qatar,Saudi Arabia,1,3,UAFA Cup,Doha,Qatar,False,4,-2,Saudi Arabia
18636,20221,21562,1998,New Zealand,Fiji,1,0,Oceania Nations Cup,Brisbane,Australia,True,1,1,New Zealand
18637,20222,21563,1998,Bahrain,Sudan,2,3,Friendly,Manama,Bahrain,False,5,-1,Sudan
18638,20223,21564,1998,Kenya,Madagascar,1,1,African Cup of Nations qualification,Nairobi,Kenya,False,2,0,Draw
18639,20224,21565,1998,Morocco,Sierra Leone,3,0,African Cup of Nations qualification,Casablanca,Morocco,False,3,3,Morocco
18640,20225,21566,1998,Namibia,Congo,0,1,African Cup of Nations qualification,Windhoek,Namibia,False,1,-1,Congo
18641,20226,21567,1998,South Africa,Angola,1,0,African Cup of Nations qualification,Johannesburg,South Africa,False,1,1,South Africa
18642,20227,21568,1998,Australia,New Zealand,0,1,Oceania Nations Cup,Brisbane,Australia,False,1,-1,New Zealand
18643,20228,21569,1998,Burkina Faso,Nigeria,0,0,African Cup of Nations qualification,Ouagadougou,Burkina Faso,False,0,0,Draw
18644,20229,21570,1998,Cameroon,Ghana,1,3,African Cup of Nations qualification,Douala,Cameroon,False,4,-2,Ghana
18645,20230,21571,1998,Gabon,Mauritius,2,0,African Cup of Nations qualification,Libreville,Gabon,False,2,2,Gabon
18646,20231,21572,1998,Mali,Ivory Coast,0,1,African Cup of Nations qualification,Bamako,Mali,False,1,-1,Ivory Coast
18647,20232,21573,1998,Mozambique,Eritrea,3,1,African Cup of Nations qualification,Maputo,Mozambique,False,4,2,Mozambique
18648,20233,21575,1998,Togo,Guinea,2,0,African Cup of Nations qualification,Lomé,Togo,False,2,2,Togo
18649,20234,21576,1998,Tunisia,Liberia,2,1,African Cup of Nations qualification,Tunis,Tunisia,False,3,1,Tunisia
18650,20235,21577,1998,Zambia,DR Congo,1,1,African Cup of Nations qualification,Lusaka,Zambia,False,2,0,Draw
18651,20236,21578,1998,Andorra,Ukraine,0,2,UEFA Euro qualification,Sant Julià de Lòria,Andorra,False,2,-2,Ukraine
18652,20237,21579,1998,Armenia,Iceland,0,0,UEFA Euro qualification,Yerevan,Armenia,False,0,0,Draw
18653,20238,21580,1998,Azerbaijan,Hungary,0,4,UEFA Euro qualification,Baku,Azerbaijan,False,4,-4,Hungary
18654,20239,21581,1998,Bosnia and Herzegovina,Czech Republic,1,3,UEFA Euro qualification,Sarajevo,Bosnia and Herzegovina,False,4,-2,Czech Republic
18655,20240,21582,1998,Cyprus,Austria,0,3,UEFA Euro qualification,Larnaca,Cyprus,False,3,-3,Austria
18656,20241,21583,1998,Denmark,Wales,1,2,UEFA Euro qualification,Copenhagen,Denmark,False,3,-1,Wales
18657,20242,21584,1998,England,Bulgaria,0,0,UEFA Euro qualification,London,England,False,0,0,Draw
18658,20243,21585,1998,Italy,Switzerland,2,0,UEFA Euro qualification,Udine,Italy,False,2,2,Italy
18659,20244,21586,1998,Latvia,Georgia,1,0,UEFA Euro qualification,Riga,Latvia,False,1,1,Latvia
18660,20245,21587,1998,Liechtenstein,Slovakia,0,4,UEFA Euro qualification,Vaduz,Liechtenstein,False,4,-4,Slovakia
18661,20246,21588,1998,Lithuania,Faroe Islands,0,0,UEFA Euro qualification,Vilnius,Lithuania,False,0,0,Draw
18662,20247,21589,1998,Malta,Croatia,1,4,UEFA Euro qualification,Attard,Malta,False,5,-3,Croatia
18663,20248,21590,1998,Netherlands,Peru,2,0,Friendly,Eindhoven,Netherlands,False,2,2,Netherlands
18664,20249,21591,1998,Northern Ireland,Finland,1,0,UEFA Euro qualification,Belfast,Northern Ireland,False,1,1,Northern Ireland
18665,20250,21592,1998,Poland,Luxembourg,3,0,UEFA Euro qualification,Warsaw,Poland,False,3,3,Poland
18666,20251,21593,1998,Portugal,Romania,0,1,UEFA Euro qualification,Porto,Portugal,False,1,-1,Romania
18667,20252,21594,1998,Russia,France,2,3,UEFA Euro qualification,Moscow,Russia,False,5,-1,France
18668,20253,21595,1998,San Marino,Israel,0,5,UEFA Euro qualification,Serravalle,San Marino,False,5,-5,Israel
18669,20254,21596,1998,Scotland,Estonia,3,2,UEFA Euro qualification,Edinburgh,Scotland,False,5,1,Scotland
18670,20255,21597,1998,Slovenia,Norway,1,2,UEFA Euro qualification,Ljubljana,Slovenia,False,3,-1,Norway
18671,20256,21598,1998,Turkey,Germany,1,0,UEFA Euro qualification,Bursa,Turkey,False,1,1,Turkey
18672,20257,21599,1998,Kuwait,Iran,3,0,Friendly,Kuwait City,Kuwait,False,3,3,Kuwait
18673,20258,21600,1998,Netherlands,Ghana,0,0,Friendly,Arnhem,Netherlands,False,0,0,Draw
18674,20259,21601,1998,Brazil,Ecuador,5,1,Friendly,Washington,United States,True,6,4,Brazil
18675,20260,21602,1998,Bulgaria,Sweden,0,1,UEFA Euro qualification,Burgas,Bulgaria,False,1,-1,Sweden
18676,20262,21604,1998,Czech Republic,Estonia,4,1,UEFA Euro qualification,Teplice,Czech Republic,False,5,3,Czech Republic
18677,20263,21605,1998,France,Andorra,2,0,UEFA Euro qualification,Saint-Denis,France,False,2,2,France
18678,20264,21606,1998,Greece,Georgia,3,0,UEFA Euro qualification,Athens,Greece,False,3,3,Greece
18679,20265,21607,1998,Hungary,Romania,1,1,UEFA Euro qualification,Budapest,Hungary,False,2,0,Draw
18680,20266,21608,1998,Iceland,Russia,1,0,UEFA Euro qualification,Reykjavík,Iceland,False,1,1,Iceland
18681,20267,21609,1998,Republic of Ireland,Malta,5,0,UEFA Euro qualification,Dublin,Republic of Ireland,False,5,5,Republic of Ireland
18682,20268,21610,1998,Israel,Spain,1,2,UEFA Euro qualification,Ramat-Gan,Israel,False,3,-1,Spain
18683,20269,21611,1998,Liechtenstein,Azerbaijan,2,1,UEFA Euro qualification,Vaduz,Liechtenstein,False,3,1,Liechtenstein
18684,20270,21612,1998,Lithuania,Bosnia and Herzegovina,4,2,UEFA Euro qualification,Vilnius,Lithuania,False,6,2,Lithuania
18685,20271,21613,1998,Luxembourg,England,0,3,UEFA Euro qualification,Luxembourg,Luxembourg,False,3,-3,England
18686,20272,21614,1998,Moldova,Germany,1,3,UEFA Euro qualification,Chişinău,Moldova,False,4,-2,Germany
18687,20273,21615,1998,Norway,Albania,2,2,UEFA Euro qualification,Oslo,Norway,False,4,0,Draw
18688,20274,21616,1998,San Marino,Austria,1,4,UEFA Euro qualification,Serravalle,San Marino,False,5,-3,Austria
18689,20275,21617,1998,Scotland,Faroe Islands,2,1,UEFA Euro qualification,Aberdeen,Scotland,False,3,1,Scotland
18690,20276,21618,1998,Slovakia,Portugal,0,3,UEFA Euro qualification,Bratislava,Slovakia,False,3,-3,Portugal
18691,20277,21619,1998,Slovenia,Latvia,1,0,UEFA Euro qualification,Maribor,Slovenia,False,1,1,Slovenia
18692,20278,21620,1998,Switzerland,Denmark,1,1,UEFA Euro qualification,Zürich,Switzerland,False,2,0,Draw
18693,20279,21621,1998,Turkey,Finland,1,3,UEFA Euro qualification,Istanbul,Turkey,False,4,-2,Finland
18694,20280,21622,1998,Ukraine,Armenia,2,0,UEFA Euro qualification,Kyïv,Ukraine,False,2,2,Ukraine
18695,20281,21623,1998,Wales,Belarus,3,2,UEFA Euro qualification,Cardiff,Wales,False,5,1,Wales
18696,20282,21624,1998,Lebanon,Syria,3,3,United Arab Emirates Friendship Tournament,Abu Dhabi,United Arab Emirates,True,6,0,Draw
18697,20283,21625,1998,Qatar,Burkina Faso,2,2,Friendly,Doha,Qatar,False,4,0,Draw
18698,20284,21626,1998,United Arab Emirates,Sudan,2,1,United Arab Emirates Friendship Tournament,Abu Dhabi,United Arab Emirates,False,3,1,United Arab Emirates
18699,20285,21627,1998,Lebanon,Sudan,1,1,United Arab Emirates Friendship Tournament,Abu Dhabi,United Arab Emirates,True,2,0,Draw
18700,20286,21628,1998,Oman,Burkina Faso,4,2,Friendly,Muscat,Oman,False,6,2,Oman
18701,20287,21629,1998,United Arab Emirates,Syria,1,0,United Arab Emirates Friendship Tournament,Abu Dhabi,United Arab Emirates,False,1,1,United Arab Emirates
18702,20288,21630,1998,Oman,Burkina Faso,0,0,Friendly,Muscat,Oman,False,0,0,Draw
18703,20289,21631,1998,Sudan,Syria,2,3,United Arab Emirates Friendship Tournament,Abu Dhabi,United Arab Emirates,True,5,-1,Syria
18704,20290,21632,1998,United Arab Emirates,Lebanon,1,0,United Arab Emirates Friendship Tournament,Abu Dhabi,United Arab Emirates,False,1,1,United Arab Emirates
18705,20291,21633,1998,Bahrain,Burkina Faso,2,1,Friendly,Manama,Bahrain,False,3,1,Bahrain
18706,20292,21634,1998,Japan,Egypt,1,0,Friendly,Osaka,Japan,False,1,1,Japan
18707,20293,21635,1998,Bahrain,United Arab Emirates,0,1,Gulf Cup,Manama,Bahrain,False,1,-1,United Arab Emirates
18708,20294,21636,1998,Kuwait,Saudi Arabia,1,2,Gulf Cup,Manama,Bahrain,True,3,-1,Saudi Arabia
18709,20295,21637,1998,Oman,Qatar,2,1,Gulf Cup,Manama,Bahrain,True,3,1,Oman
18710,20296,21638,1998,Bahrain,Saudi Arabia,1,1,Gulf Cup,Manama,Bahrain,False,2,0,Draw
18711,20297,21639,1998,Kuwait,Qatar,6,2,Gulf Cup,Manama,Bahrain,True,8,4,Kuwait
18712,20298,21640,1998,United Arab Emirates,Oman,3,2,Gulf Cup,Manama,Bahrain,True,5,1,United Arab Emirates
18713,20299,21641,1998,Bulgaria,Algeria,0,0,Friendly,Sofia,Bulgaria,False,0,0,Draw
18714,20300,21642,1998,Oman,Saudi Arabia,0,1,Gulf Cup,Manama,Bahrain,True,1,-1,Saudi Arabia
18715,20301,21643,1998,Qatar,United Arab Emirates,0,0,Gulf Cup,Manama,Bahrain,True,0,0,Draw
18716,20302,21644,1998,Bahrain,Kuwait,0,2,Gulf Cup,Manama,Bahrain,False,2,-2,Kuwait
18717,20303,21645,1998,United States,Australia,0,0,Friendly,San Jose,United States,False,0,0,Draw
18718,20304,21646,1998,Tunisia,Zimbabwe,1,1,Friendly,Tunis,Tunisia,False,2,0,Draw
18719,20305,21647,1998,Bahrain,Qatar,0,0,Gulf Cup,Manama,Bahrain,False,0,0,Draw
18720,20306,21648,1998,Saudi Arabia,United Arab Emirates,1,0,Gulf Cup,Manama,Bahrain,True,1,1,Saudi Arabia
18721,20307,21649,1998,Oman,Kuwait,0,5,Gulf Cup,Manama,Bahrain,True,5,-5,Kuwait
18722,20308,21650,1998,Slovakia,Poland,1,3,Friendly,Bratislava,Slovakia,False,4,-2,Poland
18723,20309,21651,1998,Tunisia,Latvia,3,0,Friendly,Tunis,Tunisia,False,3,3,Tunisia
18724,20310,21652,1998,Qatar,Saudi Arabia,0,0,Gulf Cup,Manama,Bahrain,True,0,0,Draw
18725,20311,21653,1998,Bahrain,Oman,2,2,Gulf Cup,Manama,Bahrain,False,4,0,Draw
18726,20312,21654,1998,United Arab Emirates,Kuwait,1,4,Gulf Cup,Manama,Bahrain,True,5,-3,Kuwait
18727,20313,21655,1998,Sri Lanka,Maldives,2,2,Friendly,Colombo,Sri Lanka,False,4,0,Draw
18728,20314,21656,1998,India,Uzbekistan,0,0,Friendly,New Delhi,India,False,0,0,Draw
18729,20315,21657,1998,El Salvador,Mexico,0,2,Friendly,Los Angeles,United States,True,2,-2,Mexico
18730,20316,21658,1998,Guatemala,Honduras,3,3,Friendly,Los Angeles,United States,True,6,0,Draw
18731,20317,21659,1998,Albania,Greece,0,0,UEFA Euro qualification,Tirana,Albania,False,0,0,Draw
18732,20318,21660,1998,Brazil,Russia,5,1,Friendly,Fortaleza,Brazil,False,6,4,Brazil
18733,20319,21661,1998,Egypt,Norway,1,1,Friendly,Cairo,Egypt,False,2,0,Draw
18734,20320,21662,1998,El Salvador,Honduras,1,2,Friendly,Los Angeles,United States,True,3,-1,Honduras
18735,20321,21663,1998,England,Czech Republic,2,0,Friendly,London,England,False,2,2,England
18736,20322,21664,1998,Georgia,Estonia,3,1,Friendly,Tbilisi,Georgia,False,4,2,Georgia
18737,20323,21665,1998,Germany,Netherlands,1,1,Friendly,Gelsenkirchen,Germany,False,2,0,Draw
18738,20324,21666,1998,Guatemala,Mexico,2,2,Friendly,Los Angeles,United States,True,4,0,Draw
18739,20325,21667,1998,Hungary,Switzerland,2,0,Friendly,Budapest,Hungary,False,2,2,Hungary
18740,20326,21668,1998,Italy,Spain,2,2,Friendly,Salerno,Italy,False,4,0,Draw
18741,20327,21669,1998,Luxembourg,Belgium,0,0,Friendly,Luxembourg,Luxembourg,False,0,0,Draw
18742,20329,21671,1998,Northern Ireland,Moldova,2,2,UEFA Euro qualification,Belfast,Northern Ireland,False,4,0,Draw
18743,20330,21672,1998,Portugal,Israel,2,0,Friendly,Setúbal,Portugal,False,2,2,Portugal
18744,20331,21673,1998,San Marino,Cyprus,0,1,UEFA Euro qualification,Serravalle,San Marino,False,1,-1,Cyprus
18745,20332,21674,1998,Serbia,Republic of Ireland,1,0,UEFA Euro qualification,Belgrade,Yugoslavia,False,1,1,Serbia
18746,20333,21675,1998,Hong Kong,Vietnam,1,1,Friendly,Victoria,Hong Kong,False,2,0,Draw
18747,20334,21676,1998,India,Uzbekistan,0,4,Friendly,Calcutta,India,False,4,-4,Uzbekistan
18748,20335,21677,1998,Armenia,Estonia,2,1,Friendly,Abovyan,Armenia,False,3,1,Armenia
18749,20336,21678,1998,Thailand,Turkmenistan,3,3,Friendly,Bangkok,Thailand,False,6,0,Draw
18750,20338,21681,1998,Singapore,United Arab Emirates,0,4,Friendly,Singapore,Singapore,False,4,-4,United Arab Emirates
18751,20339,21682,1998,Thailand,Nepal,2,0,Friendly,Bangkok,Thailand,False,2,2,Thailand
18752,20340,21683,1998,Azerbaijan,Estonia,2,1,Friendly,Gəncə,Azerbaijan,False,3,1,Azerbaijan
18753,20342,21685,1998,Mali,Ghana,0,2,Friendly,Bamako,Mali,False,2,-2,Ghana
18754,20343,21687,1998,Burundi,Senegal,1,0,African Cup of Nations qualification,Bujumbura,Burundi,False,1,1,Burundi
18755,20344,21688,1998,South Africa,Egypt,2,1,Friendly,Johannesburg,South Africa,False,3,1,South Africa
18756,20345,21692,1998,Israel,Serbia,2,0,Friendly,Ramat-Gan,Israel,False,2,2,Israel
18757,20346,21693,1998,Kuwait,Egypt,1,1,Friendly,Kuwait City,Kuwait,False,2,0,Draw
18758,20347,21694,1999,Ivory Coast,Togo,3,1,Friendly,Abidjan,Ivory Coast,False,4,2,Ivory Coast
18759,20348,21695,1999,Burkina Faso,Gabon,2,1,Friendly,Ouagadougou,Burkina Faso,False,3,1,Burkina Faso
18760,20349,21696,1999,Burkina Faso,Mali,1,0,Friendly,Ouagadougou,Burkina Faso,False,1,1,Burkina Faso
18761,20350,21697,1999,Senegal,Guinea,1,0,Friendly,Dakar,Senegal,False,1,1,Senegal
18762,20351,21698,1999,Bermuda,Antigua and Barbuda,1,0,Friendly,Hamilton,Bermuda,False,1,1,Bermuda
18763,20352,21699,1999,Senegal,Guinea,1,0,Friendly,Dakar,Senegal,False,1,1,Senegal
18764,20353,21700,1999,Bermuda,Antigua and Barbuda,0,1,Friendly,Hamilton,Bermuda,False,1,-1,Antigua and Barbuda
18765,20354,21701,1999,Burkina Faso,Mali,4,1,Friendly,Ouagadougou,Burkina Faso,False,5,3,Burkina Faso
18766,20355,21702,1999,Israel,Estonia,7,0,Friendly,Ramat-Gan,Israel,False,7,7,Israel
18767,20356,21703,1999,France,Morocco,1,0,Friendly,Marseille,France,False,1,1,France
18768,20357,21704,1999,Israel,Norway,0,1,Friendly,Ramat-Gan,Israel,False,1,-1,Norway
18769,20358,21705,1999,Estonia,Norway,3,3,Friendly,Umm al-Fahm,Israel,True,6,0,Draw
18770,20359,21706,1999,Eritrea,Cameroon,0,0,African Cup of Nations qualification,Asmara,Eritrea,False,0,0,Draw
18771,20360,21707,1999,Mauritius,South Africa,1,1,African Cup of Nations qualification,Curepipe,Mauritius,False,2,0,Draw
18772,20361,21708,1999,Nigeria,Burundi,2,0,African Cup of Nations qualification,Abeokuta,Nigeria,False,2,2,Nigeria
18773,20362,21709,1999,Senegal,Burkina Faso,1,1,African Cup of Nations qualification,Dakar,Senegal,False,2,0,Draw
18774,20363,21710,1999,Zimbabwe,Malawi,3,0,Friendly,Bulawayo,Zimbabwe,False,3,3,Zimbabwe
18775,20364,21711,1999,Angola,Gabon,3,1,African Cup of Nations qualification,Luanda,Angola,False,4,2,Angola
18776,20365,21712,1999,Bolivia,United States,0,0,Friendly,Santa Cruz,Bolivia,False,0,0,Draw
18777,20366,21713,1999,Congo,Mali,0,0,African Cup of Nations qualification,Pointe-Noire,Congo,False,0,0,Draw
18778,20367,21714,1999,DR Congo,Kenya,2,1,African Cup of Nations qualification,Kinshasa,DR Congo,False,3,1,DR Congo
18779,20368,21715,1999,Ghana,Mozambique,1,0,African Cup of Nations qualification,Accra,Ghana,False,1,1,Ghana
18780,20369,21716,1999,Guinea,Morocco,1,1,African Cup of Nations qualification,Conakry,Guinea,False,2,0,Draw
18781,20370,21717,1999,Ivory Coast,Namibia,3,0,African Cup of Nations qualification,Abidjan,Ivory Coast,False,3,3,Ivory Coast
18782,20371,21718,1999,Liberia,Uganda,2,0,African Cup of Nations qualification,Monrovia,Liberia,False,2,2,Liberia
18783,20372,21719,1999,Madagascar,Zambia,1,2,African Cup of Nations qualification,Antananarivo,Madagascar,False,3,-1,Zambia
18784,20373,21720,1999,Zimbabwe,Malawi,1,0,Friendly,Harare,Zimbabwe,False,1,1,Zimbabwe
18785,20374,21721,1999,Malta,Bosnia and Herzegovina,2,1,Friendly,Attard,Malta,False,3,1,Malta
18786,20375,21722,1999,Costa Rica,Ecuador,0,0,Friendly,Alajuela,Costa Rica,False,0,0,Draw
18787,20376,21723,1999,Vietnam,Singapore,1,0,Friendly,Ho Chi Minh City,Vietnam,False,1,1,Vietnam
18788,20377,21724,1999,Ethiopia,Kenya,2,2,Friendly,Addis Abeba,Ethiopia,False,4,0,Draw
18789,20378,21725,1999,Cyprus,Belgium,0,1,Cyprus International Tournament,Limassol,Cyprus,False,1,-1,Belgium
18790,20379,21726,1999,Greece,Finland,2,1,Cyprus International Tournament,Larnaca,Cyprus,True,3,1,Greece
18791,20380,21727,1999,Malta,Poland,0,1,Friendly,Attard,Malta,False,1,-1,Poland
18792,20381,21728,1999,Martinique,French Guiana,3,1,CFU Caribbean Cup qualification,Fort-de-France,Martinique,False,4,2,Martinique
18793,20382,21729,1999,Venezuela,Argentina,0,2,Friendly,Maracaibo,Venezuela,False,2,-2,Argentina
18794,20383,21731,1999,Cyprus,Finland,2,1,Cyprus International Tournament,Paralímni,Cyprus,False,3,1,Cyprus
18795,20384,21732,1999,Greece,Belgium,1,0,Cyprus International Tournament,Larnaca,Cyprus,True,1,1,Greece
18796,20385,21733,1999,Slovenia,Switzerland,0,2,Friendly,Muscat,Oman,True,2,-2,Switzerland
18797,20386,21734,1999,United States,Germany,3,0,Friendly,Jacksonville,United States,False,3,3,United States
18798,20387,21736,1999,Lesotho,Namibia,1,0,COSAFA Cup,Maseru,Lesotho,False,1,1,Lesotho
18799,20388,21737,1999,Oman,Slovenia,0,7,Friendly,Muscat,Oman,False,7,-7,Slovenia
18800,20389,21738,1999,Belgium,Czech Republic,0,1,Friendly,Brussels,Belgium,False,1,-1,Czech Republic
18801,20390,21739,1999,Colombia,Germany,3,3,Friendly,Miami,United States,True,6,0,Draw
18802,20391,21740,1999,Israel,Belarus,2,1,Friendly,Haifa,Israel,False,3,1,Israel
18803,20393,21742,1999,Croatia,Denmark,0,1,Friendly,Split,Croatia,False,1,-1,Denmark
18804,20394,21743,1999,Cyprus,San Marino,4,0,UEFA Euro qualification,Limassol,Cyprus,False,4,4,Cyprus
18805,20395,21744,1999,England,France,0,2,Friendly,London,England,False,2,-2,France
18806,20396,21745,1999,Finland,Poland,1,1,Friendly,Attard,Malta,True,2,0,Draw
18807,20397,21746,1999,Republic of Ireland,Paraguay,2,0,Friendly,Dublin,Republic of Ireland,False,2,2,Republic of Ireland
18808,20398,21747,1999,Italy,Norway,0,0,Friendly,Pisa,Italy,False,0,0,Draw
18809,20399,21748,1999,Jamaica,Costa Rica,1,1,Friendly,Kingston,Jamaica,False,2,0,Draw
18810,20400,21749,1999,Malta,Serbia,0,3,UEFA Euro qualification,Attard,Malta,False,3,-3,Serbia
18811,20401,21750,1999,Mexico,Argentina,0,1,Friendly,Los Angeles,United States,True,1,-1,Argentina
18812,20402,21751,1999,Oman,Switzerland,1,2,Friendly,Muscat,Oman,False,3,-1,Switzerland
18813,20403,21752,1999,Peru,Ecuador,1,2,Friendly,Lima,Peru,False,3,-1,Ecuador
18814,20404,21753,1999,Portugal,Netherlands,0,0,Friendly,Paris,France,True,0,0,Draw
18815,20405,21754,1999,Tunisia,Sweden,0,1,Friendly,Tunis,Tunisia,False,1,-1,Sweden
18816,20406,21755,1999,Saint Lucia,Antigua and Barbuda,0,0,Friendly,Castries,Saint Lucia,False,0,0,Draw
18817,20407,21756,1999,Kuwait,Iran,1,2,Friendly,Kuwait City,Kuwait,False,3,-1,Iran
18818,20408,21757,1999,Bulgaria,Egypt,1,3,Lunar New Year Cup,Kowloon,Hong Kong,True,4,-2,Egypt
18819,20409,21758,1999,Ecuador,Peru,1,2,Friendly,Guayaquil,Ecuador,False,3,-1,Peru
18820,20410,21759,1999,Guatemala,Chile,1,1,Friendly,Guatemala,Guatemala,False,2,0,Draw
18821,20411,21760,1999,Egypt,Mexico,0,3,Lunar New Year Cup,So Kon Po,Hong Kong,True,3,-3,Mexico
18822,20412,21761,1999,Botswana,South Africa,1,2,COSAFA Cup,Gaborone,Botswana,False,3,-1,South Africa
18823,20413,21762,1999,Gabon,Burkina Faso,1,1,Friendly,Libreville,Gabon,False,2,0,Draw
18824,20414,21763,1999,Zimbabwe,Zambia,1,1,Friendly,Bulawayo,Zimbabwe,False,2,0,Draw
18825,20415,21764,1999,United States,Chile,2,1,Friendly,Fort Lauderdale,United States,False,3,1,United States
18826,20416,21765,1999,Suriname,Guyana,2,1,Friendly,Paramaribo,Suriname,False,3,1,Suriname
18827,20418,21767,1999,Bahamas,Turks and Caicos Islands,3,0,CFU Caribbean Cup qualification,Nassau,Bahamas,False,3,3,Bahamas
18828,20419,21768,1999,Costa Rica,Jamaica,9,0,Friendly,San José,Costa Rica,False,9,9,Costa Rica
18829,20420,21769,1999,Israel,Latvia,2,0,Friendly,Jerusalem,Israel,False,2,2,Israel
18830,20421,21770,1999,Saint Lucia,Grenada,1,2,Friendly,Castries,Saint Lucia,False,3,-1,Grenada
18831,20422,21771,1999,U.S. Virgin Islands,Turks and Caicos Islands,2,2,CFU Caribbean Cup qualification,Nassau,Bahamas,True,4,0,Draw
18832,20423,21772,1999,South Africa,Gabon,4,1,African Cup of Nations qualification,Mabopane,South Africa,False,5,3,South Africa
18833,20424,21773,1999,Angola,Mauritius,0,2,African Cup of Nations qualification,Luanda,Angola,False,2,-2,Mauritius
18834,20425,21774,1999,Bahamas,U.S. Virgin Islands,0,0,CFU Caribbean Cup qualification,Nassau,Bahamas,False,0,0,Draw
18835,20426,21776,1999,Burundi,Burkina Faso,1,2,African Cup of Nations qualification,Bujumbura,Burundi,False,3,-1,Burkina Faso
18836,20427,21777,1999,Cameroon,Mozambique,1,0,African Cup of Nations qualification,Yaoundé,Cameroon,False,1,1,Cameroon
18837,20428,21778,1999,Congo,Ivory Coast,1,0,African Cup of Nations qualification,Pointe-Noire,Congo,False,1,1,Congo
18838,20429,21779,1999,Ghana,Eritrea,5,0,African Cup of Nations qualification,Accra,Ghana,False,5,5,Ghana
18839,20430,21780,1999,Guyana,Barbados,2,2,CFU Caribbean Cup qualification,Georgetown,Guyana,False,4,0,Draw
18840,20431,21781,1999,Kenya,Zambia,0,1,African Cup of Nations qualification,Nairobi,Kenya,False,1,-1,Zambia
18841,20432,21782,1999,Liberia,Algeria,1,1,African Cup of Nations qualification,Monrovia,Liberia,False,2,0,Draw
18842,20433,21783,1999,Madagascar,DR Congo,3,1,African Cup of Nations qualification,Antananarivo,Madagascar,False,4,2,Madagascar
18843,20434,21784,1999,Senegal,Nigeria,1,1,African Cup of Nations qualification,Dakar,Senegal,False,2,0,Draw
18844,20435,21785,1999,Togo,Morocco,2,3,African Cup of Nations qualification,Lomé,Togo,False,5,-1,Morocco
18845,20436,21786,1999,Bolivia,Jamaica,0,0,Friendly,Guatemala,Guatemala,True,0,0,Draw
18846,20437,21787,1999,Bulgaria,Slovakia,2,0,Friendly,Stara Zagora,Bulgaria,False,2,2,Bulgaria
18847,20438,21788,1999,Guatemala,Paraguay,2,3,Friendly,Guatemala,Guatemala,False,5,-1,Paraguay
18848,20439,21789,1999,Poland,Armenia,1,0,Friendly,Warsaw,Poland,False,1,1,Poland
18849,20440,21790,1999,Romania,Estonia,2,0,Friendly,Bucharest,Romania,False,2,2,Romania
18850,20441,21791,1999,Guatemala,Bolivia,0,3,Friendly,Guatemala,Guatemala,False,3,-3,Bolivia
18851,20442,21792,1999,Jamaica,Paraguay,1,3,Friendly,Guatemala,Guatemala,True,4,-2,Paraguay
18852,20443,21793,1999,Azerbaijan,Estonia,2,2,Friendly,Larnaca,Cyprus,True,4,0,Draw
18853,20444,21794,1999,Barbados,Guyana,2,0,CFU Caribbean Cup qualification,Bridgetown,Barbados,False,2,2,Barbados
18854,20445,21795,1999,Bolivia,Paraguay,0,3,Friendly,Guatemala,Guatemala,True,3,-3,Paraguay
18855,20446,21796,1999,Guatemala,Jamaica,2,4,Friendly,Guatemala,Guatemala,False,6,-2,Jamaica
18856,20447,21797,1999,Barbados,Antigua and Barbuda,2,0,CFU Caribbean Cup qualification,Pointe-à-Pitre,Guadeloupe,True,2,2,Barbados
18857,20448,21798,1999,Greece,Croatia,3,2,Friendly,Athens,Greece,False,5,1,Greece
18858,20449,21799,1999,Guadeloupe,Dominica,1,0,CFU Caribbean Cup qualification,Pointe-à-Pitre,Guadeloupe,False,1,1,Guadeloupe
18859,20450,21800,1999,Hungary,Bosnia and Herzegovina,1,1,Friendly,Budapest,Hungary,False,2,0,Draw
18860,20451,21801,1999,Luxembourg,Iceland,1,2,Friendly,Luxembourg,Luxembourg,False,3,-1,Iceland
18861,20452,21802,1999,Malta,Moldova,0,2,Friendly,Attard,Malta,False,2,-2,Moldova
18862,20453,21803,1999,Romania,Israel,0,2,Friendly,Bucharest,Romania,False,2,-2,Israel
18863,20454,21804,1999,Switzerland,Austria,2,4,Friendly,St. Gallen,Switzerland,False,6,-2,Austria
18864,20455,21805,1999,Mexico,Bolivia,2,1,USA Cup,Los Angeles,United States,True,3,1,Mexico
18865,20456,21806,1999,United States,Guatemala,3,1,USA Cup,Los Angeles,United States,False,4,2,United States
18866,20457,21807,1999,Barbados,Dominica,3,1,CFU Caribbean Cup qualification,Pointe-à-Pitre,Guadeloupe,True,4,2,Barbados
18867,20458,21808,1999,Guadeloupe,Antigua and Barbuda,2,1,CFU Caribbean Cup qualification,Pointe-à-Pitre,Guadeloupe,False,3,1,Guadeloupe
18868,20459,21809,1999,Guatemala,Bolivia,2,1,USA Cup,San Diego,United States,True,3,1,Guatemala
18869,20460,21810,1999,United States,Mexico,1,2,USA Cup,San Diego,United States,False,3,-1,Mexico
18870,20461,21811,1999,Antigua and Barbuda,Dominica,1,1,CFU Caribbean Cup qualification,Pointe-à-Pitre,Guadeloupe,True,2,0,Draw
18871,20462,21812,1999,Guadeloupe,Barbados,1,0,CFU Caribbean Cup qualification,Pointe-à-Pitre,Guadeloupe,False,1,1,Guadeloupe
18872,20463,21813,1999,Cyprus,Estonia,1,2,Friendly,Larnaca,Cyprus,False,3,-1,Estonia
18873,20464,21815,1999,Costa Rica,Belize,7,0,UNCAF Cup,San José,Costa Rica,False,7,7,Costa Rica
18874,20465,21816,1999,Guatemala,Nicaragua,1,0,UNCAF Cup,San José,Costa Rica,True,1,1,Guatemala
18875,20466,21817,1999,Haiti,Puerto Rico,2,0,CFU Caribbean Cup qualification,Port-au-Prince,Haiti,False,2,2,Haiti
18876,20467,21819,1999,Guatemala,El Salvador,1,1,UNCAF Cup,San José,Costa Rica,True,2,0,Draw
18877,20468,21820,1999,Haiti,Dominican Republic,4,0,CFU Caribbean Cup qualification,Port-au-Prince,Haiti,False,4,4,Haiti
18878,20469,21821,1999,Honduras,Belize,5,1,UNCAF Cup,San José,Costa Rica,True,6,4,Honduras
18879,20470,21822,1999,Georgia,Ukraine,0,1,Friendly,Tbilisi,Georgia,False,1,-1,Ukraine
18880,20471,21823,1999,Costa Rica,Honduras,0,1,UNCAF Cup,San José,Costa Rica,False,1,-1,Honduras
18881,20472,21824,1999,Dominican Republic,Puerto Rico,2,0,CFU Caribbean Cup qualification,Port-au-Prince,Haiti,True,2,2,Dominican Republic
18882,20473,21825,1999,El Salvador,Nicaragua,1,0,UNCAF Cup,San José,Costa Rica,True,1,1,El Salvador
18883,20475,21827,1999,Costa Rica,Guatemala,1,0,UNCAF Cup,San José,Costa Rica,False,1,1,Costa Rica
18884,20476,21828,1999,Honduras,El Salvador,3,1,UNCAF Cup,San José,Costa Rica,True,4,2,Honduras
18885,20477,21829,1999,Costa Rica,Honduras,1,2,UNCAF Cup,San José,Costa Rica,False,3,-1,Honduras
18886,20478,21830,1999,Guatemala,El Salvador,1,0,UNCAF Cup,San José,Costa Rica,True,1,1,Guatemala
18887,20479,21831,1999,Portugal,Azerbaijan,7,0,UEFA Euro qualification,Guimarães,Portugal,False,7,7,Portugal
18888,20480,21832,1999,Andorra,Iceland,0,2,UEFA Euro qualification,Sant Julià de Lòria,Andorra,False,2,-2,Iceland
18889,20481,21833,1999,Armenia,Russia,0,3,UEFA Euro qualification,Yerevan,Armenia,False,3,-3,Russia
18890,20482,21834,1999,Belarus,Switzerland,0,1,UEFA Euro qualification,Minsk,Belarus,False,1,-1,Switzerland
18891,20483,21835,1999,Belgium,Bulgaria,0,1,Friendly,Brussels,Belgium,False,1,-1,Bulgaria
18892,20484,21836,1999,Czech Republic,Lithuania,2,0,UEFA Euro qualification,Teplice,Czech Republic,False,2,2,Czech Republic
18893,20485,21837,1999,Denmark,Italy,1,2,UEFA Euro qualification,Copenhagen,Denmark,False,3,-1,Italy
18894,20486,21838,1999,England,Poland,3,1,UEFA Euro qualification,London,England,False,4,2,England
18895,20487,21839,1999,France,Ukraine,0,0,UEFA Euro qualification,Saint-Denis,France,False,0,0,Draw
18896,20488,21840,1999,Georgia,Slovenia,1,1,UEFA Euro qualification,Tbilisi,Georgia,False,2,0,Draw
18897,20489,21841,1999,Greece,Norway,0,2,UEFA Euro qualification,Athens,Greece,False,2,-2,Norway
18898,20490,21842,1999,Hungary,Liechtenstein,5,0,UEFA Euro qualification,Budapest,Hungary,False,5,5,Hungary
18899,20491,21843,1999,Northern Ireland,Germany,0,3,UEFA Euro qualification,Belfast,Northern Ireland,False,3,-3,Germany
18900,20492,21844,1999,Romania,Slovakia,0,0,UEFA Euro qualification,Bucharest,Romania,False,0,0,Draw
18901,20493,21845,1999,Spain,Austria,9,0,UEFA Euro qualification,Valencia,Spain,False,9,9,Spain
18902,20494,21846,1999,Sweden,Luxembourg,2,0,UEFA Euro qualification,Gothenburg,Sweden,False,2,2,Sweden
18903,20495,21847,1999,Turkey,Moldova,2,0,UEFA Euro qualification,Istanbul,Turkey,False,2,2,Turkey
18904,20496,21848,1999,Costa Rica,El Salvador,4,0,UNCAF Cup,San José,Costa Rica,False,4,4,Costa Rica
18905,20497,21849,1999,Honduras,Guatemala,0,2,UNCAF Cup,San José,Costa Rica,True,2,-2,Guatemala
18906,20498,21850,1999,Israel,Cyprus,3,0,UEFA Euro qualification,Ramat-Gan,Israel,False,3,3,Israel
18907,20499,21852,1999,Trinidad and Tobago,Jamaica,2,0,Friendly,Port of Spain,Trinidad and Tobago,False,2,2,Trinidad and Tobago
18908,20500,21853,1999,Belgium,Egypt,0,1,Friendly,Liège,Belgium,False,1,-1,Egypt
18909,20501,21854,1999,Venezuela,Colombia,0,0,Friendly,Maracaibo,Venezuela,False,0,0,Draw
18910,20502,21855,1999,Azerbaijan,Romania,0,1,UEFA Euro qualification,Baku,Azerbaijan,False,1,-1,Romania
18911,20503,21856,1999,France,Armenia,2,0,UEFA Euro qualification,Saint-Denis,France,False,2,2,France
18912,20504,21857,1999,Germany,Finland,2,0,UEFA Euro qualification,Nuremberg,Germany,False,2,2,Germany
18913,20505,21858,1999,Italy,Belarus,1,1,UEFA Euro qualification,Ancona,Italy,False,2,0,Draw
18914,20506,21859,1999,Jamaica,Paraguay,3,0,Friendly,Kingston,Jamaica,False,3,3,Jamaica
18915,20507,21860,1999,Japan,Brazil,0,2,Friendly,Tokyo,Japan,False,2,-2,Brazil
18916,20508,21861,1999,Latvia,Greece,0,0,UEFA Euro qualification,Riga,Latvia,False,0,0,Draw
18917,20509,21862,1999,Liechtenstein,Portugal,0,5,UEFA Euro qualification,Vaduz,Liechtenstein,False,5,-5,Portugal
18918,20510,21863,1999,Lithuania,Estonia,1,2,UEFA Euro qualification,Vilnius,Lithuania,False,3,-1,Estonia
18919,20511,21864,1999,Luxembourg,Bulgaria,0,2,UEFA Euro qualification,Luxembourg,Luxembourg,False,2,-2,Bulgaria
18920,20512,21865,1999,Moldova,Northern Ireland,0,0,UEFA Euro qualification,Chişinău,Moldova,False,0,0,Draw
18921,20513,21866,1999,Netherlands,Argentina,1,1,Friendly,Amsterdam,Netherlands,False,2,0,Draw
18922,20514,21867,1999,Poland,Sweden,0,1,UEFA Euro qualification,Chorzów,Poland,False,1,-1,Sweden
18923,20515,21868,1999,Russia,Andorra,6,1,UEFA Euro qualification,Moscow,Russia,False,7,5,Russia
18924,20516,21869,1999,San Marino,Spain,0,6,UEFA Euro qualification,Serravalle,San Marino,False,6,-6,Spain
18925,20517,21870,1999,Scotland,Czech Republic,1,2,UEFA Euro qualification,Glasgow,Scotland,False,3,-1,Czech Republic
18926,20518,21871,1999,Slovakia,Hungary,0,0,UEFA Euro qualification,Bratislava,Slovakia,False,0,0,Draw
18927,20519,21872,1999,Switzerland,Wales,2,0,UEFA Euro qualification,Zürich,Switzerland,False,2,2,Switzerland
18928,20520,21873,1999,Ukraine,Iceland,1,1,UEFA Euro qualification,Kyïv,Ukraine,False,2,0,Draw
18929,20521,21874,1999,Mali,Burkina Faso,5,2,Friendly,Bamako,Mali,False,7,3,Mali
18930,20522,21875,1999,Eswatini,Namibia,1,1,Friendly,Mbabane,Eswatini,False,2,0,Draw
18931,20523,21876,1999,Algeria,Liberia,4,1,African Cup of Nations qualification,Annaba,Algeria,False,5,3,Algeria
18932,20524,21877,1999,Gabon,South Africa,1,0,African Cup of Nations qualification,Libreville,Gabon,False,1,1,Gabon
18933,20525,21878,1999,Mauritius,Angola,1,1,African Cup of Nations qualification,Curepipe,Mauritius,False,2,0,Draw
18934,20526,21879,1999,Uganda,Tunisia,0,2,African Cup of Nations qualification,Kampala,Uganda,False,2,-2,Tunisia
18935,20527,21880,1999,Zambia,Kenya,1,0,African Cup of Nations qualification,Lusaka,Zambia,False,1,1,Zambia
18936,20528,21881,1999,Burkina Faso,Burundi,3,1,African Cup of Nations qualification,Ouagadougou,Burkina Faso,False,4,2,Burkina Faso
18937,20529,21882,1999,DR Congo,Madagascar,2,0,African Cup of Nations qualification,Kinshasa,DR Congo,False,2,2,DR Congo
18938,20530,21883,1999,Ivory Coast,Congo,2,0,African Cup of Nations qualification,Abidjan,Ivory Coast,False,2,2,Ivory Coast
18939,20531,21884,1999,Mali,Namibia,2,1,African Cup of Nations qualification,Bamako,Mali,False,3,1,Mali
18940,20532,21885,1999,Mozambique,Cameroon,1,6,African Cup of Nations qualification,Maputo,Mozambique,False,7,-5,Cameroon
18941,20533,21886,1999,Saint Vincent and the Grenadines,Grenada,2,1,Friendly,Kingstown,Saint Vincent and the Grenadines,False,3,1,Saint Vincent and the Grenadines
18942,20534,21887,1999,Mexico,Ecuador,0,0,Friendly,Monterrey,Mexico,False,0,0,Draw
18943,20535,21888,1999,Venezuela,Colombia,1,1,Friendly,Caracas,Venezuela,False,2,0,Draw
18944,20536,21889,1999,Saint Lucia,Martinique,3,1,CFU Caribbean Cup qualification,Kingstown,Saint Vincent and the Grenadines,True,4,2,Saint Lucia
18945,20537,21890,1999,Saint Vincent and the Grenadines,Saint Kitts and Nevis,3,4,CFU Caribbean Cup qualification,Kingstown,Saint Vincent and the Grenadines,False,7,-1,Saint Kitts and Nevis
18946,20538,21891,1999,Martinique,Saint Kitts and Nevis,2,1,CFU Caribbean Cup qualification,Kingstown,Saint Vincent and the Grenadines,True,3,1,Martinique
18947,20539,21892,1999,Saint Vincent and the Grenadines,Saint Lucia,2,2,CFU Caribbean Cup qualification,Kingstown,Saint Vincent and the Grenadines,False,4,0,Draw
18948,20540,21893,1999,Saint Kitts and Nevis,Saint Lucia,4,3,CFU Caribbean Cup qualification,Kingstown,Saint Vincent and the Grenadines,True,7,1,Saint Kitts and Nevis
18949,20541,21894,1999,India,Bangladesh,0,0,SAFF Cup,Margao,India,False,0,0,Draw
18950,20542,21895,1999,Paraguay,Colombia,0,2,Friendly,Luque,Paraguay,False,2,-2,Colombia
18951,20543,21896,1999,Sri Lanka,Maldives,0,0,SAFF Cup,Margao,India,True,0,0,Draw
18952,20544,21897,1999,Malawi,Angola,1,2,COSAFA Cup,Blantyre,Malawi,False,3,-1,Angola
18953,20545,21898,1999,Pakistan,Bangladesh,0,4,SAFF Cup,Margao,India,True,4,-4,Bangladesh
18954,20546,21899,1999,Sri Lanka,Nepal,2,3,SAFF Cup,Margao,India,True,5,-1,Nepal
18955,20547,21900,1999,Eswatini,Lesotho,4,1,Friendly,Lobamba,Eswatini,False,5,3,Eswatini
18956,20548,21901,1999,India,Pakistan,2,0,SAFF Cup,Margao,India,False,2,2,India
18957,20549,21902,1999,Nepal,Maldives,2,3,SAFF Cup,Margao,India,True,5,-1,Maldives
18958,20550,21903,1999,Northern Ireland,Canada,1,1,Friendly,Belfast,Northern Ireland,False,2,0,Draw
18959,20551,21904,1999,Austria,San Marino,7,0,UEFA Euro qualification,Graz,Austria,False,7,7,Austria
18960,20552,21905,1999,Bolivia,Chile,1,1,Friendly,Cochabamba,Bolivia,False,2,0,Draw
18961,20553,21906,1999,Croatia,Italy,0,0,Friendly,Zagreb,Croatia,False,0,0,Draw
18962,20554,21907,1999,Denmark,South Africa,1,1,Friendly,Copenhagen,Denmark,False,2,0,Draw
18963,20555,21908,1999,Georgia,Norway,1,4,UEFA Euro qualification,Tbilisi,Georgia,False,5,-3,Norway
18964,20556,21909,1999,Germany,Scotland,0,1,Friendly,Bremen,Germany,False,1,-1,Scotland
18965,20557,21910,1999,Greece,Switzerland,1,1,Friendly,Athens,Greece,False,2,0,Draw
18966,20558,21911,1999,Hungary,England,1,1,Friendly,Budapest,Hungary,False,2,0,Draw
18967,20559,21912,1999,Republic of Ireland,Sweden,2,0,Friendly,Dublin,Republic of Ireland,False,2,2,Republic of Ireland
18968,20560,21913,1999,Latvia,Albania,0,0,UEFA Euro qualification,Riga,Latvia,False,0,0,Draw
18969,20561,21914,1999,Malta,Iceland,1,2,Friendly,Attard,Malta,False,3,-1,Iceland
18970,20562,21915,1999,Netherlands,Morocco,1,2,Friendly,Arnhem,Netherlands,False,3,-1,Morocco
18971,20563,21916,1999,Paraguay,Mexico,2,1,Friendly,Pedro Juan Caballero,Paraguay,False,3,1,Paraguay
18972,20564,21917,1999,Poland,Czech Republic,2,1,Friendly,Warsaw,Poland,False,3,1,Poland
18973,20565,21918,1999,Romania,Belgium,1,0,Friendly,Bucharest,Romania,False,1,1,Romania
18974,20566,21919,1999,Slovenia,Finland,1,1,Friendly,Ljubljana,Slovenia,False,2,0,Draw
18975,20567,21920,1999,Bangladesh,Nepal,2,1,SAFF Cup,Margao,India,True,3,1,Bangladesh
18976,20568,21921,1999,India,Maldives,2,1,SAFF Cup,Margao,India,False,3,1,India
18977,20569,21922,1999,India,Bangladesh,2,0,SAFF Cup,Margao,India,False,2,2,India
18978,20570,21923,1999,Maldives,Nepal,2,0,SAFF Cup,Margao,India,True,2,2,Maldives
18979,20571,21924,1999,Guernsey,Jersey,2,0,Friendly,St. Sampson,Guernsey,False,2,2,Guernsey
18980,20572,21925,1999,Curaçao,Grenada,1,3,CFU Caribbean Cup qualification,Willemstad,Netherlands Antilles,True,4,-2,Grenada
18981,20573,21926,1999,Bermuda,Bahamas,6,0,CFU Caribbean Cup qualification,Hamilton,Bermuda,False,6,6,Bermuda
18982,20574,21927,1999,Cuba,Cayman Islands,4,1,CFU Caribbean Cup qualification,Hamilton,Bermuda,True,5,3,Cuba
18983,20575,21928,1999,Spain,Croatia,3,1,Friendly,Seville,Spain,False,4,2,Spain
18984,20576,21929,1999,Grenada,Suriname,0,0,CFU Caribbean Cup qualification,Willemstad,Netherlands Antilles,True,0,0,Draw
18985,20577,21930,1999,Trinidad and Tobago,South Africa,2,0,Friendly,Port of Spain,Trinidad and Tobago,False,2,2,Trinidad and Tobago
18986,20578,21931,1999,Bermuda,Cayman Islands,4,1,CFU Caribbean Cup qualification,Hamilton,Bermuda,False,5,3,Bermuda
18987,20579,21932,1999,Cuba,Bahamas,7,0,CFU Caribbean Cup qualification,Hamilton,Bermuda,True,7,7,Cuba
18988,20580,21933,1999,Curaçao,Suriname,1,1,CFU Caribbean Cup qualification,Willemstad,Netherlands Antilles,True,2,0,Draw
18989,20581,21934,1999,Namibia,Mali,0,0,African Cup of Nations qualification,Windhoek,Namibia,False,0,0,Draw
18990,20582,21935,1999,Bermuda,Cuba,1,2,CFU Caribbean Cup qualification,Hamilton,Bermuda,False,3,-1,Cuba
18991,20583,21936,1999,Cayman Islands,Bahamas,4,1,CFU Caribbean Cup qualification,Hamilton,Bermuda,True,5,3,Cayman Islands
18992,20584,21937,1999,Jamaica,South Africa,1,1,Friendly,Kingston,Jamaica,False,2,0,Draw
18993,20585,21938,1999,Eswatini,Mozambique,3,1,COSAFA Cup,Lobamba,Eswatini,False,4,2,Eswatini
18994,20586,21939,1999,Libya,Senegal,2,1,Friendly,Tripoli,Libya,False,3,1,Libya
18995,20587,21940,1999,Eswatini,Botswana,2,1,Friendly,Lobamba,Eswatini,False,3,1,Eswatini
18996,20588,21941,1999,Russia,Belarus,1,1,Friendly,Tula,Russia,False,2,0,Draw
18997,20589,21942,1999,Slovakia,Bulgaria,2,0,Friendly,Dubnica nad Váhom,Slovakia,False,2,2,Slovakia
18998,20590,21943,1999,Norway,Jamaica,6,0,Friendly,Oslo,Norway,False,6,6,Norway
18999,20591,21944,1999,Haiti,Honduras,0,2,Friendly,Miami,United States,True,2,-2,Honduras
19000,20592,21945,1999,Malawi,Namibia,1,1,COSAFA Cup,Blantyre,Malawi,False,2,0,Draw
19001,20593,21946,1999,Uganda,Zambia,0,1,Friendly,Kampala,Uganda,False,1,-1,Zambia
19002,20594,21947,1999,Sweden,Jamaica,2,1,Friendly,Solna,Sweden,False,3,1,Sweden
19003,20595,21948,1999,Canada,Guatemala,1,0,Friendly,Toronto,Canada,False,1,1,Canada
19004,20596,21949,1999,Chile,Costa Rica,3,0,Friendly,Concepción,Chile,False,3,3,Chile
19005,20597,21950,1999,El Salvador,Colombia,2,1,Friendly,East Rutherford,United States,True,3,1,El Salvador
19006,20598,21951,1999,Republic of Ireland,Northern Ireland,0,1,Friendly,Dublin,Republic of Ireland,False,1,-1,Northern Ireland
19007,20599,21952,1999,Saint Kitts and Nevis,Antigua and Barbuda,4,1,Friendly,Basseterre,Saint Kitts and Nevis,False,5,3,Saint Kitts and Nevis
19008,20600,21953,1999,Belgium,Peru,1,1,Kirin Cup,Kyoto,Japan,True,2,0,Draw
19009,20601,21954,1999,Lesotho,Mauritius,1,2,Friendly,Maseru,Lesotho,False,3,-1,Mauritius
19010,20602,21955,1999,Norway,Georgia,1,0,UEFA Euro qualification,Oslo,Norway,False,1,1,Norway
19011,20603,21956,1999,Mali,Senegal,1,1,Friendly,Bamako,Mali,False,2,0,Draw
19012,20604,21957,1999,Canada,Guatemala,2,0,Friendly,Edmonton,Canada,False,2,2,Canada
19013,20605,21958,1999,Ecuador,Iran,1,1,Friendly,Edmonton,Canada,True,2,0,Draw
19014,20606,21959,1999,Grenada,Guadeloupe,2,1,CFU Caribbean Cup,Port of Spain,Trinidad and Tobago,True,3,1,Grenada
19015,20607,21960,1999,Japan,Belgium,0,0,Kirin Cup,Tokyo,Japan,False,0,0,Draw
19016,20608,21961,1999,Trinidad and Tobago,Jamaica,1,0,CFU Caribbean Cup,Port of Spain,Trinidad and Tobago,False,1,1,Trinidad and Tobago
19017,20609,21962,1999,Canada,Iran,0,1,Friendly,Edmonton,Canada,False,1,-1,Iran
19018,20610,21963,1999,Cuba,Haiti,3,1,CFU Caribbean Cup,Macoya,Trinidad and Tobago,True,4,2,Cuba
19019,20611,21964,1999,Ecuador,Guatemala,3,1,Friendly,Edmonton,Canada,True,4,2,Ecuador
19020,20612,21965,1999,Germany,Moldova,6,1,UEFA Euro qualification,Leverkusen,Germany,False,7,5,Germany
19021,20613,21966,1999,Poland,Bulgaria,2,0,UEFA Euro qualification,Warsaw,Poland,False,2,2,Poland
19022,20614,21967,1999,Albania,Norway,1,2,UEFA Euro qualification,Tirana,Albania,False,3,-1,Norway
19023,20615,21968,1999,Azerbaijan,Liechtenstein,4,0,UEFA Euro qualification,Baku,Azerbaijan,False,4,4,Azerbaijan
19024,20616,21969,1999,Bosnia and Herzegovina,Lithuania,2,0,UEFA Euro qualification,Sarajevo,Bosnia and Herzegovina,False,2,2,Bosnia and Herzegovina
19025,20617,21970,1999,Brazil,Netherlands,2,2,Friendly,Salvador,Brazil,False,4,0,Draw
19026,20618,21971,1999,Denmark,Belarus,1,0,UEFA Euro qualification,Copenhagen,Denmark,False,1,1,Denmark
19027,20619,21972,1999,England,Sweden,0,0,UEFA Euro qualification,London,England,False,0,0,Draw
19028,20620,21973,1999,Estonia,Czech Republic,0,2,UEFA Euro qualification,Tallinn,Estonia,False,2,-2,Czech Republic
19029,20621,21974,1999,Faroe Islands,Scotland,1,1,UEFA Euro qualification,Toftir,Faroe Islands,False,2,0,Draw
19030,20622,21975,1999,Finland,Turkey,2,4,UEFA Euro qualification,Helsinki,Finland,False,6,-2,Turkey
19031,20623,21976,1999,France,Russia,2,3,UEFA Euro qualification,Saint-Denis,France,False,5,-1,Russia
19032,20624,21977,1999,Georgia,Greece,1,2,UEFA Euro qualification,Tbilisi,Georgia,False,3,-1,Greece
19033,20625,21978,1999,Guam,Micronesia,3,0,Friendly,Hagätña,Guam,False,3,3,Guam
19034,20626,21979,1999,Iceland,Armenia,2,0,UEFA Euro qualification,Reykjavík,Iceland,False,2,2,Iceland
19035,20627,21980,1999,Italy,Wales,4,0,UEFA Euro qualification,Bologna,Italy,False,4,4,Italy
19036,20628,21981,1999,Jamaica,Guadeloupe,5,1,CFU Caribbean Cup,Port of Spain,Trinidad and Tobago,True,6,4,Jamaica
19037,20629,21983,1999,Latvia,Slovenia,1,2,UEFA Euro qualification,Riga,Latvia,False,3,-1,Slovenia
19038,20630,21985,1999,Namibia,Ivory Coast,1,1,African Cup of Nations qualification,Windhoek,Namibia,False,2,0,Draw
19039,20631,21986,1999,Portugal,Slovakia,1,0,UEFA Euro qualification,Lisbon,Portugal,False,1,1,Portugal
19040,20632,21987,1999,Romania,Hungary,2,0,UEFA Euro qualification,Bucharest,Romania,False,2,2,Romania
19041,20633,21988,1999,South Africa,Mauritius,2,0,African Cup of Nations qualification,Durban,South Africa,False,2,2,South Africa
19042,20634,21989,1999,Spain,San Marino,9,0,UEFA Euro qualification,Vila-real,Spain,False,9,9,Spain
19043,20635,21990,1999,Trinidad and Tobago,Grenada,7,0,CFU Caribbean Cup,Port of Spain,Trinidad and Tobago,False,7,7,Trinidad and Tobago
19044,20636,21991,1999,Uganda,Liberia,1,0,African Cup of Nations qualification,Kampala,Uganda,False,1,1,Uganda
19045,20637,21992,1999,Ukraine,Andorra,4,0,UEFA Euro qualification,Kyïv,Ukraine,False,4,4,Ukraine
19046,20638,21993,1999,Burkina Faso,Senegal,2,2,African Cup of Nations qualification,Ouagadougou,Burkina Faso,False,4,0,Draw
19047,20639,21994,1999,Cameroon,Eritrea,1,0,African Cup of Nations qualification,Yaoundé,Cameroon,False,1,1,Cameroon
19048,20640,21995,1999,Canada,Ecuador,1,2,Friendly,Edmonton,Canada,False,3,-1,Ecuador
19049,20641,21996,1999,Gabon,Angola,3,1,African Cup of Nations qualification,Libreville,Gabon,False,4,2,Gabon
19050,20642,21997,1999,Guatemala,Iran,2,2,Friendly,Edmonton,Canada,True,4,0,Draw
19051,20643,21998,1999,Haiti,Saint Kitts and Nevis,2,0,CFU Caribbean Cup,Macoya,Trinidad and Tobago,True,2,2,Haiti
19052,20644,21999,1999,Israel,Austria,5,0,UEFA Euro qualification,Ramat-Gan,Israel,False,5,5,Israel
19053,20645,22000,1999,Japan,Peru,0,0,Kirin Cup,Yokohama,Japan,False,0,0,Draw
19054,20646,22001,1999,Kenya,DR Congo,0,1,African Cup of Nations qualification,Nairobi,Kenya,False,1,-1,DR Congo
19055,20647,22002,1999,Mali,Congo,3,1,African Cup of Nations qualification,Bamako,Mali,False,4,2,Mali
19056,20648,22003,1999,Morocco,Guinea,1,0,African Cup of Nations qualification,Rabat,Morocco,False,1,1,Morocco
19057,20649,22004,1999,Tunisia,Algeria,2,0,African Cup of Nations qualification,Tunis,Tunisia,False,2,2,Tunisia
19058,20650,22005,1999,Jamaica,Grenada,2,1,CFU Caribbean Cup,Port of Spain,Trinidad and Tobago,True,3,1,Jamaica
19059,20651,22006,1999,Trinidad and Tobago,Guadeloupe,3,2,CFU Caribbean Cup,Port of Spain,Trinidad and Tobago,False,5,1,Trinidad and Tobago
19060,20652,22007,1999,Brazil,Netherlands,3,1,Friendly,Goiânia,Brazil,False,4,2,Brazil
19061,20653,22008,1999,Cuba,Saint Kitts and Nevis,2,0,CFU Caribbean Cup,Macoya,Trinidad and Tobago,True,2,2,Cuba
19062,20654,22009,1999,Serbia,Malta,4,1,UEFA Euro qualification,Salonica,Greece,True,5,3,Serbia
19063,20655,22010,1999,Albania,Slovenia,0,1,UEFA Euro qualification,Tirana,Albania,False,1,-1,Slovenia
19064,20656,22011,1999,Andorra,France,0,1,UEFA Euro qualification,Barcelona,Spain,True,1,-1,France
19065,20657,22012,1999,Armenia,Ukraine,0,0,UEFA Euro qualification,Yerevan,Armenia,False,0,0,Draw
19066,20658,22013,1999,Bulgaria,England,1,1,UEFA Euro qualification,Sofia,Bulgaria,False,2,0,Draw
19067,20659,22014,1999,Czech Republic,Scotland,3,2,UEFA Euro qualification,Prague,Czech Republic,False,5,1,Czech Republic
19068,20660,22015,1999,Estonia,Lithuania,1,2,UEFA Euro qualification,Tallinn,Estonia,False,3,-1,Lithuania
19069,20661,22016,1999,Faroe Islands,Bosnia and Herzegovina,2,2,UEFA Euro qualification,Toftir,Faroe Islands,False,4,0,Draw
19070,20662,22017,1999,Greece,Latvia,1,2,UEFA Euro qualification,Athens,Greece,False,3,-1,Latvia
19071,20663,22018,1999,Hungary,Slovakia,0,1,UEFA Euro qualification,Győr,Hungary,False,1,-1,Slovakia
19072,20665,22020,1999,Luxembourg,Poland,2,3,UEFA Euro qualification,Luxembourg,Luxembourg,False,5,-1,Poland
19073,20666,22021,1999,Mexico,Argentina,2,2,Friendly,Chicago,United States,True,4,0,Draw
19074,20667,22022,1999,Moldova,Finland,0,0,UEFA Euro qualification,Chişinău,Moldova,False,0,0,Draw
19075,20668,22023,1999,Portugal,Liechtenstein,8,0,UEFA Euro qualification,Coimbra,Portugal,False,8,8,Portugal
19076,20669,22024,1999,Romania,Azerbaijan,4,0,UEFA Euro qualification,Bucharest,Romania,False,4,4,Romania
19077,20670,22025,1999,Russia,Iceland,1,0,UEFA Euro qualification,Moscow,Russia,False,1,1,Russia
19078,20671,22026,1999,Switzerland,Italy,0,0,UEFA Euro qualification,Lausanne,Switzerland,False,0,0,Draw
19079,20672,22027,1999,Wales,Denmark,0,2,UEFA Euro qualification,Liverpool,England,True,2,-2,Denmark
19080,20673,22028,1999,Cuba,Jamaica,2,0,CFU Caribbean Cup,Port of Spain,Trinidad and Tobago,True,2,2,Cuba
19081,20674,22029,1999,Guam,Micronesia,4,1,Friendly,Hagätña,Guam,False,5,3,Guam
19082,20675,22030,1999,Trinidad and Tobago,Haiti,6,1,CFU Caribbean Cup,Port of Spain,Trinidad and Tobago,False,7,5,Trinidad and Tobago
19083,20676,22032,1999,Croatia,Egypt,2,2,Korea Cup,Seoul,South Korea,True,4,0,Draw
19084,20678,22034,1999,Trinidad and Tobago,Cuba,2,1,CFU Caribbean Cup,Port of Spain,Trinidad and Tobago,False,3,1,Trinidad and Tobago
19085,20679,22035,1999,United States,Argentina,1,0,Friendly,Washington,United States,False,1,1,United States
19086,20680,22036,1999,Venezuela,Ecuador,3,2,Friendly,San Cristóbal,Venezuela,False,5,1,Venezuela
19087,20681,22037,1999,Brazil,Poland,2,0,Friendly,Bangkok,Thailand,True,2,2,Brazil
19088,20682,22038,1999,Croatia,Mexico,2,1,Korea Cup,Seoul,South Korea,True,3,1,Croatia
19089,20683,22040,1999,South Africa,Zimbabwe,0,1,Friendly,Johannesburg,South Africa,False,1,-1,Zimbabwe
19090,20684,22041,1999,Thailand,New Zealand,2,2,Friendly,Bangkok,Thailand,False,4,0,Draw
19091,20685,22042,1999,Colombia,Peru,3,3,Friendly,Manizales,Colombia,False,6,0,Draw
19092,20686,22043,1999,Paraguay,Uruguay,2,3,Friendly,Ciudad del Este,Paraguay,False,5,-1,Uruguay
19093,20687,22044,1999,Egypt,Mexico,0,2,Korea Cup,Seoul,South Korea,True,2,-2,Mexico
19094,20688,22045,1999,Saudi Arabia,Jordan,2,1,Friendly,Riyadh,Saudi Arabia,False,3,1,Saudi Arabia
19095,20689,22046,1999,Eritrea,Mozambique,1,0,African Cup of Nations qualification,Asmara,Eritrea,False,1,1,Eritrea
19096,20690,22048,1999,New Zealand,Poland,0,0,Friendly,Bangkok,Thailand,True,0,0,Draw
19097,20691,22049,1999,Senegal,Burundi,1,0,African Cup of Nations qualification,Dakar,Senegal,False,1,1,Senegal
19098,20692,22050,1999,Thailand,Brazil,0,2,Friendly,Bangkok,Thailand,False,2,-2,Brazil
19099,20693,22051,1999,Algeria,Uganda,2,0,African Cup of Nations qualification,Annaba,Algeria,False,2,2,Algeria
19100,20694,22052,1999,Angola,South Africa,2,2,African Cup of Nations qualification,Luanda,Angola,False,4,0,Draw
19101,20695,22053,1999,Chile,Bolivia,1,0,Friendly,Santiago,Chile,False,1,1,Chile
19102,20696,22054,1999,Congo,Namibia,3,0,African Cup of Nations qualification,Pointe-Noire,Congo,False,3,3,Congo
19103,20697,22055,1999,DR Congo,Zambia,0,1,African Cup of Nations qualification,Kinshasa,DR Congo,False,1,-1,Zambia
19104,20698,22056,1999,Guinea,Togo,2,1,African Cup of Nations qualification,Conakry,Guinea,False,3,1,Guinea
19105,20699,22057,1999,Ivory Coast,Mali,0,0,African Cup of Nations qualification,Abidjan,Ivory Coast,False,0,0,Draw
19106,20700,22058,1999,Liberia,Tunisia,2,0,African Cup of Nations qualification,Monrovia,Liberia,False,2,2,Liberia
19107,20701,22059,1999,Madagascar,Kenya,1,1,African Cup of Nations qualification,Antananarivo,Madagascar,False,2,0,Draw
19108,20702,22060,1999,Mauritius,Gabon,2,2,African Cup of Nations qualification,Les Avirons,Réunion,True,4,0,Draw
19109,20703,22061,1999,Venezuela,Peru,3,0,Friendly,Valencia,Venezuela,False,3,3,Venezuela
19110,20704,22062,1999,Oman,New Zealand,1,0,Friendly,Muscat,Oman,False,1,1,Oman
19111,20705,22063,1999,Saudi Arabia,Jordan,2,0,Friendly,Riyadh,Saudi Arabia,False,2,2,Saudi Arabia
19112,20706,22064,1999,Uganda,Zambia,0,1,Friendly,Kampala,Uganda,False,1,-1,Zambia
19113,20707,22065,1999,Peru,Venezuela,3,0,Friendly,Lima,Peru,False,3,3,Peru
19114,20708,22066,1999,Oman,New Zealand,2,2,Friendly,Muscat,Oman,False,4,0,Draw
19115,20709,22067,1999,Paraguay,Colombia,2,1,Friendly,Asunción,Paraguay,False,3,1,Paraguay
19116,20710,22068,1999,Argentina,Lithuania,0,0,Friendly,Buenos Aires,Argentina,False,0,0,Draw
19117,20711,22069,1999,Brazil,Latvia,3,0,Friendly,Curitiba,Brazil,False,3,3,Brazil
19118,20712,22070,1999,Jersey,Åland Islands,1,0,Island Games,Visby,Sweden,True,1,1,Jersey
19119,20715,22076,1999,Jordan,Iraq,0,1,Friendly,Amman,Jordan,False,1,-1,Iraq
19120,20716,22077,1999,Åland Islands,Gibraltar,2,1,Island Games,Väskinde,Sweden,True,3,1,Åland Islands
19121,20717,22083,1999,Paraguay,Bolivia,0,0,Copa América,Asunción,Paraguay,False,0,0,Draw
19122,20718,22084,1999,Peru,Japan,3,2,Copa América,Asunción,Paraguay,True,5,1,Peru
19123,20719,22085,1999,Singapore,New Zealand,0,1,Friendly,Singapore,Singapore,False,1,-1,New Zealand
19124,20720,22086,1999,Zimbabwe,Egypt,1,1,Friendly,Harare,Zimbabwe,False,2,0,Draw
19125,20721,22087,1999,Gibraltar,Jersey,1,5,Island Games,Fardhem,Sweden,True,6,-4,Jersey
19126,20723,22093,1999,Brazil,Venezuela,7,0,Copa América,Ciudad del Este,Paraguay,True,7,7,Brazil
19127,20724,22094,1999,Chile,Mexico,0,1,Copa América,Ciudad del Este,Paraguay,True,1,-1,Mexico
19128,20725,22095,1999,Jordan,Iraq,1,1,Friendly,Amman,Jordan,False,2,0,Draw
19129,20726,22096,1999,Argentina,Ecuador,3,1,Copa América,Luque,Paraguay,True,4,2,Argentina
19130,20727,22097,1999,Malaysia,New Zealand,2,1,Friendly,Shah Alam,Malaysia,False,3,1,Malaysia
19131,20728,22098,1999,Uruguay,Colombia,0,1,Copa América,Asunción,Paraguay,True,1,-1,Colombia
19132,20731,22106,1999,Isle of Man,Jersey,1,0,Island Games,Visby,Sweden,True,1,1,Isle of Man
19133,20732,22107,1999,Lithuania,Indonesia,2,2,Friendly,Valga,Estonia,True,4,0,Draw
19134,20733,22108,1999,Paraguay,Japan,4,0,Copa América,Asunción,Paraguay,False,4,4,Paraguay
19135,20734,22109,1999,Peru,Bolivia,1,0,Copa América,Asunción,Paraguay,True,1,1,Peru
19136,20737,22115,1999,Brazil,Mexico,2,1,Copa América,Ciudad del Este,Paraguay,True,3,1,Brazil
19137,20738,22116,1999,Chile,Venezuela,3,0,Copa América,Ciudad del Este,Paraguay,True,3,3,Chile
19138,20739,22117,1999,Malaysia,New Zealand,1,5,Friendly,Kuala Lumpur,Malaysia,False,6,-4,New Zealand
19139,20740,22118,1999,Argentina,Colombia,0,3,Copa América,Luque,Paraguay,True,3,-3,Colombia
19140,20741,22119,1999,Lesotho,Angola,0,1,COSAFA Cup,Maseru,Lesotho,False,1,-1,Angola
19141,20742,22120,1999,Uruguay,Ecuador,2,1,Copa América,Luque,Paraguay,True,3,1,Uruguay
19142,20743,22121,1999,Bolivia,Japan,1,1,Copa América,Pedro Juan Caballero,Paraguay,True,2,0,Draw
19143,20744,22122,1999,Paraguay,Peru,1,0,Copa América,Pedro Juan Caballero,Paraguay,False,1,1,Paraguay
19144,20745,22123,1999,Brazil,Chile,1,0,Copa América,Ciudad del Este,Paraguay,True,1,1,Brazil
19145,20746,22124,1999,Malawi,Uganda,0,2,Friendly,Blantyre,Malawi,False,2,-2,Uganda
19146,20747,22125,1999,Mexico,Venezuela,3,1,Copa América,Ciudad del Este,Paraguay,True,4,2,Mexico
19147,20748,22126,1999,Colombia,Ecuador,2,1,Copa América,Luque,Paraguay,True,3,1,Colombia
19148,20749,22127,1999,Uruguay,Argentina,0,2,Copa América,Luque,Paraguay,True,2,-2,Argentina
19149,20750,22128,1999,Canada,Saudi Arabia,0,2,Friendly,Fullerton,United States,True,2,-2,Saudi Arabia
19150,20751,22129,1999,Egypt,New Zealand,1,1,Friendly,Mexico City,Mexico,True,2,0,Draw
19151,20752,22130,1999,Mexico,Peru,3,3,Copa América,Asunción,Paraguay,True,6,0,Draw
19152,20753,22131,1999,Paraguay,Uruguay,1,1,Copa América,Asunción,Paraguay,False,2,0,Draw
19153,20754,22132,1999,Brazil,Argentina,2,1,Copa América,Ciudad del Este,Paraguay,True,3,1,Brazil
19154,20755,22133,1999,Chile,Colombia,3,2,Copa América,Luque,Paraguay,True,5,1,Chile
19155,20756,22134,1999,Uzbekistan,Malaysia,3,0,Friendly,Samarqand,Uzbekistan,False,3,3,Uzbekistan
19156,20757,22135,1999,Micronesia,Northern Mariana Islands,7,0,Friendly,Colonia,Micronesia,False,7,7,Micronesia
19157,20758,22136,1999,Jamaica,Saudi Arabia,2,1,Friendly,San Bernardino,United States,True,3,1,Jamaica
19158,20759,22137,1999,Uruguay,Chile,1,1,Copa América,Asunción,Paraguay,True,2,0,Draw
19159,20760,22138,1999,Mexico,Brazil,0,2,Copa América,Ciudad del Este,Paraguay,True,2,-2,Brazil
19160,20761,22139,1999,Egypt,New Zealand,1,0,Friendly,Guadalajara,Mexico,True,1,1,Egypt
19161,20762,22140,1999,Jamaica,Saudi Arabia,0,4,Friendly,Fullerton,United States,True,4,-4,Saudi Arabia
19162,20763,22141,1999,Jordan,Syria,1,0,Friendly,Amman,Jordan,False,1,1,Jordan
19163,20764,22142,1999,Chile,Mexico,1,2,Copa América,Asunción,Paraguay,True,3,-1,Mexico
19164,20765,22143,1999,Costa Rica,Saudi Arabia,1,0,Friendly,Fullerton,United States,True,1,1,Costa Rica
19165,20766,22144,1999,Brazil,Uruguay,3,0,Copa América,Asunción,Paraguay,True,3,3,Brazil
19166,20767,22145,1999,Jordan,Syria,4,0,Friendly,Amman,Jordan,False,4,4,Jordan
19167,20768,22146,1999,Senegal,Eritrea,6,2,African Cup of Nations qualification,Dakar,Senegal,False,8,4,Senegal
19168,20769,22147,1999,Eswatini,Zimbabwe,1,1,COSAFA Cup,Lobamba,Eswatini,False,2,0,Draw
19169,20770,22148,1999,Oman,Kenya,2,2,Friendly,Muscat,Oman,False,4,0,Draw
19170,20771,22149,1999,Brazil,Germany,4,0,Confederations Cup,Guadalajara,Mexico,True,4,4,Brazil
19171,20772,22150,1999,New Zealand,United States,1,2,Confederations Cup,Guadalajara,Mexico,True,3,-1,United States
19172,20773,22151,1999,Rwanda,Djibouti,4,1,CECAFA Cup,Kigali,Rwanda,False,5,3,Rwanda
19173,20774,22152,1999,Thailand,Uzbekistan,1,0,Friendly,Bangkok,Thailand,False,1,1,Thailand
19174,20775,22153,1999,Bolivia,Egypt,2,2,Confederations Cup,Mexico City,Mexico,True,4,0,Draw
19175,20776,22154,1999,Burundi,Uganda,0,0,CECAFA Cup,Kigali,Rwanda,True,0,0,Draw
19176,20778,22156,1999,Mexico,Saudi Arabia,5,1,Confederations Cup,Mexico City,Mexico,False,6,4,Mexico
19177,20779,22157,1999,Tanzania,Djibouti,2,1,CECAFA Cup,Kigali,Rwanda,True,3,1,Tanzania
19178,20780,22158,1999,Burundi,Somalia,3,0,CECAFA Cup,Kigali,Rwanda,True,3,3,Burundi
19179,20781,22159,1999,Ethiopia,Sudan,0,0,CECAFA Cup,Kigali,Rwanda,True,0,0,Draw
19180,20782,22160,1999,Mexico,Egypt,2,2,Confederations Cup,Mexico City,Mexico,False,4,0,Draw
19181,20783,22161,1999,Saudi Arabia,Bolivia,0,0,Confederations Cup,Mexico City,Mexico,True,0,0,Draw
19182,20784,22162,1999,Brazil,United States,1,0,Confederations Cup,Guadalajara,Mexico,True,1,1,Brazil
19183,20785,22163,1999,El Salvador,Guatemala,0,2,Friendly,Los Angeles,United States,True,2,-2,Guatemala
19184,20786,22164,1999,Germany,New Zealand,2,0,Confederations Cup,Guadalajara,Mexico,True,2,2,Germany
19185,20787,22165,1999,Kenya,Eritrea,1,0,CECAFA Cup,Kigali,Rwanda,True,1,1,Kenya
19186,20788,22166,1999,Rwanda,Tanzania,0,0,CECAFA Cup,Kigali,Rwanda,False,0,0,Draw
19187,20789,22167,1999,Egypt,Saudi Arabia,1,5,Confederations Cup,Mexico City,Mexico,True,6,-4,Saudi Arabia
19188,20790,22168,1999,Mexico,Bolivia,1,0,Confederations Cup,Mexico City,Mexico,False,1,1,Mexico
19189,20791,22169,1999,Somalia,Uganda,0,2,CECAFA Cup,Kigali,Rwanda,True,2,-2,Uganda
19190,20793,22171,1999,New Zealand,Brazil,0,2,Confederations Cup,Guadalajara,Mexico,True,2,-2,Brazil
19191,20794,22172,1999,United States,Germany,2,0,Confederations Cup,Guadalajara,Mexico,True,2,2,United States
19192,20795,22173,1999,Burundi,Tanzania,1,0,CECAFA Cup,Kigali,Rwanda,True,1,1,Burundi
19193,20796,22174,1999,Namibia,South Africa,1,1,COSAFA Cup,Windhoek,Namibia,False,2,0,Draw
19194,20797,22175,1999,Rwanda,Uganda,1,0,CECAFA Cup,Kigali,Rwanda,False,1,1,Rwanda
19195,20798,22176,1999,Brazil,Saudi Arabia,8,2,Confederations Cup,Guadalajara,Mexico,True,10,6,Brazil
19196,20799,22177,1999,Kenya,Sudan,3,0,CECAFA Cup,Kigali,Rwanda,True,3,3,Kenya
19197,20800,22178,1999,Mexico,United States,1,0,Confederations Cup,Mexico City,Mexico,False,1,1,Mexico
19198,20801,22179,1999,Oman,Kyrgyzstan,3,0,AFC Asian Cup qualification,Dushanbe,Tajikistan,True,3,3,Oman
19199,20802,22180,1999,Rwanda,Kenya,0,0,Friendly,Kigali,Rwanda,False,0,0,Draw
19200,20803,22181,1999,Tajikistan,Iraq,1,2,AFC Asian Cup qualification,Dushanbe,Tajikistan,False,3,-1,Iraq
19201,20804,22182,1999,United States,Saudi Arabia,2,0,Confederations Cup,Guadalajara,Mexico,True,2,2,United States
19202,20805,22183,1999,Mexico,Brazil,4,3,Confederations Cup,Mexico City,Mexico,False,7,1,Mexico
19203,20806,22184,1999,Iraq,Oman,2,0,AFC Asian Cup qualification,Dushanbe,Tajikistan,True,2,2,Iraq
19204,20807,22185,1999,Tajikistan,Kyrgyzstan,3,2,AFC Asian Cup qualification,Dushanbe,Tajikistan,False,5,1,Tajikistan
19205,20808,22186,1999,Ghana,Jamaica,2,1,Friendly,Accra,Ghana,False,3,1,Ghana
19206,20809,22187,1999,Iraq,Kyrgyzstan,5,1,AFC Asian Cup qualification,Dushanbe,Tajikistan,True,6,4,Iraq
19207,20810,22188,1999,Rwanda,Burundi,0,0,Friendly,Kigali,Rwanda,False,0,0,Draw
19208,20811,22189,1999,Tajikistan,Oman,2,1,AFC Asian Cup qualification,Dushanbe,Tajikistan,False,3,1,Tajikistan
19209,20812,22190,1999,Zambia,Mozambique,1,1,COSAFA Cup,Lusaka,Zambia,False,2,0,Draw
19210,20813,22191,1999,Senegal,Zimbabwe,2,0,African Cup of Nations qualification,Dakar,Senegal,False,2,2,Senegal
19211,20814,22192,1999,Zambia,Angola,0,1,COSAFA Cup,Lusaka,Zambia,False,1,-1,Angola
19212,20815,22193,1999,Lesotho,Eswatini,0,3,Friendly,Maseru,Lesotho,False,3,-3,Eswatini
19213,20816,22194,1999,Zimbabwe,Eritrea,4,0,African Cup of Nations qualification,Harare,Zimbabwe,False,4,4,Zimbabwe
19214,20817,22195,1999,Mozambique,Nigeria,0,1,Friendly,Maputo,Mozambique,False,1,-1,Nigeria
19215,20818,22196,1999,Belarus,Russia,0,2,Friendly,Minsk,Belarus,False,2,-2,Russia
19216,20819,22197,1999,Belgium,Finland,3,4,Friendly,Bruges,Belgium,False,7,-1,Finland
19217,20820,22198,1999,Cyprus,Romania,2,2,Friendly,Limassol,Cyprus,False,4,0,Draw
19218,20821,22199,1999,Czech Republic,Switzerland,3,0,Friendly,Drnovice,Czech Republic,False,3,3,Czech Republic
19219,20822,22200,1999,Denmark,Netherlands,0,0,Friendly,Copenhagen,Denmark,False,0,0,Draw
19220,20823,22201,1999,Estonia,Armenia,2,0,Friendly,Pärnu,Estonia,False,2,2,Estonia
19221,20824,22202,1999,Faroe Islands,Iceland,0,1,Friendly,Tórshavn,Faroe Islands,False,1,-1,Iceland
19222,20825,22203,1999,Greece,El Salvador,3,1,Friendly,Kavála,Greece,False,4,2,Greece
19223,20826,22204,1999,Hungary,Moldova,1,1,Friendly,Budapest,Hungary,False,2,0,Draw
19224,20827,22205,1999,Liechtenstein,Bosnia and Herzegovina,0,0,Friendly,Vaduz,Liechtenstein,False,0,0,Draw
19225,20828,22206,1999,Northern Ireland,France,0,1,Friendly,Belfast,Northern Ireland,False,1,-1,France
19226,20829,22207,1999,Norway,Lithuania,1,0,Friendly,Oslo,Norway,False,1,1,Norway
19227,20830,22208,1999,Poland,Spain,1,2,Friendly,Warsaw,Poland,False,3,-1,Spain
19228,20831,22209,1999,Portugal,Andorra,4,0,Friendly,Oeiras,Portugal,False,4,4,Portugal
19229,20832,22210,1999,Serbia,Croatia,0,0,UEFA Euro qualification,Belgrade,Yugoslavia,False,0,0,Draw
19230,20833,22211,1999,Slovakia,Israel,1,0,Friendly,Bratislava,Slovakia,False,1,1,Slovakia
19231,20834,22212,1999,Slovenia,Albania,2,0,UEFA Euro qualification,Ljubljana,Slovenia,False,2,2,Slovenia
19232,20835,22213,1999,Sweden,Austria,0,0,Friendly,Malmö,Sweden,False,0,0,Draw
19233,20836,22214,1999,Ukraine,Bulgaria,1,1,Friendly,Kyïv,Ukraine,False,2,0,Draw
19234,20837,22215,1999,Uruguay,Costa Rica,5,4,Friendly,Montevideo,Uruguay,False,9,1,Uruguay
19235,20838,22216,1999,Uzbekistan,Azerbaijan,5,1,Friendly,Samarqand,Uzbekistan,False,6,4,Uzbekistan
19236,20839,22217,1999,Greece,El Salvador,3,0,Friendly,Kavála,Greece,False,3,3,Greece
19237,20840,22218,1999,Croatia,Malta,2,1,UEFA Euro qualification,Zagreb,Croatia,False,3,1,Croatia
19238,20841,22219,1999,Bolivia,Venezuela,0,0,Friendly,Sucre,Bolivia,False,0,0,Draw
19239,20842,22220,1999,Namibia,Eswatini,1,1,COSAFA Cup,Windhoek,Namibia,False,2,0,Draw
19240,20843,22221,1999,Nigeria,Ghana,0,0,Friendly,Lagos,Nigeria,False,0,0,Draw
19241,20844,22222,1999,Republic of Ireland,Serbia,2,1,UEFA Euro qualification,Dublin,Republic of Ireland,False,3,1,Republic of Ireland
19242,20845,22223,1999,Canada,Jamaica,1,0,Friendly,Toronto,Canada,False,1,1,Canada
19243,20846,22224,1999,Albania,Latvia,3,3,UEFA Euro qualification,Tirana,Albania,False,6,0,Draw
19244,20847,22225,1999,Argentina,Brazil,2,0,Friendly,Buenos Aires,Argentina,False,2,2,Argentina
19245,20848,22226,1999,Austria,Spain,1,3,UEFA Euro qualification,Vienna,Austria,False,4,-2,Spain
19246,20849,22227,1999,Belarus,Wales,1,2,UEFA Euro qualification,Minsk,Belarus,False,3,-1,Wales
19247,20850,22228,1999,Bosnia and Herzegovina,Scotland,1,2,UEFA Euro qualification,Sarajevo,Bosnia and Herzegovina,False,3,-1,Scotland
19248,20851,22229,1999,Croatia,Republic of Ireland,1,0,UEFA Euro qualification,Zagreb,Croatia,False,1,1,Croatia
19249,20852,22230,1999,Denmark,Switzerland,2,1,UEFA Euro qualification,Copenhagen,Denmark,False,3,1,Denmark
19250,20853,22231,1999,England,Luxembourg,6,0,UEFA Euro qualification,London,England,False,6,6,England
19251,20854,22232,1999,Faroe Islands,Estonia,0,2,UEFA Euro qualification,Tórshavn,Faroe Islands,False,2,-2,Estonia
19252,20855,22233,1999,Finland,Germany,1,2,UEFA Euro qualification,Helsinki,Finland,False,3,-1,Germany
19253,20856,22234,1999,Iceland,Andorra,3,0,UEFA Euro qualification,Reykjavík,Iceland,False,3,3,Iceland
19254,20857,22235,1999,Liechtenstein,Hungary,0,0,UEFA Euro qualification,Vaduz,Liechtenstein,False,0,0,Draw
19255,20858,22236,1999,Lithuania,Czech Republic,0,4,UEFA Euro qualification,Vilnius,Lithuania,False,4,-4,Czech Republic
19256,20859,22237,1999,Netherlands,Belgium,5,5,Friendly,Rotterdam,Netherlands,False,10,0,Draw
19257,20860,22238,1999,Northern Ireland,Turkey,0,3,UEFA Euro qualification,Belfast,Northern Ireland,False,3,-3,Turkey
19258,20861,22239,1999,Norway,Greece,1,0,UEFA Euro qualification,Oslo,Norway,False,1,1,Norway
19259,20862,22240,1999,Russia,Armenia,2,0,UEFA Euro qualification,Moscow,Russia,False,2,2,Russia
19260,20863,22241,1999,Slovakia,Romania,1,5,UEFA Euro qualification,Bratislava,Slovakia,False,6,-4,Romania
19261,20864,22242,1999,Slovenia,Georgia,2,1,UEFA Euro qualification,Ljubljana,Slovenia,False,3,1,Slovenia
19262,20865,22243,1999,Sweden,Bulgaria,1,0,UEFA Euro qualification,Solna,Sweden,False,1,1,Sweden
19263,20866,22244,1999,Ukraine,France,0,0,UEFA Euro qualification,Kyïv,Ukraine,False,0,0,Draw
19264,20867,22245,1999,Cyprus,Israel,3,2,UEFA Euro qualification,Limassol,Cyprus,False,5,1,Cyprus
19265,20869,22247,1999,Belgium,Morocco,4,0,Friendly,Liège,Belgium,False,4,4,Belgium
19266,20870,22248,1999,Brazil,Argentina,4,2,Friendly,Porto Alegre,Brazil,False,6,2,Brazil
19267,20871,22249,1999,Andorra,Russia,1,2,UEFA Euro qualification,Sant Julià de Lòria,Andorra,False,3,-1,Russia
19268,20872,22250,1999,Armenia,France,2,3,UEFA Euro qualification,Yerevan,Armenia,False,5,-1,France
19269,20873,22251,1999,Czech Republic,Bosnia and Herzegovina,3,0,UEFA Euro qualification,Teplice,Czech Republic,False,3,3,Czech Republic
19270,20874,22252,1999,Estonia,Scotland,0,0,UEFA Euro qualification,Tallinn,Estonia,False,0,0,Draw
19271,20875,22253,1999,Faroe Islands,Lithuania,0,1,UEFA Euro qualification,Tórshavn,Faroe Islands,False,1,-1,Lithuania
19272,20876,22254,1999,Georgia,Latvia,2,2,UEFA Euro qualification,Tbilisi,Georgia,False,4,0,Draw
19273,20877,22255,1999,Germany,Northern Ireland,4,0,UEFA Euro qualification,Dortmund,Germany,False,4,4,Germany
19274,20878,22256,1999,Hungary,Azerbaijan,3,0,UEFA Euro qualification,Budapest,Hungary,False,3,3,Hungary
19275,20879,22257,1999,Iceland,Ukraine,0,1,UEFA Euro qualification,Reykjavík,Iceland,False,1,-1,Ukraine
19276,20880,22258,1999,Israel,San Marino,8,0,UEFA Euro qualification,Ramat-Gan,Israel,False,8,8,Israel
19277,20881,22259,1999,Italy,Denmark,2,3,UEFA Euro qualification,Naples,Italy,False,5,-1,Denmark
19278,20882,22260,1999,Jamaica,United States,2,2,Friendly,Kingston,Jamaica,False,4,0,Draw
19279,20883,22261,1999,Japan,Iran,1,1,Friendly,Yokohama,Japan,False,2,0,Draw
19280,20884,22262,1999,Luxembourg,Sweden,0,1,UEFA Euro qualification,Luxembourg,Luxembourg,False,1,-1,Sweden
19281,20885,22264,1999,Malta,Republic of Ireland,2,3,UEFA Euro qualification,Attard,Malta,False,5,-1,Republic of Ireland
19282,20886,22265,1999,Moldova,Turkey,1,1,UEFA Euro qualification,Chişinău,Moldova,False,2,0,Draw
19283,20887,22266,1999,Norway,Slovenia,4,0,UEFA Euro qualification,Oslo,Norway,False,4,4,Norway
19284,20888,22267,1999,Poland,England,0,0,UEFA Euro qualification,Warsaw,Poland,False,0,0,Draw
19285,20889,22268,1999,Romania,Portugal,1,1,UEFA Euro qualification,Bucharest,Romania,False,2,0,Draw
19286,20890,22269,1999,Slovakia,Liechtenstein,2,0,UEFA Euro qualification,Dubnica nad Váhom,Slovakia,False,2,2,Slovakia
19287,20891,22270,1999,Spain,Cyprus,8,0,UEFA Euro qualification,Badajoz,Spain,False,8,8,Spain
19288,20892,22271,1999,Switzerland,Belarus,2,0,UEFA Euro qualification,Lausanne,Switzerland,False,2,2,Switzerland
19289,20893,22272,1999,Trinidad and Tobago,Colombia,4,3,Friendly,Miami,United States,True,7,1,Trinidad and Tobago
19290,20894,22273,1999,Uruguay,Venezuela,2,0,Friendly,Montevideo,Uruguay,False,2,2,Uruguay
19291,20895,22274,1999,Zambia,Saudi Arabia,0,0,Friendly,Harare,Zimbabwe,True,0,0,Draw
19292,20896,22275,1999,Bermuda,Cayman Islands,3,1,Friendly,Hamilton,Bermuda,False,4,2,Bermuda
19293,20897,22276,1999,Dominica,Saint Lucia,0,2,Friendly,Georgetown,Guyana,True,2,-2,Saint Lucia
19294,20898,22277,1999,Bermuda,Cayman Islands,1,0,Friendly,Hamilton,Bermuda,False,1,1,Bermuda
19295,20899,22278,1999,Zambia,Saudi Arabia,1,2,Friendly,Harare,Zimbabwe,True,3,-1,Saudi Arabia
19296,20900,22279,1999,South Africa,Saudi Arabia,1,0,Friendly,Cape Town,South Africa,False,1,1,South Africa
19297,20901,22280,1999,Cayman Islands,Bahamas,4,0,Friendly,George Town,Cayman Islands,False,4,4,Cayman Islands
19298,20902,22281,1999,Haiti,Venezuela,3,2,Friendly,Port-au-Prince,Haiti,False,5,1,Haiti
19299,20903,22282,1999,Saudi Arabia,South Africa,0,0,Friendly,Riyadh,Saudi Arabia,False,0,0,Draw
19300,20904,22283,1999,Namibia,Angola,1,1,COSAFA Cup,Windhoek,Namibia,False,2,0,Draw
19301,20905,22284,1999,Scotland,Bosnia and Herzegovina,1,0,UEFA Euro qualification,Glasgow,Scotland,False,1,1,Scotland
19302,20906,22285,1999,Canada,Cuba,0,0,Gold Cup qualification,Los Angeles,United States,True,0,0,Draw
19303,20907,22286,1999,El Salvador,Haiti,1,1,Gold Cup qualification,Los Angeles,United States,True,2,0,Draw
19304,20908,22287,1999,Greece,Albania,2,0,UEFA Euro qualification,Athens,Greece,False,2,2,Greece
19305,20909,22288,1999,Canada,El Salvador,2,1,Gold Cup qualification,Los Angeles,United States,True,3,1,Canada
19306,20910,22289,1999,Cuba,Haiti,0,1,Gold Cup qualification,Los Angeles,United States,True,1,-1,Haiti
19307,20911,22290,1999,Albania,Georgia,2,1,UEFA Euro qualification,Tirana,Albania,False,3,1,Albania
19308,20912,22291,1999,Andorra,Armenia,0,3,UEFA Euro qualification,Sant Julià de Lòria,Andorra,False,3,-3,Armenia
19309,20913,22292,1999,Azerbaijan,Slovakia,0,1,UEFA Euro qualification,Baku,Azerbaijan,False,1,-1,Slovakia
19310,20914,22293,1999,Belarus,Italy,0,0,UEFA Euro qualification,Minsk,Belarus,False,0,0,Draw
19311,20915,22294,1999,Croatia,Serbia,2,2,UEFA Euro qualification,Zagreb,Croatia,False,4,0,Draw
19312,20916,22295,1999,Czech Republic,Faroe Islands,2,0,UEFA Euro qualification,Prague,Czech Republic,False,2,2,Czech Republic
19313,20917,22296,1999,Estonia,Bosnia and Herzegovina,1,4,UEFA Euro qualification,Tallinn,Estonia,False,5,-3,Bosnia and Herzegovina
19314,20918,22297,1999,Finland,Northern Ireland,4,1,UEFA Euro qualification,Helsinki,Finland,False,5,3,Finland
19315,20919,22298,1999,France,Iceland,3,2,UEFA Euro qualification,Saint-Denis,France,False,5,1,France
19316,20920,22299,1999,Germany,Turkey,0,0,UEFA Euro qualification,Munich,Germany,False,0,0,Draw
19317,20921,22300,1999,Latvia,Norway,1,2,UEFA Euro qualification,Riga,Latvia,False,3,-1,Norway
19318,20922,22301,1999,Liechtenstein,Romania,0,3,UEFA Euro qualification,Vaduz,Liechtenstein,False,3,-3,Romania
19319,20923,22303,1999,Netherlands,Brazil,2,2,Friendly,Amsterdam,Netherlands,False,4,0,Draw
19320,20924,22304,1999,Portugal,Hungary,3,0,UEFA Euro qualification,Lisbon,Portugal,False,3,3,Portugal
19321,20925,22305,1999,Russia,Ukraine,1,1,UEFA Euro qualification,Moscow,Russia,False,2,0,Draw
19322,20926,22306,1999,Scotland,Lithuania,3,0,UEFA Euro qualification,Glasgow,Scotland,False,3,3,Scotland
19323,20927,22307,1999,Slovenia,Greece,0,3,UEFA Euro qualification,Maribor,Slovenia,False,3,-3,Greece
19324,20928,22308,1999,Sweden,Poland,2,0,UEFA Euro qualification,Solna,Sweden,False,2,2,Sweden
19325,20929,22309,1999,Wales,Switzerland,0,2,UEFA Euro qualification,Wrexham,Wales,False,2,-2,Switzerland
19326,20930,22310,1999,Austria,Cyprus,3,1,UEFA Euro qualification,Vienna,Austria,False,4,2,Austria
19327,20931,22311,1999,Bulgaria,Luxembourg,3,0,UEFA Euro qualification,Sofia,Bulgaria,False,3,3,Bulgaria
19328,20932,22312,1999,Canada,Haiti,2,1,Gold Cup qualification,Los Angeles,United States,True,3,1,Canada
19329,20933,22313,1999,Cuba,El Salvador,3,1,Gold Cup qualification,Los Angeles,United States,True,4,2,Cuba
19330,20934,22314,1999,Denmark,Iran,0,0,Friendly,Copenhagen,Denmark,False,0,0,Draw
19331,20935,22315,1999,England,Belgium,2,1,Friendly,Sunderland,England,False,3,1,England
19332,20936,22316,1999,Spain,Israel,3,0,UEFA Euro qualification,Albacete,Spain,False,3,3,Spain
19333,20937,22317,1999,Hong Kong,Mauritius,4,3,Friendly,Victoria,Hong Kong,False,7,1,Hong Kong
19334,20938,22318,1999,Panama,Trinidad and Tobago,2,2,Friendly,Panama City,Panama,False,4,0,Draw
19335,20939,22319,1999,Uruguay,Ecuador,0,0,Friendly,Montevideo,Uruguay,False,0,0,Draw
19336,20940,22320,1999,Argentina,Colombia,2,1,Friendly,Córdoba,Argentina,False,3,1,Argentina
19337,20941,22321,1999,Mexico,Paraguay,0,1,Friendly,Chicago,United States,True,1,-1,Paraguay
19338,20942,22322,1999,Guatemala,Paraguay,0,0,Friendly,Guatemala,Guatemala,False,0,0,Draw
19339,20943,22323,1999,Tunisia,United Arab Emirates,1,0,Friendly,Tunis,Tunisia,False,1,1,Tunisia
19340,20944,22324,1999,Hong Kong,Cambodia,4,1,AFC Asian Cup qualification,Victoria,Hong Kong,False,5,3,Hong Kong
19341,20945,22325,1999,Mexico,Colombia,0,0,Friendly,San Diego,United States,True,0,0,Draw
19342,20946,22326,1999,Cayman Islands,Jamaica,1,4,Friendly,George Town,Cayman Islands,False,5,-3,Jamaica
19343,20947,22327,1999,Hong Kong,Indonesia,1,1,AFC Asian Cup qualification,Victoria,Hong Kong,False,2,0,Draw
19344,20948,22328,1999,Mexico,Ecuador,0,0,Friendly,Houston,United States,True,0,0,Draw
19345,20949,22329,1999,Cambodia,Indonesia,1,5,AFC Asian Cup qualification,Phnom Penh,Cambodia,False,6,-4,Indonesia
19346,20950,22330,1999,DR Congo,Congo,1,1,Friendly,Kinshasa,DR Congo,False,2,0,Draw
19347,20951,22331,1999,Iraq,Estonia,1,1,United Arab Emirates Friendship Tournament,Abu Dhabi,United Arab Emirates,True,2,0,Draw
19348,20952,22332,1999,Ivory Coast,Gabon,0,1,Friendly,Abidjan,Ivory Coast,False,1,-1,Gabon
19349,20953,22333,1999,United Arab Emirates,Turkmenistan,3,1,United Arab Emirates Friendship Tournament,Abu Dhabi,United Arab Emirates,False,4,2,United Arab Emirates
19350,20954,22334,1999,Tunisia,Zambia,2,1,Friendly,Tunis,Tunisia,False,3,1,Tunisia
19351,20955,22335,1999,Iraq,Turkmenistan,3,0,United Arab Emirates Friendship Tournament,Abu Dhabi,United Arab Emirates,True,3,3,Iraq
19352,20956,22336,1999,United Arab Emirates,Estonia,2,2,United Arab Emirates Friendship Tournament,Abu Dhabi,United Arab Emirates,False,4,0,Draw
19353,20957,22337,1999,Tunisia,Zambia,0,0,Friendly,Tunis,Tunisia,False,0,0,Draw
19354,20958,22338,1999,Bolivia,Paraguay,0,0,Copa Paz del Chaco,Buenos Aires,Argentina,True,0,0,Draw
19355,20959,22339,1999,Turkmenistan,Estonia,1,1,United Arab Emirates Friendship Tournament,Abu Dhabi,United Arab Emirates,True,2,0,Draw
19356,20960,22340,1999,United Arab Emirates,Iraq,2,2,United Arab Emirates Friendship Tournament,Abu Dhabi,United Arab Emirates,False,4,0,Draw
19357,20961,22341,1999,Burkina Faso,Togo,1,0,Friendly,Ouagadougou,Burkina Faso,False,1,1,Burkina Faso
19358,20962,22342,1999,Cambodia,Hong Kong,0,1,AFC Asian Cup qualification,Phnom Penh,Cambodia,False,1,-1,Hong Kong
19359,20963,22343,1999,Gabon,Equatorial Guinea,4,0,UNIFFAC Cup,Libreville,Gabon,False,4,4,Gabon
19360,20964,22344,1999,Central African Republic,Chad,4,1,UNIFFAC Cup,Libreville,Gabon,True,5,3,Central African Republic
19361,20965,22345,1999,Burkina Faso,Togo,1,1,Friendly,Ouagadougou,Burkina Faso,False,2,0,Draw
19362,20966,22346,1999,Chad,São Tomé and Príncipe,5,0,UNIFFAC Cup,Libreville,Gabon,True,5,5,Chad
19363,20967,22347,1999,Congo,Equatorial Guinea,2,1,UNIFFAC Cup,Libreville,Gabon,True,3,1,Congo
19364,20968,22348,1999,Gabon,Central African Republic,1,0,UNIFFAC Cup,Libreville,Gabon,False,1,1,Gabon
19365,20969,22349,1999,Congo,Chad,0,2,UNIFFAC Cup,Libreville,Gabon,True,2,-2,Chad
19366,20970,22350,1999,Equatorial Guinea,Central African Republic,4,2,UNIFFAC Cup,Libreville,Gabon,True,6,2,Equatorial Guinea
19367,20971,22351,1999,Gabon,São Tomé and Príncipe,1,0,UNIFFAC Cup,Libreville,Gabon,False,1,1,Gabon
19368,20972,22352,1999,Congo,São Tomé and Príncipe,1,0,UNIFFAC Cup,Libreville,Gabon,True,1,1,Congo
19369,20973,22353,1999,Egypt,Ghana,1,2,Friendly,Cairo,Egypt,False,3,-1,Ghana
19370,20974,22354,1999,Central African Republic,São Tomé and Príncipe,3,0,UNIFFAC Cup,Libreville,Gabon,True,3,3,Central African Republic
19371,20975,22355,1999,Chad,Equatorial Guinea,1,0,UNIFFAC Cup,Libreville,Gabon,True,1,1,Chad
19372,20976,22356,1999,France,Croatia,3,0,Friendly,Saint-Denis,France,False,3,3,France
19373,20977,22357,1999,Gabon,Congo,0,0,UNIFFAC Cup,Libreville,Gabon,False,0,0,Draw
19374,20978,22358,1999,Greece,Nigeria,2,0,Friendly,Kilkís,Greece,False,2,2,Greece
19375,20979,22359,1999,Republic of Ireland,Turkey,1,1,UEFA Euro qualification,Dublin,Republic of Ireland,False,2,0,Draw
19376,20980,22360,1999,Israel,Denmark,0,5,UEFA Euro qualification,Ramat-Gan,Israel,False,5,-5,Denmark
19377,20981,22361,1999,Italy,Belgium,1,3,Friendly,Lecce,Italy,False,4,-2,Belgium
19378,20982,22362,1999,Netherlands,Czech Republic,1,1,Friendly,Eindhoven,Netherlands,False,2,0,Draw
19379,20983,22363,1999,Scotland,England,0,2,UEFA Euro qualification,Glasgow,Scotland,False,2,-2,England
19380,20984,22364,1999,Slovenia,Ukraine,2,1,UEFA Euro qualification,Ljubljana,Slovenia,False,3,1,Slovenia
19381,20985,22365,1999,Spain,Brazil,0,0,Friendly,Vigo,Spain,False,0,0,Draw
19382,20986,22366,1999,Central African Republic,Congo,4,2,UNIFFAC Cup,Libreville,Gabon,True,6,2,Central African Republic
19383,20987,22367,1999,Gabon,Chad,2,0,UNIFFAC Cup,Libreville,Gabon,False,2,2,Gabon
19384,20988,22368,1999,Indonesia,Hong Kong,3,1,AFC Asian Cup qualification,Jakarta,Indonesia,False,4,2,Indonesia
19385,20989,22369,1999,Norway,Germany,0,1,Friendly,Oslo,Norway,False,1,-1,Germany
19386,20990,22370,1999,São Tomé and Príncipe,Equatorial Guinea,2,0,UNIFFAC Cup,Libreville,Gabon,True,2,2,São Tomé and Príncipe
19387,20991,22371,1999,Namibia,Egypt,0,1,Friendly,Windhoek,Namibia,False,1,-1,Egypt
19388,20992,22372,1999,Denmark,Israel,3,0,UEFA Euro qualification,Copenhagen,Denmark,False,3,3,Denmark
19389,20993,22373,1999,England,Scotland,0,1,UEFA Euro qualification,London,England,False,1,-1,Scotland
19390,20994,22374,1999,Greece,Bulgaria,1,0,Friendly,Kozáni,Greece,False,1,1,Greece
19391,20995,22375,1999,Honduras,Trinidad and Tobago,3,2,Friendly,San Pedro Sula,Honduras,False,5,1,Honduras
19392,20996,22376,1999,Morocco,United States,2,1,Friendly,Marrakech,Morocco,False,3,1,Morocco
19393,20997,22377,1999,Peru,Slovakia,2,1,Friendly,Lima,Peru,False,3,1,Peru
19394,20998,22378,1999,Spain,Argentina,0,2,Friendly,Seville,Spain,False,2,-2,Argentina
19395,20999,22379,1999,Turkey,Republic of Ireland,0,0,UEFA Euro qualification,Bursa,Turkey,False,0,0,Draw
19396,21000,22380,1999,Ukraine,Slovenia,1,1,UEFA Euro qualification,Kyïv,Ukraine,False,2,0,Draw
19397,21001,22381,1999,Uruguay,Paraguay,0,1,Friendly,Maldonado,Uruguay,False,1,-1,Paraguay
19398,21002,22382,1999,Libya,Togo,2,1,Friendly,Agilat,Libya,False,3,1,Libya
19399,21003,22383,1999,Indonesia,Cambodia,9,2,AFC Asian Cup qualification,Jakarta,Indonesia,False,11,7,Indonesia
19400,21004,22384,1999,Senegal,Ivory Coast,3,0,Friendly,Dakar,Senegal,False,3,3,Senegal
19401,21005,22385,1999,Bangladesh,Uzbekistan,0,6,AFC Asian Cup qualification,Abu Dhabi,United Arab Emirates,True,6,-6,Uzbekistan
19402,21006,22386,1999,Gabon,Nigeria,0,2,Friendly,Libreville,Gabon,False,2,-2,Nigeria
19403,21007,22387,1999,United Arab Emirates,India,3,1,AFC Asian Cup qualification,Abu Dhabi,United Arab Emirates,False,4,2,United Arab Emirates
19404,21008,22388,1999,Guatemala,Slovakia,0,1,Friendly,Guatemala,Guatemala,False,1,-1,Slovakia
19405,21009,22389,1999,Sri Lanka,Uzbekistan,0,6,AFC Asian Cup qualification,Abu Dhabi,United Arab Emirates,True,6,-6,Uzbekistan
19406,21010,22390,1999,United Arab Emirates,Bangladesh,3,0,AFC Asian Cup qualification,Abu Dhabi,United Arab Emirates,False,3,3,United Arab Emirates
19407,21011,22391,1999,Lebanon,Malta,0,0,Friendly,Beirut,Lebanon,False,0,0,Draw
19408,21012,22392,1999,Costa Rica,Slovakia,4,0,Friendly,San José,Costa Rica,False,4,4,Costa Rica
19409,21013,22393,1999,India,Uzbekistan,2,3,AFC Asian Cup qualification,Abu Dhabi,United Arab Emirates,True,5,-1,Uzbekistan
19410,21014,22394,1999,Sri Lanka,Bangladesh,1,3,AFC Asian Cup qualification,Abu Dhabi,United Arab Emirates,True,4,-2,Bangladesh
19411,21015,22395,1999,Gabon,Togo,0,0,Friendly,Libreville,Gabon,False,0,0,Draw
19412,21016,22396,1999,Congo,Burkina Faso,2,1,Friendly,Libreville,Gabon,True,3,1,Congo
19413,21017,22397,1999,South Africa,Sweden,1,0,Friendly,Pretoria,South Africa,False,1,1,South Africa
19414,21018,22398,1999,Sri Lanka,India,1,3,AFC Asian Cup qualification,Abu Dhabi,United Arab Emirates,True,4,-2,India
19415,21019,22399,1999,United Arab Emirates,Uzbekistan,0,1,AFC Asian Cup qualification,Abu Dhabi,United Arab Emirates,False,1,-1,Uzbekistan
19416,21020,22400,1999,Zimbabwe,Libya,2,1,Friendly,Harare,Zimbabwe,False,3,1,Zimbabwe
19417,21021,22401,1999,Congo,Togo,2,1,Friendly,Libreville,Gabon,True,3,1,Congo
19418,21022,22402,1999,Gabon,Burkina Faso,3,2,Friendly,Libreville,Gabon,False,5,1,Gabon
19419,21023,22403,1999,India,Bangladesh,2,2,AFC Asian Cup qualification,Abu Dhabi,United Arab Emirates,True,4,0,Draw
19420,21024,22404,1999,United Arab Emirates,Sri Lanka,6,0,AFC Asian Cup qualification,Abu Dhabi,United Arab Emirates,False,6,6,United Arab Emirates
19421,21025,22405,1999,Congo,DR Congo,0,1,Friendly,Brazzaville,Congo,False,1,-1,DR Congo
19422,21026,22406,1999,Peru,Honduras,0,0,Friendly,Lima,Peru,False,0,0,Draw
19423,21027,22407,1999,Gambia,Sierra Leone,0,0,Friendly,Banjul,Gambia,False,0,0,Draw
19424,21028,22408,1999,Malawi,Libya,1,2,Friendly,Lilongwe,Malawi,False,3,-1,Libya
19425,21029,22409,1999,Panama,Cuba,1,0,Friendly,Panama City,Panama,False,1,1,Panama
19426,21030,22410,1999,Malawi,Rwanda,1,1,Friendly,Lilongwe,Malawi,False,2,0,Draw
19427,21031,22411,1999,Senegal,Gambia,3,0,Friendly,Dakar,Senegal,False,3,3,Senegal
19428,21032,22412,1999,Saint Lucia,Dominica,3,1,Friendly,Vieux Fort,Saint Lucia,False,4,2,Saint Lucia
19429,21033,22413,1999,Malawi,Rwanda,1,1,Friendly,Blantyre,Malawi,False,2,0,Draw
19430,21034,22414,1999,Saint Lucia,Dominica,2,1,Friendly,Vieux Fort,Saint Lucia,False,3,1,Saint Lucia
19431,21035,22415,1999,Greece,Ghana,1,1,Friendly,Salonica,Greece,False,2,0,Draw
19432,21036,22416,1999,Malawi,Rwanda,1,2,Friendly,Blantyre,Malawi,False,3,-1,Rwanda
19433,21037,22417,1999,Greece,Moldova,2,0,Friendly,Lárisa,Greece,False,2,2,Greece
19434,21038,22418,1999,Honduras,Zambia,7,1,Friendly,San Pedro Sula,Honduras,False,8,6,Honduras
19435,21039,22419,1999,Dominica,Saint Lucia,2,1,Friendly,Roseau,Dominica,False,3,1,Dominica
19436,21040,22420,1999,Greece,Estonia,2,2,Friendly,Tríkala,Greece,False,4,0,Draw
19437,21041,22421,1999,Dominica,Saint Lucia,2,1,Friendly,Roseau,Dominica,False,3,1,Dominica
19438,21042,22422,1999,Morocco,Senegal,0,0,Friendly,Agadir,Morocco,False,0,0,Draw
19439,21043,22423,1999,Tunisia,Ghana,2,0,Friendly,Sfax,Tunisia,False,2,2,Tunisia
19440,21044,22424,1999,Libya,Gabon,2,0,Friendly,Benghazi,Libya,False,2,2,Libya
19441,21045,22426,1999,Gabon,Togo,3,2,Friendly,Benghazi,Libya,True,5,1,Gabon
19442,21046,22427,1999,Malaysia,Singapore,1,0,Friendly,Dubai,United Arab Emirates,True,1,1,Malaysia
19443,21047,22429,1999,Costa Rica,Honduras,1,1,Friendly,Alajuela,Costa Rica,False,2,0,Draw
19444,21048,22430,1999,Ivory Coast,Burkina Faso,3,1,Friendly,Abidjan,Ivory Coast,False,4,2,Ivory Coast
19445,21049,22431,1999,Libya,Togo,2,0,Friendly,Benghazi,Libya,False,2,2,Libya
19446,21050,22433,2000,Egypt,Togo,2,1,Friendly,Aswan,Egypt,False,3,1,Egypt
19447,21051,22434,2000,Tunisia,Togo,7,0,Friendly,Tunis,Tunisia,False,7,7,Tunisia
19448,21052,22435,2000,Trinidad and Tobago,Canada,0,0,Friendly,Port of Spain,Trinidad and Tobago,False,0,0,Draw
19449,21053,22436,2000,Burkina Faso,Gabon,1,1,Friendly,Ouagadougou,Burkina Faso,False,2,0,Draw
19450,21054,22437,2000,Guatemala,Armenia,1,1,Friendly,Los Angeles,United States,True,2,0,Draw
19451,21055,22438,2000,Ivory Coast,Egypt,2,0,Friendly,Abidjan,Ivory Coast,False,2,2,Ivory Coast
19452,21056,22439,2000,Mexico,Iran,2,1,Friendly,Oakland,United States,True,3,1,Mexico
19453,21057,22440,2000,Bermuda,Canada,0,2,Friendly,Hamilton,Bermuda,False,2,-2,Canada
19454,21058,22441,2000,Burkina Faso,Cameroon,2,2,Friendly,Ouagadougou,Burkina Faso,False,4,0,Draw
19455,21059,22442,2000,Senegal,Cameroon,0,0,Friendly,Dakar,Senegal,False,0,0,Draw
19456,21060,22444,2000,Jamaica,New Zealand,2,1,Friendly,Guangzhou,China PR,True,3,1,Jamaica
19457,21061,22445,2000,United States,Iran,1,1,Friendly,Pasadena,United States,False,2,0,Draw
19458,21062,22446,2000,Ghana,Tunisia,2,0,Friendly,Accra,Ghana,False,2,2,Ghana
19459,21063,22447,2000,Morocco,Trinidad and Tobago,1,0,Friendly,el-Jadida,Morocco,False,1,1,Morocco
19460,21064,22448,2000,Panama,Guatemala,2,0,Friendly,Panama City,Panama,False,2,2,Panama
19461,21065,22449,2000,Togo,Egypt,1,0,Friendly,Lomé,Togo,False,1,1,Togo
19462,21066,22450,2000,Burkina Faso,Algeria,1,0,Friendly,Ouagadougou,Burkina Faso,False,1,1,Burkina Faso
19463,21067,22451,2000,Malta,Qatar,2,0,Friendly,Attard,Malta,False,2,2,Malta
19464,21069,22453,2000,Ghana,Cameroon,1,1,African Cup of Nations,Accra,Ghana,False,2,0,Draw
19465,21070,22455,2000,Egypt,Zambia,2,0,African Cup of Nations,Kano,Nigeria,True,2,2,Egypt
19466,21072,22457,2000,Nigeria,Tunisia,4,2,African Cup of Nations,Lagos,Nigeria,False,6,2,Nigeria
19467,21073,22458,2000,South Africa,Gabon,3,1,African Cup of Nations,Kumasi,Ghana,True,4,2,South Africa
19468,21074,22459,2000,Vietnam,Guam,11,0,AFC Asian Cup qualification,Hanoi,Vietnam,False,11,11,Vietnam
19469,21075,22460,2000,DR Congo,Algeria,0,0,African Cup of Nations,Kumasi,Ghana,True,0,0,Draw
19470,21076,22461,2000,Ivory Coast,Togo,1,1,African Cup of Nations,Accra,Ghana,True,2,0,Draw
19471,21077,22462,2000,Qatar,Bosnia and Herzegovina,2,0,Friendly,Doha,Qatar,False,2,2,Qatar
19472,21078,22463,2000,Burkina Faso,Senegal,1,3,African Cup of Nations,Kano,Nigeria,True,4,-2,Senegal
19473,21079,22464,2000,Morocco,Congo,1,0,African Cup of Nations,Lagos,Nigeria,True,1,1,Morocco
19474,21080,22466,2000,Costa Rica,Trinidad and Tobago,2,1,Friendly,San José,Costa Rica,False,3,1,Costa Rica
19475,21081,22467,2000,Guatemala,Panama,1,1,Friendly,Guatemala,Guatemala,False,2,0,Draw
19476,21082,22468,2000,Spain,Poland,3,0,Friendly,Cartagena,Spain,False,3,3,Spain
19477,21083,22469,2000,Uganda,Libya,3,2,Friendly,Kampala,Uganda,False,5,1,Uganda
19478,21084,22470,2000,Vietnam,Philippines,3,0,AFC Asian Cup qualification,Hanoi,Vietnam,False,3,3,Vietnam
19479,21085,22471,2000,Ghana,Togo,2,0,African Cup of Nations,Accra,Ghana,False,2,2,Ghana
19480,21086,22472,2000,South Africa,DR Congo,1,0,African Cup of Nations,Kumasi,Ghana,True,1,1,South Africa
19481,21087,22473,2000,Cameroon,Ivory Coast,3,0,African Cup of Nations,Accra,Ghana,True,3,3,Cameroon
19482,21088,22474,2000,Egypt,Senegal,1,0,African Cup of Nations,Kano,Nigeria,True,1,1,Egypt
19483,21089,22475,2000,Nigeria,Congo,0,0,African Cup of Nations,Lagos,Nigeria,False,0,0,Draw
19484,21090,22476,2000,U.S. Virgin Islands,Saint Lucia,0,9,Friendly,St. Croix Island,U.S. Virgin Islands,False,9,-9,Saint Lucia
19485,21091,22477,2000,Algeria,Gabon,3,1,African Cup of Nations,Kumasi,Ghana,True,4,2,Algeria
19486,21092,22478,2000,Chile,United States,1,2,Friendly,Coquimbo,Chile,False,3,-1,United States
19487,21093,22479,2000,Philippines,Guam,2,0,AFC Asian Cup qualification,Hanoi,Vietnam,True,2,2,Philippines
19488,21094,22480,2000,Tunisia,Morocco,0,0,African Cup of Nations,Lagos,Nigeria,True,0,0,Draw
19489,21096,22482,2000,Zambia,Burkina Faso,1,1,African Cup of Nations,Kano,Nigeria,True,2,0,Draw
19490,21097,22483,2000,U.S. Virgin Islands,Saint Lucia,0,2,Friendly,St. Croix Island,U.S. Virgin Islands,False,2,-2,Saint Lucia
19491,21098,22484,2000,Cameroon,Togo,0,1,African Cup of Nations,Kumasi,Ghana,True,1,-1,Togo
19492,21099,22485,2000,Faroe Islands,Finland,0,1,Nordic Championship,Cartagena,Spain,True,1,-1,Finland
19493,21100,22486,2000,Ghana,Ivory Coast,0,2,African Cup of Nations,Accra,Ghana,False,2,-2,Ivory Coast
19494,21101,22487,2000,Iceland,Norway,0,0,Nordic Championship,Cartagena,Spain,True,0,0,Draw
19495,21102,22488,2000,Kuwait,Syria,4,0,Friendly,Kuwait City,Kuwait,False,4,4,Kuwait
19496,21103,22490,2000,Egypt,Burkina Faso,4,2,African Cup of Nations,Kano,Nigeria,True,6,2,Egypt
19497,21104,22491,2000,Zambia,Senegal,2,2,African Cup of Nations,Lagos,Nigeria,True,4,0,Draw
19498,21105,22492,2000,Armenia,Moldova,2,1,Cyprus International Tournament,Larnaca,Cyprus,True,3,1,Armenia
19499,21106,22493,2000,DR Congo,Gabon,0,0,African Cup of Nations,Accra,Ghana,True,0,0,Draw
19500,21107,22494,2000,Costa Rica,Chile,1,0,Friendly,San José,Costa Rica,False,1,1,Costa Rica
19501,21108,22495,2000,Cyprus,Lithuania,2,1,Cyprus International Tournament,Limassol,Cyprus,False,3,1,Cyprus
19502,21109,22496,2000,Finland,Iceland,0,1,Nordic Championship,Cartagena,Spain,True,1,-1,Iceland
19503,21110,22497,2000,Romania,Latvia,2,0,Cyprus International Tournament,Paphos,Cyprus,True,2,2,Romania
19504,21111,22498,2000,South Africa,Algeria,1,1,African Cup of Nations,Kumasi,Ghana,True,2,0,Draw
19505,21112,22499,2000,Saint Kitts and Nevis,Saint Lucia,0,1,Friendly,Basseterre,Saint Kitts and Nevis,False,1,-1,Saint Lucia
19506,21113,22500,2000,Nigeria,Morocco,2,0,African Cup of Nations,Lagos,Nigeria,False,2,2,Nigeria
19507,21114,22501,2000,Tunisia,Congo,1,0,African Cup of Nations,Kano,Nigeria,True,1,1,Tunisia
19508,21115,22502,2000,Cyprus,Armenia,3,2,Cyprus International Tournament,Nicosia,Cyprus,False,5,1,Cyprus
19509,21116,22503,2000,Faroe Islands,Iceland,2,3,Nordic Championship,Cartagena,Spain,True,5,-1,Iceland
19510,21117,22504,2000,Kuwait,Iran,1,1,Friendly,Kuwait City,Kuwait,False,2,0,Draw
19511,21118,22505,2000,Moldova,Lithuania,2,1,Cyprus International Tournament,Larnaca,Cyprus,True,3,1,Moldova
19512,21119,22506,2000,Norway,Sweden,1,1,Nordic Championship,Cartagena,Spain,True,2,0,Draw
19513,21120,22507,2000,Romania,Georgia,1,1,Cyprus International Tournament,Larnaca,Cyprus,True,2,0,Draw
19514,21121,22508,2000,Guatemala,Chile,2,1,Friendly,Guatemala,Guatemala,False,3,1,Guatemala
19515,21122,22509,2000,Japan,Mexico,0,1,Lunar New Year Cup,So Kon Po,Hong Kong,True,1,-1,Mexico
19516,21123,22510,2000,Albania,Andorra,3,0,Malta International Tournament,Attard,Malta,True,3,3,Albania
19517,21124,22511,2000,Cameroon,Algeria,2,1,African Cup of Nations,Accra,Ghana,True,3,1,Cameroon
19518,21125,22512,2000,Cayman Islands,Jamaica,0,0,Friendly,George Town,Cayman Islands,False,0,0,Draw
19519,21126,22513,2000,Cyprus,Romania,3,2,Cyprus International Tournament,Nicosia,Cyprus,False,5,1,Cyprus
19520,21127,22514,2000,Georgia,Armenia,2,1,Cyprus International Tournament,Limassol,Cyprus,True,3,1,Georgia
19521,21128,22515,2000,Ghana,South Africa,0,1,African Cup of Nations,Kumasi,Ghana,False,1,-1,South Africa
19522,21129,22516,2000,Latvia,Lithuania,1,2,Cyprus International Tournament,Larnaca,Cyprus,True,3,-1,Lithuania
19523,21130,22517,2000,Malta,Azerbaijan,3,0,Malta International Tournament,Attard,Malta,False,3,3,Malta
19524,21131,22518,2000,Egypt,Tunisia,0,1,African Cup of Nations,Kano,Nigeria,True,1,-1,Tunisia
19525,21132,22519,2000,Nigeria,Senegal,2,1,African Cup of Nations,Lagos,Nigeria,False,3,1,Nigeria
19526,21133,22520,2000,Singapore,Malaysia,3,1,Friendly,Singapore,Singapore,False,4,2,Singapore
19527,21134,22521,2000,Albania,Azerbaijan,1,0,Malta International Tournament,Attard,Malta,True,1,1,Albania
19528,21135,22522,2000,Malta,Andorra,1,1,Malta International Tournament,Attard,Malta,False,2,0,Draw
19529,21136,22523,2000,Mexico,Czech Republic,1,2,Lunar New Year Cup,So Kon Po,Hong Kong,True,3,-1,Czech Republic
19530,21138,22525,2000,Bulgaria,Slovakia,1,0,Friendly,Valparaíso,Chile,True,1,1,Bulgaria
19531,21139,22526,2000,Cayman Islands,Jamaica,0,1,Friendly,George Town,Cayman Islands,False,1,-1,Jamaica
19532,21140,22527,2000,Chile,Australia,2,1,Friendly,Valparaíso,Chile,False,3,1,Chile
19533,21141,22528,2000,Honduras,El Salvador,5,1,Friendly,San Pedro Sula,Honduras,False,6,4,Honduras
19534,21142,22529,2000,Andorra,Azerbaijan,0,0,Malta International Tournament,Attard,Malta,True,0,0,Draw
19535,21143,22530,2000,Cameroon,Tunisia,3,0,African Cup of Nations,Accra,Ghana,True,3,3,Cameroon
19536,21144,22531,2000,Hong Kong,Singapore,0,0,Friendly,Victoria,Hong Kong,False,0,0,Draw
19537,21145,22532,2000,Kuwait,Turkmenistan,6,1,AFC Asian Cup qualification,Kuwait City,Kuwait,False,7,5,Kuwait
19538,21146,22533,2000,Malta,Albania,0,1,Malta International Tournament,Attard,Malta,False,1,-1,Albania
19539,21147,22534,2000,Nepal,Yemen,0,3,AFC Asian Cup qualification,Kuwait City,Kuwait,True,3,-3,Yemen
19540,21148,22535,2000,Nigeria,South Africa,2,0,African Cup of Nations,Lagos,Nigeria,False,2,2,Nigeria
19541,21149,22536,2000,Australia,Slovakia,0,0,Friendly,Valparaíso,Chile,True,0,0,Draw
19542,21150,22537,2000,Chile,Bulgaria,3,2,Friendly,Valparaíso,Chile,False,5,1,Chile
19543,21151,22538,2000,Colombia,Jamaica,1,0,Gold Cup,Miami,United States,True,1,1,Colombia
19544,21152,22539,2000,Nepal,Bhutan,3,0,AFC Asian Cup qualification,Kuwait City,Kuwait,True,3,3,Nepal
19545,21153,22540,2000,South Africa,Tunisia,2,2,African Cup of Nations,Accra,Ghana,True,4,0,Draw
19546,21154,22541,2000,United States,Haiti,3,0,Gold Cup,Miami,United States,False,3,3,United States
19547,21155,22542,2000,Yemen,Turkmenistan,0,1,AFC Asian Cup qualification,Kuwait City,Kuwait,True,1,-1,Turkmenistan
19548,21156,22543,2000,Costa Rica,Canada,2,2,Gold Cup,San Diego,United States,True,4,0,Draw
19549,21158,22545,2000,Macau,Brunei,1,0,AFC Asian Cup qualification,Macau,Macau,False,1,1,Macau
19550,21159,22546,2000,Mexico,Trinidad and Tobago,4,0,Gold Cup,San Diego,United States,True,4,4,Mexico
19551,21160,22547,2000,Nigeria,Cameroon,2,2,African Cup of Nations,Lagos,Nigeria,False,4,0,Draw
19552,21161,22548,2000,Singapore,Japan,0,3,AFC Asian Cup qualification,Macau,Macau,True,3,-3,Japan
19553,21163,22550,2000,Haiti,Peru,1,1,Gold Cup,Miami,United States,True,2,0,Draw
19554,21164,22551,2000,Jamaica,Honduras,0,2,Gold Cup,Miami,United States,True,2,-2,Honduras
19555,21165,22552,2000,Kuwait,Bhutan,20,0,AFC Asian Cup qualification,Kuwait City,Kuwait,False,20,20,Kuwait
19556,21166,22553,2000,Turkmenistan,Nepal,5,0,AFC Asian Cup qualification,Kuwait City,Kuwait,True,5,5,Turkmenistan
19557,21167,22554,2000,Australia,Bulgaria,1,1,Friendly,Valparaíso,Chile,True,2,0,Draw
19558,21169,22556,2000,Chile,Slovakia,0,2,Friendly,Valparaíso,Chile,False,2,-2,Slovakia
19559,21170,22557,2000,Malaysia,Maldives,2,0,Friendly,Kuala Lumpur,Malaysia,False,2,2,Malaysia
19560,21171,22558,2000,Trinidad and Tobago,Guatemala,4,2,Gold Cup,Los Angeles,United States,True,6,2,Trinidad and Tobago
19561,21172,22559,2000,Bhutan,Turkmenistan,0,8,AFC Asian Cup qualification,Kuwait City,Kuwait,True,8,-8,Turkmenistan
19562,21173,22560,2000,Honduras,Colombia,2,0,Gold Cup,Miami,United States,True,2,2,Honduras
19563,21174,22561,2000,Japan,Brunei,9,0,AFC Asian Cup qualification,Macau,Macau,True,9,9,Japan
19564,21175,22562,2000,Kuwait,Yemen,2,0,AFC Asian Cup qualification,Kuwait City,Kuwait,False,2,2,Kuwait
19565,21177,22564,2000,Macau,Singapore,0,1,AFC Asian Cup qualification,Macau,Macau,False,1,-1,Singapore
19566,21178,22565,2000,Panama,El Salvador,4,1,Friendly,Panama City,Panama,False,5,3,Panama
19567,21179,22566,2000,United States,Peru,1,0,Gold Cup,Miami,United States,False,1,1,United States
19568,21180,22567,2000,Barbados,Saint Kitts and Nevis,1,0,Friendly,Bridgetown,Barbados,False,1,1,Barbados
19569,21181,22569,2000,Malaysia,Maldives,3,0,Friendly,Kuala Lumpur,Malaysia,False,3,3,Malaysia
19570,21182,22570,2000,Mexico,Guatemala,1,1,Gold Cup,Los Angeles,United States,True,2,0,Draw
19571,21183,22571,2000,Kuwait,Nepal,5,0,AFC Asian Cup qualification,Kuwait City,Kuwait,False,5,5,Kuwait
19572,21184,22572,2000,Yemen,Bhutan,11,2,AFC Asian Cup qualification,Kuwait City,Kuwait,True,13,9,Yemen
19573,21185,22573,2000,Dominica,Antigua and Barbuda,2,0,Friendly,Roseau,Dominica,False,2,2,Dominica
19574,21186,22574,2000,Honduras,Peru,3,5,Gold Cup,Miami,United States,True,8,-2,Peru
19575,21187,22575,2000,Oman,Switzerland,1,4,Friendly,Muscat,Oman,False,5,-3,Switzerland
19576,21188,22576,2000,United Arab Emirates,Slovenia,1,1,Friendly,Muscat,Oman,True,2,0,Draw
19577,21189,22577,2000,United States,Colombia,2,2,Gold Cup,Miami,United States,False,4,0,Draw
19578,21190,22578,2000,Costa Rica,Trinidad and Tobago,1,2,Gold Cup,San Diego,United States,True,3,-1,Trinidad and Tobago
19579,21191,22579,2000,Lesotho,Eswatini,1,0,Friendly,Maseru,Lesotho,False,1,1,Lesotho
19580,21192,22580,2000,Macau,Japan,0,3,AFC Asian Cup qualification,Macau,Macau,False,3,-3,Japan
19581,21193,22581,2000,Mexico,Canada,1,2,Gold Cup,San Diego,United States,True,3,-1,Canada
19582,21194,22582,2000,Singapore,Brunei,1,0,AFC Asian Cup qualification,Macau,Macau,True,1,1,Singapore
19583,21195,22583,2000,Thailand,Finland,0,0,King's Cup,Bangkok,Thailand,False,0,0,Draw
19584,21196,22585,2000,Oman,United Arab Emirates,0,1,Friendly,Muscat,Oman,False,1,-1,United Arab Emirates
19585,21197,22586,2000,Belgium,Portugal,1,1,Friendly,Charleroi,Belgium,False,2,0,Draw
19586,21198,22587,2000,Colombia,Peru,2,1,Gold Cup,San Diego,United States,True,3,1,Colombia
19587,21199,22588,2000,Croatia,Spain,0,0,Friendly,Split,Croatia,False,0,0,Draw
19588,21200,22589,2000,England,Argentina,0,0,Friendly,London,England,False,0,0,Draw
19589,21201,22590,2000,Estonia,Finland,2,4,King's Cup,Bangkok,Thailand,True,6,-2,Finland
19590,21202,22591,2000,France,Poland,1,0,Friendly,Saint-Denis,France,False,1,1,France
19591,21203,22592,2000,Greece,Austria,4,1,Friendly,Kalamáta,Greece,False,5,3,Greece
19592,21204,22593,2000,Hungary,Australia,0,3,Friendly,Budapest,Hungary,False,3,-3,Australia
19593,21205,22594,2000,Republic of Ireland,Czech Republic,3,2,Friendly,Dublin,Republic of Ireland,False,5,1,Republic of Ireland
19594,21206,22595,2000,Israel,Russia,4,1,Friendly,Haifa,Israel,False,5,3,Israel
19595,21207,22596,2000,Italy,Sweden,1,0,Friendly,Palermo,Italy,False,1,1,Italy
19596,21208,22597,2000,Lebanon,Jordan,1,1,Friendly,Tripoli,Lebanon,False,2,0,Draw
19597,21209,22598,2000,Luxembourg,Northern Ireland,1,3,Friendly,Luxembourg,Luxembourg,False,4,-2,Northern Ireland
19598,21210,22600,2000,Netherlands,Germany,2,1,Friendly,Amsterdam,Netherlands,False,3,1,Netherlands
19599,21211,22601,2000,Oman,Slovenia,0,4,Friendly,Muscat,Oman,False,4,-4,Slovenia
19600,21212,22602,2000,Qatar,Wales,0,1,Friendly,Doha,Qatar,False,1,-1,Wales
19601,21213,22603,2000,Thailand,Brazil,0,7,King's Cup,Bangkok,Thailand,False,7,-7,Brazil
19602,21214,22604,2000,Turkey,Norway,0,2,Friendly,Istanbul,Turkey,False,2,-2,Norway
19603,21215,22605,2000,United Arab Emirates,Switzerland,1,0,Friendly,Muscat,Oman,True,1,1,United Arab Emirates
19604,21216,22606,2000,Trinidad and Tobago,Canada,0,1,Gold Cup,Los Angeles,United States,True,1,-1,Canada
19605,21217,22608,2000,Thailand,Estonia,2,1,King's Cup,Bangkok,Thailand,False,3,1,Thailand
19606,21218,22609,2000,Botswana,Lesotho,1,0,Friendly,Gaborone,Botswana,False,1,1,Botswana
19607,21219,22611,2000,Canada,Colombia,2,0,Gold Cup,Los Angeles,United States,True,2,2,Canada
19608,21220,22612,2000,Thailand,Finland,5,1,King's Cup,Bangkok,Thailand,False,6,4,Thailand
19609,21221,22613,2000,Barbados,Antigua and Barbuda,2,2,Friendly,Bridgetown,Barbados,False,4,0,Draw
19610,21222,22614,2000,El Salvador,Panama,3,1,Friendly,San Salvador,El Salvador,False,4,2,El Salvador
19611,21223,22615,2000,Uzbekistan,Mongolia,8,1,Friendly,Tashkent,Uzbekistan,False,9,7,Uzbekistan
19612,21224,22616,2000,Zambia,Lesotho,2,0,Friendly,Lusaka,Zambia,False,2,2,Zambia
19613,21225,22617,2000,Honduras,Nicaragua,3,0,FIFA World Cup qualification,San Pedro Sula,Honduras,False,3,3,Honduras
19614,21226,22618,2000,Trinidad and Tobago,Curaçao,5,0,FIFA World Cup qualification,Macoya,Trinidad and Tobago,False,5,5,Trinidad and Tobago
19615,21227,22619,2000,Anguilla,Bahamas,1,3,FIFA World Cup qualification,The Valley,Anguilla,False,4,-2,Bahamas
19616,21228,22620,2000,Barbados,Grenada,2,2,FIFA World Cup qualification,Bridgetown,Barbados,False,4,0,Draw
19617,21229,22621,2000,Bolivia,Haiti,9,2,Friendly,La Paz,Bolivia,False,11,7,Bolivia
19618,21230,22623,2000,Cuba,Cayman Islands,4,0,FIFA World Cup qualification,Havana,Cuba,False,4,4,Cuba
19619,21231,22624,2000,Dominican Republic,Montserrat,3,0,FIFA World Cup qualification,San Cristóbal,Dominican Republic,False,3,3,Dominican Republic
19620,21232,22625,2000,El Salvador,Belize,5,0,FIFA World Cup qualification,San Salvador,El Salvador,False,5,5,El Salvador
19621,21233,22626,2000,Ethiopia,Sudan,1,0,Friendly,Addis Abeba,Ethiopia,False,1,1,Ethiopia
19622,21234,22627,2000,Saint Lucia,Suriname,1,0,FIFA World Cup qualification,Castries,Saint Lucia,False,1,1,Saint Lucia
19623,21235,22628,2000,Saint Vincent and the Grenadines,U.S. Virgin Islands,9,0,FIFA World Cup qualification,Kingstown,Saint Vincent and the Grenadines,False,9,9,Saint Vincent and the Grenadines
19624,21236,22629,2000,Zimbabwe,Lesotho,2,1,COSAFA Cup,Harare,Zimbabwe,False,3,1,Zimbabwe
19625,21237,22630,2000,Syria,Jordan,0,0,Friendly,Damascus,Syria,False,0,0,Draw
19626,21238,22631,2000,Ecuador,Honduras,1,3,Friendly,Quito,Ecuador,False,4,-2,Honduras
19627,21239,22632,2000,Jordan,Lebanon,1,1,Friendly,Amman,Jordan,False,2,0,Draw
19628,21240,22633,2000,Cuba,Nicaragua,4,0,Friendly,Havana,Cuba,False,4,4,Cuba
19629,21241,22634,2000,Qatar,Sudan,3,0,Friendly,Doha,Qatar,False,3,3,Qatar
19630,21242,22635,2000,Aruba,Puerto Rico,4,2,FIFA World Cup qualification,Oranjestad,Aruba,False,6,2,Aruba
19631,21243,22636,2000,Haiti,Dominica,4,0,FIFA World Cup qualification,Port-au-Prince,Haiti,False,4,4,Haiti
19632,21244,22637,2000,Jordan,Bosnia and Herzegovina,0,0,Friendly,Zarqa,Jordan,False,0,0,Draw
19633,21245,22638,2000,United States,Tunisia,1,1,Friendly,Birmingham,United States,False,2,0,Draw
19634,21246,22639,2000,Zambia,Malawi,1,1,Friendly,Kitwe,Zambia,False,2,0,Draw
19635,21247,22640,2000,Jordan,Syria,0,0,Friendly,Amman,Jordan,False,0,0,Draw
19636,21248,22641,2000,Zambia,Malawi,0,1,Friendly,Lusaka,Zambia,False,1,-1,Malawi
19637,21250,22643,2000,Jordan,Bosnia and Herzegovina,1,2,Friendly,Zarqa,Jordan,False,3,-1,Bosnia and Herzegovina
19638,21251,22644,2000,Venezuela,Bolivia,0,0,Friendly,Maracaibo,Venezuela,False,0,0,Draw
19639,21252,22645,2000,Jordan,Syria,0,0,Friendly,Amman,Jordan,False,0,0,Draw
19640,21253,22646,2000,Curaçao,Trinidad and Tobago,1,1,FIFA World Cup qualification,Willemstad,Netherlands Antilles,True,2,0,Draw
19641,21254,22647,2000,Grenada,Barbados,2,3,FIFA World Cup qualification,St. George's,Grenada,False,5,-1,Barbados
19642,21255,22648,2000,Puerto Rico,Aruba,2,2,FIFA World Cup qualification,San Juan,Puerto Rico,False,4,0,Draw
19643,21256,22649,2000,Saint Kitts and Nevis,Turks and Caicos Islands,8,0,FIFA World Cup qualification,Basseterre,Saint Kitts and Nevis,False,8,8,Saint Kitts and Nevis
19644,21257,22650,2000,Bahamas,Anguilla,2,1,FIFA World Cup qualification,Nassau,Bahamas,False,3,1,Bahamas
19645,21258,22651,2000,Belize,Guatemala,1,2,FIFA World Cup qualification,San Pedro Sula,Honduras,True,3,-1,Guatemala
19646,21260,22653,2000,Botswana,Eswatini,3,0,Friendly,Gaborone,Botswana,False,3,3,Botswana
19647,21261,22654,2000,Cayman Islands,Cuba,0,0,FIFA World Cup qualification,George Town,Cayman Islands,False,0,0,Draw
19648,21262,22655,2000,Dominica,Haiti,1,3,FIFA World Cup qualification,Roseau,Dominica,False,4,-2,Haiti
19649,21263,22656,2000,Montserrat,Dominican Republic,1,3,FIFA World Cup qualification,Port of Spain,Trinidad and Tobago,True,4,-2,Dominican Republic
19650,21264,22657,2000,Nicaragua,Panama,0,2,FIFA World Cup qualification,Diriamba,Nicaragua,False,2,-2,Panama
19651,21265,22658,2000,Suriname,Saint Lucia,1,0,FIFA World Cup qualification,Paramaribo,Suriname,False,1,1,Suriname
19652,21266,22659,2000,U.S. Virgin Islands,Saint Vincent and the Grenadines,1,5,FIFA World Cup qualification,Frederiksted,U.S. Virgin Islands,False,6,-4,Saint Vincent and the Grenadines
19653,21267,22660,2000,Bahrain,Kazakhstan,0,1,Friendly,Manama,Bahrain,False,1,-1,Kazakhstan
19654,21268,22661,2000,Namibia,Zimbabwe,2,1,Friendly,Windhoek,Namibia,False,3,1,Namibia
19655,21269,22662,2000,Saint Kitts and Nevis,Turks and Caicos Islands,6,0,FIFA World Cup qualification,Basseterre,Saint Kitts and Nevis,False,6,6,Saint Kitts and Nevis
19656,21270,22663,2000,Bahrain,Qatar,1,0,Friendly,Manama,Bahrain,False,1,1,Bahrain
19657,21271,22664,2000,Chile,Honduras,5,2,Friendly,Santiago,Chile,False,7,3,Chile
19658,21272,22665,2000,Cyprus,Iran,0,0,Friendly,Nicosia,Cyprus,False,0,0,Draw
19659,21273,22666,2000,Gambia,Mauritania,0,0,Friendly,Banjul,Gambia,False,0,0,Draw
19660,21274,22667,2000,Bahrain,Jordan,1,1,Friendly,Manama,Bahrain,False,2,0,Draw
19661,21276,22669,2000,Tanzania,Malawi,1,1,Friendly,Morogoro,Tanzania,False,2,0,Draw
19662,21278,22671,2000,Zambia,Botswana,3,0,COSAFA Cup,Lusaka,Zambia,False,3,3,Zambia
19663,21279,22672,2000,Tanzania,Malawi,4,3,Friendly,Dar es Salaam,Tanzania,False,7,1,Tanzania
19664,21282,22675,2000,Colombia,Brazil,0,0,FIFA World Cup qualification,Bogotá,Colombia,False,0,0,Draw
19665,21283,22676,2000,El Salvador,Haiti,3,1,Friendly,San Salvador,El Salvador,False,4,2,El Salvador
19666,21284,22677,2000,Malta,Northern Ireland,0,3,Friendly,Attard,Malta,False,3,-3,Northern Ireland
19667,21286,22679,2000,Argentina,Chile,4,1,FIFA World Cup qualification,Buenos Aires,Argentina,False,5,3,Argentina
19668,21287,22680,2000,Austria,Sweden,1,1,Friendly,Graz,Austria,False,2,0,Draw
19669,21288,22681,2000,Belgium,Netherlands,2,2,Friendly,Brussels,Belgium,False,4,0,Draw
19670,21290,22683,2000,Bulgaria,Belarus,4,1,Friendly,Sofia,Bulgaria,False,5,3,Bulgaria
19671,21291,22684,2000,Croatia,Germany,1,1,Friendly,Zagreb,Croatia,False,2,0,Draw
19672,21292,22685,2000,Czech Republic,Australia,3,1,Friendly,Teplice,Czech Republic,False,4,2,Czech Republic
19673,21293,22686,2000,Ecuador,Venezuela,2,0,FIFA World Cup qualification,Quito,Ecuador,False,2,2,Ecuador
19674,21294,22687,2000,Greece,Romania,2,0,Friendly,Athens,Greece,False,2,2,Greece
19675,21295,22688,2000,Hungary,Poland,0,0,Friendly,Debrecen,Hungary,False,0,0,Draw
19676,21296,22689,2000,Israel,Georgia,1,1,Friendly,Ashkelon,Israel,False,2,0,Draw
19677,21297,22690,2000,Malaysia,Thailand,3,2,AFC Asian Cup qualification,Kuala Lumpur,Malaysia,False,5,1,Malaysia
19678,21298,22691,2000,Peru,Paraguay,2,0,FIFA World Cup qualification,Lima,Peru,False,2,2,Peru
19679,21299,22692,2000,Portugal,Denmark,2,1,Friendly,Leiria,Portugal,False,3,1,Portugal
19680,21300,22693,2000,Scotland,France,0,2,Friendly,Glasgow,Scotland,False,2,-2,France
19681,21301,22694,2000,Spain,Italy,2,0,Friendly,Barcelona,Spain,False,2,2,Spain
19682,21302,22695,2000,Switzerland,Norway,2,2,Friendly,Lugano,Switzerland,False,4,0,Draw
19683,21303,22696,2000,Uruguay,Bolivia,1,0,FIFA World Cup qualification,Montevideo,Uruguay,False,1,1,Uruguay
19684,21304,22697,2000,Wales,Finland,1,2,Friendly,Cardiff,Wales,False,3,-1,Finland
19685,21305,22698,2000,Gambia,Mauritania,0,0,Friendly,Banjul,Gambia,False,0,0,Draw
19686,21306,22699,2000,Jordan,Kazakhstan,0,1,AFC Asian Cup qualification,Doha,Qatar,True,1,-1,Kazakhstan
19687,21307,22700,2000,Maldives,Iran,0,8,AFC Asian Cup qualification,Damascus,Syria,True,8,-8,Iran
19688,21308,22701,2000,Qatar,Palestine,1,0,AFC Asian Cup qualification,Doha,Qatar,False,1,1,Qatar
19689,21309,22702,2000,Syria,Bahrain,1,0,AFC Asian Cup qualification,Damascus,Syria,False,1,1,Syria
19690,21310,22703,2000,Aruba,Barbados,1,3,FIFA World Cup qualification,Oranjestad,Aruba,False,4,-2,Barbados
19691,21311,22704,2000,Haiti,Bahamas,9,0,FIFA World Cup qualification,Port-au-Prince,Haiti,False,9,9,Haiti
19692,21312,22705,2000,Zambia,Kenya,1,0,Friendly,Lusaka,Zambia,False,1,1,Zambia
19693,21313,22706,2000,Bahrain,Maldives,4,1,AFC Asian Cup qualification,Damascus,Syria,True,5,3,Bahrain
19694,21314,22707,2000,Cuba,Suriname,1,0,FIFA World Cup qualification,Havana,Cuba,False,1,1,Cuba
19695,21315,22708,2000,Guatemala,El Salvador,0,1,FIFA World Cup qualification,Guatemala,Guatemala,False,1,-1,El Salvador
19696,21316,22709,2000,Palestine,Pakistan,2,0,AFC Asian Cup qualification,Doha,Qatar,True,2,2,Palestine
19697,21317,22710,2000,Panama,Honduras,1,0,FIFA World Cup qualification,Panama City,Panama,False,1,1,Panama
19698,21318,22711,2000,Qatar,Kazakhstan,3,1,AFC Asian Cup qualification,Doha,Qatar,False,4,2,Qatar
19699,21319,22712,2000,Syria,Iran,0,1,AFC Asian Cup qualification,Damascus,Syria,False,1,-1,Iran
19700,21320,22713,2000,Trinidad and Tobago,Dominican Republic,3,0,FIFA World Cup qualification,Port of Spain,Trinidad and Tobago,False,3,3,Trinidad and Tobago
19701,21321,22714,2000,Bahrain,Iran,1,0,AFC Asian Cup qualification,Damascus,Syria,True,1,1,Bahrain
19702,21323,22716,2000,Palestine,Jordan,1,5,AFC Asian Cup qualification,Doha,Qatar,True,6,-4,Jordan
19703,21324,22717,2000,Qatar,Pakistan,5,0,AFC Asian Cup qualification,Doha,Qatar,False,5,5,Qatar
19704,21325,22718,2000,Syria,Maldives,2,1,AFC Asian Cup qualification,Damascus,Syria,False,3,1,Syria
19705,21327,22720,2000,Burma,Mongolia,2,0,AFC Asian Cup qualification,Seoul,South Korea,True,2,2,Burma
19706,21328,22722,2000,Kazakhstan,Palestine,2,0,AFC Asian Cup qualification,Doha,Qatar,True,2,2,Kazakhstan
19707,21330,22724,2000,Pakistan,Jordan,0,5,AFC Asian Cup qualification,Doha,Qatar,True,5,-5,Jordan
19708,21332,22726,2000,Burma,Laos,4,0,AFC Asian Cup qualification,Seoul,South Korea,True,4,4,Burma
19709,21333,22727,2000,Djibouti,DR Congo,1,1,FIFA World Cup qualification,Djibouti,Djibouti,False,2,0,Draw
19710,21334,22729,2000,Mauritania,Tunisia,1,2,FIFA World Cup qualification,Nouakchott,Mauritania,False,3,-1,Tunisia
19711,21335,22730,2000,Botswana,Zambia,0,1,FIFA World Cup qualification,Gaborone,Botswana,False,1,-1,Zambia
19712,21336,22731,2000,Fiji,Papua New Guinea,5,0,Oceania Nations Cup qualification,Suva,Fiji,False,5,5,Fiji
19713,21337,22732,2000,Guinea-Bissau,Togo,0,0,FIFA World Cup qualification,Bissau,Guinea-Bissau,False,0,0,Draw
19714,21338,22733,2000,Madagascar,Gabon,2,0,FIFA World Cup qualification,Antananarivo,Madagascar,False,2,2,Madagascar
19715,21339,22734,2000,Malawi,Kenya,2,0,FIFA World Cup qualification,Blantyre,Malawi,False,2,2,Malawi
19716,21340,22735,2000,New Caledonia,Solomon Islands,4,2,Oceania Nations Cup qualification,Suva,Fiji,True,6,2,New Caledonia
19717,21341,22736,2000,Pakistan,Kazakhstan,0,4,AFC Asian Cup qualification,Doha,Qatar,True,4,-4,Kazakhstan
19718,21342,22737,2000,Qatar,Jordan,2,2,AFC Asian Cup qualification,Doha,Qatar,False,4,0,Draw
19719,21343,22738,2000,São Tomé and Príncipe,Sierra Leone,2,0,FIFA World Cup qualification,São Tomé,São Tomé and Príncipe,False,2,2,São Tomé and Príncipe
19720,21344,22739,2000,Seychelles,Namibia,1,1,FIFA World Cup qualification,Victoria,Seychelles,False,2,0,Draw
19721,21345,22740,2000,Tanzania,Ghana,0,1,FIFA World Cup qualification,Arusha,Tanzania,False,1,-1,Ghana
19722,21346,22741,2000,Thailand,Malaysia,3,2,AFC Asian Cup qualification,Bangkok,Thailand,False,5,1,Thailand
19723,21347,22742,2000,Uganda,Guinea,4,4,FIFA World Cup qualification,Kampala,Uganda,False,8,0,Draw
19724,21348,22743,2000,Benin,Senegal,1,1,FIFA World Cup qualification,Cotonou,Benin,False,2,0,Draw
19725,21349,22745,2000,Central African Republic,Zimbabwe,0,1,FIFA World Cup qualification,Bangui,Central African Republic,False,1,-1,Zimbabwe
19726,21350,22746,2000,Chad,Liberia,0,1,FIFA World Cup qualification,N'Djamena,Chad,False,1,-1,Liberia
19727,21351,22747,2000,Equatorial Guinea,Congo,1,3,FIFA World Cup qualification,Malabo,Equatorial Guinea,False,4,-2,Congo
19728,21352,22748,2000,Eritrea,Nigeria,0,0,FIFA World Cup qualification,Asmara,Eritrea,False,0,0,Draw
19729,21353,22749,2000,Ethiopia,Burkina Faso,2,1,FIFA World Cup qualification,Addis Abeba,Ethiopia,False,3,1,Ethiopia
19730,21354,22750,2000,Gambia,Morocco,0,1,FIFA World Cup qualification,Bakau,Gambia,False,1,-1,Morocco
19731,21355,22751,2000,Iran,Bahrain,3,0,AFC Asian Cup qualification,Teheran,Iran,False,3,3,Iran
19732,21356,22753,2000,Laos,Mongolia,2,1,AFC Asian Cup qualification,Seoul,South Korea,True,3,1,Laos
19733,21357,22754,2000,Lesotho,South Africa,0,2,FIFA World Cup qualification,Maseru,Lesotho,False,2,-2,South Africa
19734,21358,22755,2000,Libya,Mali,3,0,FIFA World Cup qualification,Tripoli,Libya,False,3,3,Libya
19735,21359,22756,2000,Rwanda,Ivory Coast,2,2,FIFA World Cup qualification,Kigali,Rwanda,False,4,0,Draw
19736,21360,22757,2000,Sudan,Mozambique,1,0,FIFA World Cup qualification,Omdurman,Sudan,False,1,1,Sudan
19737,21361,22758,2000,Eswatini,Angola,0,1,FIFA World Cup qualification,Lobamba,Eswatini,False,1,-1,Angola
19738,21362,22759,2000,Syria,Maldives,2,1,AFC Asian Cup qualification,Teheran,Iran,True,3,1,Syria
19739,21363,22760,2000,Fiji,New Caledonia,2,1,Oceania Nations Cup qualification,Suva,Fiji,False,3,1,Fiji
19740,21364,22761,2000,Solomon Islands,Vanuatu,2,1,Oceania Nations Cup qualification,Suva,Fiji,True,3,1,Solomon Islands
19741,21365,22762,2000,Bahrain,Maldives,1,0,AFC Asian Cup qualification,Teheran,Iran,True,1,1,Bahrain
19742,21366,22763,2000,Fiji,Vanuatu,4,1,Oceania Nations Cup qualification,Suva,Fiji,False,5,3,Fiji
19743,21367,22764,2000,Iran,Syria,1,1,AFC Asian Cup qualification,Teheran,Iran,False,2,0,Draw
19744,21368,22765,2000,New Caledonia,Papua New Guinea,6,1,Oceania Nations Cup qualification,Suva,Fiji,True,7,5,New Caledonia
19745,21369,22766,2000,Ethiopia,DR Congo,1,2,Friendly,Addis Abeba,Ethiopia,False,3,-1,DR Congo
19746,21370,22767,2000,Bahrain,Syria,0,1,AFC Asian Cup qualification,Teheran,Iran,True,1,-1,Syria
19747,21371,22768,2000,Iran,Maldives,3,0,AFC Asian Cup qualification,Teheran,Iran,False,3,3,Iran
19748,21372,22769,2000,Solomon Islands,Papua New Guinea,4,2,Oceania Nations Cup qualification,Suva,Fiji,True,6,2,Solomon Islands
19749,21373,22770,2000,Vanuatu,New Caledonia,6,0,Oceania Nations Cup qualification,Suva,Fiji,True,6,6,Vanuatu
19750,21374,22771,2000,Fiji,Solomon Islands,2,2,Oceania Nations Cup qualification,Suva,Fiji,False,4,0,Draw
19751,21375,22772,2000,Malawi,Mozambique,2,1,COSAFA Cup,Blantyre,Malawi,False,3,1,Malawi
19752,21376,22773,2000,Papua New Guinea,Vanuatu,1,4,Oceania Nations Cup qualification,Suva,Fiji,True,5,-3,Vanuatu
19753,21377,22774,2000,Antigua and Barbuda,Bermuda,0,0,FIFA World Cup qualification,St. John's,Antigua and Barbuda,False,0,0,Draw
19754,21378,22775,2000,Bahamas,Haiti,0,4,FIFA World Cup qualification,Nassau,Bahamas,False,4,-4,Haiti
19755,21379,22776,2000,Barbados,Aruba,4,0,FIFA World Cup qualification,Bridgetown,Barbados,False,4,4,Barbados
19756,21380,22777,2000,Belize,El Salvador,1,3,FIFA World Cup qualification,Orange Walk,Belize,False,4,-2,El Salvador
19757,21381,22778,2000,Dominican Republic,Trinidad and Tobago,0,1,FIFA World Cup qualification,San Cristóbal,Dominican Republic,False,1,-1,Trinidad and Tobago
19758,21382,22779,2000,Nicaragua,Honduras,0,1,FIFA World Cup qualification,Diriamba,Nicaragua,False,1,-1,Honduras
19759,21383,22780,2000,Saint Vincent and the Grenadines,Saint Kitts and Nevis,1,0,FIFA World Cup qualification,Kingstown,Saint Vincent and the Grenadines,False,1,1,Saint Vincent and the Grenadines
19760,21384,22781,2000,Suriname,Cuba,0,0,FIFA World Cup qualification,Paramaribo,Suriname,False,0,0,Draw
19761,21385,22782,2000,Uganda,Kenya,2,2,Friendly,Kampala,Uganda,False,4,0,Draw
19762,21386,22783,2000,Cameroon,Somalia,3,0,FIFA World Cup qualification,Yaoundé,Cameroon,False,3,3,Cameroon
19763,21387,22784,2000,Mali,Burkina Faso,2,1,Friendly,Bamako,Mali,False,3,1,Mali
19764,21388,22785,2000,Egypt,Mauritius,2,0,FIFA World Cup qualification,Cairo,Egypt,False,2,2,Egypt
19765,21390,22787,2000,Gabon,Madagascar,1,0,FIFA World Cup qualification,Libreville,Gabon,False,1,1,Gabon
19766,21391,22788,2000,Kenya,Malawi,0,0,FIFA World Cup qualification,Nairobi,Kenya,False,0,0,Draw
19767,21392,22789,2000,Morocco,Gambia,2,0,FIFA World Cup qualification,Casablanca,Morocco,False,2,2,Morocco
19768,21393,22790,2000,Namibia,Seychelles,3,0,FIFA World Cup qualification,Windhoek,Namibia,False,3,3,Namibia
19769,21394,22791,2000,Nigeria,Eritrea,4,0,FIFA World Cup qualification,Lagos,Nigeria,False,4,4,Nigeria
19770,21395,22792,2000,Sierra Leone,São Tomé and Príncipe,4,0,FIFA World Cup qualification,Freetown,Sierra Leone,False,4,4,Sierra Leone
19771,21396,22793,2000,South Africa,Lesotho,1,0,FIFA World Cup qualification,Bloemfontein,South Africa,False,1,1,South Africa
19772,21397,22794,2000,Saint Kitts and Nevis,Saint Vincent and the Grenadines,1,2,FIFA World Cup qualification,Basseterre,Saint Kitts and Nevis,False,3,-1,Saint Vincent and the Grenadines
19773,21398,22795,2000,Tunisia,Mauritania,3,0,FIFA World Cup qualification,Tunis,Tunisia,False,3,3,Tunisia
19774,21399,22796,2000,Zambia,Botswana,1,0,FIFA World Cup qualification,Lusaka,Zambia,False,1,1,Zambia
19775,21400,22797,2000,Angola,Eswatini,7,1,FIFA World Cup qualification,Luanda,Angola,False,8,6,Angola
19776,21401,22798,2000,Bermuda,Antigua and Barbuda,1,1,FIFA World Cup qualification,Hamilton,Bermuda,False,2,0,Draw
19777,21402,22799,2000,Burkina Faso,Ethiopia,3,0,FIFA World Cup qualification,Ouagadougou,Burkina Faso,False,3,3,Burkina Faso
19778,21403,22800,2000,Cameroon,Somalia,3,0,FIFA World Cup qualification,Yaoundé,Cameroon,False,3,3,Cameroon
19779,21404,22801,2000,Congo,Equatorial Guinea,2,1,FIFA World Cup qualification,Pointe-Noire,Congo,False,3,1,Congo
19780,21405,22802,2000,DR Congo,Djibouti,9,1,FIFA World Cup qualification,Kinshasa,DR Congo,False,10,8,DR Congo
19781,21406,22803,2000,Egypt,Mauritius,4,2,FIFA World Cup qualification,Alexandria,Egypt,False,6,2,Egypt
19782,21407,22804,2000,Ghana,Tanzania,3,2,FIFA World Cup qualification,Accra,Ghana,False,5,1,Ghana
19783,21408,22805,2000,Guinea,Uganda,3,0,FIFA World Cup qualification,Conakry,Guinea,False,3,3,Guinea
19784,21409,22806,2000,Ivory Coast,Rwanda,2,0,FIFA World Cup qualification,Abidjan,Ivory Coast,False,2,2,Ivory Coast
19785,21410,22807,2000,Liberia,Chad,0,0,FIFA World Cup qualification,Paynesville,Liberia,False,0,0,Draw
19786,21411,22808,2000,Mali,Libya,3,1,FIFA World Cup qualification,Bamako,Mali,False,4,2,Mali
19787,21412,22809,2000,Mozambique,Sudan,2,1,FIFA World Cup qualification,Maputo,Mozambique,False,3,1,Mozambique
19788,21413,22810,2000,Senegal,Benin,1,0,FIFA World Cup qualification,Dakar,Senegal,False,1,1,Senegal
19789,21414,22811,2000,Togo,Guinea-Bissau,3,0,FIFA World Cup qualification,Lomé,Togo,False,3,3,Togo
19790,21415,22812,2000,Zimbabwe,Central African Republic,3,1,FIFA World Cup qualification,Harare,Zimbabwe,False,4,2,Zimbabwe
19791,21417,22814,2000,Andorra,Belarus,2,0,Friendly,Sant Julià de Lòria,Andorra,False,2,2,Andorra
19792,21418,22815,2000,Armenia,Georgia,0,0,Friendly,Yerevan,Armenia,False,0,0,Draw
19793,21419,22816,2000,Austria,Croatia,1,2,Friendly,Vienna,Austria,False,3,-1,Croatia
19794,21420,22817,2000,Bolivia,Colombia,1,1,FIFA World Cup qualification,La Paz,Bolivia,False,2,0,Draw
19795,21421,22818,2000,Brazil,Ecuador,3,2,FIFA World Cup qualification,São Paulo,Brazil,False,5,1,Brazil
19796,21422,22819,2000,Bulgaria,Ukraine,0,1,Friendly,Sofia,Bulgaria,False,1,-1,Ukraine
19797,21423,22820,2000,Chile,Peru,1,1,FIFA World Cup qualification,Santiago,Chile,False,2,0,Draw
19798,21424,22821,2000,Czech Republic,Israel,4,1,Friendly,Prague,Czech Republic,False,5,3,Czech Republic
19799,21425,22822,2000,Denmark,Sweden,0,1,Friendly,Copenhagen,Denmark,False,1,-1,Sweden
19800,21426,22823,2000,France,Slovenia,3,2,Friendly,Saint-Denis,France,False,5,1,France
19801,21427,22824,2000,Germany,Switzerland,1,1,Friendly,Kaiserslautern,Germany,False,2,0,Draw
19802,21428,22825,2000,Republic of Ireland,Greece,0,1,Friendly,Dublin,Republic of Ireland,False,1,-1,Greece
19803,21429,22826,2000,Italy,Portugal,2,0,Friendly,Reggio di Calabria,Italy,False,2,2,Italy
19804,21430,22828,2000,Liechtenstein,Faroe Islands,0,1,Friendly,Vaduz,Liechtenstein,False,1,-1,Faroe Islands
19805,21431,22829,2000,Lithuania,Latvia,2,1,Baltic Cup,Kaunas,Lithuania,False,3,1,Lithuania
19806,21432,22830,2000,Luxembourg,Estonia,1,1,Friendly,Luxembourg,Luxembourg,False,2,0,Draw
19807,21433,22832,2000,Netherlands,Scotland,0,0,Friendly,Arnhem,Netherlands,False,0,0,Draw
19808,21434,22833,2000,Northern Ireland,Hungary,0,1,Friendly,Belfast,Northern Ireland,False,1,-1,Hungary
19809,21435,22834,2000,Norway,Belgium,0,2,Friendly,Oslo,Norway,False,2,-2,Belgium
19810,21436,22835,2000,Paraguay,Uruguay,1,0,FIFA World Cup qualification,Asunción,Paraguay,False,1,1,Paraguay
19811,21437,22836,2000,Poland,Finland,0,0,Friendly,Poznań,Poland,False,0,0,Draw
19812,21438,22837,2000,Romania,Cyprus,2,0,Friendly,Constanţa,Romania,False,2,2,Romania
19813,21439,22838,2000,Russia,United States,2,0,Friendly,Moscow,Russia,False,2,2,Russia
19814,21440,22839,2000,San Marino,Moldova,0,1,Friendly,Serravalle,San Marino,False,1,-1,Moldova
19815,21441,22840,2000,Venezuela,Argentina,0,4,FIFA World Cup qualification,Maracaibo,Venezuela,False,4,-4,Argentina
19816,21442,22841,2000,Antigua and Barbuda,Dominica,3,2,Friendly,Road Town,British Virgin Islands,True,5,1,Antigua and Barbuda
19817,21443,22843,2000,South Africa,Mauritius,3,0,COSAFA Cup,Rustenburg,South Africa,False,3,3,South Africa
19818,21444,22845,2000,Dominica,Sint Maarten,3,1,Friendly,Road Town,British Virgin Islands,True,4,2,Dominica
19819,21445,22846,2000,Jersey,Guernsey,1,0,Friendly,St. Helier,Jersey,False,1,1,Jersey
19820,21446,22847,2000,Maldives,Sri Lanka,1,1,Friendly,Malé,Maldives,False,2,0,Draw
19821,21447,22848,2000,Bangladesh,India,1,1,Friendly,Malé,Maldives,True,2,0,Draw
19822,21448,22850,2000,Maldives,Bangladesh,1,1,Friendly,Malé,Maldives,False,2,0,Draw
19823,21449,22851,2000,Guinea,Mali,3,1,Amílcar Cabral Cup,Praia,Cape Verde,True,4,2,Guinea
19824,21450,22852,2000,Guinea-Bissau,Mauritania,1,0,Amílcar Cabral Cup,Praia,Cape Verde,True,1,1,Guinea-Bissau
19825,21451,22853,2000,India,Sri Lanka,0,1,Friendly,Malé,Maldives,True,1,-1,Sri Lanka
19826,21452,22855,2000,Gambia,Senegal,1,1,Amílcar Cabral Cup,Praia,Cape Verde,True,2,0,Draw
19827,21453,22856,2000,Bangladesh,Sri Lanka,0,1,Friendly,Malé,Maldives,True,1,-1,Sri Lanka
19828,21454,22857,2000,Cuba,Barbados,1,1,FIFA World Cup qualification,Havana,Cuba,False,2,0,Draw
19829,21455,22858,2000,El Salvador,Guatemala,1,1,FIFA World Cup qualification,San Salvador,El Salvador,False,2,0,Draw
19830,21456,22859,2000,Guinea,Mauritania,1,1,Amílcar Cabral Cup,Praia,Cape Verde,True,2,0,Draw
19831,21457,22860,2000,Honduras,Panama,3,1,FIFA World Cup qualification,Tegucigalpa,Honduras,False,4,2,Honduras
19832,21458,22861,2000,Mali,Guinea-Bissau,3,2,Amílcar Cabral Cup,Praia,Cape Verde,True,5,1,Mali
19833,21459,22862,2000,Trinidad and Tobago,Haiti,3,1,FIFA World Cup qualification,Port of Spain,Trinidad and Tobago,False,4,2,Trinidad and Tobago
19834,21460,22864,2000,Gambia,Sierra Leone,2,2,Amílcar Cabral Cup,Praia,Cape Verde,True,4,0,Draw
19835,21461,22865,2000,Maldives,India,1,0,Friendly,Malé,Maldives,False,1,1,Maldives
19836,21462,22866,2000,Guinea,Guinea-Bissau,2,1,Amílcar Cabral Cup,Praia,Cape Verde,True,3,1,Guinea
19837,21463,22867,2000,Mali,Mauritania,2,2,Amílcar Cabral Cup,Praia,Cape Verde,True,4,0,Draw
19838,21464,22868,2000,Maldives,Sri Lanka,1,1,Friendly,Malé,Maldives,False,2,0,Draw
19839,21465,22870,2000,Senegal,Mali,2,2,Amílcar Cabral Cup,Praia,Cape Verde,True,4,0,Draw
19840,21466,22871,2000,Jordan,Lebanon,1,1,Friendly,Limassol,Cyprus,True,2,0,Draw
19841,21467,22873,2000,Guinea,Mali,2,0,Amílcar Cabral Cup,Praia,Cape Verde,True,2,2,Guinea
19842,21468,22874,2000,Jamaica,Panama,0,1,Friendly,Montego Bay,Jamaica,False,1,-1,Panama
19843,21469,22875,2000,Zimbabwe,Namibia,3,2,COSAFA Cup,Harare,Zimbabwe,False,5,1,Zimbabwe
19844,21470,22876,2000,Thailand,Uzbekistan,2,0,Friendly,Bangkok,Thailand,False,2,2,Thailand
19845,21471,22877,2000,Guatemala,Belize,0,0,FIFA World Cup qualification,San Pedro Sula,Honduras,True,0,0,Draw
19846,21472,22878,2000,Haiti,Trinidad and Tobago,1,1,FIFA World Cup qualification,Port-au-Prince,Haiti,False,2,0,Draw
19847,21473,22879,2000,Malawi,Angola,0,0,COSAFA Cup,Blantyre,Malawi,False,0,0,Draw
19848,21474,22880,2000,Barbados,Cuba,1,1,FIFA World Cup qualification,Bridgetown,Barbados,False,2,0,Draw
19849,21475,22881,2000,Lebanon,Saudi Arabia,0,0,Friendly,Zahlé,Lebanon,False,0,0,Draw
19850,21476,22882,2000,Panama,Nicaragua,4,0,FIFA World Cup qualification,Panama City,Panama,False,4,4,Panama
19851,21477,22883,2000,Jordan,Kyrgyzstan,2,0,WAFF Championship,Amman,Jordan,False,2,2,Jordan
19852,21478,22884,2000,Lebanon,Iraq,1,2,WAFF Championship,Amman,Jordan,True,3,-1,Iraq
19853,21479,22885,2000,Wales,Brazil,0,3,Friendly,Cardiff,Wales,False,3,-3,Brazil
19854,21480,22886,2000,Iran,Kazakhstan,3,0,WAFF Championship,Amman,Jordan,True,3,3,Iran
19855,21481,22887,2000,Slovakia,Saudi Arabia,1,1,Friendly,Nitra,Slovakia,False,2,0,Draw
19856,21482,22888,2000,Syria,Palestine,1,0,WAFF Championship,Amman,Jordan,True,1,1,Syria
19857,21483,22890,2000,Jordan,Iraq,0,0,WAFF Championship,Amman,Jordan,False,0,0,Draw
19858,21484,22891,2000,Kyrgyzstan,Lebanon,0,2,WAFF Championship,Amman,Jordan,True,2,-2,Lebanon
19859,21485,22892,2000,Algeria,Burkina Faso,2,0,Friendly,Algiers,Algeria,False,2,2,Algeria
19860,21486,22893,2000,Kazakhstan,Syria,0,4,WAFF Championship,Amman,Jordan,True,4,-4,Syria
19861,21487,22894,2000,Palestine,Iran,1,1,WAFF Championship,Amman,Jordan,True,2,0,Draw
19862,21488,22895,2000,Canada,Trinidad and Tobago,1,0,Friendly,Toronto,Canada,False,1,1,Canada
19863,21489,22896,2000,Cuba,Haiti,0,1,Friendly,Havana,Cuba,False,1,-1,Haiti
19864,21490,22897,2000,England,Brazil,1,1,Friendly,London,England,False,2,0,Draw
19865,21491,22898,2000,Iraq,Kyrgyzstan,4,0,WAFF Championship,Amman,Jordan,True,4,4,Iraq
19866,21492,22899,2000,Jamaica,Colombia,0,3,Friendly,East Rutherford,United States,True,3,-3,Colombia
19867,21493,22900,2000,Jordan,Lebanon,0,0,WAFF Championship,Amman,Jordan,False,0,0,Draw
19868,21494,22901,2000,Netherlands,Romania,2,1,Friendly,Amsterdam,Netherlands,False,3,1,Netherlands
19869,21495,22902,2000,Norway,Slovakia,2,0,Friendly,Oslo,Norway,False,2,2,Norway
19870,21496,22903,2000,Croatia,France,0,2,Friendly,Zagreb,Croatia,False,2,-2,France
19871,21497,22904,2000,Iran,Syria,1,0,WAFF Championship,Amman,Jordan,True,1,1,Iran
19872,21498,22905,2000,Kazakhstan,Palestine,3,2,WAFF Championship,Amman,Jordan,True,5,1,Kazakhstan
19873,21499,22907,2000,Macau,Hong Kong,0,1,Friendly,Macau,Macau,False,1,-1,Hong Kong
19874,21500,22908,2000,Malta,South Africa,0,1,Friendly,Attard,Malta,False,1,-1,South Africa
19875,21501,22909,2000,Cuba,Haiti,1,1,Friendly,Havana,Cuba,False,2,0,Draw
19876,21502,22910,2000,Canada,Honduras,2,1,Friendly,Winnipeg,Canada,False,3,1,Canada
19877,21503,22911,2000,Republic of Ireland,Scotland,1,2,Friendly,Dublin,Republic of Ireland,False,3,-1,Scotland
19878,21504,22913,2000,England,Ukraine,2,0,Friendly,London,England,False,2,2,England
19879,21505,22914,2000,Hungary,Saudi Arabia,2,2,Friendly,Győr,Hungary,False,4,0,Draw
19880,21506,22915,2000,Iraq,Syria,0,0,WAFF Championship,Amman,Jordan,True,0,0,Draw
19881,21507,22916,2000,Jordan,Iran,0,1,WAFF Championship,Amman,Jordan,False,1,-1,Iran
19882,21508,22917,2000,Russia,Slovakia,1,1,Friendly,Moscow,Russia,False,2,0,Draw
19883,21509,22918,2000,Venezuela,Panama,3,1,Friendly,San Cristóbal,Venezuela,False,4,2,Venezuela
19884,21510,22919,2000,Botswana,Mozambique,2,0,Friendly,Mbabane,Eswatini,True,2,2,Botswana
19885,21511,22920,2000,Eswatini,Lesotho,0,1,Friendly,Lobamba,Eswatini,False,1,-1,Lesotho
19886,21512,22921,2000,Iran,Syria,1,0,WAFF Championship,Amman,Jordan,True,1,1,Iran
19887,21513,22922,2000,Jordan,Iraq,1,4,WAFF Championship,Amman,Jordan,False,5,-3,Iraq
19888,21514,22923,2000,Lesotho,Mozambique,0,0,Friendly,Mbabane,Eswatini,True,0,0,Draw
19889,21515,22924,2000,Portugal,Wales,3,0,Friendly,Chaves,Portugal,False,3,3,Portugal
19890,21516,22925,2000,Singapore,Qatar,1,5,Friendly,Singapore,Singapore,False,6,-4,Qatar
19891,21517,22926,2000,Eswatini,Botswana,0,0,Friendly,Mbabane,Eswatini,False,0,0,Draw
19892,21518,22927,2000,Algeria,Guinea,4,0,Friendly,Annaba,Algeria,False,4,4,Algeria
19893,21519,22928,2000,Denmark,Belgium,2,2,Friendly,Copenhagen,Denmark,False,4,0,Draw
19894,21520,22929,2000,Germany,Czech Republic,3,2,Friendly,Nuremberg,Germany,False,5,1,Germany
19895,21521,22930,2000,Honduras,Haiti,4,0,FIFA World Cup qualification,San Pedro Sula,Honduras,False,4,4,Honduras
19896,21522,22931,2000,Hungary,Israel,2,1,Friendly,Budapest,Hungary,False,3,1,Hungary
19897,21523,22932,2000,Latvia,Finland,1,0,Friendly,Riga,Latvia,False,1,1,Latvia
19898,21524,22933,2000,Malta,England,1,2,Friendly,Attard,Malta,False,3,-1,England
19899,21525,22934,2000,Norway,Italy,1,0,Friendly,Oslo,Norway,False,1,1,Norway
19900,21526,22935,2000,Paraguay,Ecuador,3,1,FIFA World Cup qualification,Asunción,Paraguay,False,4,2,Paraguay
19901,21527,22936,2000,Romania,Greece,2,1,Friendly,Bucharest,Romania,False,3,1,Romania
19902,21528,22937,2000,Slovenia,Saudi Arabia,2,0,Friendly,Ljubljana,Slovenia,False,2,2,Slovenia
19903,21529,22938,2000,Sweden,Spain,1,1,Friendly,Gothenburg,Sweden,False,2,0,Draw
19904,21530,22939,2000,Uruguay,Chile,2,1,FIFA World Cup qualification,Montevideo,Uruguay,False,3,1,Uruguay
19905,21531,22940,2000,United States,South Africa,4,0,USA Cup,Washington,United States,False,4,4,United States
19906,21532,22941,2000,Argentina,Bolivia,1,0,FIFA World Cup qualification,Buenos Aires,Argentina,False,1,1,Argentina
19907,21533,22942,2000,Azerbaijan,Georgia,0,0,Friendly,Baku,Azerbaijan,False,0,0,Draw
19908,21534,22943,2000,Benin,Togo,1,2,Friendly,Cotonou,Benin,False,3,-1,Togo
19909,21535,22944,2000,Botswana,Lesotho,1,1,Friendly,Mbabane,Eswatini,True,2,0,Draw
19910,21536,22945,2000,Colombia,Venezuela,3,0,FIFA World Cup qualification,Bogotá,Colombia,False,3,3,Colombia
19911,21537,22946,2000,Cuba,Canada,0,1,FIFA World Cup qualification,Havana,Cuba,False,1,-1,Canada
19912,21538,22947,2000,Estonia,Belarus,2,0,Friendly,Tallinn,Estonia,False,2,2,Estonia
19913,21539,22948,2000,France,Japan,2,2,King Hassan II Tournament,Casablanca,Morocco,True,4,0,Draw
19914,21540,22949,2000,Mexico,Republic of Ireland,2,2,USA Cup,Chicago,United States,True,4,0,Draw
19915,21541,22950,2000,Moldova,Russia,0,1,Friendly,Chişinău,Moldova,False,1,-1,Russia
19916,21542,22951,2000,Morocco,Jamaica,1,0,King Hassan II Tournament,Casablanca,Morocco,False,1,1,Morocco
19917,21543,22952,2000,Netherlands,Poland,3,1,Friendly,Lausanne,Switzerland,True,4,2,Netherlands
19918,21544,22953,2000,Nigeria,Malawi,3,2,Friendly,Kano,Nigeria,False,5,1,Nigeria
19919,21545,22954,2000,Peru,Brazil,0,1,FIFA World Cup qualification,Lima,Peru,False,1,-1,Brazil
19920,21546,22955,2000,Senegal,Zambia,0,0,Friendly,Dakar,Senegal,False,0,0,Draw
19921,21547,22956,2000,Eswatini,Mozambique,1,1,Friendly,Mbabane,Eswatini,False,2,0,Draw
19922,21548,22957,2000,Jamaica,Japan,0,4,King Hassan II Tournament,Casablanca,Morocco,True,4,-4,Japan
19923,21549,22958,2000,Morocco,France,1,5,King Hassan II Tournament,Casablanca,Morocco,False,6,-4,France
19924,21550,22959,2000,Nigeria,Malawi,4,1,Friendly,Port Harcourt,Nigeria,False,5,3,Nigeria
19925,21551,22960,2000,Senegal,Zambia,0,0,Friendly,Dakar,Senegal,False,0,0,Draw
19926,21552,22961,2000,United States,Republic of Ireland,1,1,USA Cup,Foxborough,United States,False,2,0,Draw
19927,21553,22962,2000,Germany,Liechtenstein,8,2,Friendly,Freiburg,Germany,False,10,6,Germany
19928,21554,22963,2000,Iran,Egypt,1,1,Friendly,Teheran,Iran,False,2,0,Draw
19929,21555,22965,2000,Luxembourg,Spain,0,1,Friendly,Luxembourg,Luxembourg,False,1,-1,Spain
19930,21556,22966,2000,Mexico,South Africa,4,2,USA Cup,Dallas,United States,True,6,2,Mexico
19931,21557,22967,2000,Tonga,Cook Islands,1,2,Oceania Nations Cup qualification,Papeete,French Polynesia,True,3,-1,Cook Islands
19932,21558,22968,2000,Australia,Paraguay,0,0,Friendly,Sydney,Australia,False,0,0,Draw
19933,21561,22971,2000,Belgium,Sweden,2,1,UEFA Euro,Brussels,Belgium,False,3,1,Belgium
19934,21562,22972,2000,Saint Vincent and the Grenadines,Barbados,1,0,Friendly,Kingstown,Saint Vincent and the Grenadines,False,1,1,Saint Vincent and the Grenadines
19935,21563,22973,2000,Thailand,Qatar,2,3,Friendly,Bangkok,Thailand,False,5,-1,Qatar
19936,21564,22974,2000,Antigua and Barbuda,Guatemala,0,1,FIFA World Cup qualification,St. John's,Antigua and Barbuda,False,1,-1,Guatemala
19937,21565,22975,2000,Canada,Cuba,0,0,FIFA World Cup qualification,Winnipeg,Canada,False,0,0,Draw
19938,21566,22976,2000,Estonia,Georgia,1,0,Friendly,Tallinn,Estonia,False,1,1,Estonia
19939,21567,22977,2000,France,Denmark,3,0,UEFA Euro,Bruges,Belgium,True,3,3,France
19940,21568,22978,2000,Republic of Ireland,South Africa,2,1,USA Cup,East Rutherford,United States,True,3,1,Republic of Ireland
19941,21569,22979,2000,Japan,Slovakia,1,1,Kirin Cup,Rifu,Japan,False,2,0,Draw
19942,21570,22980,2000,Lesotho,Zambia,0,0,COSAFA Cup,Maseru,Lesotho,False,0,0,Draw
19943,21571,22981,2000,Netherlands,Czech Republic,1,0,UEFA Euro,Amsterdam,Netherlands,False,1,1,Netherlands
19944,21572,22982,2000,Tunisia,Senegal,4,1,Friendly,Tunis,Tunisia,False,5,3,Tunisia
19945,21573,22983,2000,Turkey,Italy,1,2,UEFA Euro,Arnhem,Netherlands,True,3,-1,Italy
19946,21574,22984,2000,United States,Mexico,3,0,USA Cup,East Rutherford,United States,False,3,3,United States
19947,21575,22985,2000,Australia,Paraguay,0,0,Friendly,Brisbane,Australia,False,0,0,Draw
19948,21576,22986,2000,Germany,Romania,1,1,UEFA Euro,Liège,Belgium,True,2,0,Draw
19949,21577,22987,2000,New Caledonia,Vanuatu,3,1,Friendly,Nouméa,New Caledonia,False,4,2,New Caledonia
19950,21578,22988,2000,Portugal,England,3,2,UEFA Euro,Eindhoven,Netherlands,True,5,1,Portugal
19951,21579,22989,2000,Serbia,Slovenia,3,3,UEFA Euro,Charleroi,Belgium,True,6,0,Draw
19952,21580,22990,2000,Spain,Norway,0,1,UEFA Euro,Rotterdam,Netherlands,True,1,-1,Norway
19953,21581,22991,2000,American Samoa,Tonga,1,2,Oceania Nations Cup qualification,Papeete,French Polynesia,True,3,-1,Tonga
19954,21582,22992,2000,Belgium,Italy,0,2,UEFA Euro,Brussels,Belgium,False,2,-2,Italy
19955,21583,22993,2000,Bolivia,Slovakia,0,2,Kirin Cup,Tosu,Japan,True,2,-2,Slovakia
19956,21584,22994,2000,Kenya,Burkina Faso,0,1,Friendly,Nairobi,Kenya,False,1,-1,Burkina Faso
19957,21585,22995,2000,Australia,Paraguay,2,1,Friendly,Melbourne,Australia,False,3,1,Australia
19958,21586,22996,2000,New Caledonia,Vanuatu,1,0,Friendly,Nouméa,New Caledonia,False,1,1,New Caledonia
19959,21587,22997,2000,Sweden,Turkey,0,0,UEFA Euro,Eindhoven,Netherlands,True,0,0,Draw
19960,21588,22998,2000,Algeria,Senegal,1,1,FIFA World Cup qualification,Annaba,Algeria,False,2,0,Draw
19961,21589,22999,2000,Czech Republic,France,1,2,UEFA Euro,Bruges,Belgium,True,3,-1,France
19962,21590,23000,2000,Netherlands,Denmark,3,0,UEFA Euro,Rotterdam,Netherlands,False,3,3,Netherlands
19963,21591,23001,2000,Egypt,Ghana,2,0,Friendly,Cairo,Egypt,False,2,2,Egypt
19964,21592,23002,2000,England,Germany,1,0,UEFA Euro,Charleroi,Belgium,True,1,1,England
19965,21593,23003,2000,Haiti,Honduras,1,3,FIFA World Cup qualification,Port-au-Prince,Haiti,False,4,-2,Honduras
19966,21594,23004,2000,Madagascar,DR Congo,3,0,FIFA World Cup qualification,Antananarivo,Madagascar,False,3,3,Madagascar
19967,21595,23005,2000,Malawi,Burkina Faso,1,1,FIFA World Cup qualification,Blantyre,Malawi,False,2,0,Draw
19968,21596,23006,2000,Namibia,Morocco,0,0,FIFA World Cup qualification,Windhoek,Namibia,False,0,0,Draw
19969,21597,23007,2000,Nigeria,Sierra Leone,2,0,FIFA World Cup qualification,Lagos,Nigeria,False,2,2,Nigeria
19970,21598,23008,2000,Romania,Portugal,0,1,UEFA Euro,Arnhem,Netherlands,True,1,-1,Portugal
19971,21599,23009,2000,Angola,Zambia,2,1,FIFA World Cup qualification,Luanda,Angola,False,3,1,Angola
19972,21600,23010,2000,Guatemala,Antigua and Barbuda,8,1,FIFA World Cup qualification,Guatemala,Guatemala,False,9,7,Guatemala
19973,21601,23011,2000,Guinea,Zimbabwe,3,0,FIFA World Cup qualification,Conakry,Guinea,False,3,3,Guinea
19974,21602,23012,2000,Ivory Coast,Tunisia,2,2,FIFA World Cup qualification,Abidjan,Ivory Coast,False,4,0,Draw
19975,21603,23013,2000,Japan,Bolivia,2,0,Kirin Cup,Yokohama,Japan,False,2,2,Japan
19976,21604,23014,2000,Libya,Cameroon,0,3,FIFA World Cup qualification,Tripoli,Libya,False,3,-3,Cameroon
19977,21605,23015,2000,Norway,Serbia,0,1,UEFA Euro,Liège,Belgium,True,1,-1,Serbia
19978,21606,23016,2000,Slovenia,Spain,1,2,UEFA Euro,Amsterdam,Netherlands,True,3,-1,Spain
19979,21607,23017,2000,South Africa,Eswatini,2,0,COSAFA Cup,Witbank,South Africa,False,2,2,South Africa
19980,21608,23018,2000,Sudan,Liberia,2,0,FIFA World Cup qualification,Omdurman,Sudan,False,2,2,Sudan
19981,21609,23019,2000,Australia,Cook Islands,17,0,Oceania Nations Cup,Papeete,French Polynesia,True,17,17,Australia
19982,21610,23020,2000,Belgium,Turkey,0,2,UEFA Euro,Brussels,Belgium,False,2,-2,Turkey
19983,21611,23021,2000,Italy,Sweden,2,1,UEFA Euro,Eindhoven,Netherlands,True,3,1,Italy
19984,21612,23023,2000,England,Romania,2,3,UEFA Euro,Charleroi,Belgium,True,5,-1,Romania
19985,21613,23024,2000,Madagascar,Mauritius,1,1,Friendly,Antananarivo,Madagascar,False,2,0,Draw
19986,21614,23025,2000,Portugal,Germany,3,0,UEFA Euro,Rotterdam,Netherlands,True,3,3,Portugal
19987,21615,23026,2000,Denmark,Czech Republic,0,2,UEFA Euro,Liège,Belgium,True,2,-2,Czech Republic
19988,21616,23027,2000,Netherlands,France,3,2,UEFA Euro,Amsterdam,Netherlands,False,5,1,Netherlands
19989,21617,23028,2000,New Zealand,Vanuatu,3,1,Oceania Nations Cup,Papeete,French Polynesia,True,4,2,New Zealand
19990,21618,23029,2000,Paraguay,Costa Rica,1,0,Friendly,Ciudad del Este,Paraguay,False,1,1,Paraguay
19991,21619,23030,2000,Serbia,Spain,3,4,UEFA Euro,Bruges,Belgium,True,7,-1,Spain
19992,21620,23031,2000,Slovenia,Norway,0,0,UEFA Euro,Arnhem,Netherlands,True,0,0,Draw
19993,21621,23032,2000,Solomon Islands,Cook Islands,5,1,Oceania Nations Cup,Papeete,French Polynesia,True,6,4,Solomon Islands
19994,21622,23033,2000,Gabon,Congo,0,2,Friendly,Libreville,Gabon,False,2,-2,Congo
19995,21623,23034,2000,Solomon Islands,Australia,0,6,Oceania Nations Cup,Papeete,French Polynesia,True,6,-6,Australia
19996,21624,23036,2000,Italy,Romania,2,0,UEFA Euro,Brussels,Belgium,True,2,2,Italy
19997,21625,23037,2000,Madagascar,Mauritius,1,0,Friendly,Antananarivo,Madagascar,False,1,1,Madagascar
19998,21626,23038,2000,Turkey,Portugal,0,2,UEFA Euro,Amsterdam,Netherlands,True,2,-2,Portugal
19999,21627,23039,2000,Uganda,Rwanda,2,1,Friendly,Kampala,Uganda,False,3,1,Uganda
20000,21628,23040,2000,Australia,Vanuatu,1,0,Oceania Nations Cup,Papeete,French Polynesia,True,1,1,Australia
20001,21629,23041,2000,Ecuador,Panama,5,0,Friendly,Quito,Ecuador,False,5,5,Ecuador
20002,21630,23042,2000,Gabon,Congo,2,3,Friendly,Libreville,Gabon,False,5,-1,Congo
20003,21631,23043,2000,Lebanon,Kuwait,3,1,Friendly,Tripoli,Lebanon,False,4,2,Lebanon
20004,21632,23044,2000,Netherlands,Serbia,6,1,UEFA Euro,Rotterdam,Netherlands,False,7,5,Netherlands
20005,21633,23045,2000,New Zealand,Solomon Islands,2,0,Oceania Nations Cup,Papeete,French Polynesia,True,2,2,New Zealand
20006,21634,23046,2000,Spain,France,1,2,UEFA Euro,Bruges,Belgium,True,3,-1,France
20007,21635,23047,2000,Australia,New Zealand,2,0,Oceania Nations Cup,Papeete,French Polynesia,True,2,2,Australia
20008,21636,23048,2000,Brazil,Uruguay,1,1,FIFA World Cup qualification,Rio de Janeiro,Brazil,False,2,0,Draw
20009,21637,23049,2000,France,Portugal,2,1,UEFA Euro,Brussels,Belgium,True,3,1,France
20010,21638,23050,2000,Tunisia,Algeria,2,2,Friendly,Tunis,Tunisia,False,4,0,Draw
20011,21639,23051,2000,Vanuatu,Solomon Islands,1,2,Oceania Nations Cup,Papeete,French Polynesia,True,3,-1,Solomon Islands
20012,21640,23052,2000,Venezuela,Bolivia,4,2,FIFA World Cup qualification,San Cristóbal,Venezuela,False,6,2,Venezuela
20013,21641,23053,2000,Barbados,Trinidad and Tobago,0,0,Friendly,Bridgetown,Barbados,False,0,0,Draw
20014,21642,23054,2000,Chile,Paraguay,3,1,FIFA World Cup qualification,Santiago,Chile,False,4,2,Chile
20015,21643,23055,2000,Colombia,Argentina,1,3,FIFA World Cup qualification,Bogotá,Colombia,False,4,-2,Argentina
20016,21644,23056,2000,Ecuador,Peru,2,1,FIFA World Cup qualification,Quito,Ecuador,False,3,1,Ecuador
20017,21645,23057,2000,Netherlands,Italy,0,0,UEFA Euro,Amsterdam,Netherlands,False,0,0,Draw
20018,21646,23058,2000,Djibouti,Burundi,1,3,African Cup of Nations qualification,Djibouti,Djibouti,False,4,-2,Burundi
20019,21647,23059,2000,Botswana,Madagascar,1,0,African Cup of Nations qualification,Gaborone,Botswana,False,1,1,Botswana
20020,21648,23060,2000,Costa Rica,Panama,5,1,Friendly,Alajuela,Costa Rica,False,6,4,Costa Rica
20021,21649,23061,2000,El Salvador,Mexico,0,3,Friendly,San Francisco,United States,True,3,-3,Mexico
20022,21650,23062,2000,Seychelles,Zimbabwe,0,1,African Cup of Nations qualification,Victoria,Seychelles,False,1,-1,Zimbabwe
20023,21651,23063,2000,Tanzania,Mauritius,0,1,African Cup of Nations qualification,Dar es Salaam,Tanzania,False,1,-1,Mauritius
20024,21652,23064,2000,Uganda,Malawi,3,1,African Cup of Nations qualification,Kampala,Uganda,False,4,2,Uganda
20025,21653,23065,2000,Benin,Namibia,2,0,African Cup of Nations qualification,Cotonou,Benin,False,2,2,Benin
20026,21654,23066,2000,Central African Republic,DR Congo,1,1,African Cup of Nations qualification,Bangui,Central African Republic,False,2,0,Draw
20027,21655,23067,2000,Equatorial Guinea,Angola,0,1,African Cup of Nations qualification,Malabo,Equatorial Guinea,False,1,-1,Angola
20028,21656,23068,2000,Ethiopia,Zambia,1,0,African Cup of Nations qualification,Addis Abeba,Ethiopia,False,1,1,Ethiopia
20029,21657,23069,2000,France,Italy,2,1,UEFA Euro,Rotterdam,Netherlands,True,3,1,France
20030,21658,23070,2000,Jamaica,Cuba,1,1,Friendly,Kingston,Jamaica,False,2,0,Draw
20031,21659,23071,2000,Lesotho,Mozambique,1,0,African Cup of Nations qualification,Maseru,Lesotho,False,1,1,Lesotho
20032,21660,23072,2000,Niger,Ivory Coast,0,1,African Cup of Nations qualification,Niamey,Niger,False,1,-1,Ivory Coast
20033,21661,23073,2000,Rwanda,Congo,2,1,African Cup of Nations qualification,Kigali,Rwanda,False,3,1,Rwanda
20034,21662,23074,2000,Saint Vincent and the Grenadines,Trinidad and Tobago,2,1,Friendly,Kingstown,Saint Vincent and the Grenadines,False,3,1,Saint Vincent and the Grenadines
20035,21663,23075,2000,Sudan,Eritrea,5,1,African Cup of Nations qualification,Khartoum,Sudan,False,6,4,Sudan
20036,21664,23076,2000,Eswatini,Kenya,3,2,African Cup of Nations qualification,Mbabane,Eswatini,False,5,1,Eswatini
20037,21665,23077,2000,Guatemala,Haiti,4,1,Friendly,Montréal,Canada,True,5,3,Guatemala
20038,21666,23078,2000,Rwanda,Uganda,2,0,Friendly,Kigali,Rwanda,False,2,2,Rwanda
20039,21667,23079,2000,Trinidad and Tobago,Cuba,4,1,Friendly,Macoya,Trinidad and Tobago,False,5,3,Trinidad and Tobago
20040,21668,23080,2000,Jamaica,Barbados,5,0,Friendly,Kingston,Jamaica,False,5,5,Jamaica
20041,21669,23081,2000,Mexico,Venezuela,2,1,Friendly,Monterrey,Mexico,False,3,1,Mexico
20042,21670,23083,2000,Malawi,Namibia,1,2,Friendly,Lilongwe,Malawi,False,3,-1,Namibia
20043,21671,23084,2000,El Salvador,Guatemala,0,1,Friendly,Los Angeles,United States,True,1,-1,Guatemala
20044,21672,23085,2000,Trinidad and Tobago,Jamaica,2,4,Friendly,Port of Spain,Trinidad and Tobago,False,6,-2,Jamaica
20045,21673,23086,2000,Tunisia,Madagascar,1,0,FIFA World Cup qualification,Tunis,Tunisia,False,1,1,Tunisia
20046,21674,23087,2000,Zambia,Togo,2,0,FIFA World Cup qualification,Lusaka,Zambia,False,2,2,Zambia
20047,21675,23088,2000,Burkina Faso,Guinea,2,3,FIFA World Cup qualification,Ouagadougou,Burkina Faso,False,5,-1,Guinea
20048,21676,23089,2000,Cameroon,Angola,3,0,FIFA World Cup qualification,Yaoundé,Cameroon,False,3,3,Cameroon
20049,21677,23090,2000,DR Congo,Congo,2,0,FIFA World Cup qualification,Kinshasa,DR Congo,False,2,2,DR Congo
20050,21678,23091,2000,Ghana,Sierra Leone,5,0,FIFA World Cup qualification,Accra,Ghana,False,5,5,Ghana
20051,21679,23092,2000,Liberia,Nigeria,2,1,FIFA World Cup qualification,Paynesville,Liberia,False,3,1,Liberia
20052,21680,23093,2000,Morocco,Algeria,2,1,FIFA World Cup qualification,Fès,Morocco,False,3,1,Morocco
20053,21681,23094,2000,Senegal,Egypt,0,0,FIFA World Cup qualification,Dakar,Senegal,False,0,0,Draw
20054,21682,23095,2000,Zimbabwe,South Africa,0,2,FIFA World Cup qualification,Harare,Zimbabwe,False,2,-2,South Africa
20055,21683,23096,2000,Libya,Chad,3,1,African Cup of Nations qualification,Tripoli,Libya,False,4,2,Libya
20056,21684,23097,2000,Burundi,Djibouti,1,0,African Cup of Nations qualification,Bujumbura,Burundi,False,1,1,Burundi
20057,21685,23098,2000,Eritrea,Sudan,2,1,African Cup of Nations qualification,Asmara,Eritrea,False,3,1,Eritrea
20058,21686,23099,2000,Gabon,São Tomé and Príncipe,4,1,African Cup of Nations qualification,Libreville,Gabon,False,5,3,Gabon
20059,21687,23100,2000,Kenya,Eswatini,3,0,African Cup of Nations qualification,Nairobi,Kenya,False,3,3,Kenya
20060,21688,23101,2000,Malawi,Uganda,1,2,African Cup of Nations qualification,Blantyre,Malawi,False,3,-1,Uganda
20061,21689,23102,2000,Namibia,Benin,8,2,African Cup of Nations qualification,Windhoek,Namibia,False,10,6,Namibia
20062,21690,23103,2000,Zambia,Ethiopia,2,0,African Cup of Nations qualification,Lusaka,Zambia,False,2,2,Zambia
20063,21691,23104,2000,Angola,Equatorial Guinea,4,1,African Cup of Nations qualification,Luanda,Angola,False,5,3,Angola
20064,21692,23105,2000,Barbados,Costa Rica,2,1,FIFA World Cup qualification,Bridgetown,Barbados,False,3,1,Barbados
20065,21693,23106,2000,Canada,Trinidad and Tobago,0,2,FIFA World Cup qualification,Edmonton,Canada,False,2,-2,Trinidad and Tobago
20066,21694,23107,2000,DR Congo,Central African Republic,2,0,African Cup of Nations qualification,Kinshasa,DR Congo,False,2,2,DR Congo
20067,21695,23108,2000,El Salvador,Honduras,2,5,FIFA World Cup qualification,San Salvador,El Salvador,False,7,-3,Honduras
20068,21696,23109,2000,Guatemala,United States,1,1,FIFA World Cup qualification,Mazatenango,Guatemala,False,2,0,Draw
20069,21697,23110,2000,Guinea,Gambia,2,0,African Cup of Nations qualification,Conakry,Guinea,False,2,2,Guinea
20070,21698,23111,2000,Ivory Coast,Niger,6,0,African Cup of Nations qualification,Abidjan,Ivory Coast,False,6,6,Ivory Coast
20071,21699,23112,2000,Mauritius,Tanzania,3,2,African Cup of Nations qualification,Curepipe,Mauritius,False,5,1,Mauritius
20072,21700,23113,2000,Mozambique,Lesotho,1,0,African Cup of Nations qualification,Maputo,Mozambique,False,1,1,Mozambique
20073,21701,23114,2000,Panama,Mexico,0,1,FIFA World Cup qualification,Panama City,Panama,False,1,-1,Mexico
20074,21702,23115,2000,Paraguay,Brazil,2,1,FIFA World Cup qualification,Asunción,Paraguay,False,3,1,Paraguay
20075,21703,23116,2000,Uruguay,Venezuela,3,1,FIFA World Cup qualification,Montevideo,Uruguay,False,4,2,Uruguay
20076,21704,23117,2000,Argentina,Ecuador,2,0,FIFA World Cup qualification,Buenos Aires,Argentina,False,2,2,Argentina
20077,21705,23118,2000,Bolivia,Chile,1,0,FIFA World Cup qualification,La Paz,Bolivia,False,1,1,Bolivia
20078,21706,23119,2000,Peru,Colombia,0,1,FIFA World Cup qualification,Lima,Peru,False,1,-1,Colombia
20079,21707,23120,2000,Guatemala,Barbados,2,0,FIFA World Cup qualification,Quetzaltenango,Guatemala,False,2,2,Guatemala
20080,21708,23121,2000,Costa Rica,United States,2,1,FIFA World Cup qualification,San José,Costa Rica,False,3,1,Costa Rica
20081,21709,23122,2000,Jamaica,Honduras,3,1,FIFA World Cup qualification,Kingston,Jamaica,False,4,2,Jamaica
20082,21710,23123,2000,Lesotho,Angola,2,1,COSAFA Cup,Maseru,Lesotho,False,3,1,Lesotho
20083,21711,23124,2000,Panama,Canada,0,0,FIFA World Cup qualification,Panama City,Panama,False,0,0,Draw
20084,21712,23125,2000,Trinidad and Tobago,Mexico,1,0,FIFA World Cup qualification,Port of Spain,Trinidad and Tobago,False,1,1,Trinidad and Tobago
20085,21713,23126,2000,Ecuador,Colombia,0,0,FIFA World Cup qualification,Quito,Ecuador,False,0,0,Draw
20086,21714,23127,2000,Venezuela,Chile,0,2,FIFA World Cup qualification,San Cristóbal,Venezuela,False,2,-2,Chile
20087,21715,23128,2000,Brazil,Argentina,3,1,FIFA World Cup qualification,São Paulo,Brazil,False,4,2,Brazil
20088,21716,23129,2000,Bulgaria,Azerbaijan,2,1,Friendly,Varna,Bulgaria,False,3,1,Bulgaria
20089,21717,23130,2000,Uruguay,Peru,0,0,FIFA World Cup qualification,Montevideo,Uruguay,False,0,0,Draw
20090,21719,23132,2000,Bolivia,Paraguay,0,0,FIFA World Cup qualification,La Paz,Bolivia,False,0,0,Draw
20091,21720,23133,2000,Iceland,Malta,5,0,Friendly,Reykjavík,Iceland,False,5,5,Iceland
20092,21721,23135,2000,Bangladesh,India,0,1,Friendly,Leicester,England,True,1,-1,India
20093,21722,23136,2000,South Africa,Zimbabwe,0,1,COSAFA Cup,Port Elizabeth,South Africa,False,1,-1,Zimbabwe
20094,21723,23137,2000,El Salvador,Haiti,1,2,Friendly,Foxborough,United States,True,3,-1,Haiti
20095,21724,23138,2000,Lebanon,Oman,3,1,Friendly,Zahlé,Lebanon,False,4,2,Lebanon
20096,21725,23139,2000,Guyana,Trinidad and Tobago,0,0,Friendly,Georgetown,Guyana,False,0,0,Draw
20097,21726,23140,2000,Malaysia,Burma,6,0,Friendly,Kuala Lumpur,Malaysia,False,6,6,Malaysia
20098,21727,23141,2000,Lebanon,Oman,1,2,Friendly,Zahlé,Lebanon,False,3,-1,Oman
20099,21728,23142,2000,Malaysia,Burma,1,2,Friendly,Ipoh,Malaysia,False,3,-1,Burma
20100,21729,23143,2000,Syria,Bahrain,1,0,Friendly,Latakia,Syria,False,1,1,Syria
20101,21730,23144,2000,Costa Rica,Venezuela,1,5,Friendly,Alajuela,Costa Rica,False,6,-4,Venezuela
20102,21731,23145,2000,Bahrain,Jordan,0,2,Friendly,Latakia,Syria,True,2,-2,Jordan
20103,21732,23146,2000,Panama,Ecuador,0,0,Friendly,Panama City,Panama,False,0,0,Draw
20104,21733,23147,2000,Lesotho,Zimbabwe,0,3,COSAFA Cup,Maseru,Lesotho,False,3,-3,Zimbabwe
20105,21734,23148,2000,Malaysia,New Zealand,0,0,Merdeka Tournament,Kuala Lumpur,Malaysia,False,0,0,Draw
20106,21735,23149,2000,Syria,Jordan,1,0,Friendly,Latakia,Syria,False,1,1,Syria
20107,21736,23150,2000,Albania,Cyprus,0,0,Friendly,Tirana,Albania,False,0,0,Draw
20108,21737,23151,2000,Chile,Brazil,3,0,FIFA World Cup qualification,Santiago,Chile,False,3,3,Chile
20109,21738,23152,2000,Colombia,Uruguay,1,0,FIFA World Cup qualification,Bogotá,Colombia,False,1,1,Colombia
20110,21739,23153,2000,Costa Rica,Guatemala,2,1,FIFA World Cup qualification,Alajuela,Costa Rica,False,3,1,Costa Rica
20111,21740,23154,2000,Malaysia,Oman,2,0,Merdeka Tournament,Kuala Lumpur,Malaysia,False,2,2,Malaysia
20112,21741,23155,2000,Mexico,Canada,2,0,FIFA World Cup qualification,Mexico City,Mexico,False,2,2,Mexico
20113,21742,23156,2000,Argentina,Paraguay,1,1,FIFA World Cup qualification,Buenos Aires,Argentina,False,2,0,Draw
20114,21743,23157,2000,Bosnia and Herzegovina,Turkey,2,0,Friendly,Sarajevo,Bosnia and Herzegovina,False,2,2,Bosnia and Herzegovina
20115,21744,23158,2000,Bulgaria,Belgium,1,3,Friendly,Sofia,Bulgaria,False,4,-2,Belgium
20116,21745,23159,2000,Czech Republic,Slovenia,0,1,Friendly,Ostrava,Czech Republic,False,1,-1,Slovenia
20117,21746,23160,2000,Ecuador,Bolivia,2,0,FIFA World Cup qualification,Quito,Ecuador,False,2,2,Ecuador
20118,21747,23161,2000,Estonia,Andorra,1,0,FIFA World Cup qualification,Tallinn,Estonia,False,1,1,Estonia
20119,21748,23162,2000,Faroe Islands,Denmark,0,2,Nordic Championship,Tórshavn,Faroe Islands,False,2,-2,Denmark
20120,21749,23163,2000,Finland,Norway,3,1,Nordic Championship,Helsinki,Finland,False,4,2,Finland
20121,21750,23164,2000,Germany,Spain,4,1,Friendly,Hanover,Germany,False,5,3,Germany
20122,21751,23165,2000,Hungary,Austria,1,1,Friendly,Budapest,Hungary,False,2,0,Draw
20123,21752,23166,2000,Iceland,Sweden,2,1,Nordic Championship,Reykjavík,Iceland,False,3,1,Iceland
20124,21753,23167,2000,Iran,Georgia,2,1,Friendly,Teheran,Iran,False,3,1,Iran
20125,21754,23168,2000,Jamaica,El Salvador,1,0,FIFA World Cup qualification,Kingston,Jamaica,False,1,1,Jamaica
20126,21755,23169,2000,Japan,United Arab Emirates,3,1,Friendly,Hiroshima,Japan,False,4,2,Japan
20127,21756,23170,2000,Latvia,Belarus,0,1,Friendly,Riga,Latvia,False,1,-1,Belarus
20128,21757,23171,2000,Moldova,Malta,1,0,Friendly,Chişinău,Moldova,False,1,1,Moldova
20129,21758,23172,2000,Northern Ireland,Serbia,1,2,Friendly,Belfast,Northern Ireland,False,3,-1,Serbia
20130,21759,23173,2000,Peru,Venezuela,1,0,FIFA World Cup qualification,Lima,Peru,False,1,1,Peru
20131,21760,23174,2000,Portugal,Lithuania,5,1,Friendly,Viseu,Portugal,False,6,4,Portugal
20132,21761,23175,2000,Romania,Poland,1,1,Friendly,Bucharest,Romania,False,2,0,Draw
20133,21762,23176,2000,Russia,Israel,1,0,Friendly,Moscow,Russia,False,1,1,Russia
20134,21763,23177,2000,Slovakia,Croatia,1,1,Friendly,Bratislava,Slovakia,False,2,0,Draw
20135,21764,23178,2000,Switzerland,Greece,2,2,Friendly,St. Gallen,Switzerland,False,4,0,Draw
20136,21765,23179,2000,Trinidad and Tobago,Panama,6,0,FIFA World Cup qualification,Port of Spain,Trinidad and Tobago,False,6,6,Trinidad and Tobago
20137,21766,23180,2000,United States,Barbados,7,0,FIFA World Cup qualification,Foxborough,United States,False,7,7,United States
20138,21767,23181,2000,New Zealand,Oman,1,0,Merdeka Tournament,Kuala Lumpur,Malaysia,True,1,1,New Zealand
20139,21768,23182,2000,Malaysia,New Zealand,0,2,Merdeka Tournament,Kuala Lumpur,Malaysia,False,2,-2,New Zealand
20140,21769,23183,2000,Haiti,Honduras,0,4,Friendly,New York,United States,True,4,-4,Honduras
20141,21770,23184,2000,Sierra Leone,Togo,2,0,African Cup of Nations qualification,Freetown,Sierra Leone,False,2,2,Sierra Leone
20142,21771,23185,2000,Egypt,Kenya,2,1,Friendly,Port Said,Egypt,False,3,1,Egypt
20143,21772,23186,2000,Vietnam,Sri Lanka,2,2,Friendly,Ho Chi Minh City,Vietnam,False,4,0,Draw
20144,21773,23187,2000,Cayman Islands,Jamaica,0,6,Friendly,George Town,Cayman Islands,False,6,-6,Jamaica
20145,21774,23188,2000,Zimbabwe,Lesotho,3,0,COSAFA Cup,Bulawayo,Zimbabwe,False,3,3,Zimbabwe
20146,21775,23189,2000,Indonesia,Burma,4,1,Friendly,Jakarta,Indonesia,False,5,3,Indonesia
20147,21777,23191,2000,Burma,Iraq,0,1,Friendly,Jakarta,Indonesia,True,1,-1,Iraq
20148,21779,23193,2000,Austria,Iran,5,1,Friendly,Vienna,Austria,False,6,4,Austria
20149,21780,23194,2000,Indonesia,Iraq,0,0,Friendly,Jakarta,Indonesia,False,0,0,Draw
20150,21781,23195,2000,Andorra,Cyprus,2,3,FIFA World Cup qualification,Sant Julià de Lòria,Andorra,False,5,-1,Cyprus
20151,21782,23196,2000,Azerbaijan,Sweden,0,1,FIFA World Cup qualification,Baku,Azerbaijan,False,1,-1,Sweden
20152,21783,23197,2000,Belarus,Wales,2,1,FIFA World Cup qualification,Minsk,Belarus,False,3,1,Belarus
20153,21784,23198,2000,Belgium,Croatia,0,0,FIFA World Cup qualification,Brussels,Belgium,False,0,0,Draw
20154,21785,23199,2000,Bosnia and Herzegovina,Spain,1,2,FIFA World Cup qualification,Sarajevo,Bosnia and Herzegovina,False,3,-1,Spain
20155,21786,23200,2000,Bulgaria,Czech Republic,0,1,FIFA World Cup qualification,Sofia,Bulgaria,False,1,-1,Czech Republic
20156,21787,23201,2000,Chile,Colombia,0,1,FIFA World Cup qualification,Santiago,Chile,False,1,-1,Colombia
20157,21788,23203,2000,Egypt,Ivory Coast,1,0,African Cup of Nations qualification,Alexandria,Egypt,False,1,1,Egypt
20158,21789,23204,2000,Finland,Albania,2,1,FIFA World Cup qualification,Helsinki,Finland,False,3,1,Finland
20159,21790,23205,2000,France,England,1,1,Friendly,Saint-Denis,France,False,2,0,Draw
20160,21791,23206,2000,Gabon,Morocco,2,0,African Cup of Nations qualification,Libreville,Gabon,False,2,2,Gabon
20161,21792,23207,2000,Germany,Greece,2,0,FIFA World Cup qualification,Hamburg,Germany,False,2,2,Germany
20162,21793,23208,2000,Honduras,El Salvador,5,0,FIFA World Cup qualification,San Pedro Sula,Honduras,False,5,5,Honduras
20163,21794,23209,2000,Iceland,Denmark,1,2,FIFA World Cup qualification,Reykjavík,Iceland,False,3,-1,Denmark
20164,21795,23210,2000,Iraq,Uzbekistan,2,0,Friendly,Shanghai,China PR,True,2,2,Iraq
20165,21796,23211,2000,Latvia,Scotland,0,1,FIFA World Cup qualification,Riga,Latvia,False,1,-1,Scotland
20166,21797,23212,2000,Netherlands,Republic of Ireland,2,2,FIFA World Cup qualification,Amsterdam,Netherlands,False,4,0,Draw
20167,21798,23213,2000,Nigeria,Namibia,4,0,African Cup of Nations qualification,Lagos,Nigeria,False,4,4,Nigeria
20168,21799,23214,2000,Northern Ireland,Malta,1,0,FIFA World Cup qualification,Belfast,Northern Ireland,False,1,1,Northern Ireland
20169,21800,23215,2000,Norway,Armenia,0,0,FIFA World Cup qualification,Oslo,Norway,False,0,0,Draw
20170,21801,23216,2000,Paraguay,Venezuela,3,0,FIFA World Cup qualification,Asunción,Paraguay,False,3,3,Paraguay
20171,21802,23217,2000,Switzerland,Russia,0,1,FIFA World Cup qualification,Zürich,Switzerland,False,1,-1,Russia
20172,21803,23218,2000,Turkey,Moldova,2,0,FIFA World Cup qualification,Istanbul,Turkey,False,2,2,Turkey
20173,21804,23219,2000,Uganda,Guinea,3,1,African Cup of Nations qualification,Kampala,Uganda,False,4,2,Uganda
20174,21805,23220,2000,Ukraine,Poland,1,3,FIFA World Cup qualification,Kyïv,Ukraine,False,4,-2,Poland
20175,21806,23221,2000,Zambia,Madagascar,1,2,African Cup of Nations qualification,Lusaka,Zambia,False,3,-1,Madagascar
20176,21807,23222,2000,Algeria,Burkina Faso,1,1,African Cup of Nations qualification,Algiers,Algeria,False,2,0,Draw
20177,21808,23223,2000,Brazil,Bolivia,5,0,FIFA World Cup qualification,Rio de Janeiro,Brazil,False,5,5,Brazil
20178,21809,23224,2000,Burundi,Angola,0,0,African Cup of Nations qualification,Bujumbura,Burundi,False,0,0,Draw
20179,21810,23226,2000,Congo,South Africa,1,2,African Cup of Nations qualification,Pointe-Noire,Congo,False,3,-1,South Africa
20180,21811,23227,2000,Costa Rica,Barbados,3,0,FIFA World Cup qualification,San José,Costa Rica,False,3,3,Costa Rica
20181,21812,23228,2000,Estonia,Portugal,1,3,FIFA World Cup qualification,Tallinn,Estonia,False,4,-2,Portugal
20182,21813,23229,2000,Faroe Islands,Slovenia,2,2,FIFA World Cup qualification,Toftir,Faroe Islands,False,4,0,Draw
20183,21814,23230,2000,Hungary,Italy,2,2,FIFA World Cup qualification,Budapest,Hungary,False,4,0,Draw
20184,21815,23231,2000,Indonesia,Iraq,3,0,Friendly,Jakarta,Indonesia,False,3,3,Indonesia
20185,21816,23232,2000,Israel,Liechtenstein,2,0,FIFA World Cup qualification,Ramat-Gan,Israel,False,2,2,Israel
20186,21817,23233,2000,Kenya,Tunisia,0,0,African Cup of Nations qualification,Nairobi,Kenya,False,0,0,Draw
20187,21818,23234,2000,Lesotho,Ghana,3,3,African Cup of Nations qualification,Maseru,Lesotho,False,6,0,Draw
20188,21819,23235,2000,Liberia,Mauritius,4,0,African Cup of Nations qualification,Monrovia,Liberia,False,4,4,Liberia
20189,21820,23236,2000,Luxembourg,Serbia,0,2,FIFA World Cup qualification,Luxembourg,Luxembourg,False,2,-2,Serbia
20190,21821,23237,2000,Mexico,Panama,7,1,FIFA World Cup qualification,Mexico City,Mexico,False,8,6,Mexico
20191,21822,23238,2000,Peru,Argentina,1,2,FIFA World Cup qualification,Lima,Peru,False,3,-1,Argentina
20192,21823,23239,2000,Romania,Lithuania,1,0,FIFA World Cup qualification,Bucharest,Romania,False,1,1,Romania
20193,21825,23241,2000,Thailand,Uzbekistan,4,2,Friendly,Shanghai,China PR,True,6,2,Thailand
20194,21826,23242,2000,Togo,Sierra Leone,2,0,African Cup of Nations qualification,Lomé,Togo,False,2,2,Togo
20195,21827,23243,2000,Trinidad and Tobago,Canada,4,0,FIFA World Cup qualification,Port of Spain,Trinidad and Tobago,False,4,4,Trinidad and Tobago
20196,21828,23244,2000,Uruguay,Ecuador,4,0,FIFA World Cup qualification,Montevideo,Uruguay,False,4,4,Uruguay
20197,21829,23245,2000,United States,Guatemala,1,0,FIFA World Cup qualification,Washington,United States,False,1,1,United States
20198,21830,23246,2000,Zimbabwe,DR Congo,3,2,African Cup of Nations qualification,Harare,Zimbabwe,False,5,1,Zimbabwe
20199,21831,23247,2000,Lebanon,United Arab Emirates,0,1,Friendly,Beirut,Lebanon,False,1,-1,United Arab Emirates
20200,21832,23248,2000,Lebanon,United Arab Emirates,2,2,Friendly,Beirut,Lebanon,False,4,0,Draw
20201,21833,23249,2000,Libya,Sudan,1,0,African Cup of Nations qualification,Tripoli,Libya,False,1,1,Libya
20202,21834,23250,2000,Mexico,Ecuador,2,0,Friendly,San Diego,United States,True,2,2,Mexico
20203,21835,23251,2000,Qatar,Kuwait,0,0,Friendly,Doha,Qatar,False,0,0,Draw
20204,21836,23252,2000,Saudi Arabia,Syria,2,1,Friendly,Abha,Saudi Arabia,False,3,1,Saudi Arabia
20205,21837,23253,2000,Senegal,Togo,0,0,African Cup of Nations qualification,Dakar,Senegal,False,0,0,Draw
20206,21838,23255,2000,Saudi Arabia,Syria,3,0,Friendly,Abha,Saudi Arabia,False,3,3,Saudi Arabia
20207,21839,23256,2000,Cayman Islands,Turks and Caicos Islands,3,0,Friendly,George Town,Cayman Islands,False,3,3,Cayman Islands
20208,21840,23257,2000,Mexico,Bolivia,1,0,Friendly,San Diego,United States,True,1,1,Mexico
20209,21841,23258,2000,Qatar,Iran,1,2,Friendly,Doha,Qatar,False,3,-1,Iran
20210,21842,23259,2000,Saudi Arabia,United Arab Emirates,6,1,Friendly,Abha,Saudi Arabia,False,7,5,Saudi Arabia
20211,21843,23260,2000,Kenya,Burundi,1,0,Friendly,Nairobi,Kenya,False,1,1,Kenya
20212,21844,23261,2000,Kuwait,Thailand,3,2,Friendly,Kuwait City,Kuwait,False,5,1,Kuwait
20213,21845,23262,2000,Kenya,Lesotho,1,1,Friendly,Nairobi,Kenya,False,2,0,Draw
20214,21846,23263,2000,Jordan,Saudi Arabia,1,0,Friendly,Amman,Jordan,False,1,1,Jordan
20215,21847,23264,2000,Qatar,Egypt,0,1,Friendly,Doha,Qatar,False,1,-1,Egypt
20216,21848,23265,2000,Kenya,Burundi,2,3,Friendly,Nairobi,Kenya,False,5,-1,Burundi
20217,21849,23266,2000,Australia,Kuwait,1,0,United Arab Emirates Friendship Tournament,Dubai,United Arab Emirates,True,1,1,Australia
20218,21850,23267,2000,France,Cameroon,1,1,Friendly,Saint-Denis,France,False,2,0,Draw
20219,21852,23271,2000,Qatar,Thailand,1,1,Friendly,Doha,Qatar,False,2,0,Draw
20220,21853,23272,2000,Andorra,Estonia,1,2,FIFA World Cup qualification,Sant Julià de Lòria,Andorra,False,3,-1,Estonia
20221,21854,23273,2000,Armenia,Ukraine,2,3,FIFA World Cup qualification,Yerevan,Armenia,False,5,-1,Ukraine
20222,21856,23275,2000,Bulgaria,Malta,3,0,FIFA World Cup qualification,Sofia,Bulgaria,False,3,3,Bulgaria
20223,21857,23276,2000,Burkina Faso,Burundi,1,0,African Cup of Nations qualification,Ouagadougou,Burkina Faso,False,1,1,Burkina Faso
20224,21858,23277,2000,Colombia,Paraguay,0,2,FIFA World Cup qualification,Bogotá,Colombia,False,2,-2,Paraguay
20225,21859,23278,2000,Cyprus,Netherlands,0,4,FIFA World Cup qualification,Nicosia,Cyprus,False,4,-4,Netherlands
20226,21860,23279,2000,Czech Republic,Iceland,4,0,FIFA World Cup qualification,Teplice,Czech Republic,False,4,4,Czech Republic
20227,21861,23280,2000,England,Germany,0,1,FIFA World Cup qualification,London,England,False,1,-1,Germany
20228,21862,23281,2000,Greece,Finland,1,0,FIFA World Cup qualification,Athens,Greece,False,1,1,Greece
20229,21863,23282,2000,Italy,Romania,3,0,FIFA World Cup qualification,Milan,Italy,False,3,3,Italy
20230,21865,23284,2000,Latvia,Belgium,0,4,FIFA World Cup qualification,Riga,Latvia,False,4,-4,Belgium
20231,21866,23285,2000,Liechtenstein,Austria,0,1,FIFA World Cup qualification,Vaduz,Liechtenstein,False,1,-1,Austria
20232,21867,23286,2000,Lithuania,Georgia,0,4,FIFA World Cup qualification,Kaunas,Lithuania,False,4,-4,Georgia
20233,21868,23287,2000,Luxembourg,Slovenia,1,2,FIFA World Cup qualification,Luxembourg,Luxembourg,False,3,-1,Slovenia
20234,21869,23288,2000,Madagascar,Nigeria,0,0,African Cup of Nations qualification,Antananarivo,Madagascar,False,0,0,Draw
20235,21870,23289,2000,Moldova,Slovakia,0,1,FIFA World Cup qualification,Chişinău,Moldova,False,1,-1,Slovakia
20236,21871,23290,2000,Northern Ireland,Denmark,1,1,FIFA World Cup qualification,Belfast,Northern Ireland,False,2,0,Draw
20237,21872,23291,2000,Poland,Belarus,3,1,FIFA World Cup qualification,Łódź,Poland,False,4,2,Poland
20238,21873,23292,2000,Portugal,Republic of Ireland,1,1,FIFA World Cup qualification,Lisbon,Portugal,False,2,0,Draw
20239,21874,23293,2000,San Marino,Scotland,0,2,FIFA World Cup qualification,Serravalle,San Marino,False,2,-2,Scotland
20240,21875,23294,2000,Saudi Arabia,Kazakhstan,1,0,Friendly,Amman,Jordan,True,1,1,Saudi Arabia
20241,21876,23295,2000,South Africa,France,0,0,Friendly,Johannesburg,South Africa,False,0,0,Draw
20242,21877,23296,2000,Spain,Israel,2,0,FIFA World Cup qualification,Madrid,Spain,False,2,2,Spain
20243,21878,23297,2000,Sweden,Turkey,1,1,FIFA World Cup qualification,Gothenburg,Sweden,False,2,0,Draw
20244,21879,23298,2000,Switzerland,Faroe Islands,5,1,FIFA World Cup qualification,Zürich,Switzerland,False,6,4,Switzerland
20245,21880,23299,2000,Tunisia,Gabon,4,2,African Cup of Nations qualification,Tunis,Tunisia,False,6,2,Tunisia
20246,21881,23300,2000,United Arab Emirates,Kuwait,1,0,United Arab Emirates Friendship Tournament,Dubai,United Arab Emirates,False,1,1,United Arab Emirates
20247,21882,23301,2000,Wales,Norway,1,1,FIFA World Cup qualification,Cardiff,Wales,False,2,0,Draw
20248,21883,23302,2000,Angola,Algeria,2,2,African Cup of Nations qualification,Luanda,Angola,False,4,0,Draw
20249,21884,23303,2000,Argentina,Uruguay,2,1,FIFA World Cup qualification,Buenos Aires,Argentina,False,3,1,Argentina
20250,21885,23304,2000,Barbados,Guatemala,1,3,FIFA World Cup qualification,Bridgetown,Barbados,False,4,-2,Guatemala
20251,21886,23305,2000,Bolivia,Peru,1,0,FIFA World Cup qualification,La Paz,Bolivia,False,1,1,Bolivia
20252,21887,23306,2000,Ecuador,Chile,1,0,FIFA World Cup qualification,Quito,Ecuador,False,1,1,Ecuador
20253,21888,23307,2000,Guinea,Senegal,1,0,African Cup of Nations qualification,Conakry,Guinea,False,1,1,Guinea
20254,21889,23308,2000,Honduras,Jamaica,1,0,FIFA World Cup qualification,Tegucigalpa,Honduras,False,1,1,Honduras
20255,21890,23309,2000,Hong Kong,Singapore,1,0,Friendly,Victoria,Hong Kong,False,1,1,Hong Kong
20256,21891,23310,2000,Mauritius,Congo,1,2,African Cup of Nations qualification,Curepipe,Mauritius,False,3,-1,Congo
20257,21892,23311,2000,Mexico,Trinidad and Tobago,7,0,FIFA World Cup qualification,Mexico City,Mexico,False,7,7,Mexico
20258,21893,23312,2000,Morocco,Kenya,1,0,African Cup of Nations qualification,Casablanca,Morocco,False,1,1,Morocco
20259,21894,23313,2000,Qatar,Thailand,3,1,Friendly,Doha,Qatar,False,4,2,Qatar
20260,21895,23314,2000,Sudan,Egypt,0,1,African Cup of Nations qualification,Khartoum,Sudan,False,1,-1,Egypt
20261,21896,23315,2000,Togo,Uganda,3,0,African Cup of Nations qualification,Lomé,Togo,False,3,3,Togo
20262,21897,23316,2000,Uzbekistan,Turkmenistan,3,0,Friendly,Tashkent,Uzbekistan,False,3,3,Uzbekistan
20263,21898,23317,2000,Venezuela,Brazil,0,6,FIFA World Cup qualification,Maracaibo,Venezuela,False,6,-6,Brazil
20264,21899,23318,2000,Canada,Panama,1,0,FIFA World Cup qualification,Winnipeg,Canada,False,1,1,Canada
20265,21900,23319,2000,DR Congo,Lesotho,1,1,African Cup of Nations qualification,Kinshasa,DR Congo,False,2,0,Draw
20266,21901,23320,2000,Albania,Greece,2,0,FIFA World Cup qualification,Tirana,Albania,False,2,2,Albania
20267,21902,23321,2000,Austria,Spain,1,1,FIFA World Cup qualification,Vienna,Austria,False,2,0,Draw
20268,21903,23322,2000,Azerbaijan,Turkey,0,1,FIFA World Cup qualification,Baku,Azerbaijan,False,1,-1,Turkey
20269,21904,23323,2000,Belarus,Armenia,2,1,FIFA World Cup qualification,Minsk,Belarus,False,3,1,Belarus
20270,21905,23324,2000,Croatia,Scotland,1,1,FIFA World Cup qualification,Zagreb,Croatia,False,2,0,Draw
20271,21906,23325,2000,Denmark,Bulgaria,1,1,FIFA World Cup qualification,Copenhagen,Denmark,False,2,0,Draw
20272,21907,23326,2000,Finland,England,0,0,FIFA World Cup qualification,Helsinki,Finland,False,0,0,Draw
20273,21908,23327,2000,Iceland,Northern Ireland,1,0,FIFA World Cup qualification,Reykjavík,Iceland,False,1,1,Iceland
20274,21909,23328,2000,Republic of Ireland,Estonia,2,0,FIFA World Cup qualification,Dublin,Republic of Ireland,False,2,2,Republic of Ireland
20275,21910,23329,2000,Israel,Bosnia and Herzegovina,3,1,FIFA World Cup qualification,Ramat-Gan,Israel,False,4,2,Israel
20276,21911,23330,2000,Italy,Georgia,2,0,FIFA World Cup qualification,Ancona,Italy,False,2,2,Italy
20277,21912,23331,2000,Lithuania,Hungary,1,6,FIFA World Cup qualification,Kaunas,Lithuania,False,7,-5,Hungary
20278,21913,23332,2000,Malta,Czech Republic,0,0,FIFA World Cup qualification,Attard,Malta,False,0,0,Draw
20279,21915,23334,2000,Netherlands,Portugal,0,2,FIFA World Cup qualification,Rotterdam,Netherlands,False,2,-2,Portugal
20280,21916,23335,2000,Norway,Ukraine,0,1,FIFA World Cup qualification,Oslo,Norway,False,1,-1,Ukraine
20281,21917,23336,2000,Poland,Wales,0,0,FIFA World Cup qualification,Warsaw,Poland,False,0,0,Draw
20282,21918,23337,2000,Russia,Luxembourg,3,0,FIFA World Cup qualification,Moscow,Russia,False,3,3,Russia
20283,21919,23338,2000,Slovakia,Sweden,0,0,FIFA World Cup qualification,Bratislava,Slovakia,False,0,0,Draw
20284,21920,23339,2000,Slovenia,Switzerland,2,2,FIFA World Cup qualification,Ljubljana,Slovenia,False,4,0,Draw
20285,21921,23340,2000,United States,Costa Rica,0,0,FIFA World Cup qualification,Columbus,United States,False,0,0,Draw
20286,21922,23341,2000,Iraq,Thailand,2,0,AFC Asian Cup,Tripoli,Lebanon,True,2,2,Iraq
20287,21923,23342,2000,Lebanon,Iran,0,4,AFC Asian Cup,Beirut,Lebanon,False,4,-4,Iran
20288,21924,23344,2000,Kuwait,Indonesia,0,0,AFC Asian Cup,Tripoli,Lebanon,True,0,0,Draw
20289,21925,23345,2000,Malaysia,Cambodia,2,0,Friendly,Kuala Lumpur,Malaysia,False,2,2,Malaysia
20290,21926,23346,2000,Qatar,Uzbekistan,1,1,AFC Asian Cup,Sidon,Lebanon,True,2,0,Draw
20291,21927,23347,2000,Saudi Arabia,Japan,1,4,AFC Asian Cup,Sidon,Lebanon,True,5,-3,Japan
20292,21928,23348,2000,Iran,Thailand,1,1,AFC Asian Cup,Beirut,Lebanon,True,2,0,Draw
20293,21929,23349,2000,Kenya,Tanzania,3,0,Friendly,Nairobi,Kenya,False,3,3,Kenya
20294,21930,23350,2000,Lebanon,Iraq,2,2,AFC Asian Cup,Beirut,Lebanon,False,4,0,Draw
20295,21931,23353,2000,Japan,Uzbekistan,8,1,AFC Asian Cup,Sidon,Lebanon,True,9,7,Japan
20296,21932,23354,2000,Malaysia,Cambodia,1,1,Friendly,Kuala Lumpur,Malaysia,False,2,0,Draw
20297,21933,23355,2000,Saudi Arabia,Qatar,0,0,AFC Asian Cup,Sidon,Lebanon,True,0,0,Draw
20298,21934,23356,2000,Iran,Iraq,1,0,AFC Asian Cup,Sidon,Lebanon,True,1,1,Iran
20299,21935,23357,2000,Lebanon,Thailand,1,1,AFC Asian Cup,Beirut,Lebanon,False,2,0,Draw
20300,21936,23360,2000,Japan,Qatar,1,1,AFC Asian Cup,Beirut,Lebanon,True,2,0,Draw
20301,21937,23361,2000,Saudi Arabia,Uzbekistan,5,0,AFC Asian Cup,Sidon,Lebanon,True,5,5,Saudi Arabia
20302,21939,23364,2000,Malaysia,Sri Lanka,2,0,Friendly,Kuala Lumpur,Malaysia,False,2,2,Malaysia
20303,21940,23365,2000,Japan,Iraq,4,1,AFC Asian Cup,Beirut,Lebanon,True,5,3,Japan
20304,21941,23366,2000,Kuwait,Saudi Arabia,2,3,AFC Asian Cup,Beirut,Lebanon,True,5,-1,Saudi Arabia
20305,21942,23367,2000,Ghana,Uganda,1,2,Friendly,Nairobi,Kenya,True,3,-1,Uganda
20306,21943,23368,2000,Malaysia,Sri Lanka,3,1,Friendly,Kuala Lumpur,Malaysia,False,4,2,Malaysia
20307,21944,23369,2000,United States,Mexico,2,0,Friendly,Los Angeles,United States,False,2,2,United States
20308,21945,23372,2000,Eritrea,Rwanda,0,1,Friendly,Lusaka,Zambia,True,1,-1,Rwanda
20309,21946,23373,2000,Kenya,Uganda,1,1,Friendly,Nairobi,Kenya,False,2,0,Draw
20310,21947,23374,2000,Singapore,Sri Lanka,4,0,Friendly,Singapore,Singapore,False,4,4,Singapore
20311,21948,23376,2000,Japan,Saudi Arabia,1,0,AFC Asian Cup,Beirut,Lebanon,True,1,1,Japan
20312,21949,23377,2000,Oman,Yemen,4,0,Friendly,Muscat,Oman,False,4,4,Oman
20313,21950,23378,2000,Zambia,Rwanda,0,2,Friendly,Lusaka,Zambia,False,2,-2,Rwanda
20314,21951,23379,2000,Rwanda,Zimbabwe,1,0,Friendly,Lusaka,Zambia,True,1,1,Rwanda
20315,21952,23380,2000,Oman,Yemen,4,0,Friendly,Muscat,Oman,False,4,4,Oman
20316,21953,23381,2000,Singapore,Indonesia,1,0,Friendly,Singapore,Singapore,False,1,1,Singapore
20317,21954,23382,2000,Singapore,Cambodia,1,0,AFF Championship,Songkhla,Thailand,True,1,1,Singapore
20318,21955,23383,2000,Vietnam,Malaysia,0,0,AFF Championship,Songkhla,Thailand,True,0,0,Draw
20319,21956,23384,2000,Indonesia,Philippines,3,0,AFF Championship,Chiang Mai,Thailand,True,3,3,Indonesia
20320,21957,23385,2000,Thailand,Burma,3,1,AFF Championship,Chiang Mai,Thailand,False,4,2,Thailand
20321,21958,23386,2000,Cambodia,Vietnam,0,6,AFF Championship,Songkhla,Thailand,True,6,-6,Vietnam
20322,21959,23387,2000,Laos,Malaysia,0,5,AFF Championship,Songkhla,Thailand,True,5,-5,Malaysia
20323,21960,23388,2000,Burma,Philippines,3,0,AFF Championship,Chiang Mai,Thailand,True,3,3,Burma
20324,21961,23389,2000,Malaysia,Cambodia,3,2,AFF Championship,Songkhla,Thailand,True,5,1,Malaysia
20325,21962,23390,2000,Singapore,Laos,3,0,AFF Championship,Songkhla,Thailand,True,3,3,Singapore
20326,21963,23391,2000,Thailand,Indonesia,4,1,AFF Championship,Chiang Mai,Thailand,False,5,3,Thailand
20327,21964,23392,2000,Cambodia,Laos,3,0,AFF Championship,Songkhla,Thailand,True,3,3,Cambodia
20328,21965,23393,2000,Vietnam,Singapore,1,0,AFF Championship,Songkhla,Thailand,True,1,1,Vietnam
20329,21966,23394,2000,Burma,Indonesia,0,5,AFF Championship,Chiang Mai,Thailand,True,5,-5,Indonesia
20330,21967,23395,2000,Thailand,Philippines,2,0,AFF Championship,Chiang Mai,Thailand,False,2,2,Thailand
20331,21968,23396,2000,United Arab Emirates,Hong Kong,1,1,Friendly,Abu Dhabi,United Arab Emirates,False,2,0,Draw
20332,21969,23397,2000,Laos,Vietnam,0,5,AFF Championship,Songkhla,Thailand,True,5,-5,Vietnam
20333,21970,23398,2000,Malaysia,Singapore,1,0,AFF Championship,Songkhla,Thailand,True,1,1,Malaysia
20334,21971,23399,2000,Algeria,Bulgaria,1,2,Friendly,Algiers,Algeria,False,3,-1,Bulgaria
20335,21972,23400,2000,Albania,Malta,3,0,Friendly,Tirana,Albania,False,3,3,Albania
20336,21973,23401,2000,Barbados,United States,0,4,FIFA World Cup qualification,Bridgetown,Barbados,False,4,-4,United States
20337,21974,23402,2000,Bolivia,Uruguay,0,0,FIFA World Cup qualification,La Paz,Bolivia,False,0,0,Draw
20338,21975,23403,2000,Brazil,Colombia,1,0,FIFA World Cup qualification,São Paulo,Brazil,False,1,1,Brazil
20339,21976,23404,2000,Canada,Mexico,0,0,FIFA World Cup qualification,Toronto,Canada,False,0,0,Draw
20340,21977,23405,2000,Chile,Argentina,0,2,FIFA World Cup qualification,Santiago,Chile,False,2,-2,Argentina
20341,21978,23406,2000,Cyprus,Andorra,5,0,FIFA World Cup qualification,Limassol,Cyprus,False,5,5,Cyprus
20342,21979,23407,2000,Denmark,Germany,2,1,Friendly,Copenhagen,Denmark,False,3,1,Denmark
20343,21980,23408,2000,El Salvador,Jamaica,2,0,FIFA World Cup qualification,San Salvador,El Salvador,False,2,2,El Salvador
20344,21981,23409,2000,Estonia,Kyrgyzstan,1,0,Friendly,Kuressaare,Estonia,False,1,1,Estonia
20345,21982,23410,2000,Greece,Slovakia,0,2,Friendly,Rhodes,Greece,False,2,-2,Slovakia
20346,21983,23411,2000,Guatemala,Costa Rica,2,1,FIFA World Cup qualification,Mazatenango,Guatemala,False,3,1,Guatemala
20347,21984,23412,2000,Republic of Ireland,Finland,3,0,Friendly,Dublin,Republic of Ireland,False,3,3,Republic of Ireland
20348,21985,23413,2000,Italy,England,1,0,Friendly,Turin,Italy,False,1,1,Italy
20349,21986,23415,2000,Paraguay,Peru,5,1,FIFA World Cup qualification,Asunción,Paraguay,False,6,4,Paraguay
20350,21987,23416,2000,Poland,Iceland,1,0,Friendly,Warsaw,Poland,False,1,1,Poland
20351,21988,23417,2000,Portugal,Israel,2,1,Friendly,Braga,Portugal,False,3,1,Portugal
20352,21989,23418,2000,Romania,Serbia,2,1,Friendly,Bucharest,Romania,False,3,1,Romania
20353,21990,23419,2000,San Marino,Latvia,0,1,FIFA World Cup qualification,Serravalle,San Marino,False,1,-1,Latvia
20354,21991,23420,2000,Scotland,Australia,0,2,Friendly,Glasgow,Scotland,False,2,-2,Australia
20355,21992,23421,2000,Spain,Netherlands,1,2,Friendly,Seville,Spain,False,3,-1,Netherlands
20356,21993,23422,2000,Trinidad and Tobago,Panama,1,0,FIFA World Cup qualification,Port of Spain,Trinidad and Tobago,False,1,1,Trinidad and Tobago
20357,21994,23423,2000,Tunisia,Switzerland,1,1,Friendly,Tunis,Tunisia,False,2,0,Draw
20358,21995,23424,2000,Turkey,France,0,4,Friendly,Istanbul,Turkey,False,4,-4,France
20359,21996,23425,2000,Venezuela,Ecuador,1,2,FIFA World Cup qualification,Maracaibo,Venezuela,False,3,-1,Ecuador
20360,21997,23426,2000,Thailand,Malaysia,2,0,AFF Championship,Bangkok,Thailand,False,2,2,Thailand
20361,21998,23427,2000,Vietnam,Indonesia,2,3,AFF Championship,Bangkok,Thailand,True,5,-1,Indonesia
20362,21999,23428,2000,Thailand,Indonesia,4,1,AFF Championship,Bangkok,Thailand,False,5,3,Thailand
20363,22000,23429,2000,Uganda,Ethiopia,2,2,CECAFA Cup,Kampala,Uganda,False,4,0,Draw
20364,22001,23430,2000,Vietnam,Malaysia,0,3,AFF Championship,Bangkok,Thailand,True,3,-3,Malaysia
20365,22002,23431,2000,Djibouti,Somalia,0,0,CECAFA Cup,Kampala,Uganda,True,0,0,Draw
20366,22003,23432,2000,Ivory Coast,Libya,2,1,African Cup of Nations qualification,Abidjan,Ivory Coast,False,3,1,Ivory Coast
20367,22004,23433,2000,Uganda,Burundi,2,1,CECAFA Cup,Kampala,Uganda,False,3,1,Uganda
20368,22005,23434,2000,Oman,Bahrain,2,1,Friendly,Muscat,Oman,False,3,1,Oman
20369,22006,23435,2000,Somalia,Ethiopia,1,2,CECAFA Cup,Kampala,Uganda,True,3,-1,Ethiopia
20370,22007,23436,2000,Kenya,Rwanda,1,2,CECAFA Cup,Mbale,Uganda,True,3,-1,Rwanda
20371,22008,23437,2000,Morocco,Libya,0,0,Friendly,Casablanca,Morocco,False,0,0,Draw
20372,22009,23438,2000,Djibouti,Burundi,2,4,CECAFA Cup,Kampala,Uganda,True,6,-2,Burundi
20373,22010,23439,2000,Uganda,Somalia,6,0,CECAFA Cup,Kampala,Uganda,False,6,6,Uganda
20374,22011,23440,2000,Iran,Guam,19,0,FIFA World Cup qualification,Tabriz,Iran,False,19,19,Iran
20375,22012,23441,2000,Eritrea,Rwanda,1,1,CECAFA Cup,Mbale,Uganda,True,2,0,Draw
20376,22013,23442,2000,Ethiopia,Djibouti,4,2,CECAFA Cup,Kampala,Uganda,True,6,2,Ethiopia
20377,22014,23443,2000,Tajikistan,Guam,16,0,FIFA World Cup qualification,Tabriz,Iran,True,16,16,Tajikistan
20378,22015,23444,2000,Ethiopia,Burundi,1,0,CECAFA Cup,Kampala,Uganda,True,1,1,Ethiopia
20379,22016,23445,2000,Uganda,Djibouti,7,0,CECAFA Cup,Kampala,Uganda,False,7,7,Uganda
20380,22017,23446,2000,Iran,Tajikistan,2,0,FIFA World Cup qualification,Tabriz,Iran,False,2,2,Iran
20381,22018,23447,2000,Uganda,Rwanda,3,1,CECAFA Cup,Kampala,Uganda,False,4,2,Uganda
20382,22019,23448,2000,Ethiopia,Rwanda,1,1,Friendly,Kampala,Uganda,True,2,0,Draw
20383,22020,23449,2000,Algeria,Romania,3,2,Friendly,Annaba,Algeria,False,5,1,Algeria
20384,22021,23450,2000,Algeria,Romania,2,3,Friendly,Annaba,Algeria,False,5,-1,Romania
20385,22022,23451,2000,Hong Kong,Estonia,1,2,Friendly,So Kon Po,Hong Kong,False,3,-1,Estonia
20386,22023,23452,2000,Greece,Serbia,1,1,Friendly,Xánthi,Greece,False,2,0,Draw
20387,22024,23453,2000,South Africa,Liberia,2,1,African Cup of Nations qualification,Johannesburg,South Africa,False,3,1,South Africa
20388,22026,23455,2000,Mexico,Argentina,0,2,Friendly,Los Angeles,United States,True,2,-2,Argentina
20389,22027,23459,2001,Kenya,Zambia,2,1,Friendly,Nairobi,Kenya,False,3,1,Kenya
20390,22028,23460,2001,Costa Rica,Guatemala,5,2,FIFA World Cup qualification,Miami,United States,True,7,3,Costa Rica
20391,22029,23461,2001,Egypt,United Arab Emirates,2,1,Friendly,Cairo,Egypt,False,3,1,Egypt
20392,22030,23462,2001,Eswatini,Angola,1,0,Friendly,Manzini,Eswatini,False,1,1,Eswatini
20393,22031,23463,2001,Angola,Lesotho,2,0,Friendly,Manzini,Eswatini,True,2,2,Angola
20394,22032,23464,2001,Eswatini,Namibia,2,1,Friendly,Manzini,Eswatini,False,3,1,Eswatini
20395,22033,23465,2001,Togo,Burkina Faso,1,1,Friendly,Lomé,Togo,False,2,0,Draw
20396,22034,23466,2001,Egypt,Zambia,3,1,Friendly,Cairo,Egypt,False,4,2,Egypt
20397,22035,23467,2001,Eswatini,Lesotho,2,2,Friendly,Manzini,Eswatini,False,4,0,Draw
20398,22036,23468,2001,Romania,Jordan,0,1,Millennium Cup,Margao,India,True,1,-1,Jordan
20399,22037,23469,2001,Algeria,Burundi,2,1,African Cup of Nations qualification,Algiers,Algeria,False,3,1,Algeria
20400,22038,23470,2001,Bosnia and Herzegovina,Bangladesh,2,0,Millennium Cup,Cochin,India,True,2,2,Bosnia and Herzegovina
20401,22039,23471,2001,Qatar,Kuwait,1,0,Friendly,Doha,Qatar,False,1,1,Qatar
20402,22040,23472,2001,Uzbekistan,Bahrain,5,0,Millennium Cup,Calcutta,India,True,5,5,Uzbekistan
20403,22041,23473,2001,Burkina Faso,Angola,1,0,African Cup of Nations qualification,Ouagadougou,Burkina Faso,False,1,1,Burkina Faso
20404,22042,23474,2001,India,Iceland,0,3,Millennium Cup,Cochin,India,False,3,-3,Iceland
20405,22043,23475,2001,Kenya,Gabon,2,1,African Cup of Nations qualification,Nairobi,Kenya,False,3,1,Kenya
20406,22044,23476,2001,Namibia,Madagascar,2,2,African Cup of Nations qualification,Windhoek,Namibia,False,4,0,Draw
20407,22045,23477,2001,Nigeria,Zambia,1,0,African Cup of Nations qualification,Lagos,Nigeria,False,1,1,Nigeria
20408,22046,23478,2001,Tunisia,Morocco,0,1,African Cup of Nations qualification,Tunis,Tunisia,False,1,-1,Morocco
20409,22047,23479,2001,Uganda,Senegal,1,1,African Cup of Nations qualification,Kampala,Uganda,False,2,0,Draw
20410,22048,23480,2001,DR Congo,Ghana,2,1,African Cup of Nations qualification,Kinshasa,DR Congo,False,3,1,DR Congo
20411,22049,23481,2001,Egypt,Libya,4,0,African Cup of Nations qualification,Cairo,Egypt,False,4,4,Egypt
20412,22050,23482,2001,Guinea,Togo,0,0,African Cup of Nations qualification,Conakry,Guinea,False,0,0,Draw
20413,22051,23483,2001,Liberia,Congo,5,1,African Cup of Nations qualification,Monrovia,Liberia,False,6,4,Liberia
20414,22052,23484,2001,Romania,Hong Kong,4,2,Millennium Cup,Margao,India,True,6,2,Romania
20415,22053,23485,2001,Serbia,Bosnia and Herzegovina,1,1,Millennium Cup,Cochin,India,True,2,0,Draw
20416,22054,23486,2001,Zimbabwe,Lesotho,1,2,African Cup of Nations qualification,Bulawayo,Zimbabwe,False,3,-1,Lesotho
20417,22055,23487,2001,Chile,Bahrain,2,0,Millennium Cup,Calcutta,India,True,2,2,Chile
20418,22056,23488,2001,Bangladesh,Serbia,1,4,Millennium Cup,Cochin,India,True,5,-3,Serbia
20419,22057,23489,2001,Hong Kong,Jordan,0,2,Millennium Cup,Margao,India,True,2,-2,Jordan
20420,22058,23490,2001,Chile,Uzbekistan,2,0,Millennium Cup,Calcutta,India,True,2,2,Chile
20421,22059,23492,2001,Israel,Uzbekistan,2,0,Friendly,Beit She'an,Israel,False,2,2,Israel
20422,22060,23493,2001,Kuwait,Syria,2,0,Friendly,Doha,Qatar,True,2,2,Kuwait
20423,22062,23495,2001,Chile,Iceland,2,0,Millennium Cup,Calcutta,India,True,2,2,Chile
20424,22063,23496,2001,Ivory Coast,Sudan,2,0,African Cup of Nations qualification,Bouaké,Ivory Coast,False,2,2,Ivory Coast
20425,22064,23497,2001,Mali,Guinea,0,1,Friendly,Bamako,Mali,False,1,-1,Guinea
20426,22065,23498,2001,Serbia,Romania,2,0,Millennium Cup,Margao,India,True,2,2,Serbia
20427,22066,23499,2001,Bosnia and Herzegovina,Chile,1,0,Millennium Cup,Calcutta,India,True,1,1,Bosnia and Herzegovina
20428,22067,23500,2001,Burkina Faso,Mali,0,2,Friendly,Ouagadougou,Burkina Faso,False,2,-2,Mali
20429,22069,23502,2001,Serbia,Japan,1,0,Millennium Cup,Calcutta,India,True,1,1,Serbia
20430,22070,23503,2001,Thailand,Kuwait,5,4,Friendly,Bangkok,Thailand,False,9,1,Thailand
20431,22071,23505,2001,Mexico,Bulgaria,0,2,Friendly,Morelia,Mexico,False,2,-2,Bulgaria
20432,22072,23506,2001,Benin,Cameroon,1,3,Friendly,Cotonou,Benin,False,4,-2,Cameroon
20433,22073,23507,2001,Bosnia and Herzegovina,Serbia,0,2,Millennium Cup,Calcutta,India,True,2,-2,Serbia
20434,22074,23508,2001,Algeria,Namibia,1,0,FIFA World Cup qualification,Algiers,Algeria,False,1,1,Algeria
20435,22075,23509,2001,Botswana,Eswatini,1,2,Friendly,Gaborone,Botswana,False,3,-1,Eswatini
20436,22076,23510,2001,Grenada,Trinidad and Tobago,1,2,Friendly,St. George's,Grenada,False,3,-1,Trinidad and Tobago
20437,22077,23512,2001,Nigeria,Sudan,3,0,FIFA World Cup qualification,Port Harcourt,Nigeria,False,3,3,Nigeria
20438,22078,23513,2001,Singapore,Thailand,1,1,Friendly,Singapore,Singapore,False,2,0,Draw
20439,22079,23514,2001,South Africa,Burkina Faso,1,0,FIFA World Cup qualification,Rustenburg,South Africa,False,1,1,South Africa
20440,22081,23516,2001,Angola,Libya,3,1,FIFA World Cup qualification,Luanda,Angola,False,4,2,Angola
20441,22083,23518,2001,Botswana,Lesotho,2,1,Friendly,Gaborone,Botswana,False,3,1,Botswana
20442,22084,23519,2001,Congo,Tunisia,1,2,FIFA World Cup qualification,Pointe-Noire,Congo,False,3,-1,Tunisia
20443,22085,23520,2001,Egypt,Morocco,0,0,FIFA World Cup qualification,Cairo,Egypt,False,0,0,Draw
20444,22086,23521,2001,Ghana,Liberia,1,3,FIFA World Cup qualification,Accra,Ghana,False,4,-2,Liberia
20445,22087,23522,2001,Guinea,Malawi,1,1,FIFA World Cup qualification,Conakry,Guinea,False,2,0,Draw
20446,22088,23523,2001,Jamaica,Bulgaria,0,0,Friendly,Kingston,Jamaica,False,0,0,Draw
20447,22090,23525,2001,Madagascar,Ivory Coast,1,3,FIFA World Cup qualification,Antananarivo,Madagascar,False,4,-2,Ivory Coast
20448,22091,23526,2001,Togo,Cameroon,0,2,FIFA World Cup qualification,Lomé,Togo,False,2,-2,Cameroon
20449,22092,23527,2001,Grenada,Trinidad and Tobago,0,2,Friendly,St. George's,Grenada,False,2,-2,Trinidad and Tobago
20450,22094,23529,2001,Saudi Arabia,Syria,1,0,Friendly,Dammam,Saudi Arabia,False,1,1,Saudi Arabia
20451,22095,23530,2001,Thailand,Kyrgyzstan,3,1,Friendly,Bangkok,Thailand,False,4,2,Thailand
20452,22096,23531,2001,Lebanon,Iraq,0,0,Friendly,Beirut,Lebanon,False,0,0,Draw
20453,22097,23532,2001,Mexico,Colombia,2,3,Friendly,Los Angeles,United States,True,5,-1,Colombia
20454,22098,23533,2001,Sweden,Faroe Islands,0,0,Nordic Championship,Växjö,Sweden,False,0,0,Draw
20455,22099,23534,2001,Sweden,Finland,0,1,Nordic Championship,Jönköping,Sweden,False,1,-1,Finland
20456,22100,23535,2001,Bahrain,Kuwait,1,2,FIFA World Cup qualification,Singapore,Singapore,True,3,-1,Kuwait
20457,22102,23537,2001,Saudi Arabia,Uganda,3,1,Friendly,Dammam,Saudi Arabia,False,4,2,Saudi Arabia
20458,22103,23538,2001,Singapore,Kyrgyzstan,0,1,FIFA World Cup qualification,Singapore,Singapore,False,1,-1,Kyrgyzstan
20459,22104,23539,2001,United States,Colombia,0,1,Friendly,Miami,United States,False,1,-1,Colombia
20460,22105,23540,2001,Senegal,Mali,1,0,Friendly,Dakar,Senegal,False,1,1,Senegal
20461,22106,23541,2001,Fiji,Malaysia,4,1,Friendly,Lautoka,Fiji,False,5,3,Fiji
20462,22107,23542,2001,Bahrain,Kyrgyzstan,1,0,FIFA World Cup qualification,Singapore,Singapore,True,1,1,Bahrain
20463,22108,23543,2001,Singapore,Kuwait,1,1,FIFA World Cup qualification,Singapore,Singapore,False,2,0,Draw
20464,22109,23544,2001,Saint Martin,Montserrat,3,1,CFU Caribbean Cup qualification,Philipsburg,Sint Maarten,True,4,2,Saint Martin
20465,22110,23545,2001,Fiji,Malaysia,2,0,Friendly,Suva,Fiji,False,2,2,Fiji
20466,22111,23546,2001,Anguilla,Montserrat,4,1,CFU Caribbean Cup qualification,Marigot,Saint Martin,True,5,3,Anguilla
20467,22113,23548,2001,Saudi Arabia,Mongolia,6,0,FIFA World Cup qualification,Dammam,Saudi Arabia,False,6,6,Saudi Arabia
20468,22114,23549,2001,Vietnam,Bangladesh,0,0,FIFA World Cup qualification,Dammam,Saudi Arabia,True,0,0,Draw
20469,22115,23550,2001,Fiji,Malaysia,1,2,Friendly,Ba,Fiji,False,3,-1,Malaysia
20470,22116,23551,2001,Kyrgyzstan,Kuwait,0,3,FIFA World Cup qualification,Singapore,Singapore,True,3,-3,Kuwait
20471,22117,23552,2001,Singapore,Bahrain,1,2,FIFA World Cup qualification,Singapore,Singapore,False,3,-1,Bahrain
20472,22118,23554,2001,Mongolia,Vietnam,0,1,FIFA World Cup qualification,Dammam,Saudi Arabia,True,1,-1,Vietnam
20473,22119,23555,2001,Saudi Arabia,Bangladesh,3,0,FIFA World Cup qualification,Dammam,Saudi Arabia,False,3,3,Saudi Arabia
20474,22120,23556,2001,Saint Martin,Anguilla,3,1,CFU Caribbean Cup qualification,Marigot,Saint Martin,False,4,2,Saint Martin
20475,22121,23557,2001,Thailand,Sweden,1,4,King's Cup,Bangkok,Thailand,False,5,-3,Sweden
20476,22122,23559,2001,Eswatini,Zambia,0,0,COSAFA Cup,Lobamba,Eswatini,False,0,0,Draw
20477,22124,23561,2001,Armenia,Uzbekistan,2,0,Friendly,Balchik,Bulgaria,True,2,2,Armenia
20478,22125,23563,2001,Mongolia,Bangladesh,0,3,FIFA World Cup qualification,Dammam,Saudi Arabia,True,3,-3,Bangladesh
20479,22126,23564,2001,Saudi Arabia,Vietnam,5,0,FIFA World Cup qualification,Dammam,Saudi Arabia,False,5,5,Saudi Arabia
20480,22127,23565,2001,Thailand,Qatar,1,3,King's Cup,Bangkok,Thailand,False,4,-2,Qatar
20481,22128,23566,2001,Georgia,Ukraine,0,0,Friendly,Tbilisi,Georgia,False,0,0,Draw
20482,22129,23567,2001,Israel,Moldova,1,0,Friendly,Herzliyya,Israel,False,1,1,Israel
20483,22130,23568,2001,Sweden,Qatar,0,0,King's Cup,Bangkok,Thailand,True,0,0,Draw
20484,22132,23570,2001,United Arab Emirates,Morocco,1,1,United Arab Emirates Friendship Tournament,Dubai,United Arab Emirates,False,2,0,Draw
20485,22133,23571,2001,Azerbaijan,Uzbekistan,1,2,Friendly,Varna,Bulgaria,True,3,-1,Uzbekistan
20486,22134,23572,2001,Bangladesh,Vietnam,0,4,FIFA World Cup qualification,Dammam,Saudi Arabia,True,4,-4,Vietnam
20487,22135,23573,2001,Kuwait,Finland,4,3,Friendly,Kuwait City,Kuwait,False,7,1,Kuwait
20488,22136,23574,2001,Saudi Arabia,Mongolia,6,0,FIFA World Cup qualification,Dammam,Saudi Arabia,False,6,6,Saudi Arabia
20489,22137,23576,2001,Saudi Arabia,Bangladesh,6,0,FIFA World Cup qualification,Dammam,Saudi Arabia,False,6,6,Saudi Arabia
20490,22138,23577,2001,Thailand,Qatar,2,0,King's Cup,Bangkok,Thailand,False,2,2,Thailand
20491,22139,23578,2001,Vietnam,Mongolia,4,0,FIFA World Cup qualification,Dammam,Saudi Arabia,True,4,4,Vietnam
20492,22140,23579,2001,Oman,Finland,1,2,Friendly,Muscat,Oman,False,3,-1,Finland
20493,22141,23580,2001,Bangladesh,Mongolia,2,2,FIFA World Cup qualification,Dammam,Saudi Arabia,True,4,0,Draw
20494,22142,23581,2001,Saudi Arabia,Vietnam,4,0,FIFA World Cup qualification,Dammam,Saudi Arabia,False,4,4,Saudi Arabia
20495,22143,23582,2001,Saint Kitts and Nevis,Saint Lucia,2,0,Friendly,Basseterre,Saint Kitts and Nevis,False,2,2,Saint Kitts and Nevis
20496,22144,23583,2001,Oman,Finland,0,2,Friendly,Muscat,Oman,False,2,-2,Finland
20497,22145,23584,2001,Kuwait,Singapore,1,0,FIFA World Cup qualification,Kuwait City,Kuwait,False,1,1,Kuwait
20498,22146,23585,2001,Kyrgyzstan,Bahrain,1,2,FIFA World Cup qualification,Kuwait City,Kuwait,True,3,-1,Bahrain
20499,22147,23586,2001,Martinique,Saint Lucia,4,2,Friendly,Fort-de-France,Martinique,False,6,2,Martinique
20500,22148,23587,2001,Panama,Guatemala,2,2,Friendly,Panama City,Panama,False,4,0,Draw
20501,22149,23588,2001,Libya,Togo,3,3,FIFA World Cup qualification,Benghazi,Libya,False,6,0,Draw
20502,22150,23589,2001,Bahrain,Singapore,2,0,FIFA World Cup qualification,Kuwait City,Kuwait,True,2,2,Bahrain
20503,22151,23590,2001,Burkina Faso,Zimbabwe,1,2,FIFA World Cup qualification,Bobo Dioulasso,Burkina Faso,False,3,-1,Zimbabwe
20504,22152,23591,2001,Kuwait,Kyrgyzstan,2,0,FIFA World Cup qualification,Kuwait City,Kuwait,False,2,2,Kuwait
20505,22153,23592,2001,Morocco,Senegal,0,0,FIFA World Cup qualification,Rabat,Morocco,False,0,0,Draw
20506,22154,23593,2001,Namibia,Egypt,1,1,FIFA World Cup qualification,Windhoek,Namibia,False,2,0,Draw
20507,22155,23594,2001,Antigua and Barbuda,Saint Lucia,0,1,Friendly,St. John's,Antigua and Barbuda,False,1,-1,Saint Lucia
20508,22156,23595,2001,Cameroon,Zambia,1,0,FIFA World Cup qualification,Yaoundé,Cameroon,False,1,1,Cameroon
20509,22157,23596,2001,Cayman Islands,Trinidad and Tobago,0,3,Friendly,George Town,Cayman Islands,False,3,-3,Trinidad and Tobago
20510,22158,23597,2001,Liberia,Sierra Leone,1,0,FIFA World Cup qualification,Paynesville,Liberia,False,1,1,Liberia
20511,22159,23598,2001,Malawi,South Africa,1,2,FIFA World Cup qualification,Blantyre,Malawi,False,3,-1,South Africa
20512,22160,23599,2001,Oman,Maldives,5,0,Friendly,Muscat,Oman,False,5,5,Oman
20513,22161,23600,2001,Sudan,Ghana,1,0,FIFA World Cup qualification,Omdurman,Sudan,False,1,1,Sudan
20514,22162,23601,2001,Tunisia,DR Congo,6,0,FIFA World Cup qualification,Tunis,Tunisia,False,6,6,Tunisia
20515,22163,23602,2001,Cyprus,Lithuania,1,2,Cyprus International Tournament,Limassol,Cyprus,False,3,-1,Lithuania
20516,22164,23603,2001,Romania,Ukraine,1,0,Cyprus International Tournament,Nicosia,Cyprus,True,1,1,Romania
20517,22165,23604,2001,Algeria,Slovakia,1,1,Friendly,Algiers,Algeria,False,2,0,Draw
20518,22166,23605,2001,France,Germany,1,0,Friendly,Saint-Denis,France,False,1,1,France
20519,22167,23606,2001,Kuwait,Bahrain,0,1,FIFA World Cup qualification,Kuwait City,Kuwait,False,1,-1,Bahrain
20520,22168,23607,2001,Kyrgyzstan,Singapore,1,1,FIFA World Cup qualification,Kuwait City,Kuwait,True,2,0,Draw
20521,22169,23608,2001,Oman,Maldives,2,0,Friendly,Muscat,Oman,False,2,2,Oman
20522,22170,23609,2001,Belgium,San Marino,10,1,FIFA World Cup qualification,Brussels,Belgium,False,11,9,Belgium
20523,22171,23610,2001,Bosnia and Herzegovina,Hungary,1,1,Friendly,Zenica,Bosnia and Herzegovina,False,2,0,Draw
20524,22172,23611,2001,Colombia,Australia,3,2,Friendly,Bogotá,Colombia,False,5,1,Colombia
20525,22173,23612,2001,Costa Rica,Honduras,2,2,FIFA World Cup qualification,San José,Costa Rica,False,4,0,Draw
20526,22174,23613,2001,Croatia,Austria,1,0,Friendly,Rijeka,Croatia,False,1,1,Croatia
20527,22175,23614,2001,Cyprus,Ukraine,4,3,Cyprus International Tournament,Larnaca,Cyprus,False,7,1,Cyprus
20528,22176,23615,2001,England,Spain,3,0,Friendly,Birmingham,England,False,3,3,England
20529,22177,23616,2001,Greece,Russia,3,3,Friendly,Heraklion,Greece,False,6,0,Draw
20530,22178,23617,2001,Italy,Argentina,1,2,Friendly,Rome,Italy,False,3,-1,Argentina
20531,22179,23618,2001,Jamaica,Trinidad and Tobago,1,0,FIFA World Cup qualification,Kingston,Jamaica,False,1,1,Jamaica
20532,22180,23619,2001,Jordan,Bulgaria,0,2,Friendly,Amman,Jordan,False,2,-2,Bulgaria
20533,22181,23620,2001,Liechtenstein,Latvia,0,2,Friendly,Vaduz,Liechtenstein,False,2,-2,Latvia
20534,22182,23621,2001,Lithuania,Romania,0,3,Cyprus International Tournament,Nicosia,Cyprus,True,3,-3,Romania
20535,22183,23622,2001,Luxembourg,Finland,0,1,Friendly,Luxembourg,Luxembourg,False,1,-1,Finland
20536,22184,23624,2001,Malta,Sweden,0,3,Friendly,Attard,Malta,False,3,-3,Sweden
20537,22185,23625,2001,Netherlands,Turkey,0,0,Friendly,Amsterdam,Netherlands,False,0,0,Draw
20538,22186,23626,2001,Northern Ireland,Norway,0,4,Friendly,Belfast,Northern Ireland,False,4,-4,Norway
20539,22187,23627,2001,Portugal,Andorra,3,0,FIFA World Cup qualification,Funchal,Portugal,False,3,3,Portugal
20540,22188,23628,2001,Slovenia,Uruguay,0,2,Friendly,Koper,Slovenia,False,2,-2,Uruguay
20541,22189,23629,2001,Switzerland,Poland,0,4,Friendly,Larnaca,Cyprus,True,4,-4,Poland
20542,22190,23630,2001,United States,Mexico,2,0,FIFA World Cup qualification,Columbus,United States,False,2,2,United States
20543,22191,23631,2001,Saint Kitts and Nevis,Dominican Republic,2,1,CFU Caribbean Cup qualification,St. John's,Antigua and Barbuda,True,3,1,Saint Kitts and Nevis
20544,22192,23632,2001,Antigua and Barbuda,Dominican Republic,2,3,CFU Caribbean Cup qualification,St. John's,Antigua and Barbuda,False,5,-1,Dominican Republic
20545,22193,23633,2001,United States,Brazil,1,2,Friendly,Pasadena,United States,False,3,-1,Brazil
20546,22194,23634,2001,Antigua and Barbuda,Saint Kitts and Nevis,2,2,CFU Caribbean Cup qualification,St. John's,Antigua and Barbuda,False,4,0,Draw
20547,22195,23635,2001,Hong Kong,Palestine,1,1,FIFA World Cup qualification,So Kon Po,Hong Kong,False,2,0,Draw
20548,22196,23636,2001,Qatar,Malaysia,5,1,FIFA World Cup qualification,So Kon Po,Hong Kong,True,6,4,Qatar
20549,22197,23637,2001,Guatemala,El Salvador,1,1,Friendly,Mazatenango,Guatemala,False,2,0,Draw
20550,22198,23638,2001,Honduras,Peru,0,0,Friendly,Miami,United States,True,0,0,Draw
20551,22199,23639,2001,Jordan,Hungary,1,1,Friendly,Amman,Jordan,False,2,0,Draw
20552,22200,23640,2001,Lebanon,Syria,2,2,Friendly,Tripoli,Lebanon,False,4,0,Draw
20553,22201,23641,2001,Mexico,Brazil,3,3,Friendly,Guadalajara,Mexico,False,6,0,Draw
20554,22202,23642,2001,Hong Kong,Malaysia,0,2,FIFA World Cup qualification,So Kon Po,Hong Kong,False,2,-2,Malaysia
20555,22203,23643,2001,Palestine,Qatar,1,2,FIFA World Cup qualification,So Kon Po,Hong Kong,True,3,-1,Qatar
20556,22204,23644,2001,Botswana,Eswatini,1,0,Friendly,Maseru,Lesotho,True,1,1,Botswana
20557,22205,23645,2001,DR Congo,Ivory Coast,1,2,FIFA World Cup qualification,Kinshasa,DR Congo,False,3,-1,Ivory Coast
20558,22206,23646,2001,Kenya,Uganda,1,0,Friendly,Mumias,Kenya,False,1,1,Kenya
20559,22207,23647,2001,Lesotho,Mozambique,0,0,Friendly,Maseru,Lesotho,False,0,0,Draw
20560,22208,23648,2001,Senegal,Namibia,4,0,FIFA World Cup qualification,Dakar,Senegal,False,4,4,Senegal
20561,22209,23649,2001,Sierra Leone,Sudan,0,2,FIFA World Cup qualification,Freetown,Sierra Leone,False,2,-2,Sudan
20562,22210,23650,2001,Zambia,Libya,2,0,FIFA World Cup qualification,Chingola,Zambia,False,2,2,Zambia
20563,22211,23651,2001,Botswana,Mozambique,1,3,Friendly,Maseru,Lesotho,True,4,-2,Mozambique
20564,22212,23652,2001,Egypt,Algeria,5,2,FIFA World Cup qualification,Cairo,Egypt,False,7,3,Egypt
20565,22213,23653,2001,Ghana,Nigeria,0,0,FIFA World Cup qualification,Accra,Ghana,False,0,0,Draw
20566,22214,23654,2001,Hong Kong,Qatar,0,2,FIFA World Cup qualification,So Kon Po,Hong Kong,False,2,-2,Qatar
20567,22215,23655,2001,Lesotho,Eswatini,2,1,Friendly,Maseru,Lesotho,False,3,1,Lesotho
20568,22216,23656,2001,Palestine,Malaysia,1,0,FIFA World Cup qualification,So Kon Po,Hong Kong,True,1,1,Palestine
20569,22217,23657,2001,Togo,Angola,1,1,FIFA World Cup qualification,Lomé,Togo,False,2,0,Draw
20570,22218,23658,2001,Zimbabwe,Malawi,2,0,FIFA World Cup qualification,Harare,Zimbabwe,False,2,2,Zimbabwe
20571,22219,23659,2001,Grenada,Dominica,8,3,Windward Islands Tournament,St. George's,Grenada,False,11,5,Grenada
20572,22220,23660,2001,Saint Lucia,Saint Vincent and the Grenadines,0,2,Windward Islands Tournament,St. George's,Grenada,True,2,-2,Saint Vincent and the Grenadines
20573,22221,23661,2001,Dominica,Saint Vincent and the Grenadines,0,2,Windward Islands Tournament,St. George's,Grenada,True,2,-2,Saint Vincent and the Grenadines
20574,22222,23662,2001,Grenada,Saint Lucia,4,3,Windward Islands Tournament,St. George's,Grenada,False,7,1,Grenada
20575,22223,23663,2001,Panama,El Salvador,1,0,Friendly,Panama City,Panama,False,1,1,Panama
20576,22224,23664,2001,Dominica,Saint Lucia,1,1,Windward Islands Tournament,St. George's,Grenada,True,2,0,Draw
20577,22225,23665,2001,Botswana,Malawi,0,1,COSAFA Cup,Gaborone,Botswana,False,1,-1,Malawi
20578,22226,23666,2001,Dominica,Saint Lucia,0,1,Windward Islands Tournament,St. George's,Grenada,True,1,-1,Saint Lucia
20579,22227,23667,2001,Gabon,Mali,2,0,Friendly,Libreville,Gabon,False,2,2,Gabon
20580,22228,23668,2001,Egypt,Estonia,3,3,Friendly,Cairo,Egypt,False,6,0,Draw
20581,22229,23669,2001,Palestine,Hong Kong,1,0,FIFA World Cup qualification,Doha,Qatar,True,1,1,Palestine
20582,22230,23670,2001,Qatar,Malaysia,0,0,FIFA World Cup qualification,Doha,Qatar,False,0,0,Draw
20583,22231,23671,2001,Honduras,Chile,3,1,Friendly,San Pedro Sula,Honduras,False,4,2,Honduras
20584,22232,23672,2001,Saint Lucia,Martinique,1,1,Friendly,Castries,Saint Lucia,False,2,0,Draw
20585,22233,23673,2001,Hong Kong,Malaysia,2,1,FIFA World Cup qualification,Doha,Qatar,True,3,1,Hong Kong
20586,22234,23674,2001,Libya,Egypt,2,0,African Cup of Nations qualification,Tripoli,Libya,False,2,2,Libya
20587,22235,23675,2001,Qatar,Palestine,2,1,FIFA World Cup qualification,Doha,Qatar,False,3,1,Qatar
20588,22236,23676,2001,Andorra,Netherlands,0,5,FIFA World Cup qualification,Barcelona,Spain,True,5,-5,Netherlands
20589,22237,23677,2001,Armenia,Wales,2,2,FIFA World Cup qualification,Yerevan,Armenia,False,4,0,Draw
20590,22238,23678,2001,Azerbaijan,Moldova,0,0,FIFA World Cup qualification,Baku,Azerbaijan,False,0,0,Draw
20591,22239,23679,2001,Bosnia and Herzegovina,Austria,1,1,FIFA World Cup qualification,Sarajevo,Bosnia and Herzegovina,False,2,0,Draw
20592,22240,23681,2001,Bulgaria,Iceland,2,1,FIFA World Cup qualification,Sofia,Bulgaria,False,3,1,Bulgaria
20593,22241,23682,2001,Croatia,Latvia,4,1,FIFA World Cup qualification,Osijek,Croatia,False,5,3,Croatia
20594,22242,23683,2001,Cyprus,Republic of Ireland,0,4,FIFA World Cup qualification,Nicosia,Cyprus,False,4,-4,Republic of Ireland
20595,22243,23684,2001,England,Finland,2,1,FIFA World Cup qualification,Liverpool,England,False,3,1,England
20596,22244,23685,2001,France,Japan,5,0,Friendly,Saint-Denis,France,False,5,5,France
20597,22245,23686,2001,Gabon,Kenya,1,1,African Cup of Nations qualification,Libreville,Gabon,False,2,0,Draw
20598,22246,23687,2001,Germany,Albania,2,1,FIFA World Cup qualification,Leverkusen,Germany,False,3,1,Germany
20599,22247,23688,2001,Hungary,Lithuania,1,1,FIFA World Cup qualification,Budapest,Hungary,False,2,0,Draw
20600,22248,23689,2001,Lesotho,Zimbabwe,0,1,African Cup of Nations qualification,Maseru,Lesotho,False,1,-1,Zimbabwe
20601,22249,23690,2001,Luxembourg,Faroe Islands,0,2,FIFA World Cup qualification,Luxembourg,Luxembourg,False,2,-2,Faroe Islands
20602,22250,23691,2001,Madagascar,Namibia,1,2,African Cup of Nations qualification,Antananarivo,Madagascar,False,3,-1,Namibia
20603,22251,23692,2001,Malta,Denmark,0,5,FIFA World Cup qualification,Attard,Malta,False,5,-5,Denmark
20604,22252,23693,2001,Morocco,Tunisia,2,0,African Cup of Nations qualification,Rabat,Morocco,False,2,2,Morocco
20605,22253,23694,2001,Northern Ireland,Czech Republic,0,1,FIFA World Cup qualification,Belfast,Northern Ireland,False,1,-1,Czech Republic
20606,22254,23695,2001,Norway,Poland,2,3,FIFA World Cup qualification,Oslo,Norway,False,5,-1,Poland
20607,22255,23696,2001,Romania,Italy,0,2,FIFA World Cup qualification,Bucharest,Romania,False,2,-2,Italy
20608,22256,23697,2001,Russia,Slovenia,1,1,FIFA World Cup qualification,Moscow,Russia,False,2,0,Draw
20609,22257,23698,2001,Scotland,Belgium,2,2,FIFA World Cup qualification,Glasgow,Scotland,False,4,0,Draw
20610,22258,23699,2001,Senegal,Uganda,3,0,African Cup of Nations qualification,Dakar,Senegal,False,3,3,Senegal
20611,22259,23700,2001,Serbia,Switzerland,1,1,FIFA World Cup qualification,Belgrade,Yugoslavia,True,2,0,Draw
20612,22260,23701,2001,South Africa,Mauritius,3,0,African Cup of Nations qualification,Port Elizabeth,South Africa,False,3,3,South Africa
20613,22261,23702,2001,Spain,Liechtenstein,5,0,FIFA World Cup qualification,Alicante,Spain,False,5,5,Spain
20614,22263,23704,2001,Trinidad and Tobago,Guatemala,3,1,Friendly,Port of Spain,Trinidad and Tobago,False,4,2,Trinidad and Tobago
20615,22264,23705,2001,Turkey,Slovakia,1,1,FIFA World Cup qualification,Istanbul,Turkey,False,2,0,Draw
20616,22265,23706,2001,Ukraine,Belarus,0,0,FIFA World Cup qualification,Kyïv,Ukraine,False,0,0,Draw
20617,22266,23707,2001,Zambia,Nigeria,1,1,African Cup of Nations qualification,Chingola,Zambia,False,2,0,Draw
20618,22267,23708,2001,Angola,Burkina Faso,2,0,African Cup of Nations qualification,Luanda,Angola,False,2,2,Angola
20619,22268,23709,2001,Burundi,Algeria,0,1,African Cup of Nations qualification,Bujumbura,Burundi,False,1,-1,Algeria
20620,22269,23710,2001,Congo,Liberia,0,1,African Cup of Nations qualification,Pointe-Noire,Congo,False,1,-1,Liberia
20621,22270,23711,2001,Ghana,DR Congo,3,0,African Cup of Nations qualification,Accra,Ghana,False,3,3,Ghana
20622,22271,23712,2001,Malaysia,Palestine,4,3,FIFA World Cup qualification,Doha,Qatar,True,7,1,Malaysia
20623,22272,23713,2001,Mexico,Jamaica,4,0,FIFA World Cup qualification,Mexico City,Mexico,False,4,4,Mexico
20624,22273,23714,2001,Qatar,Hong Kong,3,0,FIFA World Cup qualification,Doha,Qatar,False,3,3,Qatar
20625,22274,23715,2001,Sudan,Ivory Coast,0,0,African Cup of Nations qualification,Omdurman,Sudan,False,0,0,Draw
20626,22275,23716,2001,Colombia,Bolivia,2,0,FIFA World Cup qualification,Bogotá,Colombia,False,2,2,Colombia
20627,22276,23717,2001,Oman,United Arab Emirates,2,1,Friendly,Muscat,Oman,False,3,1,Oman
20628,22277,23718,2001,Peru,Chile,3,1,FIFA World Cup qualification,Lima,Peru,False,4,2,Peru
20629,22278,23719,2001,Albania,England,1,3,FIFA World Cup qualification,Tirana,Albania,False,4,-2,England
20630,22279,23720,2001,Andorra,Republic of Ireland,0,3,FIFA World Cup qualification,Barcelona,Spain,True,3,-3,Republic of Ireland
20631,22280,23721,2001,Argentina,Venezuela,5,0,FIFA World Cup qualification,Buenos Aires,Argentina,False,5,5,Argentina
20632,22281,23722,2001,Austria,Israel,2,1,FIFA World Cup qualification,Vienna,Austria,False,3,1,Austria
20633,22282,23723,2001,Belarus,Norway,2,1,FIFA World Cup qualification,Minsk,Belarus,False,3,1,Belarus
20634,22283,23724,2001,Bulgaria,Northern Ireland,4,3,FIFA World Cup qualification,Sofia,Bulgaria,False,7,1,Bulgaria
20635,22284,23725,2001,Costa Rica,Trinidad and Tobago,3,0,FIFA World Cup qualification,Alajuela,Costa Rica,False,3,3,Costa Rica
20636,22285,23726,2001,Cyprus,Estonia,2,2,FIFA World Cup qualification,Limassol,Cyprus,False,4,0,Draw
20637,22286,23727,2001,Czech Republic,Denmark,0,0,FIFA World Cup qualification,Prague,Czech Republic,False,0,0,Draw
20638,22287,23728,2001,Ecuador,Brazil,1,0,FIFA World Cup qualification,Quito,Ecuador,False,1,1,Ecuador
20639,22288,23729,2001,Georgia,Romania,0,2,FIFA World Cup qualification,Tbilisi,Georgia,False,2,-2,Romania
20640,22289,23730,2001,Greece,Germany,2,4,FIFA World Cup qualification,Athens,Greece,False,6,-2,Germany
20641,22290,23731,2001,Honduras,United States,1,2,FIFA World Cup qualification,San Pedro Sula,Honduras,False,3,-1,United States
20642,22291,23732,2001,Italy,Lithuania,4,0,FIFA World Cup qualification,Trieste,Italy,False,4,4,Italy
20643,22292,23733,2001,Liechtenstein,Bosnia and Herzegovina,0,3,FIFA World Cup qualification,Vaduz,Liechtenstein,False,3,-3,Bosnia and Herzegovina
20644,22293,23735,2001,Martinique,Guadeloupe,4,1,Friendly,Fort-de-France,Martinique,False,5,3,Martinique
20645,22294,23736,2001,Moldova,Sweden,0,2,FIFA World Cup qualification,Chişinău,Moldova,False,2,-2,Sweden
20646,22295,23737,2001,Poland,Armenia,4,0,FIFA World Cup qualification,Warsaw,Poland,False,4,4,Poland
20647,22296,23738,2001,Portugal,Netherlands,2,2,FIFA World Cup qualification,Porto,Portugal,False,4,0,Draw
20648,22297,23739,2001,Russia,Faroe Islands,1,0,FIFA World Cup qualification,Moscow,Russia,False,1,1,Russia
20649,22298,23740,2001,Scotland,San Marino,4,0,FIFA World Cup qualification,Glasgow,Scotland,False,4,4,Scotland
20650,22299,23741,2001,Slovakia,Azerbaijan,3,1,FIFA World Cup qualification,Trnava,Slovakia,False,4,2,Slovakia
20651,22300,23742,2001,Slovenia,Serbia,1,1,FIFA World Cup qualification,Ljubljana,Slovenia,False,2,0,Draw
20652,22301,23743,2001,Spain,France,2,1,Friendly,Valencia,Spain,False,3,1,Spain
20653,22302,23744,2001,Sri Lanka,Cambodia,1,0,Friendly,Colombo,Sri Lanka,False,1,1,Sri Lanka
20654,22303,23745,2001,Switzerland,Luxembourg,5,0,FIFA World Cup qualification,Zürich,Switzerland,False,5,5,Switzerland
20655,22304,23746,2001,Uruguay,Paraguay,0,1,FIFA World Cup qualification,Montevideo,Uruguay,False,1,-1,Paraguay
20656,22305,23747,2001,Wales,Ukraine,1,1,FIFA World Cup qualification,Cardiff,Wales,False,2,0,Draw
20657,22306,23748,2001,Maldives,Cambodia,6,0,FIFA World Cup qualification,Malé,Maldives,False,6,6,Maldives
20658,22307,23749,2001,Barbados,Grenada,2,1,CFU Caribbean Cup qualification,Paramaribo,Suriname,True,3,1,Barbados
20659,22309,23751,2001,Cuba,Dominica,3,1,CFU Caribbean Cup qualification,Uitvlugt,Guyana,True,4,2,Cuba
20660,22310,23752,2001,Guyana,Saint Martin,2,0,CFU Caribbean Cup qualification,Georgetown,Guyana,False,2,2,Guyana
20661,22311,23753,2001,Lebanon,Bahrain,1,1,Friendly,Beirut,Lebanon,False,2,0,Draw
20662,22312,23754,2001,Suriname,Aruba,5,0,CFU Caribbean Cup qualification,Paramaribo,Suriname,False,5,5,Suriname
20663,22313,23755,2001,Haiti,Panama,1,1,Friendly,Port-au-Prince,Haiti,False,2,0,Draw
20664,22314,23756,2001,Oman,Sudan,0,1,Friendly,Muscat,Oman,False,1,-1,Sudan
20665,22315,23757,2001,Cuba,Saint Martin,1,0,CFU Caribbean Cup qualification,Uitvlugt,Guyana,True,1,1,Cuba
20666,22316,23758,2001,Grenada,Aruba,4,2,CFU Caribbean Cup qualification,Paramaribo,Suriname,True,6,2,Grenada
20667,22317,23759,2001,Guyana,Dominica,2,0,CFU Caribbean Cup qualification,Georgetown,Guyana,False,2,2,Guyana
20668,22319,23761,2001,Suriname,Barbados,2,2,CFU Caribbean Cup qualification,Paramaribo,Suriname,False,4,0,Draw
20669,22320,23762,2001,Brunei,Yemen,0,5,FIFA World Cup qualification,Bandar Seri Begawan,Brunei,False,5,-5,Yemen
20670,22321,23763,2001,Fiji,American Samoa,13,0,FIFA World Cup qualification,Coffs Harbour,Australia,True,13,13,Fiji
20671,22322,23764,2001,Haiti,Panama,0,0,Friendly,Cap-Haïtien,Haiti,False,0,0,Draw
20672,22324,23766,2001,Oman,Sudan,1,1,Friendly,Muscat,Oman,False,2,0,Draw
20673,22325,23767,2001,Samoa,Tonga,0,1,FIFA World Cup qualification,Coffs Harbour,Australia,True,1,-1,Tonga
20674,22326,23768,2001,Barbados,Aruba,5,2,CFU Caribbean Cup qualification,Paramaribo,Suriname,True,7,3,Barbados
20675,22327,23769,2001,Dominica,Saint Martin,2,3,CFU Caribbean Cup qualification,Georgetown,Guyana,True,5,-1,Saint Martin
20676,22328,23770,2001,Guyana,Cuba,0,3,CFU Caribbean Cup qualification,Georgetown,Guyana,False,3,-3,Cuba
20677,22329,23771,2001,India,United Arab Emirates,1,0,FIFA World Cup qualification,Bangalore,India,False,1,1,India
20678,22330,23772,2001,Indonesia,Maldives,5,0,FIFA World Cup qualification,Jakarta,Indonesia,False,5,5,Indonesia
20679,22331,23773,2001,Mali,Liberia,3,0,Friendly,Bamako,Mali,False,3,3,Mali
20680,22332,23774,2001,Martinique,Cayman Islands,1,1,CFU Caribbean Cup qualification,Fort-de-France,Martinique,False,2,0,Draw
20681,22333,23775,2001,Mauritius,Namibia,1,0,COSAFA Cup,Mapou,Mauritius,False,1,1,Mauritius
20682,22334,23776,2001,Suriname,Grenada,3,1,CFU Caribbean Cup qualification,Paramaribo,Suriname,False,4,2,Suriname
20683,22335,23777,2001,American Samoa,Samoa,0,8,FIFA World Cup qualification,Coffs Harbour,Australia,True,8,-8,Samoa
20684,22336,23778,2001,Australia,Tonga,22,0,FIFA World Cup qualification,Coffs Harbour,Australia,False,22,22,Australia
20685,22337,23779,2001,Guadeloupe,Saint Lucia,2,3,CFU Caribbean Cup qualification,Port-au-Prince,Haiti,True,5,-1,Saint Lucia
20686,22338,23780,2001,Haiti,U.S. Virgin Islands,12,1,CFU Caribbean Cup qualification,Port-au-Prince,Haiti,False,13,11,Haiti
20687,22339,23781,2001,Australia,American Samoa,31,0,FIFA World Cup qualification,Coffs Harbour,Australia,False,31,31,Australia
20688,22340,23782,2001,Mexico,Chile,1,0,Friendly,Monterrey,Mexico,False,1,1,Mexico
20689,22341,23783,2001,Samoa,Fiji,1,6,FIFA World Cup qualification,Coffs Harbour,Australia,True,7,-5,Fiji
20690,22342,23784,2001,Guadeloupe,U.S. Virgin Islands,11,0,CFU Caribbean Cup qualification,Port-au-Prince,Haiti,True,11,11,Guadeloupe
20691,22343,23785,2001,Haiti,Saint Lucia,3,2,CFU Caribbean Cup qualification,Port-au-Prince,Haiti,False,5,1,Haiti
20692,22344,23786,2001,Iraq,Macau,8,0,FIFA World Cup qualification,Baghdad,Iraq,False,8,8,Iraq
20693,22345,23787,2001,Nepal,Kazakhstan,0,6,FIFA World Cup qualification,Baghdad,Iraq,True,6,-6,Kazakhstan
20694,22346,23788,2001,American Samoa,Tonga,0,5,FIFA World Cup qualification,Coffs Harbour,Australia,True,5,-5,Tonga
20695,22347,23789,2001,Australia,Fiji,2,0,FIFA World Cup qualification,Coffs Harbour,Australia,False,2,2,Australia
20696,22348,23790,2001,Brunei,United Arab Emirates,0,12,FIFA World Cup qualification,Bandar Seri Begawan,Brunei,False,12,-12,United Arab Emirates
20697,22349,23791,2001,Haiti,Guadeloupe,2,0,CFU Caribbean Cup qualification,Port-au-Prince,Haiti,False,2,2,Haiti
20698,22350,23792,2001,Iraq,Nepal,9,1,FIFA World Cup qualification,Baghdad,Iraq,False,10,8,Iraq
20699,22351,23793,2001,Kazakhstan,Macau,3,0,FIFA World Cup qualification,Baghdad,Iraq,True,3,3,Kazakhstan
20700,22352,23794,2001,Saint Lucia,U.S. Virgin Islands,14,1,CFU Caribbean Cup qualification,Port-au-Prince,Haiti,True,15,13,Saint Lucia
20701,22353,23795,2001,Cambodia,Maldives,1,1,FIFA World Cup qualification,Phnom Penh,Cambodia,False,2,0,Draw
20702,22354,23796,2001,India,Yemen,1,1,FIFA World Cup qualification,Bangalore,India,False,2,0,Draw
20703,22355,23797,2001,Australia,Samoa,11,0,FIFA World Cup qualification,Coffs Harbour,Australia,False,11,11,Australia
20704,22356,23798,2001,Bahrain,Oman,0,1,Friendly,Manama,Bahrain,False,1,-1,Oman
20705,22357,23799,2001,Iraq,Kazakhstan,1,1,FIFA World Cup qualification,Baghdad,Iraq,False,2,0,Draw
20706,22358,23800,2001,Nepal,Macau,4,1,FIFA World Cup qualification,Baghdad,Iraq,True,5,3,Nepal
20707,22359,23801,2001,Tonga,Fiji,1,8,FIFA World Cup qualification,Coffs Harbour,Australia,True,9,-7,Fiji
20708,22360,23802,2001,Burkina Faso,Malawi,4,2,FIFA World Cup qualification,Ouagadougou,Burkina Faso,False,6,2,Burkina Faso
20709,22361,23803,2001,Kazakhstan,Nepal,4,0,FIFA World Cup qualification,Almaty,Kazakhstan,False,4,4,Kazakhstan
20710,22362,23804,2001,Macau,Iraq,0,5,FIFA World Cup qualification,Almaty,Kazakhstan,True,5,-5,Iraq
20711,22363,23805,2001,Morocco,Namibia,3,0,FIFA World Cup qualification,Rabat,Morocco,False,3,3,Morocco
20712,22364,23806,2001,Senegal,Algeria,3,0,FIFA World Cup qualification,Dakar,Senegal,False,3,3,Senegal
20713,22365,23807,2001,Sierra Leone,Nigeria,1,0,FIFA World Cup qualification,Freetown,Sierra Leone,False,1,1,Sierra Leone
20714,22366,23808,2001,Zambia,Angola,1,1,FIFA World Cup qualification,Chingola,Zambia,False,2,0,Draw
20715,22367,23809,2001,Cameroon,Libya,1,0,FIFA World Cup qualification,Yaoundé,Cameroon,False,1,1,Cameroon
20716,22368,23811,2001,DR Congo,Madagascar,1,0,FIFA World Cup qualification,Kinshasa,DR Congo,False,1,1,DR Congo
20717,22369,23812,2001,Indonesia,Cambodia,6,0,FIFA World Cup qualification,Jakarta,Indonesia,False,6,6,Indonesia
20718,22370,23813,2001,Ivory Coast,Congo,2,0,FIFA World Cup qualification,Abidjan,Ivory Coast,False,2,2,Ivory Coast
20719,22371,23814,2001,Liberia,Sudan,2,0,FIFA World Cup qualification,Paynesville,Liberia,False,2,2,Liberia
20720,22372,23815,2001,Mozambique,Lesotho,1,0,Friendly,Beira,Mozambique,False,1,1,Mozambique
20721,22373,23816,2001,Iraq,Nepal,4,2,FIFA World Cup qualification,Almaty,Kazakhstan,True,6,2,Iraq
20722,22374,23817,2001,Kazakhstan,Macau,5,0,FIFA World Cup qualification,Almaty,Kazakhstan,False,5,5,Kazakhstan
20723,22375,23818,2001,Turkmenistan,Jordan,2,0,FIFA World Cup qualification,Tashkent,Uzbekistan,True,2,2,Turkmenistan
20724,22377,23820,2001,Belize,Nicaragua,2,0,Friendly,Belize City,Belize,False,2,2,Belize
20725,22378,23821,2001,Chile,Uruguay,0,1,FIFA World Cup qualification,Santiago,Chile,False,1,-1,Uruguay
20726,22379,23822,2001,Ecuador,Paraguay,2,1,FIFA World Cup qualification,Quito,Ecuador,False,3,1,Ecuador
20727,22380,23823,2001,Egypt,Canada,3,0,Friendly,Cairo,Egypt,False,3,3,Egypt
20728,22381,23824,2001,Georgia,Israel,3,2,Friendly,Tbilisi,Georgia,False,5,1,Georgia
20729,22383,23826,2001,Panama,Haiti,2,0,Friendly,Panama City,Panama,False,2,2,Panama
20730,22384,23827,2001,Venezuela,Colombia,2,2,FIFA World Cup qualification,San Cristóbal,Venezuela,False,4,0,Draw
20731,22385,23828,2001,Austria,Liechtenstein,2,0,FIFA World Cup qualification,Innsbruck,Austria,False,2,2,Austria
20732,22386,23829,2001,Bolivia,Argentina,3,3,FIFA World Cup qualification,La Paz,Bolivia,False,6,0,Draw
20733,22387,23830,2001,Brazil,Peru,1,1,FIFA World Cup qualification,São Paulo,Brazil,False,2,0,Draw
20734,22388,23831,2001,Croatia,Greece,2,2,Friendly,Varaždin,Croatia,False,4,0,Draw
20735,22389,23832,2001,Czech Republic,Belgium,1,1,Friendly,Prague,Czech Republic,False,2,0,Draw
20736,22390,23833,2001,Denmark,Slovenia,3,0,Friendly,Copenhagen,Denmark,False,3,3,Denmark
20737,22391,23834,2001,France,Portugal,4,0,Friendly,Saint-Denis,France,False,4,4,France
20738,22392,23835,2001,Hungary,Finland,0,0,Friendly,Budapest,Hungary,False,0,0,Draw
20739,22393,23836,2001,Republic of Ireland,Andorra,3,1,FIFA World Cup qualification,Dublin,Republic of Ireland,False,4,2,Republic of Ireland
20740,22394,23837,2001,Italy,South Africa,1,0,Friendly,Perugia,Italy,False,1,1,Italy
20741,22395,23838,2001,Jamaica,Honduras,1,1,FIFA World Cup qualification,Kingston,Jamaica,False,2,0,Draw
20742,22396,23839,2001,Kazakhstan,Iraq,1,1,FIFA World Cup qualification,Almaty,Kazakhstan,False,2,0,Draw
20743,22397,23840,2001,Latvia,San Marino,1,1,FIFA World Cup qualification,Riga,Latvia,False,2,0,Draw
20744,22398,23841,2001,Lebanon,Philippines,3,0,Friendly,Tripoli,Lebanon,False,3,3,Lebanon
20745,22399,23842,2001,Macau,Nepal,1,6,FIFA World Cup qualification,Almaty,Kazakhstan,True,7,-5,Nepal
20746,22400,23843,2001,Malta,Iceland,1,4,FIFA World Cup qualification,Attard,Malta,False,5,-3,Iceland
20747,22401,23844,2001,Moldova,Estonia,0,0,Friendly,Chişinău,Moldova,False,0,0,Draw
20748,22402,23845,2001,Netherlands,Cyprus,4,0,FIFA World Cup qualification,Eindhoven,Netherlands,False,4,4,Netherlands
20749,22403,23846,2001,Norway,Bulgaria,2,1,Friendly,Oslo,Norway,False,3,1,Norway
20750,22404,23847,2001,Poland,Scotland,1,1,Friendly,Bydgoszcz,Poland,False,2,0,Draw
20751,22405,23848,2001,Romania,Slovakia,0,0,Friendly,Ploieşti,Romania,False,0,0,Draw
20752,22406,23849,2001,Serbia,Russia,0,1,FIFA World Cup qualification,Belgrade,Yugoslavia,True,1,-1,Russia
20753,22407,23850,2001,Spain,Japan,1,0,Friendly,Córdoba,Spain,False,1,1,Spain
20754,22408,23851,2001,Switzerland,Sweden,0,2,Friendly,Geneva,Switzerland,False,2,-2,Sweden
20755,22409,23852,2001,Trinidad and Tobago,Mexico,1,1,FIFA World Cup qualification,Port of Spain,Trinidad and Tobago,False,2,0,Draw
20756,22410,23853,2001,Turkey,Albania,0,2,Friendly,Gaziantep,Turkey,False,2,-2,Albania
20757,22411,23854,2001,United States,Costa Rica,1,0,FIFA World Cup qualification,Kansas City,United States,False,1,1,United States
20758,22412,23855,2001,Uzbekistan,Turkmenistan,1,0,FIFA World Cup qualification,Tashkent,Uzbekistan,False,1,1,Uzbekistan
20759,22413,23856,2001,Belize,Nicaragua,2,1,Friendly,Belize City,Belize,False,3,1,Belize
20760,22414,23857,2001,Canada,Iran,1,0,Friendly,Cairo,Egypt,True,1,1,Canada
20761,22416,23859,2001,United Arab Emirates,India,1,0,FIFA World Cup qualification,Al Ain,United Arab Emirates,False,1,1,United Arab Emirates
20762,22417,23860,2001,Uzbekistan,Jordan,2,2,FIFA World Cup qualification,Tashkent,Uzbekistan,False,4,0,Draw
20763,22418,23861,2001,Yemen,Brunei,1,0,FIFA World Cup qualification,Sana'a,Yemen,False,1,1,Yemen
20764,22419,23862,2001,Bangladesh,Bhutan,3,1,Friendly,Dhaka,Bangladesh,False,4,2,Bangladesh
20765,22420,23863,2001,Congo,Madagascar,2,0,FIFA World Cup qualification,Pointe-Noire,Congo,False,2,2,Congo
20766,22422,23865,2001,Cambodia,Indonesia,0,2,FIFA World Cup qualification,Phnom Penh,Cambodia,False,2,-2,Indonesia
20767,22423,23866,2001,Mozambique,South Africa,0,3,COSAFA Cup,Maputo,Mozambique,False,3,-3,South Africa
20768,22424,23867,2001,Oman,Laos,12,0,FIFA World Cup qualification,Muscat,Oman,False,12,12,Oman
20769,22425,23868,2001,Syria,Philippines,12,0,FIFA World Cup qualification,Aleppo,Syria,False,12,12,Syria
20770,22427,23870,2001,Turkmenistan,Uzbekistan,2,5,FIFA World Cup qualification,Amman,Jordan,True,7,-3,Uzbekistan
20771,22428,23871,2001,Algeria,Morocco,1,2,FIFA World Cup qualification,Algiers,Algeria,False,3,-1,Morocco
20772,22429,23872,2001,Oman,Laos,7,0,FIFA World Cup qualification,Muscat,Oman,False,7,7,Oman
20773,22430,23873,2001,Syria,Philippines,5,1,FIFA World Cup qualification,Aleppo,Syria,False,6,4,Syria
20774,22431,23874,2001,United Arab Emirates,Brunei,4,0,FIFA World Cup qualification,Al Ain,United Arab Emirates,False,4,4,United Arab Emirates
20775,22432,23875,2001,Yemen,India,3,3,FIFA World Cup qualification,Sana'a,Yemen,False,6,0,Draw
20776,22433,23876,2001,Jordan,Turkmenistan,1,2,FIFA World Cup qualification,Amman,Jordan,False,3,-1,Turkmenistan
20777,22434,23877,2001,Madagascar,Tunisia,0,2,FIFA World Cup qualification,Antananarivo,Madagascar,False,2,-2,Tunisia
20778,22435,23878,2001,Nigeria,Liberia,2,0,FIFA World Cup qualification,Port Harcourt,Nigeria,False,2,2,Nigeria
20779,22436,23879,2001,Sierra Leone,Ghana,1,1,FIFA World Cup qualification,Freetown,Sierra Leone,False,2,0,Draw
20780,22437,23880,2001,South Africa,Zimbabwe,2,1,FIFA World Cup qualification,Johannesburg,South Africa,False,3,1,South Africa
20781,22438,23881,2001,Saint Kitts and Nevis,Puerto Rico,2,0,Friendly,Basseterre,Saint Kitts and Nevis,False,2,2,Saint Kitts and Nevis
20782,22439,23882,2001,Angola,Cameroon,2,0,FIFA World Cup qualification,Luanda,Angola,False,2,2,Angola
20783,22441,23884,2001,Congo,DR Congo,1,1,FIFA World Cup qualification,Pointe-Noire,Congo,False,2,0,Draw
20784,22442,23885,2001,Egypt,Senegal,1,0,FIFA World Cup qualification,Cairo,Egypt,False,1,1,Egypt
20785,22443,23886,2001,Maldives,Indonesia,0,2,FIFA World Cup qualification,Malé,Maldives,False,2,-2,Indonesia
20786,22444,23887,2001,Togo,Zambia,3,2,FIFA World Cup qualification,Lomé,Togo,False,5,1,Togo
20787,22445,23888,2001,Guernsey,Jersey,4,1,Friendly,St. Sampson,Guernsey,False,5,3,Guernsey
20788,22446,23889,2001,Jordan,Uzbekistan,1,1,FIFA World Cup qualification,Amman,Jordan,False,2,0,Draw
20789,22447,23890,2001,Oman,Philippines,7,0,FIFA World Cup qualification,Muscat,Oman,False,7,7,Oman
20790,22448,23891,2001,Syria,Laos,11,0,FIFA World Cup qualification,Aleppo,Syria,False,11,11,Syria
20791,22450,23893,2001,Estonia,Finland,1,1,Friendly,Kuressaare,Estonia,False,2,0,Draw
20792,22451,23894,2001,Georgia,Azerbaijan,1,0,Friendly,Kutaisi,Georgia,False,1,1,Georgia
20793,22452,23895,2001,Trinidad and Tobago,Grenada,5,3,Friendly,Macoya,Trinidad and Tobago,False,8,2,Trinidad and Tobago
20794,22453,23896,2001,Oman,Philippines,2,0,FIFA World Cup qualification,Muscat,Oman,False,2,2,Oman
20795,22454,23897,2001,Syria,Laos,9,0,FIFA World Cup qualification,Aleppo,Syria,False,9,9,Syria
20796,22455,23898,2001,Yemen,United Arab Emirates,2,1,FIFA World Cup qualification,Sana'a,Yemen,False,3,1,Yemen
20797,22456,23899,2001,Brunei,India,0,1,FIFA World Cup qualification,Bandar Seri Begawan,Brunei,False,1,-1,India
20798,22457,23901,2001,Lebanon,Pakistan,6,0,FIFA World Cup qualification,Beirut,Lebanon,False,6,6,Lebanon
20799,22458,23902,2001,Thailand,Sri Lanka,4,2,FIFA World Cup qualification,Beirut,Lebanon,True,6,2,Thailand
20800,22459,23903,2001,Lebanon,Sri Lanka,4,0,FIFA World Cup qualification,Beirut,Lebanon,False,4,4,Lebanon
20801,22460,23904,2001,Martinique,Jamaica,0,1,CFU Caribbean Cup,Arima,Trinidad and Tobago,True,1,-1,Jamaica
20802,22461,23905,2001,Thailand,Pakistan,3,0,FIFA World Cup qualification,Beirut,Lebanon,True,3,3,Thailand
20803,22462,23906,2001,Trinidad and Tobago,Barbados,5,0,CFU Caribbean Cup,Arima,Trinidad and Tobago,False,5,5,Trinidad and Tobago
20804,22463,23907,2001,Cuba,Suriname,4,3,CFU Caribbean Cup,Macoya,Trinidad and Tobago,True,7,1,Cuba
20805,22464,23908,2001,Haiti,Saint Kitts and Nevis,7,2,CFU Caribbean Cup,Macoya,Trinidad and Tobago,True,9,5,Haiti
20806,22465,23909,2001,Lebanon,Thailand,1,2,FIFA World Cup qualification,Beirut,Lebanon,False,3,-1,Thailand
20807,22466,23910,2001,Martinique,Barbados,3,1,CFU Caribbean Cup,Port of Spain,Trinidad and Tobago,True,4,2,Martinique
20808,22467,23911,2001,Pakistan,Sri Lanka,3,3,FIFA World Cup qualification,Beirut,Lebanon,True,6,0,Draw
20809,22468,23912,2001,Trinidad and Tobago,Jamaica,2,1,CFU Caribbean Cup,Port of Spain,Trinidad and Tobago,False,3,1,Trinidad and Tobago
20810,22469,23914,2001,Haiti,Suriname,1,1,CFU Caribbean Cup,Macoya,Trinidad and Tobago,True,2,0,Draw
20811,22470,23915,2001,Saint Kitts and Nevis,Cuba,1,1,CFU Caribbean Cup,Macoya,Trinidad and Tobago,True,2,0,Draw
20812,22471,23916,2001,Syria,Oman,3,3,FIFA World Cup qualification,Aleppo,Syria,False,6,0,Draw
20813,22472,23917,2001,United Arab Emirates,Yemen,3,2,FIFA World Cup qualification,Al Ain,United Arab Emirates,False,5,1,United Arab Emirates
20814,22473,23918,2001,Barbados,Jamaica,1,2,CFU Caribbean Cup,Port of Spain,Trinidad and Tobago,True,3,-1,Jamaica
20815,22474,23919,2001,Laos,Philippines,2,0,FIFA World Cup qualification,Vientiane,Laos,False,2,2,Laos
20816,22475,23920,2001,Trinidad and Tobago,Martinique,1,2,CFU Caribbean Cup,Port of Spain,Trinidad and Tobago,False,3,-1,Martinique
20817,22476,23922,2001,Haiti,Cuba,0,0,CFU Caribbean Cup,Arima,Trinidad and Tobago,True,0,0,Draw
20818,22477,23923,2001,India,Brunei,5,0,FIFA World Cup qualification,Bangalore,India,False,5,5,India
20819,22478,23924,2001,Lesotho,Eswatini,1,0,Friendly,Maseru,Lesotho,False,1,1,Lesotho
20820,22479,23925,2001,Suriname,Saint Kitts and Nevis,0,4,CFU Caribbean Cup,Arima,Trinidad and Tobago,True,4,-4,Saint Kitts and Nevis
20821,22480,23926,2001,Tunisia,Ivory Coast,1,1,FIFA World Cup qualification,Tunis,Tunisia,False,2,0,Draw
20822,22481,23927,2001,Haiti,Martinique,5,0,CFU Caribbean Cup,Port of Spain,Trinidad and Tobago,True,5,5,Haiti
20823,22482,23928,2001,Singapore,New Zealand,3,0,Friendly,Singapore,Singapore,False,3,3,Singapore
20824,22483,23929,2001,Trinidad and Tobago,Cuba,2,0,CFU Caribbean Cup,Port of Spain,Trinidad and Tobago,False,2,2,Trinidad and Tobago
20825,22484,23930,2001,Costa Rica,Belize,4,0,UNCAF Cup,San Pedro Sula,Honduras,True,4,4,Costa Rica
20826,22485,23931,2001,El Salvador,Nicaragua,3,0,UNCAF Cup,Puerto Cortés,Honduras,True,3,3,El Salvador
20827,22486,23932,2001,Honduras,Panama,1,2,UNCAF Cup,San Pedro Sula,Honduras,False,3,-1,Panama
20828,22487,23933,2001,Martinique,Cuba,1,0,CFU Caribbean Cup,Arima,Trinidad and Tobago,True,1,1,Martinique
20829,22488,23934,2001,El Salvador,Panama,2,1,UNCAF Cup,Tegucigalpa,Honduras,True,3,1,El Salvador
20830,22489,23935,2001,England,Mexico,4,0,Friendly,Derby,England,False,4,4,England
20831,22490,23936,2001,Guatemala,Belize,3,3,UNCAF Cup,Puerto Cortés,Honduras,True,6,0,Draw
20832,22491,23937,2001,Honduras,Nicaragua,10,2,UNCAF Cup,Tegucigalpa,Honduras,False,12,8,Honduras
20833,22492,23939,2001,Oman,Syria,2,0,FIFA World Cup qualification,Muscat,Oman,False,2,2,Oman
20834,22493,23940,2001,Trinidad and Tobago,Haiti,3,0,CFU Caribbean Cup,Port of Spain,Trinidad and Tobago,False,3,3,Trinidad and Tobago
20835,22494,23941,2001,Pakistan,Lebanon,1,8,FIFA World Cup qualification,Bangkok,Thailand,True,9,-7,Lebanon
20836,22495,23942,2001,Philippines,Laos,1,1,FIFA World Cup qualification,Pasig City,Philippines,False,2,0,Draw
20837,22496,23943,2001,Thailand,Sri Lanka,3,0,FIFA World Cup qualification,Bangkok,Thailand,False,3,3,Thailand
20838,22497,23944,2001,Costa Rica,Guatemala,1,1,UNCAF Cup,San Pedro Sula,Honduras,True,2,0,Draw
20839,22498,23945,2001,Honduras,El Salvador,1,1,UNCAF Cup,San Pedro Sula,Honduras,False,2,0,Draw
20840,22500,23947,2001,Panama,Nicaragua,6,0,UNCAF Cup,Puerto Cortés,Honduras,True,6,6,Panama
20841,22501,23948,2001,Sri Lanka,Lebanon,0,5,FIFA World Cup qualification,Bangkok,Thailand,True,5,-5,Lebanon
20842,22502,23949,2001,Thailand,Pakistan,6,0,FIFA World Cup qualification,Bangkok,Thailand,False,6,6,Thailand
20843,22503,23950,2001,Germany,Slovakia,2,0,Friendly,Bremen,Germany,False,2,2,Germany
20844,22504,23951,2001,El Salvador,Guatemala,0,0,UNCAF Cup,San Pedro Sula,Honduras,True,0,0,Draw
20845,22505,23953,2001,Mexico,Australia,0,2,Confederations Cup,Suwon,South Korea,True,2,-2,Australia
20846,22506,23954,2001,Panama,Costa Rica,1,2,UNCAF Cup,San Pedro Sula,Honduras,True,3,-1,Costa Rica
20847,22507,23955,2001,Sri Lanka,Pakistan,3,1,FIFA World Cup qualification,Bangkok,Thailand,True,4,2,Sri Lanka
20848,22508,23956,2001,Thailand,Lebanon,2,2,FIFA World Cup qualification,Bangkok,Thailand,False,4,0,Draw
20849,22509,23957,2001,Brazil,Cameroon,2,0,Confederations Cup,Kashima,Japan,True,2,2,Brazil
20850,22510,23958,2001,Japan,Canada,3,0,Confederations Cup,Niigata,Japan,False,3,3,Japan
20851,22511,23959,2001,Algeria,Angola,3,2,African Cup of Nations qualification,Algiers,Algeria,False,5,1,Algeria
20852,22512,23960,2001,Australia,France,1,0,Confederations Cup,Daegu,South Korea,True,1,1,Australia
20853,22513,23961,2001,El Salvador,Panama,1,1,UNCAF Cup,Tegucigalpa,Honduras,True,2,0,Draw
20854,22514,23962,2001,Guatemala,Costa Rica,2,0,UNCAF Cup,Tegucigalpa,Honduras,True,2,2,Guatemala
20855,22515,23964,2001,Armenia,Belarus,0,0,FIFA World Cup qualification,Yerevan,Armenia,False,0,0,Draw
20856,22516,23965,2001,Belgium,Latvia,3,1,FIFA World Cup qualification,Brussels,Belgium,False,4,2,Belgium
20857,22517,23966,2001,Canada,Brazil,0,0,Confederations Cup,Kashima,Japan,True,0,0,Draw
20858,22518,23967,2001,Croatia,San Marino,4,0,FIFA World Cup qualification,Varaždin,Croatia,False,4,4,Croatia
20859,22519,23968,2001,Denmark,Czech Republic,2,1,FIFA World Cup qualification,Copenhagen,Denmark,False,3,1,Denmark
20860,22520,23969,2001,Estonia,Netherlands,2,4,FIFA World Cup qualification,Tallinn,Estonia,False,6,-2,Netherlands
20861,22521,23970,2001,Faroe Islands,Switzerland,0,1,FIFA World Cup qualification,Toftir,Faroe Islands,False,1,-1,Switzerland
20862,22522,23971,2001,Finland,Germany,2,2,FIFA World Cup qualification,Helsinki,Finland,False,4,0,Draw
20863,22523,23972,2001,Gabon,Tunisia,1,1,African Cup of Nations qualification,Libreville,Gabon,False,2,0,Draw
20864,22524,23973,2001,Georgia,Italy,1,2,FIFA World Cup qualification,Tbilisi,Georgia,False,3,-1,Italy
20865,22525,23974,2001,Greece,Albania,1,0,FIFA World Cup qualification,Heraklion,Greece,False,1,1,Greece
20866,22526,23975,2001,Iceland,Malta,3,0,FIFA World Cup qualification,Reykjavík,Iceland,False,3,3,Iceland
20867,22527,23976,2001,Republic of Ireland,Portugal,1,1,FIFA World Cup qualification,Dublin,Republic of Ireland,False,2,0,Draw
20868,22528,23977,2001,Japan,Cameroon,2,0,Confederations Cup,Niigata,Japan,False,2,2,Japan
20869,22529,23978,2001,Kenya,Morocco,1,1,African Cup of Nations qualification,Nairobi,Kenya,False,2,0,Draw
20870,22530,23979,2001,Liechtenstein,Israel,0,3,FIFA World Cup qualification,Vaduz,Liechtenstein,False,3,-3,Israel
20871,22531,23981,2001,Nigeria,Madagascar,1,0,African Cup of Nations qualification,Benin City,Nigeria,False,1,1,Nigeria
20872,22532,23982,2001,Northern Ireland,Bulgaria,0,1,FIFA World Cup qualification,Belfast,Northern Ireland,False,1,-1,Bulgaria
20873,22533,23983,2001,Paraguay,Chile,1,0,FIFA World Cup qualification,Asunción,Paraguay,False,1,1,Paraguay
20874,22534,23984,2001,Peru,Ecuador,1,2,FIFA World Cup qualification,Lima,Peru,False,3,-1,Ecuador
20875,22535,23985,2001,Romania,Hungary,2,0,FIFA World Cup qualification,Bucharest,Romania,False,2,2,Romania
20876,22536,23986,2001,Russia,Serbia,1,1,FIFA World Cup qualification,Moscow,Russia,False,2,0,Draw
20877,22537,23987,2001,Slovenia,Luxembourg,2,0,FIFA World Cup qualification,Ljubljana,Slovenia,False,2,2,Slovenia
20878,22538,23988,2001,Spain,Bosnia and Herzegovina,4,1,FIFA World Cup qualification,Oviedo,Spain,False,5,3,Spain
20879,22539,23989,2001,Sweden,Slovakia,2,0,FIFA World Cup qualification,Solna,Sweden,False,2,2,Sweden
20880,22540,23990,2001,Turkey,Azerbaijan,3,0,FIFA World Cup qualification,Istanbul,Turkey,False,3,3,Turkey
20881,22541,23991,2001,Uganda,Togo,0,3,African Cup of Nations qualification,Kampala,Uganda,False,3,-3,Togo
20882,22542,23992,2001,Ukraine,Norway,0,0,FIFA World Cup qualification,Kyïv,Ukraine,False,0,0,Draw
20883,22543,23993,2001,Wales,Poland,1,2,FIFA World Cup qualification,Cardiff,Wales,False,3,-1,Poland
20884,22544,23994,2001,Zambia,Namibia,0,0,African Cup of Nations qualification,Chingola,Zambia,False,0,0,Draw
20885,22545,23995,2001,Argentina,Colombia,3,0,FIFA World Cup qualification,Buenos Aires,Argentina,False,3,3,Argentina
20886,22546,23996,2001,Bolivia,Venezuela,5,0,FIFA World Cup qualification,La Paz,Bolivia,False,5,5,Bolivia
20887,22547,23997,2001,Burundi,Burkina Faso,0,0,African Cup of Nations qualification,Bujumbura,Burundi,False,0,0,Draw
20888,22548,23998,2001,Congo,Mauritius,0,0,African Cup of Nations qualification,Pointe-Noire,Congo,False,0,0,Draw
20889,22549,23999,2001,Costa Rica,El Salvador,1,1,UNCAF Cup,San Pedro Sula,Honduras,True,2,0,Draw
20890,22550,24000,2001,France,Mexico,4,0,Confederations Cup,Ulsan,South Korea,True,4,4,France
20891,22551,24001,2001,Gambia,Senegal,0,0,Friendly,Banjul,Gambia,False,0,0,Draw
20892,22552,24002,2001,Guatemala,Panama,3,1,UNCAF Cup,San Pedro Sula,Honduras,True,4,2,Guatemala
20893,22553,24004,2001,Lesotho,DR Congo,0,0,African Cup of Nations qualification,Maseru,Lesotho,False,0,0,Draw
20894,22554,24005,2001,Liberia,South Africa,1,1,African Cup of Nations qualification,Paynesville,Liberia,False,2,0,Draw
20895,22555,24006,2001,Libya,Ivory Coast,0,3,African Cup of Nations qualification,Tripoli,Libya,False,3,-3,Ivory Coast
20896,22556,24007,2001,Zimbabwe,Ghana,1,2,African Cup of Nations qualification,Harare,Zimbabwe,False,3,-1,Ghana
20897,22557,24008,2001,Cameroon,Canada,2,0,Confederations Cup,Niigata,Japan,True,2,2,Cameroon
20898,22558,24009,2001,Japan,Brazil,0,0,Confederations Cup,Kashima,Japan,False,0,0,Draw
20899,22559,24010,2001,Solomon Islands,Cook Islands,9,1,FIFA World Cup qualification,North Shore,New Zealand,True,10,8,Solomon Islands
20900,22561,24012,2001,Albania,Germany,0,2,FIFA World Cup qualification,Tirana,Albania,False,2,-2,Germany
20901,22562,24013,2001,Armenia,Poland,1,1,FIFA World Cup qualification,Yerevan,Armenia,False,2,0,Draw
20902,22563,24014,2001,Azerbaijan,Slovakia,2,0,FIFA World Cup qualification,Baku,Azerbaijan,False,2,2,Azerbaijan
20903,22564,24015,2001,Cook Islands,Vanuatu,1,8,FIFA World Cup qualification,North Shore,New Zealand,True,9,-7,Vanuatu
20904,22565,24016,2001,Czech Republic,Northern Ireland,3,1,FIFA World Cup qualification,Teplice,Czech Republic,False,4,2,Czech Republic
20905,22566,24017,2001,Denmark,Malta,2,1,FIFA World Cup qualification,Copenhagen,Denmark,False,3,1,Denmark
20906,22567,24018,2001,Estonia,Republic of Ireland,0,2,FIFA World Cup qualification,Tallinn,Estonia,False,2,-2,Republic of Ireland
20907,22568,24019,2001,Faroe Islands,Serbia,0,6,FIFA World Cup qualification,Toftir,Faroe Islands,False,6,-6,Serbia
20908,22569,24020,2001,Greece,England,0,2,FIFA World Cup qualification,Athens,Greece,False,2,-2,England
20909,22570,24021,2001,Hungary,Georgia,4,1,FIFA World Cup qualification,Budapest,Hungary,False,5,3,Hungary
20910,22571,24022,2001,Iceland,Bulgaria,1,1,FIFA World Cup qualification,Reykjavík,Iceland,False,2,0,Draw
20911,22572,24023,2001,Israel,Spain,1,1,FIFA World Cup qualification,Ramat-Gan,Israel,False,2,0,Draw
20912,22573,24024,2001,Latvia,Croatia,0,1,FIFA World Cup qualification,Riga,Latvia,False,1,-1,Croatia
20913,22574,24025,2001,Lithuania,Romania,1,2,FIFA World Cup qualification,Kaunas,Lithuania,False,3,-1,Romania
20914,22575,24026,2001,Luxembourg,Russia,1,2,FIFA World Cup qualification,Luxembourg,Luxembourg,False,3,-1,Russia
20915,22577,24028,2001,Norway,Belarus,1,1,FIFA World Cup qualification,Oslo,Norway,False,2,0,Draw
20916,22578,24029,2001,Portugal,Cyprus,6,0,FIFA World Cup qualification,Lisbon,Portugal,False,6,6,Portugal
20917,22579,24030,2001,San Marino,Belgium,1,4,FIFA World Cup qualification,Serravalle,San Marino,False,5,-3,Belgium
20918,22580,24031,2001,Sweden,Moldova,6,0,FIFA World Cup qualification,Gothenburg,Sweden,False,6,6,Sweden
20919,22581,24032,2001,Switzerland,Slovenia,0,1,FIFA World Cup qualification,Basel,Switzerland,False,1,-1,Slovenia
20920,22583,24034,2001,Ukraine,Wales,1,1,FIFA World Cup qualification,Kyïv,Ukraine,False,2,0,Draw
20921,22584,24035,2001,France,Brazil,2,1,Confederations Cup,Suwon,South Korea,True,3,1,France
20922,22585,24036,2001,Japan,Australia,1,0,Confederations Cup,Yokohama,Japan,False,1,1,Japan
20923,22586,24037,2001,United States,Ecuador,0,0,Friendly,Columbus,United States,False,0,0,Draw
20924,22587,24038,2001,New Zealand,Cook Islands,2,0,FIFA World Cup qualification,North Shore,New Zealand,False,2,2,New Zealand
20925,22588,24039,2001,Vanuatu,Solomon Islands,2,7,FIFA World Cup qualification,North Shore,New Zealand,True,9,-5,Solomon Islands
20926,22589,24040,2001,Australia,Brazil,1,0,Confederations Cup,Ulsan,South Korea,True,1,1,Australia
20927,22590,24041,2001,Angola,Mauritius,1,0,COSAFA Cup,Luanda,Angola,False,1,1,Angola
20928,22591,24042,2001,Jamaica,Cuba,4,1,Friendly,Kingston,Jamaica,False,5,3,Jamaica
20929,22592,24043,2001,Japan,France,0,1,Confederations Cup,Yokohama,Japan,False,1,-1,France
20930,22593,24044,2001,Kenya,Egypt,1,1,Friendly,Nairobi,Kenya,False,2,0,Draw
20931,22594,24045,2001,Panama,Trinidad and Tobago,0,0,Friendly,La Chorrera,Panama,False,0,0,Draw
20932,22595,24046,2001,Sierra Leone,Gambia,1,1,Friendly,Freetown,Sierra Leone,False,2,0,Draw
20933,22597,24048,2001,New Zealand,Solomon Islands,5,1,FIFA World Cup qualification,North Shore,New Zealand,False,6,4,New Zealand
20934,22598,24049,2001,New Zealand,Vanuatu,7,0,FIFA World Cup qualification,North Shore,New Zealand,False,7,7,New Zealand
20935,22599,24051,2001,Jamaica,United States,0,0,FIFA World Cup qualification,Kingston,Jamaica,False,0,0,Draw
20936,22600,24052,2001,Madagascar,Zambia,0,1,African Cup of Nations qualification,Antananarivo,Madagascar,False,1,-1,Zambia
20937,22601,24053,2001,Mexico,Costa Rica,1,2,FIFA World Cup qualification,Mexico City,Mexico,False,3,-1,Costa Rica
20938,22602,24054,2001,Morocco,Gabon,0,1,African Cup of Nations qualification,Fès,Morocco,False,1,-1,Gabon
20939,22603,24055,2001,Namibia,Nigeria,0,2,African Cup of Nations qualification,Windhoek,Namibia,False,2,-2,Nigeria
20940,22604,24056,2001,Trinidad and Tobago,Honduras,2,4,FIFA World Cup qualification,Port of Spain,Trinidad and Tobago,False,6,-2,Honduras
20941,22605,24057,2001,Angola,Burundi,2,1,African Cup of Nations qualification,Cabinda,Angola,False,3,1,Angola
20942,22606,24058,2001,Burkina Faso,Algeria,1,0,African Cup of Nations qualification,Ouagadougou,Burkina Faso,False,1,1,Burkina Faso
20943,22607,24059,2001,DR Congo,Zimbabwe,2,1,African Cup of Nations qualification,Kinshasa,DR Congo,False,3,1,DR Congo
20944,22608,24060,2001,Ivory Coast,Egypt,2,2,African Cup of Nations qualification,Abidjan,Ivory Coast,False,4,0,Draw
20945,22609,24061,2001,Sudan,Libya,1,0,African Cup of Nations qualification,Khartoum,Sudan,False,1,1,Sudan
20946,22610,24062,2001,Costa Rica,Jamaica,2,1,FIFA World Cup qualification,Alajuela,Costa Rica,False,3,1,Costa Rica
20947,22611,24063,2001,Honduras,Mexico,3,1,FIFA World Cup qualification,San Pedro Sula,Honduras,False,4,2,Honduras
20948,22612,24064,2001,New Zealand,Australia,0,2,FIFA World Cup qualification,Wellington,New Zealand,False,2,-2,Australia
20949,22613,24065,2001,United States,Trinidad and Tobago,2,0,FIFA World Cup qualification,Foxborough,United States,False,2,2,United States
20950,22614,24066,2001,Malaysia,Bahrain,2,4,Merdeka Tournament,Shah Alam,Malaysia,False,6,-2,Bahrain
20951,22615,24067,2001,Bahrain,Bosnia and Herzegovina,0,1,Merdeka Tournament,Shah Alam,Malaysia,True,1,-1,Bosnia and Herzegovina
20952,22616,24068,2001,Bermuda,Trinidad and Tobago,0,5,Friendly,Hamilton,Bermuda,False,5,-5,Trinidad and Tobago
20953,22617,24069,2001,Australia,New Zealand,4,1,FIFA World Cup qualification,Sydney,Australia,False,5,3,Australia
20954,22618,24070,2001,Belize,Cuba,3,2,Friendly,Belize,Belize,False,5,1,Belize
20955,22619,24071,2001,Lesotho,Zambia,1,2,COSAFA Cup,Maseru,Lesotho,False,3,-1,Zambia
20956,22620,24072,2001,Malaysia,Bosnia and Herzegovina,2,2,Merdeka Tournament,Shah Alam,Malaysia,False,4,0,Draw
20957,22621,24073,2001,India,Uzbekistan,1,2,Merdeka Tournament,Shah Alam,Malaysia,True,3,-1,Uzbekistan
20958,22622,24074,2001,Bahrain,Uzbekistan,0,2,Merdeka Tournament,Shah Alam,Malaysia,True,2,-2,Uzbekistan
20959,22623,24075,2001,Paraguay,Serbia,2,0,Kirin Cup,Tokyo,Japan,True,2,2,Paraguay
20960,22624,24076,2001,Libya,Angola,1,1,FIFA World Cup qualification,Tripoli,Libya,False,2,0,Draw
20961,22625,24077,2001,Bosnia and Herzegovina,Uzbekistan,1,2,Merdeka Tournament,Shah Alam,Malaysia,True,3,-1,Uzbekistan
20962,22627,24079,2001,Morocco,Egypt,1,0,FIFA World Cup qualification,Rabat,Morocco,False,1,1,Morocco
20963,22628,24080,2001,Namibia,Algeria,0,4,FIFA World Cup qualification,Windhoek,Namibia,False,4,-4,Algeria
20964,22629,24081,2001,Trinidad and Tobago,Jamaica,1,2,FIFA World Cup qualification,Port of Spain,Trinidad and Tobago,False,3,-1,Jamaica
20965,22630,24082,2001,Burkina Faso,South Africa,1,1,FIFA World Cup qualification,Ouagadougou,Burkina Faso,False,2,0,Draw
20966,22631,24083,2001,Cameroon,Togo,2,0,FIFA World Cup qualification,Yaoundé,Cameroon,False,2,2,Cameroon
20967,22632,24084,2001,Honduras,Costa Rica,2,3,FIFA World Cup qualification,Tegucigalpa,Honduras,False,5,-1,Costa Rica
20968,22633,24085,2001,Ivory Coast,Madagascar,6,0,FIFA World Cup qualification,Abidjan,Ivory Coast,False,6,6,Ivory Coast
20969,22634,24086,2001,Japan,Paraguay,2,0,Kirin Cup,Sapporo,Japan,False,2,2,Japan
20970,22635,24087,2001,Liberia,Ghana,1,2,FIFA World Cup qualification,Paynesville,Liberia,False,3,-1,Ghana
20971,22636,24088,2001,Malawi,Eswatini,2,2,Friendly,Lilongwe,Malawi,False,4,0,Draw
20972,22637,24089,2001,Mexico,United States,1,0,FIFA World Cup qualification,Mexico City,Mexico,False,1,1,Mexico
20973,22638,24090,2001,Sudan,Nigeria,0,4,FIFA World Cup qualification,Omdurman,Sudan,False,4,-4,Nigeria
20974,22639,24091,2001,Tunisia,Congo,6,0,FIFA World Cup qualification,Tunis,Tunisia,False,6,6,Tunisia
20975,22640,24092,2001,Uruguay,Brazil,1,0,FIFA World Cup qualification,Montevideo,Uruguay,False,1,1,Uruguay
20976,22641,24093,2001,El Salvador,Ecuador,0,1,Friendly,East Rutherford,United States,True,1,-1,Ecuador
20977,22642,24094,2001,Latvia,Estonia,3,1,Baltic Cup,Riga,Latvia,False,4,2,Latvia
20978,22643,24095,2001,Estonia,Lithuania,2,5,Baltic Cup,Riga,Latvia,True,7,-3,Lithuania
20979,22644,24096,2001,Japan,Serbia,1,0,Kirin Cup,Ōita,Japan,False,1,1,Japan
20980,22645,24097,2001,Latvia,Lithuania,4,1,Baltic Cup,Riga,Latvia,False,5,3,Latvia
20981,22646,24098,2001,Honduras,Ecuador,1,1,Friendly,Miami,United States,True,2,0,Draw
20982,22647,24099,2001,Zimbabwe,Eswatini,2,1,COSAFA Cup,Harare,Zimbabwe,False,3,1,Zimbabwe
20983,22649,24103,2001,Isle of Man,Falkland Islands,9,0,Island Games,Douglas,Isle of Man,False,9,9,Isle of Man
20984,22651,24107,2001,Guernsey,Falkland Islands,3,0,Island Games,Douglas,Isle of Man,True,3,3,Guernsey
20985,22652,24108,2001,Singapore,Saudi Arabia,0,3,Friendly,Singapore,Singapore,False,3,-3,Saudi Arabia
20986,22653,24110,2001,Jersey,Gibraltar,2,1,Island Games,Douglas,Isle of Man,True,3,1,Jersey
20987,22654,24112,2001,Isle of Man,Guernsey,2,3,Island Games,Douglas,Isle of Man,False,5,-1,Guernsey
20988,22655,24113,2001,Colombia,Venezuela,2,0,Copa América,Barranquilla,Colombia,False,2,2,Colombia
20989,22656,24114,2001,Ecuador,Chile,1,4,Copa América,Barranquilla,Colombia,True,5,-3,Chile
20990,22657,24115,2001,Brazil,Mexico,0,1,Copa América,Cali,Colombia,True,1,-1,Mexico
20991,22658,24116,2001,Peru,Paraguay,3,3,Copa América,Cali,Colombia,True,6,0,Draw
20992,22659,24118,2001,Greenland,Falkland Islands,4,0,Island Games,Braddan,Isle of Man,True,4,4,Greenland
20993,22662,24123,2001,Bolivia,Uruguay,0,1,Copa América,Medellín,Colombia,True,1,-1,Uruguay
20994,22663,24124,2001,Egypt,Namibia,8,2,FIFA World Cup qualification,Alexandria,Egypt,False,10,6,Egypt
20995,22664,24125,2001,Honduras,Costa Rica,0,1,Copa América,Medellín,Colombia,True,1,-1,Costa Rica
20996,22669,24132,2001,Chile,Venezuela,1,0,Copa América,Barranquilla,Colombia,True,1,1,Chile
20997,22670,24133,2001,Colombia,Ecuador,1,0,Copa América,Barranquilla,Colombia,False,1,1,Colombia
20998,22672,24135,2001,Senegal,Morocco,1,0,FIFA World Cup qualification,Dakar,Senegal,False,1,1,Senegal
20999,22673,24136,2001,Sierra Leone,Liberia,0,1,FIFA World Cup qualification,Freetown,Sierra Leone,False,1,-1,Liberia
21000,22674,24137,2001,South Africa,Malawi,2,0,FIFA World Cup qualification,Durban,South Africa,False,2,2,South Africa
21001,22675,24138,2001,Zambia,Cameroon,2,2,FIFA World Cup qualification,Lusaka,Zambia,False,4,0,Draw
21002,22676,24139,2001,Brazil,Peru,2,0,Copa América,Cali,Colombia,True,2,2,Brazil
21003,22677,24140,2001,Congo,Ivory Coast,1,1,FIFA World Cup qualification,Pointe-Noire,Congo,False,2,0,Draw
21004,22678,24141,2001,DR Congo,Tunisia,0,3,FIFA World Cup qualification,Kinshasa,DR Congo,False,3,-3,Tunisia
21005,22679,24142,2001,Ghana,Sudan,1,0,FIFA World Cup qualification,Accra,Ghana,False,1,1,Ghana
21006,22680,24143,2001,Paraguay,Mexico,0,0,Copa América,Cali,Colombia,True,0,0,Draw
21007,22681,24144,2001,Togo,Libya,2,0,FIFA World Cup qualification,Lomé,Togo,False,2,2,Togo
21008,22682,24145,2001,Zimbabwe,Burkina Faso,1,0,FIFA World Cup qualification,Harare,Zimbabwe,False,1,1,Zimbabwe
21009,22683,24146,2001,Honduras,Bolivia,2,0,Copa América,Medellín,Colombia,True,2,2,Honduras
21010,22684,24147,2001,Uruguay,Costa Rica,1,1,Copa América,Medellín,Colombia,True,2,0,Draw
21011,22685,24148,2001,Colombia,Chile,2,0,Copa América,Barranquilla,Colombia,False,2,2,Colombia
21012,22686,24149,2001,Ecuador,Venezuela,4,0,Copa América,Barranquilla,Colombia,True,4,4,Ecuador
21013,22687,24150,2001,Brazil,Paraguay,3,1,Copa América,Cali,Colombia,True,4,2,Brazil
21014,22688,24151,2001,Peru,Mexico,1,0,Copa América,Cali,Colombia,True,1,1,Peru
21015,22689,24152,2001,Bolivia,Costa Rica,0,4,Copa América,Medellín,Colombia,True,4,-4,Costa Rica
21016,22690,24153,2001,Honduras,Uruguay,1,0,Copa América,Medellín,Colombia,True,1,1,Honduras
21017,22691,24154,2001,Malaysia,Saudi Arabia,0,4,Friendly,Kuala Lumpur,Malaysia,False,4,-4,Saudi Arabia
21018,22692,24155,2001,Cuba,Jamaica,0,0,Friendly,Havana,Cuba,False,0,0,Draw
21019,22693,24156,2001,Algeria,Egypt,1,1,FIFA World Cup qualification,Annaba,Algeria,False,2,0,Draw
21020,22694,24157,2001,Malawi,South Africa,1,0,COSAFA Cup,Blantyre,Malawi,False,1,1,Malawi
21021,22695,24158,2001,Namibia,Senegal,0,5,FIFA World Cup qualification,Windhoek,Namibia,False,5,-5,Senegal
21022,22696,24159,2001,Bosnia and Herzegovina,Iran,2,2,Friendly,Bihać,Bosnia and Herzegovina,False,4,0,Draw
21023,22697,24160,2001,Chile,Mexico,0,2,Copa América,Pereira,Colombia,True,2,-2,Mexico
21024,22698,24161,2001,Uruguay,Costa Rica,2,1,Copa América,Armenia,Colombia,True,3,1,Uruguay
21025,22699,24162,2001,Brazil,Honduras,0,2,Copa América,Manizales,Colombia,True,2,-2,Honduras
21026,22700,24163,2001,Colombia,Peru,3,0,Copa América,Armenia,Colombia,False,3,3,Colombia
21027,22702,24166,2001,Mexico,Uruguay,2,1,Copa América,Pereira,Colombia,True,3,1,Mexico
21028,22703,24167,2001,Colombia,Honduras,2,0,Copa América,Manizales,Colombia,False,2,2,Colombia
21029,22704,24168,2001,Jamaica,Martinique,0,0,SKN Football Festival,Basseterre,Saint Kitts and Nevis,True,0,0,Draw
21030,22705,24169,2001,Libya,Zambia,2,4,FIFA World Cup qualification,Tripoli,Libya,False,6,-2,Zambia
21031,22706,24170,2001,Malawi,Zimbabwe,0,1,FIFA World Cup qualification,Blantyre,Malawi,False,1,-1,Zimbabwe
21032,22707,24171,2001,Saint Kitts and Nevis,Martinique,4,2,SKN Football Festival,Basseterre,Saint Kitts and Nevis,False,6,2,Saint Kitts and Nevis
21033,22708,24172,2001,Uruguay,Honduras,2,2,Copa América,Bogotá,Colombia,True,4,0,Draw
21034,22709,24173,2001,Angola,Togo,1,1,FIFA World Cup qualification,Luanda,Angola,False,2,0,Draw
21035,22710,24174,2001,Colombia,Mexico,1,0,Copa América,Bogotá,Colombia,False,1,1,Colombia
21036,22711,24175,2001,Ivory Coast,DR Congo,1,2,FIFA World Cup qualification,Abidjan,Ivory Coast,False,3,-1,DR Congo
21037,22712,24176,2001,Madagascar,Congo,1,0,FIFA World Cup qualification,Antananarivo,Madagascar,False,1,1,Madagascar
21038,22713,24177,2001,Nigeria,Ghana,3,0,FIFA World Cup qualification,Port Harcourt,Nigeria,False,3,3,Nigeria
21039,22714,24178,2001,Oman,Iraq,1,0,Friendly,Muscat,Oman,False,1,1,Oman
21040,22715,24179,2001,Panama,Cuba,0,0,Gold Cup qualification,Panama City,Panama,False,0,0,Draw
21041,22716,24180,2001,Sudan,Sierra Leone,3,0,FIFA World Cup qualification,Omdurman,Sudan,False,3,3,Sudan
21042,22717,24181,2001,Saint Kitts and Nevis,Jamaica,0,0,SKN Football Festival,Basseterre,Saint Kitts and Nevis,False,0,0,Draw
21043,22718,24182,2001,Grenada,Jamaica,2,0,Friendly,St. George's,Grenada,False,2,2,Grenada
21044,22719,24183,2001,Qatar,Iran,2,1,Friendly,Doha,Qatar,False,3,1,Qatar
21045,22721,24185,2001,United Arab Emirates,Iraq,2,2,Friendly,Abu Dhabi,United Arab Emirates,False,4,0,Draw
21046,22722,24187,2001,Kuwait,Trinidad and Tobago,1,1,Friendly,Shanghai,China PR,True,2,0,Draw
21047,22723,24188,2001,Colombia,Liberia,2,1,Friendly,East Rutherford,United States,True,3,1,Colombia
21048,22724,24190,2001,Cuba,Panama,1,0,Gold Cup qualification,Havana,Cuba,False,1,1,Cuba
21049,22726,24192,2001,Saudi Arabia,Qatar,1,2,Friendly,Riyadh,Saudi Arabia,False,3,-1,Qatar
21050,22727,24193,2001,Iran,Oman,5,2,Friendly,Teheran,Iran,False,7,3,Iran
21051,22728,24194,2001,United Arab Emirates,Saudi Arabia,0,1,Friendly,Doha,Qatar,True,1,-1,Saudi Arabia
21052,22729,24195,2001,Brazil,Panama,5,0,Friendly,Curitiba,Brazil,False,5,5,Brazil
21053,22730,24196,2001,Iran,Bosnia and Herzegovina,4,0,Friendly,Teheran,Iran,False,4,4,Iran
21054,22731,24197,2001,Qatar,Bahrain,1,1,Friendly,Doha,Qatar,False,2,0,Draw
21055,22732,24198,2001,Singapore,Thailand,0,5,Friendly,Singapore,Singapore,False,5,-5,Thailand
21056,22733,24199,2001,Chile,Bolivia,2,2,FIFA World Cup qualification,Santiago,Chile,False,4,0,Draw
21057,22734,24200,2001,Venezuela,Uruguay,2,0,FIFA World Cup qualification,Maracaibo,Venezuela,False,2,2,Venezuela
21058,22735,24201,2001,Austria,Switzerland,1,2,Friendly,Vienna,Austria,False,3,-1,Switzerland
21059,22736,24202,2001,Bosnia and Herzegovina,Malta,2,0,Friendly,Sarajevo,Bosnia and Herzegovina,False,2,2,Bosnia and Herzegovina
21060,22737,24203,2001,Brazil,Paraguay,2,0,FIFA World Cup qualification,Porto Alegre,Brazil,False,2,2,Brazil
21061,22740,24206,2001,Ecuador,Argentina,0,2,FIFA World Cup qualification,Quito,Ecuador,False,2,-2,Argentina
21062,22741,24207,2001,England,Netherlands,0,2,Friendly,London,England,False,2,-2,Netherlands
21063,22742,24208,2001,Estonia,Cyprus,2,2,FIFA World Cup qualification,Tallinn,Estonia,False,4,0,Draw
21064,22743,24209,2001,Finland,Belgium,4,1,Friendly,Helsinki,Finland,False,5,3,Finland
21065,22744,24210,2001,France,Denmark,1,0,Friendly,Nantes,France,False,1,1,France
21066,22745,24211,2001,Hungary,Germany,2,5,Friendly,Budapest,Hungary,False,7,-3,Germany
21067,22746,24212,2001,Iceland,Poland,1,1,Friendly,Reykjavík,Iceland,False,2,0,Draw
21068,22747,24213,2001,Republic of Ireland,Croatia,2,2,Friendly,Dublin,Republic of Ireland,False,4,0,Draw
21069,22748,24214,2001,Japan,Australia,3,0,Friendly,Fukuroi,Japan,False,3,3,Japan
21070,22749,24215,2001,Latvia,Ukraine,0,1,Friendly,Riga,Latvia,False,1,-1,Ukraine
21071,22750,24216,2001,Lithuania,Israel,2,3,Friendly,Kaunas,Lithuania,False,5,-1,Israel
21072,22751,24217,2001,Luxembourg,Georgia,0,3,Friendly,Mondercange,Luxembourg,False,3,-3,Georgia
21073,22752,24218,2001,Norway,Turkey,1,1,Friendly,Oslo,Norway,False,2,0,Draw
21074,22753,24219,2001,Portugal,Moldova,3,0,Friendly,Faro,Portugal,False,3,3,Portugal
21075,22754,24220,2001,Russia,Greece,0,0,Friendly,Moscow,Russia,False,0,0,Draw
21076,22755,24221,2001,Serbia,Faroe Islands,2,0,FIFA World Cup qualification,Belgrade,Yugoslavia,True,2,2,Serbia
21077,22756,24222,2001,Slovakia,Iran,3,4,Friendly,Bratislava,Slovakia,False,7,-1,Iran
21078,22757,24223,2001,Slovenia,Romania,2,2,Friendly,Ljubljana,Slovenia,False,4,0,Draw
21079,22758,24224,2001,Sweden,South Africa,3,0,Friendly,Solna,Sweden,False,3,3,Sweden
21080,22759,24225,2001,Colombia,Peru,0,1,FIFA World Cup qualification,Bogotá,Colombia,False,1,-1,Peru
21081,22760,24226,2001,Qatar,Oman,0,0,FIFA World Cup qualification,Doha,Qatar,False,0,0,Draw
21082,22761,24227,2001,Iraq,Thailand,4,0,FIFA World Cup qualification,Baghdad,Iraq,False,4,4,Iraq
21083,22762,24228,2001,Saudi Arabia,Bahrain,1,1,FIFA World Cup qualification,Riyadh,Saudi Arabia,False,2,0,Draw
21084,22763,24229,2001,United Arab Emirates,Uzbekistan,4,1,FIFA World Cup qualification,Abu Dhabi,United Arab Emirates,False,5,3,United Arab Emirates
21085,22764,24230,2001,Zambia,Angola,1,1,COSAFA Cup,Lusaka,Zambia,False,2,0,Draw
21086,22765,24231,2001,Bahrain,Iraq,2,0,FIFA World Cup qualification,Riffa,Bahrain,False,2,2,Bahrain
21087,22766,24232,2001,Mexico,Liberia,5,4,Friendly,Veracruz,Mexico,False,9,1,Mexico
21088,22767,24233,2001,Iran,Saudi Arabia,2,0,FIFA World Cup qualification,Teheran,Iran,False,2,2,Iran
21089,22768,24235,2001,Malawi,Zimbabwe,0,2,COSAFA Cup,Blantyre,Malawi,False,2,-2,Zimbabwe
21090,22769,24236,2001,Uzbekistan,Qatar,2,1,FIFA World Cup qualification,Tashkent,Uzbekistan,False,3,1,Uzbekistan
21091,22771,24238,2001,Saudi Arabia,Iraq,1,0,FIFA World Cup qualification,Riffa,Bahrain,True,1,1,Saudi Arabia
21092,22772,24239,2001,United Arab Emirates,Qatar,0,2,FIFA World Cup qualification,Abu Dhabi,United Arab Emirates,False,2,-2,Qatar
21093,22773,24240,2001,Albania,Finland,0,2,FIFA World Cup qualification,Tirana,Albania,False,2,-2,Finland
21094,22774,24241,2001,Andorra,Portugal,1,7,FIFA World Cup qualification,Lleida,Spain,True,8,-6,Portugal
21095,22775,24242,2001,Belarus,Ukraine,0,2,FIFA World Cup qualification,Minsk,Belarus,False,2,-2,Ukraine
21096,22776,24243,2001,Bosnia and Herzegovina,Israel,0,0,FIFA World Cup qualification,Sarajevo,Bosnia and Herzegovina,False,0,0,Draw
21097,22777,24244,2001,Chile,France,2,1,Friendly,Santiago,Chile,False,3,1,Chile
21098,22778,24245,2001,Denmark,Northern Ireland,1,1,FIFA World Cup qualification,Copenhagen,Denmark,False,2,0,Draw
21099,22779,24246,2001,Faroe Islands,Luxembourg,1,0,FIFA World Cup qualification,Toftir,Faroe Islands,False,1,1,Faroe Islands
21100,22780,24247,2001,Georgia,Hungary,3,1,FIFA World Cup qualification,Tbilisi,Georgia,False,4,2,Georgia
21101,22781,24248,2001,Germany,England,1,5,FIFA World Cup qualification,Munich,Germany,False,6,-4,England
21102,22782,24249,2001,Iceland,Czech Republic,3,1,FIFA World Cup qualification,Reykjavík,Iceland,False,4,2,Iceland
21103,22783,24250,2001,Republic of Ireland,Netherlands,1,0,FIFA World Cup qualification,Dublin,Republic of Ireland,False,1,1,Republic of Ireland
21104,22784,24251,2001,Lithuania,Italy,0,0,FIFA World Cup qualification,Kaunas,Lithuania,False,0,0,Draw
21105,22785,24253,2001,Malta,Bulgaria,0,2,FIFA World Cup qualification,Attard,Malta,False,2,-2,Bulgaria
21106,22786,24254,2001,Moldova,Azerbaijan,2,0,FIFA World Cup qualification,Chişinău,Moldova,False,2,2,Moldova
21107,22787,24255,2001,Poland,Norway,3,0,FIFA World Cup qualification,Chorzów,Poland,False,3,3,Poland
21108,22788,24256,2001,Scotland,Croatia,0,0,FIFA World Cup qualification,Glasgow,Scotland,False,0,0,Draw
21109,22789,24257,2001,Slovakia,Turkey,0,1,FIFA World Cup qualification,Bratislava,Slovakia,False,1,-1,Turkey
21110,22790,24258,2001,Slovenia,Russia,2,1,FIFA World Cup qualification,Ljubljana,Slovenia,False,3,1,Slovenia
21111,22791,24259,2001,Spain,Austria,4,0,FIFA World Cup qualification,Valencia,Spain,False,4,4,Spain
21112,22792,24260,2001,Switzerland,Serbia,1,2,FIFA World Cup qualification,Basel,Switzerland,False,3,-1,Serbia
21113,22793,24261,2001,Thailand,Iran,0,0,FIFA World Cup qualification,Bangkok,Thailand,False,0,0,Draw
21114,22794,24262,2001,Trinidad and Tobago,Costa Rica,0,2,FIFA World Cup qualification,Port of Spain,Trinidad and Tobago,False,2,-2,Costa Rica
21115,22795,24263,2001,United States,Honduras,2,3,FIFA World Cup qualification,Washington,United States,False,5,-1,Honduras
21116,22796,24264,2001,Wales,Armenia,0,0,FIFA World Cup qualification,Cardiff,Wales,False,0,0,Draw
21117,22797,24265,2001,Jamaica,Mexico,1,2,FIFA World Cup qualification,Kingston,Jamaica,False,3,-1,Mexico
21118,22798,24266,2001,Chile,Venezuela,0,2,FIFA World Cup qualification,Santiago,Chile,False,2,-2,Venezuela
21119,22799,24267,2001,Peru,Uruguay,0,2,FIFA World Cup qualification,Lima,Peru,False,2,-2,Uruguay
21120,22800,24268,2001,Argentina,Brazil,2,1,FIFA World Cup qualification,Buenos Aires,Argentina,False,3,1,Argentina
21121,22801,24269,2001,Austria,Bosnia and Herzegovina,2,0,FIFA World Cup qualification,Vienna,Austria,False,2,2,Austria
21122,22803,24271,2001,Belarus,Poland,4,1,FIFA World Cup qualification,Minsk,Belarus,False,5,3,Belarus
21123,22804,24272,2001,Belgium,Scotland,2,0,FIFA World Cup qualification,Brussels,Belgium,False,2,2,Belgium
21124,22805,24273,2001,Bulgaria,Denmark,0,2,FIFA World Cup qualification,Sofia,Bulgaria,False,2,-2,Denmark
21125,22806,24274,2001,Colombia,Ecuador,0,0,FIFA World Cup qualification,Bogotá,Colombia,False,0,0,Draw
21126,22807,24275,2001,Costa Rica,United States,2,0,FIFA World Cup qualification,San José,Costa Rica,False,2,2,Costa Rica
21127,22808,24276,2001,Cyprus,Portugal,1,3,FIFA World Cup qualification,Larnaca,Cyprus,False,4,-2,Portugal
21128,22809,24277,2001,Czech Republic,Malta,3,2,FIFA World Cup qualification,Teplice,Czech Republic,False,5,1,Czech Republic
21129,22810,24278,2001,England,Albania,2,0,FIFA World Cup qualification,Newcastle,England,False,2,2,England
21130,22811,24279,2001,Faroe Islands,Russia,0,3,FIFA World Cup qualification,Tórshavn,Faroe Islands,False,3,-3,Russia
21131,22812,24280,2001,Finland,Greece,5,1,FIFA World Cup qualification,Helsinki,Finland,False,6,4,Finland
21132,22813,24281,2001,Georgia,Lithuania,2,0,FIFA World Cup qualification,Tbilisi,Georgia,False,2,2,Georgia
21133,22814,24282,2001,Honduras,Jamaica,1,0,FIFA World Cup qualification,Tegucigalpa,Honduras,False,1,1,Honduras
21134,22815,24283,2001,Hungary,Romania,0,2,FIFA World Cup qualification,Budapest,Hungary,False,2,-2,Romania
21135,22816,24284,2001,Italy,Morocco,1,0,Friendly,Piacenza,Italy,False,1,1,Italy
21136,22817,24285,2001,Liechtenstein,Spain,0,2,FIFA World Cup qualification,Vaduz,Liechtenstein,False,2,-2,Spain
21137,22818,24286,2001,Luxembourg,Switzerland,0,3,FIFA World Cup qualification,Luxembourg,Luxembourg,False,3,-3,Switzerland
21138,22819,24287,2001,Mexico,Trinidad and Tobago,3,0,FIFA World Cup qualification,Mexico City,Mexico,False,3,3,Mexico
21139,22820,24288,2001,Netherlands,Estonia,5,0,FIFA World Cup qualification,Eindhoven,Netherlands,False,5,5,Netherlands
21140,22821,24289,2001,Northern Ireland,Iceland,3,0,FIFA World Cup qualification,Belfast,Northern Ireland,False,3,3,Northern Ireland
21141,22822,24290,2001,Norway,Wales,3,2,FIFA World Cup qualification,Oslo,Norway,False,5,1,Norway
21142,22823,24291,2001,Paraguay,Bolivia,5,1,FIFA World Cup qualification,Asunción,Paraguay,False,6,4,Paraguay
21143,22824,24292,2001,San Marino,Croatia,0,4,FIFA World Cup qualification,Serravalle,San Marino,False,4,-4,Croatia
21144,22825,24293,2001,Serbia,Slovenia,1,1,FIFA World Cup qualification,Belgrade,Yugoslavia,True,2,0,Draw
21145,22826,24294,2001,Slovakia,Moldova,4,2,FIFA World Cup qualification,Trenčín,Slovakia,False,6,2,Slovakia
21146,22827,24295,2001,Turkey,Sweden,1,2,FIFA World Cup qualification,Istanbul,Turkey,False,3,-1,Sweden
21147,22828,24296,2001,Ukraine,Armenia,3,0,FIFA World Cup qualification,L'viv,Ukraine,False,3,3,Ukraine
21148,22829,24297,2001,Bahrain,Thailand,1,1,FIFA World Cup qualification,Riffa,Bahrain,False,2,0,Draw
21149,22830,24298,2001,Iraq,Iran,1,2,FIFA World Cup qualification,Baghdad,Iraq,False,3,-1,Iran
21150,22832,24300,2001,Saudi Arabia,United Arab Emirates,0,2,Friendly,Dammam,Saudi Arabia,False,2,-2,United Arab Emirates
21151,22833,24301,2001,Uzbekistan,Oman,5,0,FIFA World Cup qualification,Tashkent,Uzbekistan,False,5,5,Uzbekistan
21152,22834,24303,2001,Iran,Bahrain,0,0,FIFA World Cup qualification,Teheran,Iran,False,0,0,Draw
21153,22835,24304,2001,Oman,United Arab Emirates,1,1,FIFA World Cup qualification,Muscat,Oman,False,2,0,Draw
21154,22836,24305,2001,Qatar,Iraq,0,0,Friendly,Doha,Qatar,False,0,0,Draw
21155,22837,24307,2001,Thailand,Saudi Arabia,1,3,FIFA World Cup qualification,Bangkok,Thailand,False,4,-2,Saudi Arabia
21156,22838,24308,2001,Angola,Zimbabwe,0,0,COSAFA Cup,Luanda,Angola,False,0,0,Draw
21157,22839,24310,2001,Bahrain,Saudi Arabia,0,4,FIFA World Cup qualification,Riffa,Bahrain,False,4,-4,Saudi Arabia
21158,22840,24311,2001,Oman,Qatar,0,3,FIFA World Cup qualification,Muscat,Oman,False,3,-3,Qatar
21159,22841,24312,2001,Thailand,Iraq,1,1,FIFA World Cup qualification,Bangkok,Thailand,False,2,0,Draw
21160,22842,24313,2001,Uzbekistan,United Arab Emirates,0,1,FIFA World Cup qualification,Tashkent,Uzbekistan,False,1,-1,United Arab Emirates
21161,22844,24315,2001,Iraq,Bahrain,1,0,FIFA World Cup qualification,Baghdad,Iraq,False,1,1,Iraq
21162,22845,24316,2001,Qatar,Uzbekistan,2,2,FIFA World Cup qualification,Doha,Qatar,False,4,0,Draw
21163,22846,24317,2001,Saudi Arabia,Iran,2,2,FIFA World Cup qualification,Jeddah,Saudi Arabia,False,4,0,Draw
21164,22847,24318,2001,Thailand,Oman,2,0,Friendly,Bangkok,Thailand,False,2,2,Thailand
21165,22848,24319,2001,Japan,Senegal,0,2,Friendly,Lens,France,True,2,-2,Senegal
21166,22849,24320,2001,Qatar,United Arab Emirates,1,2,FIFA World Cup qualification,Doha,Qatar,False,3,-1,United Arab Emirates
21167,22850,24321,2001,Bahrain,Qatar,1,0,Friendly,Manama,Bahrain,False,1,1,Bahrain
21168,22851,24322,2001,Iran,Thailand,1,0,FIFA World Cup qualification,Teheran,Iran,False,1,1,Iran
21169,22852,24323,2001,Iraq,Saudi Arabia,1,2,FIFA World Cup qualification,Amman,Jordan,True,3,-1,Saudi Arabia
21170,22853,24324,2001,Armenia,Norway,1,4,FIFA World Cup qualification,Yerevan,Armenia,False,5,-3,Norway
21171,22854,24325,2001,Bolivia,Ecuador,1,5,FIFA World Cup qualification,La Paz,Bolivia,False,6,-4,Ecuador
21172,22855,24326,2001,Croatia,Belgium,1,0,FIFA World Cup qualification,Zagreb,Croatia,False,1,1,Croatia
21173,22856,24327,2001,Czech Republic,Bulgaria,6,0,FIFA World Cup qualification,Prague,Czech Republic,False,6,6,Czech Republic
21174,22857,24328,2001,Denmark,Iceland,6,0,FIFA World Cup qualification,Copenhagen,Denmark,False,6,6,Denmark
21175,22858,24329,2001,England,Greece,2,2,FIFA World Cup qualification,Manchester,England,False,4,0,Draw
21176,22859,24330,2001,France,Algeria,4,1,Friendly,Saint-Denis,France,False,5,3,France
21177,22860,24331,2001,Germany,Finland,0,0,FIFA World Cup qualification,Gelsenkirchen,Germany,False,0,0,Draw
21178,22861,24332,2001,Republic of Ireland,Cyprus,4,0,FIFA World Cup qualification,Dublin,Republic of Ireland,False,4,4,Republic of Ireland
21179,22862,24333,2001,Italy,Hungary,1,0,FIFA World Cup qualification,Parma,Italy,False,1,1,Italy
21180,22863,24334,2001,Malta,Northern Ireland,0,1,FIFA World Cup qualification,Attard,Malta,False,1,-1,Northern Ireland
21181,22864,24335,2001,Moldova,Turkey,0,3,FIFA World Cup qualification,Chişinău,Moldova,False,3,-3,Turkey
21182,22865,24336,2001,Netherlands,Andorra,4,0,FIFA World Cup qualification,Arnhem,Netherlands,False,4,4,Netherlands
21183,22866,24337,2001,Poland,Ukraine,1,1,FIFA World Cup qualification,Chorzów,Poland,False,2,0,Draw
21184,22867,24338,2001,Portugal,Estonia,5,0,FIFA World Cup qualification,Lisbon,Portugal,False,5,5,Portugal
21185,22868,24339,2001,Romania,Georgia,1,1,FIFA World Cup qualification,Bucharest,Romania,False,2,0,Draw
21186,22869,24340,2001,Russia,Switzerland,4,0,FIFA World Cup qualification,Moscow,Russia,False,4,4,Russia
21187,22870,24341,2001,Scotland,Latvia,2,1,FIFA World Cup qualification,Glasgow,Scotland,False,3,1,Scotland
21188,22871,24342,2001,Serbia,Luxembourg,6,2,FIFA World Cup qualification,Belgrade,Yugoslavia,True,8,4,Serbia
21189,22872,24343,2001,Slovenia,Faroe Islands,3,0,FIFA World Cup qualification,Ljubljana,Slovenia,False,3,3,Slovenia
21190,22873,24344,2001,Venezuela,Peru,3,0,FIFA World Cup qualification,San Cristóbal,Venezuela,False,3,3,Venezuela
21191,22874,24345,2001,Wales,Belarus,1,0,FIFA World Cup qualification,Cardiff,Wales,False,1,1,Wales
21192,22875,24346,2001,Bosnia and Herzegovina,Liechtenstein,5,0,FIFA World Cup qualification,Zenica,Bosnia and Herzegovina,False,5,5,Bosnia and Herzegovina
21193,22876,24347,2001,Brazil,Chile,2,0,FIFA World Cup qualification,Curitiba,Brazil,False,2,2,Brazil
21194,22877,24349,2001,Costa Rica,Mexico,0,0,FIFA World Cup qualification,San José,Costa Rica,False,0,0,Draw
21195,22878,24350,2001,Honduras,Trinidad and Tobago,0,1,FIFA World Cup qualification,San Pedro Sula,Honduras,False,1,-1,Trinidad and Tobago
21196,22879,24351,2001,Japan,Nigeria,2,2,Friendly,Southampton,England,True,4,0,Draw
21197,22880,24353,2001,Paraguay,Argentina,2,2,FIFA World Cup qualification,Asunción,Paraguay,False,4,0,Draw
21198,22881,24354,2001,Sweden,Azerbaijan,3,0,FIFA World Cup qualification,Solna,Sweden,False,3,3,Sweden
21199,22882,24355,2001,Uruguay,Colombia,1,1,FIFA World Cup qualification,Montevideo,Uruguay,False,2,0,Draw
21200,22883,24356,2001,United States,Jamaica,2,1,FIFA World Cup qualification,Foxborough,United States,False,3,1,United States
21201,22884,24357,2001,Gambia,Morocco,0,2,Friendly,Bamako,Mali,True,2,-2,Morocco
21202,22885,24358,2001,Iran,Iraq,2,1,FIFA World Cup qualification,Teheran,Iran,False,3,1,Iran
21203,22886,24360,2001,Oman,Uzbekistan,4,2,FIFA World Cup qualification,Muscat,Oman,False,6,2,Oman
21204,22887,24361,2001,Mali,Morocco,2,1,Friendly,Bamako,Mali,False,3,1,Mali
21205,22888,24362,2001,Algeria,Burkina Faso,2,0,Friendly,Annaba,Algeria,False,2,2,Algeria
21206,22889,24363,2001,Thailand,Bahrain,1,1,FIFA World Cup qualification,Bangkok,Thailand,False,2,0,Draw
21207,22890,24364,2001,Kuwait,Qatar,0,1,Friendly,Kuwait City,Kuwait,False,1,-1,Qatar
21208,22891,24365,2001,United Arab Emirates,Oman,2,2,FIFA World Cup qualification,Abu Dhabi,United Arab Emirates,False,4,0,Draw
21209,22893,24367,2001,Bahamas,Haiti,0,2,Friendly,Nassau,Bahamas,False,2,-2,Haiti
21210,22894,24368,2001,Bahrain,Iran,3,1,FIFA World Cup qualification,Riffa,Bahrain,False,4,2,Bahrain
21211,22895,24369,2001,Saudi Arabia,Thailand,4,1,FIFA World Cup qualification,Riyadh,Saudi Arabia,False,5,3,Saudi Arabia
21212,22896,24370,2001,Kenya,Uganda,0,0,Friendly,Arusha,Tanzania,True,0,0,Draw
21213,22897,24371,2001,Tanzania,DR Congo,2,2,Friendly,Arusha,Tanzania,False,4,0,Draw
21214,22898,24372,2001,Iran,United Arab Emirates,1,0,FIFA World Cup qualification,Teheran,Iran,False,1,1,Iran
21215,22899,24373,2001,DR Congo,Uganda,0,1,Friendly,Mwanza,Tanzania,True,1,-1,Uganda
21216,22900,24374,2001,Israel,Austria,1,1,FIFA World Cup qualification,Ramat-Gan,Israel,False,2,0,Draw
21217,22901,24375,2001,Tanzania,Kenya,3,1,Friendly,Mwanza,Tanzania,False,4,2,Tanzania
21218,22902,24376,2001,Mexico,El Salvador,4,1,Friendly,Puebla,Mexico,False,5,3,Mexico
21219,22903,24377,2001,United Arab Emirates,Iran,0,3,FIFA World Cup qualification,Abu Dhabi,United Arab Emirates,False,3,-3,Iran
21220,22904,24378,2001,Benin,Guinea-Bissau,2,7,Amílcar Cabral Cup,Bamako,Mali,True,9,-5,Guinea-Bissau
21221,22905,24379,2001,Mali,Mauritania,3,2,Amílcar Cabral Cup,Bamako,Mali,False,5,1,Mali
21222,22906,24380,2001,Benin,Mauritania,2,0,Amílcar Cabral Cup,Ségou,Mali,True,2,2,Benin
21223,22907,24381,2001,Mali,Guinea-Bissau,2,0,Amílcar Cabral Cup,Ségou,Mali,False,2,2,Mali
21224,22908,24382,2001,Bolivia,Brazil,3,1,FIFA World Cup qualification,La Paz,Bolivia,False,4,2,Bolivia
21225,22909,24384,2001,Colombia,Chile,3,1,FIFA World Cup qualification,Bogotá,Colombia,False,4,2,Colombia
21226,22910,24385,2001,Ecuador,Uruguay,1,1,FIFA World Cup qualification,Quito,Ecuador,False,2,0,Draw
21227,22911,24386,2001,Guinea-Bissau,Mauritania,1,0,Amílcar Cabral Cup,Ségou,Mali,True,1,1,Guinea-Bissau
21228,22912,24387,2001,Japan,Italy,1,1,Friendly,Saitama,Japan,False,2,0,Draw
21229,22913,24388,2001,Mali,Benin,0,0,Amílcar Cabral Cup,Ségou,Mali,False,0,0,Draw
21230,22914,24389,2001,Argentina,Peru,2,0,FIFA World Cup qualification,Buenos Aires,Argentina,False,2,2,Argentina
21231,22915,24391,2001,Venezuela,Paraguay,3,1,FIFA World Cup qualification,San Cristóbal,Venezuela,False,4,2,Venezuela
21232,22916,24392,2001,Mali,Gambia,0,1,Amílcar Cabral Cup,Ségou,Mali,False,1,-1,Gambia
21233,22917,24393,2001,Austria,Turkey,0,1,FIFA World Cup qualification,Vienna,Austria,False,1,-1,Turkey
21234,22918,24394,2001,Belgium,Czech Republic,1,0,FIFA World Cup qualification,Brussels,Belgium,False,1,1,Belgium
21235,22919,24395,2001,Denmark,Netherlands,1,1,Friendly,Copenhagen,Denmark,False,2,0,Draw
21236,22920,24396,2001,England,Sweden,1,1,Friendly,Manchester,England,False,2,0,Draw
21237,22921,24397,2001,Greece,Estonia,4,2,Friendly,Athens,Greece,False,6,2,Greece
21238,22922,24398,2001,Republic of Ireland,Iran,2,0,FIFA World Cup qualification,Dublin,Republic of Ireland,False,2,2,Republic of Ireland
21239,22923,24400,2001,Slovenia,Romania,2,1,FIFA World Cup qualification,Ljubljana,Slovenia,False,3,1,Slovenia
21240,22924,24401,2001,South Africa,Egypt,1,0,Friendly,Johannesburg,South Africa,False,1,1,South Africa
21241,22925,24402,2001,Ukraine,Germany,1,1,FIFA World Cup qualification,Kyïv,Ukraine,False,2,0,Draw
21242,22926,24403,2001,Australia,France,1,1,Friendly,Melbourne,Australia,False,2,0,Draw
21243,22927,24404,2001,Jamaica,Costa Rica,0,1,FIFA World Cup qualification,Kingston,Jamaica,False,1,-1,Costa Rica
21244,22928,24405,2001,Mali,Guinea-Bissau,2,1,Amílcar Cabral Cup,Bamako,Mali,False,3,1,Mali
21245,22929,24406,2001,Mexico,Honduras,3,0,FIFA World Cup qualification,Mexico City,Mexico,False,3,3,Mexico
21246,22930,24407,2001,Trinidad and Tobago,United States,0,0,FIFA World Cup qualification,Port of Spain,Trinidad and Tobago,False,0,0,Draw
21247,22931,24409,2001,Brazil,Venezuela,3,0,FIFA World Cup qualification,São Luís,Brazil,False,3,3,Brazil
21248,22932,24410,2001,Chile,Ecuador,0,0,FIFA World Cup qualification,Santiago,Chile,False,0,0,Draw
21249,22933,24411,2001,Czech Republic,Belgium,0,1,FIFA World Cup qualification,Prague,Czech Republic,False,1,-1,Belgium
21250,22934,24412,2001,Estonia,Kazakhstan,0,0,Friendly,Tallinn,Estonia,False,0,0,Draw
21251,22935,24413,2001,Germany,Ukraine,4,1,FIFA World Cup qualification,Dortmund,Germany,False,5,3,Germany
21252,22936,24414,2001,Greece,Cyprus,1,2,Friendly,Athens,Greece,False,3,-1,Cyprus
21253,22938,24416,2001,Latvia,Russia,1,3,Friendly,Riga,Latvia,False,4,-2,Russia
21254,22939,24417,2001,Malta,Canada,2,1,Friendly,Paola,Malta,False,3,1,Malta
21255,22940,24418,2001,Morocco,Zambia,1,0,Friendly,Rabat,Morocco,False,1,1,Morocco
21256,22941,24419,2001,Paraguay,Colombia,0,4,FIFA World Cup qualification,Asunción,Paraguay,False,4,-4,Colombia
21257,22942,24420,2001,Peru,Bolivia,1,1,FIFA World Cup qualification,Lima,Peru,False,2,0,Draw
21258,22943,24421,2001,Poland,Cameroon,0,0,Friendly,Poznań,Poland,False,0,0,Draw
21259,22944,24422,2001,Portugal,Angola,5,1,Friendly,Lisbon,Portugal,False,6,4,Portugal
21260,22945,24423,2001,Romania,Slovenia,1,1,FIFA World Cup qualification,Bucharest,Romania,False,2,0,Draw
21261,22946,24424,2001,Spain,Mexico,1,0,Friendly,Huelva,Spain,False,1,1,Spain
21262,22947,24425,2001,Turkey,Austria,5,0,FIFA World Cup qualification,Istanbul,Turkey,False,5,5,Turkey
21263,22948,24426,2001,Uruguay,Argentina,1,1,FIFA World Cup qualification,Montevideo,Uruguay,False,2,0,Draw
21264,22949,24427,2001,Iran,Republic of Ireland,1,0,FIFA World Cup qualification,Teheran,Iran,False,1,1,Iran
21265,22950,24428,2001,Australia,Uruguay,1,0,FIFA World Cup qualification,Melbourne,Australia,False,1,1,Australia
21266,22951,24429,2001,Madagascar,Mayotte,1,0,Friendly,Antananarivo,Madagascar,False,1,1,Madagascar
21267,22952,24430,2001,Ethiopia,Zambia,1,2,Friendly,Addis Abeba,Ethiopia,False,3,-1,Zambia
21268,22953,24431,2001,Uruguay,Australia,3,0,FIFA World Cup qualification,Montevideo,Uruguay,False,3,3,Uruguay
21269,22954,24432,2001,Tunisia,Togo,1,0,Friendly,Tunis,Tunisia,False,1,1,Tunisia
21270,22955,24433,2001,Oman,Kuwait,1,1,Friendly,Muscat,Oman,False,2,0,Draw
21271,22956,24434,2001,Algeria,Ghana,1,1,Friendly,Algiers,Algeria,False,2,0,Draw
21272,22957,24435,2001,Mali,Ivory Coast,0,3,Friendly,Sikasso,Mali,False,3,-3,Ivory Coast
21273,22958,24436,2001,Rwanda,Somalia,3,0,CECAFA Cup,Kigali,Rwanda,False,3,3,Rwanda
21274,22959,24437,2001,Burundi,Tanzania,1,2,CECAFA Cup,Kigali,Rwanda,True,3,-1,Tanzania
21275,22960,24439,2001,Uganda,Djibouti,10,1,CECAFA Cup,Kigali,Rwanda,True,11,9,Uganda
21276,22961,24440,2001,Kenya,Eritrea,2,1,CECAFA Cup,Kigali,Rwanda,True,3,1,Kenya
21277,22962,24441,2001,Burundi,Djibouti,3,1,CECAFA Cup,Kigali,Rwanda,True,4,2,Burundi
21278,22963,24442,2001,Uganda,Tanzania,0,1,CECAFA Cup,Kigali,Rwanda,True,1,-1,Tanzania
21279,22964,24443,2001,Kenya,Somalia,3,0,CECAFA Cup,Kigali,Rwanda,True,3,3,Kenya
21280,22965,24444,2001,Rwanda,Eritrea,1,0,CECAFA Cup,Kigali,Rwanda,False,1,1,Rwanda
21281,22966,24445,2001,Bahrain,Oman,2,2,Friendly,Manama,Bahrain,False,4,0,Draw
21282,22968,24447,2001,Tanzania,Djibouti,4,1,CECAFA Cup,Kigali,Rwanda,True,5,3,Tanzania
21283,22969,24448,2001,Eritrea,Somalia,0,0,CECAFA Cup,Kigali,Rwanda,True,0,0,Draw
21284,22970,24449,2001,Uganda,Burundi,0,2,CECAFA Cup,Kigali,Rwanda,True,2,-2,Burundi
21285,22971,24450,2001,Botswana,Namibia,3,2,Friendly,Gaborone,Botswana,False,5,1,Botswana
21286,22972,24451,2001,El Salvador,Haiti,0,0,Friendly,Miami,United States,True,0,0,Draw
21287,22973,24452,2001,Rwanda,Kenya,0,0,CECAFA Cup,Kigali,Rwanda,False,0,0,Draw
21288,22974,24453,2001,Botswana,Lesotho,1,0,Friendly,Gaborone,Botswana,False,1,1,Botswana
21289,22975,24454,2001,Burkina Faso,Togo,1,2,Friendly,Ouagadougou,Burkina Faso,False,3,-1,Togo
21290,22976,24455,2001,Kenya,Eritrea,1,0,CECAFA Cup,Kigali,Rwanda,True,1,1,Kenya
21291,22977,24456,2001,Ethiopia,Burundi,2,2,Friendly,Kigali,Rwanda,True,4,0,Draw
21292,22978,24457,2001,Rwanda,Uganda,3,2,CECAFA Cup,Kigali,Rwanda,False,5,1,Rwanda
21293,22979,24458,2001,Rwanda,Ethiopia,0,1,CECAFA Cup,Kigali,Rwanda,False,1,-1,Ethiopia
21294,22980,24459,2001,Kenya,Ethiopia,1,2,CECAFA Cup,Kigali,Rwanda,True,3,-1,Ethiopia
21295,22981,24460,2001,Togo,Burkina Faso,1,0,Friendly,Lomé,Togo,False,1,1,Togo
21296,22982,24461,2001,Oman,Syria,2,0,Friendly,Muscat,Oman,False,2,2,Oman
21297,22983,24462,2001,Mali,Ghana,1,1,Friendly,Mopti,Mali,False,2,0,Draw
21298,22984,24463,2001,Oman,Syria,1,0,Friendly,Muscat,Oman,False,1,1,Oman
21299,22985,24464,2001,Senegal,Burkina Faso,2,4,Friendly,Dakar,Senegal,False,6,-2,Burkina Faso
21300,22986,24466,2001,Mali,Burkina Faso,2,1,Friendly,Ségou,Mali,False,3,1,Mali
21301,22987,24468,2001,Kuwait,Syria,0,0,Friendly,Kuwait City,Kuwait,False,0,0,Draw
21302,22988,24470,2001,Benin,Togo,1,1,Friendly,Cotonou,Benin,False,2,0,Draw
21303,22990,24472,2001,Qatar,Egypt,2,2,Friendly,Doha,Qatar,False,4,0,Draw
21304,22991,24473,2001,Saudi Arabia,Zimbabwe,0,2,Friendly,Riyadh,Saudi Arabia,False,2,-2,Zimbabwe
21305,22992,24474,2001,Senegal,Algeria,1,0,Friendly,Dakar,Senegal,False,1,1,Senegal
21306,22993,24475,2001,Tunisia,Liberia,7,2,Friendly,Tunis,Tunisia,False,9,5,Tunisia
21307,22994,24476,2001,Kuwait,Syria,2,2,Friendly,Kuwait City,Kuwait,False,4,0,Draw
21308,22995,24477,2002,Bahrain,Finland,0,2,Prime Minister's Cup,Riffa,Bahrain,False,2,-2,Finland
21309,22996,24478,2002,Egypt,Ghana,2,0,Friendly,Cairo,Egypt,False,2,2,Egypt
21310,22997,24479,2002,Martinique,Guadeloupe,1,3,Friendly,Fort-de-France,Martinique,False,4,-2,Guadeloupe
21311,22999,24481,2002,Kuwait,Zimbabwe,3,0,Friendly,Kuwait City,Kuwait,False,3,3,Kuwait
21312,23000,24482,2002,Cuba,Guatemala,0,1,Friendly,Havana,Cuba,False,1,-1,Guatemala
21313,23001,24483,2002,Egypt,Mali,1,2,Friendly,Ismailia,Egypt,False,3,-1,Mali
21314,23002,24484,2002,Martinique,Haiti,3,3,Friendly,Fort-de-France,Martinique,False,6,0,Draw
21315,23003,24485,2002,Albania,Finland,1,1,Prime Minister's Cup,Riffa,Bahrain,True,2,0,Draw
21316,23005,24487,2002,Burkina Faso,Cameroon,1,3,Friendly,Ouagadougou,Burkina Faso,False,4,-2,Cameroon
21317,23006,24488,2002,Kuwait,Iceland,0,0,Friendly,Muscat,Oman,True,0,0,Draw
21318,23007,24489,2002,Qatar,Zimbabwe,0,2,Friendly,Doha,Qatar,False,2,-2,Zimbabwe
21319,23008,24490,2002,Cuba,Guatemala,0,0,Friendly,Havana,Cuba,False,0,0,Draw
21320,23009,24491,2002,Bahrain,Albania,3,0,Prime Minister's Cup,Riffa,Bahrain,False,3,3,Bahrain
21321,23011,24493,2002,Mali,Zambia,1,1,Friendly,Kayès,Mali,False,2,0,Draw
21322,23012,24494,2002,Saudi Arabia,Iceland,1,0,Friendly,Riyadh,Saudi Arabia,False,1,1,Saudi Arabia
21323,23013,24495,2002,Egypt,Burkina Faso,2,2,Friendly,Cairo,Egypt,False,4,0,Draw
21324,23014,24496,2002,Grenada,Trinidad and Tobago,2,3,Friendly,St. George's,Grenada,False,5,-1,Trinidad and Tobago
21325,23015,24497,2002,Iraq,Oman,2,0,Friendly,Doha,Qatar,True,2,2,Iraq
21326,23016,24498,2002,Tunisia,Cameroon,0,1,Friendly,Tunis,Tunisia,False,1,-1,Cameroon
21327,23017,24499,2002,Ecuador,Guatemala,1,0,Friendly,Guayaquil,Ecuador,False,1,1,Ecuador
21328,23018,24500,2002,Ivory Coast,Nigeria,1,1,Friendly,Abidjan,Ivory Coast,False,2,0,Draw
21329,23019,24501,2002,Morocco,Guinea,2,1,Friendly,Rabat,Morocco,False,3,1,Morocco
21330,23020,24502,2002,Qatar,Iraq,1,3,Friendly,Doha,Qatar,False,4,-2,Iraq
21331,23021,24503,2002,Algeria,Benin,4,0,Friendly,Algiers,Algeria,False,4,4,Algeria
21332,23022,24504,2002,South Africa,Angola,1,0,Friendly,Mafikeng,South Africa,False,1,1,South Africa
21333,23023,24505,2002,Gambia,Morocco,0,2,Friendly,Banjul,Gambia,False,2,-2,Morocco
21334,23024,24506,2002,Saudi Arabia,Kuwait,1,1,Gulf Cup,Riyadh,Saudi Arabia,False,2,0,Draw
21335,23025,24507,2002,Qatar,Bahrain,1,0,Gulf Cup,Riyadh,Saudi Arabia,True,1,1,Qatar
21336,23026,24508,2002,United Arab Emirates,Oman,1,0,Gulf Cup,Riyadh,Saudi Arabia,True,1,1,United Arab Emirates
21337,23027,24509,2002,Haiti,Canada,0,2,Gold Cup,Miami,United States,True,2,-2,Canada
21338,23028,24510,2002,Martinique,Costa Rica,0,2,Gold Cup,Miami,United States,True,2,-2,Costa Rica
21339,23029,24511,2002,El Salvador,Mexico,0,1,Gold Cup,Pasadena,United States,True,1,-1,Mexico
21340,23030,24512,2002,Kuwait,Oman,1,3,Gulf Cup,Riyadh,Saudi Arabia,True,4,-2,Oman
21341,23031,24513,2002,Mali,Liberia,1,1,African Cup of Nations,Bamako,Mali,False,2,0,Draw
21342,23032,24514,2002,Saint Kitts and Nevis,Grenada,1,1,Friendly,Basseterre,Saint Kitts and Nevis,False,2,0,Draw
21343,23034,24516,2002,Antigua and Barbuda,Dominica,4,0,Friendly,St. John's,Antigua and Barbuda,False,4,4,Antigua and Barbuda
21344,23035,24517,2002,Cameroon,DR Congo,1,0,African Cup of Nations,Sikasso,Mali,True,1,1,Cameroon
21345,23036,24518,2002,Costa Rica,Trinidad and Tobago,1,1,Gold Cup,Miami,United States,True,2,0,Draw
21346,23037,24519,2002,Ecuador,Haiti,0,2,Gold Cup,Miami,United States,True,2,-2,Haiti
21347,23038,24520,2002,Egypt,Senegal,0,1,African Cup of Nations,Bamako,Mali,True,1,-1,Senegal
21348,23039,24521,2002,Saudi Arabia,Bahrain,3,1,Gulf Cup,Riyadh,Saudi Arabia,False,4,2,Saudi Arabia
21349,23040,24522,2002,South Africa,Burkina Faso,0,0,African Cup of Nations,Ségou,Mali,True,0,0,Draw
21350,23041,24523,2002,United Arab Emirates,Qatar,0,2,Gulf Cup,Riyadh,Saudi Arabia,True,2,-2,Qatar
21351,23042,24524,2002,Algeria,Nigeria,0,1,African Cup of Nations,Bamako,Mali,True,1,-1,Nigeria
21352,23043,24525,2002,Mexico,Guatemala,3,1,Gold Cup,Pasadena,United States,True,4,2,Mexico
21353,23044,24526,2002,Morocco,Ghana,0,0,African Cup of Nations,Ségou,Mali,True,0,0,Draw
21354,23045,24527,2002,Togo,Ivory Coast,0,0,African Cup of Nations,Sikasso,Mali,True,0,0,Draw
21355,23046,24528,2002,United States,Cuba,1,0,Gold Cup,Pasadena,United States,False,1,1,United States
21356,23047,24529,2002,Zambia,Tunisia,0,0,African Cup of Nations,Bamako,Mali,True,0,0,Draw
21357,23048,24530,2002,Canada,Ecuador,0,2,Gold Cup,Miami,United States,True,2,-2,Ecuador
21358,23049,24531,2002,Kuwait,Bahrain,0,0,Gulf Cup,Riyadh,Saudi Arabia,True,0,0,Draw
21359,23050,24532,2002,Trinidad and Tobago,Martinique,0,1,Gold Cup,Miami,United States,True,1,-1,Martinique
21360,23051,24533,2002,Guatemala,El Salvador,0,1,Gold Cup,Pasadena,United States,True,1,-1,El Salvador
21361,23052,24535,2002,Mali,Nigeria,0,0,African Cup of Nations,Bamako,Mali,False,0,0,Draw
21362,23053,24536,2002,South Africa,Ghana,0,0,African Cup of Nations,Ségou,Mali,True,0,0,Draw
21363,23054,24537,2002,Cameroon,Ivory Coast,1,0,African Cup of Nations,Sikasso,Mali,True,1,1,Cameroon
21364,23055,24538,2002,Egypt,Tunisia,1,0,African Cup of Nations,Bamako,Mali,True,1,1,Egypt
21365,23056,24539,2002,Liberia,Algeria,2,2,African Cup of Nations,Bamako,Mali,True,4,0,Draw
21366,23057,24540,2002,Burkina Faso,Morocco,1,2,African Cup of Nations,Ségou,Mali,True,3,-1,Morocco
21367,23058,24541,2002,Canada,Martinique,1,1,Gold Cup,Miami,United States,True,2,0,Draw
21368,23059,24542,2002,DR Congo,Togo,0,0,African Cup of Nations,Sikasso,Mali,True,0,0,Draw
21369,23060,24543,2002,Costa Rica,Haiti,2,1,Gold Cup,Miami,United States,True,3,1,Costa Rica
21370,23061,24544,2002,Senegal,Zambia,1,0,African Cup of Nations,Bamako,Mali,True,1,1,Senegal
21371,23063,24546,2002,United States,El Salvador,4,0,Gold Cup,Pasadena,United States,False,4,4,United States
21372,23064,24547,2002,Liberia,Nigeria,0,1,African Cup of Nations,Mopti,Mali,True,1,-1,Nigeria
21373,23065,24548,2002,Mali,Algeria,2,0,African Cup of Nations,Bamako,Mali,False,2,2,Mali
21374,23066,24549,2002,Cameroon,Togo,3,0,African Cup of Nations,Sikasso,Mali,True,3,3,Cameroon
21375,23067,24550,2002,DR Congo,Ivory Coast,3,1,African Cup of Nations,Kayes,Mali,True,4,2,DR Congo
21376,23068,24551,2002,Burkina Faso,Ghana,1,2,African Cup of Nations,Mopti,Mali,True,3,-1,Ghana
21377,23070,24553,2002,South Africa,Morocco,3,1,African Cup of Nations,Ségou,Mali,True,4,2,South Africa
21378,23071,24554,2002,United States,Canada,0,0,Gold Cup,Pasadena,United States,False,0,0,Draw
21379,23072,24555,2002,Brazil,Bolivia,6,0,Friendly,Goiânia,Brazil,False,6,6,Brazil
21380,23073,24556,2002,Egypt,Zambia,2,1,African Cup of Nations,Bamako,Mali,True,3,1,Egypt
21381,23074,24557,2002,Senegal,Tunisia,0,0,African Cup of Nations,Kayes,Mali,True,0,0,Draw
21382,23076,24559,2002,United States,Costa Rica,2,0,Gold Cup,Pasadena,United States,False,2,2,United States
21383,23077,24560,2002,Mali,South Africa,2,0,African Cup of Nations,Kayes,Mali,False,2,2,Mali
21384,23078,24561,2002,Nigeria,Ghana,1,0,African Cup of Nations,Bamako,Mali,True,1,1,Nigeria
21385,23079,24562,2002,Cameroon,Egypt,1,0,African Cup of Nations,Sikasso,Mali,True,1,1,Cameroon
21386,23080,24563,2002,Senegal,DR Congo,2,0,African Cup of Nations,Bamako,Mali,True,2,2,Senegal
21387,23081,24564,2002,Iran,Slovakia,2,3,Friendly,Teheran,Iran,False,5,-1,Slovakia
21388,23082,24565,2002,Saudi Arabia,Brazil,0,1,Friendly,Riyadh,Saudi Arabia,False,1,-1,Brazil
21389,23083,24566,2002,Mali,Cameroon,0,3,African Cup of Nations,Bamako,Mali,False,3,-3,Cameroon
21390,23084,24567,2002,Nigeria,Senegal,1,2,African Cup of Nations,Bamako,Mali,True,3,-1,Senegal
21391,23086,24569,2002,Lithuania,Moldova,1,0,Malta International Tournament,Attard,Malta,True,1,1,Lithuania
21392,23087,24570,2002,Mali,Nigeria,0,3,African Cup of Nations,Mopti,Mali,False,3,-3,Nigeria
21393,23088,24571,2002,Malta,Jordan,2,1,Malta International Tournament,Attard,Malta,False,3,1,Malta
21394,23089,24572,2002,Faroe Islands,Poland,1,2,Friendly,Limassol,Cyprus,True,3,-1,Poland
21395,23090,24574,2002,Senegal,Cameroon,0,0,African Cup of Nations,Bamako,Mali,True,0,0,Draw
21396,23091,24575,2002,Thailand,Singapore,4,0,King's Cup,Bangkok,Thailand,False,4,4,Thailand
21397,23092,24576,2002,Malta,Lithuania,1,1,Malta International Tournament,Attard,Malta,False,2,0,Draw
21398,23093,24577,2002,Moldova,Jordan,2,0,Malta International Tournament,Attard,Malta,True,2,2,Moldova
21399,23094,24578,2002,Cyprus,Switzerland,1,1,Cyprus International Tournament,Nicosia,Cyprus,False,2,0,Draw
21400,23095,24579,2002,Czech Republic,Hungary,2,0,Cyprus International Tournament,Larnaca,Cyprus,True,2,2,Czech Republic
21401,23096,24581,2002,Slovenia,Honduras,1,5,Lunar New Year Cup,So Kon Po,Hong Kong,True,6,-4,Honduras
21402,23097,24582,2002,Thailand,Qatar,1,0,King's Cup,Bangkok,Thailand,False,1,1,Thailand
21403,23098,24583,2002,Turkey,Ecuador,0,1,Friendly,Breda,Netherlands,True,1,-1,Ecuador
21404,23099,24584,2002,Belgium,Norway,1,0,Friendly,Brussels,Belgium,False,1,1,Belgium
21405,23100,24585,2002,Croatia,Bulgaria,0,0,Friendly,Rijeka,Croatia,False,0,0,Draw
21406,23101,24586,2002,Cyprus,Czech Republic,3,4,Cyprus International Tournament,Nicosia,Cyprus,False,7,-1,Czech Republic
21407,23102,24587,2002,Faroe Islands,Liechtenstein,1,0,Friendly,Pégeia,Cyprus,True,1,1,Faroe Islands
21408,23103,24588,2002,France,Romania,2,1,Friendly,Saint-Denis,France,False,3,1,France
21409,23104,24589,2002,Germany,Israel,7,1,Friendly,Kaiserslautern,Germany,False,8,6,Germany
21410,23105,24590,2002,Greece,Sweden,2,2,Friendly,Salonica,Greece,False,4,0,Draw
21411,23106,24591,2002,Republic of Ireland,Russia,2,0,Friendly,Dublin,Republic of Ireland,False,2,2,Republic of Ireland
21412,23107,24592,2002,Italy,United States,1,0,Friendly,Catania,Italy,False,1,1,Italy
21413,23108,24593,2002,Lithuania,Jordan,0,3,Malta International Tournament,Attard,Malta,True,3,-3,Jordan
21414,23109,24594,2002,Luxembourg,Albania,0,0,Friendly,Hesperange,Luxembourg,False,0,0,Draw
21415,23110,24595,2002,Malta,Moldova,3,0,Malta International Tournament,Attard,Malta,False,3,3,Malta
21416,23111,24596,2002,Mexico,Serbia,1,2,Friendly,Phoenix,United States,True,3,-1,Serbia
21417,23112,24597,2002,Netherlands,England,1,1,Friendly,Amsterdam,Netherlands,False,2,0,Draw
21418,23113,24598,2002,Northern Ireland,Poland,1,4,Friendly,Limassol,Cyprus,True,5,-3,Poland
21419,23114,24599,2002,Paraguay,Bolivia,2,2,Friendly,Ciudad del Este,Paraguay,False,4,0,Draw
21420,23115,24600,2002,Saudi Arabia,Denmark,0,1,Friendly,Riyadh,Saudi Arabia,False,1,-1,Denmark
21421,23116,24601,2002,Spain,Portugal,1,1,Friendly,Barcelona,Spain,False,2,0,Draw
21422,23117,24602,2002,Switzerland,Hungary,2,1,Cyprus International Tournament,Limassol,Cyprus,True,3,1,Switzerland
21423,23119,24604,2002,Wales,Argentina,1,1,Friendly,Cardiff,Wales,False,2,0,Draw
21424,23120,24605,2002,Qatar,Singapore,3,0,King's Cup,Bangkok,Thailand,True,3,3,Qatar
21425,23122,24608,2002,Qatar,Singapore,2,0,King's Cup,Bangkok,Thailand,True,2,2,Qatar
21426,23124,24610,2002,Gibraltar,Monaco,2,2,Friendly,Nice,France,True,4,0,Draw
21427,23125,24611,2002,Iran,Venezuela,1,0,Friendly,Casablanca,Morocco,True,1,1,Iran
21428,23126,24612,2002,Botswana,Eswatini,6,2,Friendly,Gaborone,Botswana,False,8,4,Botswana
21429,23127,24613,2002,United States,Honduras,4,0,Friendly,Seattle,United States,False,4,4,United States
21430,23128,24614,2002,Brazil,Iceland,6,1,Friendly,Cuiabá,Brazil,False,7,5,Brazil
21431,23129,24615,2002,American Samoa,New Caledonia,0,10,Oceania Nations Cup qualification,Apia,Samoa,True,10,-10,New Caledonia
21432,23130,24616,2002,Samoa,Tonga,2,0,Oceania Nations Cup qualification,Apia,Samoa,False,2,2,Samoa
21433,23131,24617,2002,Eswatini,Lesotho,1,0,Friendly,Mbabane,Eswatini,False,1,1,Eswatini
21434,23132,24618,2002,United States,Ecuador,1,0,Friendly,Birmingham,United States,False,1,1,United States
21435,23133,24619,2002,American Samoa,Tonga,2,7,Oceania Nations Cup qualification,Apia,Samoa,True,9,-5,Tonga
21436,23134,24620,2002,New Caledonia,Papua New Guinea,1,4,Oceania Nations Cup qualification,Apia,Samoa,True,5,-3,Papua New Guinea
21437,23135,24621,2002,Mexico,Albania,4,0,Friendly,San Diego,United States,True,4,4,Mexico
21438,23137,24623,2002,Estonia,Saudi Arabia,2,0,Friendly,Montecatini Terme,Italy,True,2,2,Estonia
21439,23138,24624,2002,Papua New Guinea,Tonga,5,0,Oceania Nations Cup qualification,Apia,Samoa,True,5,5,Papua New Guinea
21440,23139,24625,2002,Samoa,American Samoa,5,0,Oceania Nations Cup qualification,Apia,Samoa,False,5,5,Samoa
21441,23140,24626,2002,Botswana,Namibia,3,1,Friendly,Gaborone,Botswana,False,4,2,Botswana
21442,23141,24627,2002,Mauritius,Madagascar,2,3,COSAFA Cup,Mapou,Mauritius,False,5,-1,Madagascar
21443,23142,24628,2002,New Caledonia,Tonga,9,0,Oceania Nations Cup qualification,Apia,Samoa,True,9,9,New Caledonia
21444,23143,24629,2002,Samoa,Papua New Guinea,1,4,Oceania Nations Cup qualification,Apia,Samoa,False,5,-3,Papua New Guinea
21445,23144,24630,2002,Sri Lanka,Pakistan,1,1,Friendly,Colombo,Sri Lanka,False,2,0,Draw
21446,23145,24631,2002,American Samoa,Papua New Guinea,0,7,Oceania Nations Cup qualification,Apia,Samoa,True,7,-7,Papua New Guinea
21447,23146,24632,2002,Samoa,New Caledonia,0,5,Oceania Nations Cup qualification,Apia,Samoa,False,5,-5,New Caledonia
21448,23147,24633,2002,Sri Lanka,Pakistan,0,0,Friendly,Kurunegala,Sri Lanka,False,0,0,Draw
21449,23149,24635,2002,Saudi Arabia,South Africa,1,0,Friendly,Pistoia,Italy,True,1,1,Saudi Arabia
21450,23150,24636,2002,Japan,Ukraine,1,0,Friendly,Osaka,Japan,False,1,1,Japan
21451,23151,24637,2002,Sri Lanka,Pakistan,1,0,Friendly,Colombo,Sri Lanka,False,1,1,Sri Lanka
21452,23152,24638,2002,Sri Lanka,Pakistan,2,1,Friendly,Kalutara,Sri Lanka,False,3,1,Sri Lanka
21453,23153,24640,2002,Nigeria,Paraguay,1,1,Friendly,London,England,True,2,0,Draw
21454,23154,24641,2002,Albania,Azerbaijan,1,0,Friendly,Tirana,Albania,False,1,1,Albania
21455,23155,24642,2002,Argentina,Cameroon,2,2,Friendly,Geneva,Switzerland,True,4,0,Draw
21456,23156,24643,2002,Austria,Slovakia,2,0,Friendly,Graz,Austria,False,2,2,Austria
21457,23157,24644,2002,Belize,Guyana,3,1,Friendly,Belize,Belize,False,4,2,Belize
21458,23159,24646,2002,Brazil,Serbia,1,0,Friendly,Fortaleza,Brazil,False,1,1,Brazil
21459,23160,24647,2002,Bulgaria,Ecuador,0,3,Friendly,East Rutherford,United States,True,3,-3,Ecuador
21460,23161,24648,2002,Croatia,Slovenia,0,0,Friendly,Zagreb,Croatia,False,0,0,Draw
21461,23162,24649,2002,England,Italy,1,2,Friendly,Leeds,England,False,3,-1,Italy
21462,23163,24650,2002,Estonia,Russia,2,1,Friendly,Tallinn,Estonia,False,3,1,Estonia
21463,23164,24651,2002,France,Scotland,5,0,Friendly,Saint-Denis,France,False,5,5,France
21464,23165,24652,2002,Georgia,South Africa,4,1,Friendly,Tbilisi,Georgia,False,5,3,Georgia
21465,23166,24653,2002,Germany,United States,4,2,Friendly,Rostock,Germany,False,6,2,Germany
21466,23167,24654,2002,Republic of Ireland,Denmark,3,0,Friendly,Dublin,Republic of Ireland,False,3,3,Republic of Ireland
21467,23168,24655,2002,Liechtenstein,Northern Ireland,0,0,Friendly,Vaduz,Liechtenstein,False,0,0,Draw
21468,23169,24656,2002,Luxembourg,Latvia,0,3,Friendly,Hesperange,Luxembourg,False,3,-3,Latvia
21469,23170,24657,2002,Malta,Andorra,1,1,Friendly,Attard,Malta,False,2,0,Draw
21470,23171,24658,2002,Moldova,Hungary,0,2,Friendly,Chişinău,Moldova,False,2,-2,Hungary
21471,23172,24659,2002,Netherlands,Spain,1,0,Friendly,Rotterdam,Netherlands,False,1,1,Netherlands
21472,23173,24660,2002,Poland,Japan,0,2,Friendly,Łódź,Poland,False,2,-2,Japan
21473,23174,24661,2002,Portugal,Finland,1,4,Friendly,Porto,Portugal,False,5,-3,Finland
21474,23175,24662,2002,Romania,Ukraine,4,1,Friendly,Constanţa,Romania,False,5,3,Romania
21475,23176,24663,2002,Saudi Arabia,Uruguay,3,2,Friendly,Dammam,Saudi Arabia,False,5,1,Saudi Arabia
21476,23177,24664,2002,Senegal,Bolivia,2,1,Friendly,Dakar,Senegal,False,3,1,Senegal
21477,23178,24665,2002,Sweden,Switzerland,1,1,Friendly,Malmö,Sweden,False,2,0,Draw
21478,23179,24666,2002,Tunisia,Norway,0,0,Friendly,Tunis,Tunisia,False,0,0,Draw
21479,23180,24667,2002,Wales,Czech Republic,0,0,Friendly,Cardiff,Wales,False,0,0,Draw
21480,23181,24668,2002,Botswana,South Africa,0,0,COSAFA Cup,Gaborone,Botswana,False,0,0,Draw
21481,23182,24669,2002,Eswatini,Mozambique,1,2,Friendly,Mhlume,Eswatini,False,3,-1,Mozambique
21482,23183,24670,2002,Eswatini,Mozambique,1,1,Friendly,Big Bend,Eswatini,False,2,0,Draw
21483,23184,24671,2002,Sri Lanka,Maldives,1,0,Friendly,Colombo,Sri Lanka,False,1,1,Sri Lanka
21484,23185,24672,2002,Sri Lanka,Maldives,1,1,Friendly,Jaffna,Sri Lanka,False,2,0,Draw
21485,23186,24673,2002,Lesotho,Mozambique,0,2,COSAFA Cup,Maseru,Lesotho,False,2,-2,Mozambique
21486,23187,24674,2002,Singapore,Maldives,2,0,Friendly,Singapore,Singapore,False,2,2,Singapore
21487,23188,24675,2002,Yemen,Ethiopia,1,1,Friendly,Sana'a,Yemen,False,2,0,Draw
21488,23189,24676,2002,Andorra,Albania,2,0,Friendly,Sant Julià de Lòria,Andorra,False,2,2,Andorra
21489,23190,24677,2002,Austria,Cameroon,0,0,Friendly,Vienna,Austria,False,0,0,Draw
21490,23191,24678,2002,Belgium,Slovakia,1,1,Friendly,Brussels,Belgium,False,2,0,Draw
21491,23192,24679,2002,Belize,Nicaragua,7,1,Friendly,Belize,Belize,False,8,6,Belize
21492,23193,24680,2002,Croatia,Bosnia and Herzegovina,2,0,Friendly,Zagreb,Croatia,False,2,2,Croatia
21493,23194,24681,2002,Denmark,Israel,3,1,Friendly,Copenhagen,Denmark,False,4,2,Denmark
21494,23195,24682,2002,Ecuador,South Africa,0,0,Friendly,Murcia,Spain,True,0,0,Draw
21495,23196,24683,2002,England,Paraguay,4,0,Friendly,Liverpool,England,False,4,4,England
21496,23197,24684,2002,France,Russia,0,0,Friendly,Saint-Denis,France,False,0,0,Draw
21497,23198,24685,2002,Germany,Argentina,0,1,Friendly,Stuttgart,Germany,False,1,-1,Argentina
21498,23199,24686,2002,Greece,Czech Republic,0,0,Friendly,Ioannina,Greece,False,0,0,Draw
21499,23200,24687,2002,Hungary,Belarus,2,5,Friendly,Debrecen,Hungary,False,7,-3,Belarus
21500,23201,24688,2002,Republic of Ireland,United States,2,1,Friendly,Dublin,Republic of Ireland,False,3,1,Republic of Ireland
21501,23202,24689,2002,Italy,Uruguay,1,1,Friendly,Milan,Italy,False,2,0,Draw
21502,23203,24690,2002,Japan,Costa Rica,1,1,Friendly,Yokohama,Japan,False,2,0,Draw
21503,23204,24691,2002,Latvia,Kazakhstan,2,1,Friendly,Ventspils,Latvia,False,3,1,Latvia
21504,23205,24692,2002,Luxembourg,Liechtenstein,3,3,Friendly,Hesperange,Luxembourg,False,6,0,Draw
21505,23206,24694,2002,Malta,Azerbaijan,1,0,Friendly,Attard,Malta,False,1,1,Malta
21506,23207,24695,2002,Mexico,Bulgaria,1,0,Friendly,East Rutherford,United States,True,1,1,Mexico
21507,23208,24696,2002,Northern Ireland,Spain,0,5,Friendly,Belfast,Northern Ireland,False,5,-5,Spain
21508,23209,24697,2002,Norway,Sweden,0,0,Friendly,Oslo,Norway,False,0,0,Draw
21509,23210,24698,2002,Poland,Romania,1,2,Friendly,Bydgoszcz,Poland,False,3,-1,Romania
21510,23211,24699,2002,Portugal,Brazil,1,1,Friendly,Lisbon,Portugal,False,2,0,Draw
21511,23212,24700,2002,Scotland,Nigeria,1,2,Friendly,Aberdeen,Scotland,False,3,-1,Nigeria
21512,23213,24701,2002,Serbia,Lithuania,4,1,Friendly,Smederevo,Yugoslavia,False,5,3,Serbia
21513,23214,24702,2002,Slovenia,Tunisia,1,0,Friendly,Ljubljana,Slovenia,False,1,1,Slovenia
21514,23215,24703,2002,Turkey,Chile,2,0,Friendly,Kerkrade,Netherlands,True,2,2,Turkey
21515,23216,24704,2002,Ukraine,Georgia,2,1,Friendly,Kyïv,Ukraine,False,3,1,Ukraine
21516,23217,24706,2002,Eswatini,Namibia,2,1,COSAFA Cup,Lobamba,Eswatini,False,3,1,Eswatini
21517,23218,24708,2002,Japan,Slovakia,1,0,Kirin Cup,Tokyo,Japan,False,1,1,Japan
21518,23219,24709,2002,Japan,Honduras,3,3,Kirin Cup,Kobe,Japan,False,6,0,Draw
21519,23220,24710,2002,Malawi,Tanzania,1,0,Friendly,Blantyre,Malawi,False,1,1,Malawi
21520,23221,24711,2002,Nigeria,Kenya,3,0,Friendly,Lagos,Nigeria,False,3,3,Nigeria
21521,23222,24712,2002,Zimbabwe,Eswatini,0,2,COSAFA Cup,Harare,Zimbabwe,False,2,-2,Eswatini
21522,23223,24713,2002,Jersey,Guernsey,2,1,Friendly,St. Helier,Jersey,False,3,1,Jersey
21523,23224,24714,2002,Venezuela,Colombia,0,0,Friendly,Caracas,Venezuela,False,0,0,Draw
21524,23225,24715,2002,Ecuador,Serbia,1,0,Friendly,East Rutherford,United States,True,1,1,Ecuador
21525,23226,24716,2002,Hungary,Croatia,0,2,Friendly,Pécs,Hungary,False,2,-2,Croatia
21526,23227,24717,2002,Costa Rica,Colombia,1,2,Friendly,San José,Costa Rica,False,3,-1,Colombia
21527,23228,24718,2002,Germany,Kuwait,7,0,Friendly,Freiburg,Germany,False,7,7,Germany
21528,23229,24719,2002,Kenya,Tanzania,1,0,Friendly,Nairobi,Kenya,False,1,1,Kenya
21529,23230,24720,2002,Mexico,Colombia,2,1,Friendly,Mexico City,Mexico,False,3,1,Mexico
21530,23231,24721,2002,South Africa,Madagascar,1,0,Friendly,Durban,South Africa,False,1,1,South Africa
21531,23232,24722,2002,United States,Uruguay,2,1,Friendly,Washington,United States,False,3,1,United States
21532,23233,24723,2002,Belgium,Algeria,0,0,Friendly,Brussels,Belgium,False,0,0,Draw
21533,23234,24724,2002,Norway,Japan,3,0,Friendly,Oslo,Norway,False,3,3,Norway
21534,23235,24725,2002,Saudi Arabia,Senegal,3,2,Friendly,Riyadh,Saudi Arabia,False,5,1,Saudi Arabia
21535,23236,24726,2002,Slovakia,Uzbekistan,4,1,Friendly,Prešov,Slovakia,False,5,3,Slovakia
21536,23237,24727,2002,Wales,Germany,1,0,Friendly,Cardiff,Wales,False,1,1,Wales
21537,23238,24728,2002,Greece,Cyprus,3,1,Friendly,Rhodes,Greece,False,4,2,Greece
21538,23239,24729,2002,Switzerland,Canada,1,3,Friendly,St. Gallen,Switzerland,False,4,-2,Canada
21539,23240,24731,2002,Republic of Ireland,Nigeria,1,2,Friendly,Dublin,Republic of Ireland,False,3,-1,Nigeria
21540,23241,24733,2002,Mexico,Bolivia,1,0,Friendly,San Francisco,United States,True,1,1,Mexico
21541,23242,24734,2002,United States,Jamaica,5,0,Friendly,East Rutherford,United States,False,5,5,United States
21542,23243,24735,2002,Burma,Malaysia,1,1,Friendly,Rangoon,Burma,False,2,0,Draw
21543,23244,24736,2002,Denmark,Cameroon,2,1,Friendly,Copenhagen,Denmark,False,3,1,Denmark
21544,23245,24737,2002,Russia,Belarus,1,1,Friendly,Moscow,Russia,False,2,0,Draw
21545,23246,24738,2002,Slovenia,Ghana,2,0,Friendly,Ljubljana,Slovenia,False,2,2,Slovenia
21546,23247,24739,2002,Sweden,Paraguay,1,2,Friendly,Solna,Sweden,False,3,-1,Paraguay
21547,23248,24740,2002,Ukraine,Serbia,2,0,Friendly,Moscow,Russia,True,2,2,Ukraine
21548,23249,24742,2002,Czech Republic,Italy,1,0,Friendly,Prague,Czech Republic,False,1,1,Czech Republic
21549,23250,24743,2002,France,Belgium,1,2,Friendly,Saint-Denis,France,False,3,-1,Belgium
21550,23251,24744,2002,Germany,Austria,6,2,Friendly,Leverkusen,Germany,False,8,4,Germany
21551,23252,24745,2002,Jamaica,Nigeria,0,1,Friendly,London,England,True,1,-1,Nigeria
21552,23253,24746,2002,Malawi,Angola,2,1,COSAFA Cup,Blantyre,Malawi,False,3,1,Malawi
21553,23254,24747,2002,Poland,Estonia,1,0,Friendly,Warsaw,Poland,False,1,1,Poland
21554,23255,24748,2002,Tanzania,Kenya,0,5,Friendly,Arusha,Tanzania,False,5,-5,Kenya
21555,23256,24750,2002,Belarus,Ukraine,2,0,Friendly,Moscow,Russia,True,2,2,Belarus
21556,23257,24751,2002,Burma,Malaysia,0,0,Friendly,Rangoon,Burma,False,0,0,Draw
21557,23258,24752,2002,Russia,Serbia,1,1,Friendly,Moscow,Russia,False,2,0,Draw
21558,23259,24753,2002,United States,Netherlands,0,2,Friendly,Foxborough,United States,False,2,-2,Netherlands
21559,23260,24754,2002,Scotland,South Africa,0,2,Friendly,So Kon Po,Hong Kong,True,2,-2,South Africa
21560,23261,24756,2002,San Marino,Estonia,0,1,Friendly,Serravalle,San Marino,False,1,-1,Estonia
21561,23262,24757,2002,Singapore,Uruguay,1,2,Friendly,Kallang,Singapore,False,3,-1,Uruguay
21562,23263,24758,2002,Finland,Latvia,2,1,Friendly,Helsinki,Finland,False,3,1,Finland
21563,23264,24759,2002,Norway,Iceland,1,1,Friendly,Bodø,Norway,False,2,0,Draw
21564,23265,24760,2002,Ecuador,Senegal,0,1,Friendly,Tottori,Japan,True,1,-1,Senegal
21565,23266,24761,2002,South Africa,Turkey,2,0,Friendly,So Kon Po,Hong Kong,True,2,2,South Africa
21566,23267,24763,2002,Japan,Sweden,1,1,Friendly,Tokyo,Japan,False,2,0,Draw
21567,23268,24764,2002,Malaysia,Brazil,0,4,Friendly,Kuala Lumpur,Malaysia,False,4,-4,Brazil
21568,23269,24765,2002,Belgium,Costa Rica,1,0,Friendly,Kumamoto,Japan,True,1,1,Belgium
21569,23270,24766,2002,Cameroon,England,2,2,Friendly,Kobe,Japan,True,4,0,Draw
21570,23271,24767,2002,Denmark,Tunisia,2,1,Friendly,Wakayama,Japan,True,3,1,Denmark
21571,23272,24769,2002,Kuwait,Iran,1,3,Friendly,Kuwait City,Kuwait,False,4,-2,Iran
21572,23273,24770,2002,France,Senegal,0,1,FIFA World Cup,Seoul,South Korea,True,1,-1,Senegal
21573,23274,24771,2002,Germany,Saudi Arabia,8,0,FIFA World Cup,Sapporo,Japan,True,8,8,Germany
21574,23275,24772,2002,Republic of Ireland,Cameroon,1,1,FIFA World Cup,Niigata,Japan,True,2,0,Draw
21575,23276,24773,2002,Uruguay,Denmark,1,2,FIFA World Cup,Ulsan,South Korea,True,3,-1,Denmark
21576,23277,24774,2002,Argentina,Nigeria,1,0,FIFA World Cup,Kashima,Japan,True,1,1,Argentina
21577,23278,24775,2002,England,Sweden,1,1,FIFA World Cup,Saitama,Japan,True,2,0,Draw
21578,23279,24776,2002,Paraguay,South Africa,2,2,FIFA World Cup,Busan,South Korea,True,4,0,Draw
21579,23280,24777,2002,Spain,Slovenia,3,1,FIFA World Cup,Gwangju,South Korea,True,4,2,Spain
21580,23281,24778,2002,Brazil,Turkey,2,1,FIFA World Cup,Ulsan,South Korea,True,3,1,Brazil
21581,23282,24779,2002,Croatia,Mexico,0,1,FIFA World Cup,Niigata,Japan,True,1,-1,Mexico
21582,23283,24780,2002,Italy,Ecuador,2,0,FIFA World Cup,Sapporo,Japan,True,2,2,Italy
21583,23284,24782,2002,Japan,Belgium,2,2,FIFA World Cup,Saitama,Japan,False,4,0,Draw
21584,23285,24784,2002,Germany,Republic of Ireland,1,1,FIFA World Cup,Kashima,Japan,True,2,0,Draw
21585,23286,24785,2002,Russia,Tunisia,2,0,FIFA World Cup,Kobe,Japan,True,2,2,Russia
21586,23287,24786,2002,United States,Portugal,3,2,FIFA World Cup,Suwon,South Korea,True,5,1,United States
21587,23288,24787,2002,Cameroon,Saudi Arabia,1,0,FIFA World Cup,Saitama,Japan,True,1,1,Cameroon
21588,23289,24788,2002,Denmark,Senegal,1,1,FIFA World Cup,Daegu,South Korea,True,2,0,Draw
21589,23290,24789,2002,France,Uruguay,0,0,FIFA World Cup,Busan,South Korea,True,0,0,Draw
21590,23291,24790,2002,Saint Martin,Anguilla,2,1,Friendly,Marigot,Saint Martin,False,3,1,Saint Martin
21591,23292,24791,2002,Andorra,Armenia,0,2,Friendly,Sant Julià de Lòria,Andorra,False,2,-2,Armenia
21592,23293,24792,2002,Argentina,England,0,1,FIFA World Cup,Sapporo,Japan,True,1,-1,England
21593,23294,24793,2002,Spain,Paraguay,3,1,FIFA World Cup,Jeonju,South Korea,True,4,2,Spain
21594,23295,24794,2002,Sweden,Nigeria,2,1,FIFA World Cup,Kobe,Japan,True,3,1,Sweden
21595,23297,24796,2002,Italy,Croatia,1,2,FIFA World Cup,Kashima,Japan,True,3,-1,Croatia
21596,23298,24797,2002,Malawi,Botswana,2,0,Friendly,Lilongwe,Malawi,False,2,2,Malawi
21597,23299,24798,2002,South Africa,Slovenia,1,0,FIFA World Cup,Daegu,South Korea,True,1,1,South Africa
21598,23300,24799,2002,Costa Rica,Turkey,1,1,FIFA World Cup,Incheon,South Korea,True,2,0,Draw
21599,23301,24800,2002,Japan,Russia,1,0,FIFA World Cup,Yokohama,Japan,False,1,1,Japan
21600,23302,24801,2002,Malawi,Botswana,1,0,Friendly,Blantyre,Malawi,False,1,1,Malawi
21601,23303,24802,2002,Mexico,Ecuador,2,1,FIFA World Cup,Rifu,Japan,True,3,1,Mexico
21602,23304,24804,2002,Portugal,Poland,4,0,FIFA World Cup,Jeonju,South Korea,True,4,4,Portugal
21603,23305,24805,2002,Tunisia,Belgium,1,1,FIFA World Cup,Ōita,Japan,True,2,0,Draw
21604,23306,24806,2002,Cameroon,Germany,0,2,FIFA World Cup,Fukuroi,Japan,True,2,-2,Germany
21605,23307,24807,2002,Denmark,France,2,0,FIFA World Cup,Incheon,South Korea,True,2,2,Denmark
21606,23308,24808,2002,Saudi Arabia,Republic of Ireland,0,3,FIFA World Cup,Yokohama,Japan,True,3,-3,Republic of Ireland
21607,23309,24809,2002,Senegal,Uruguay,3,3,FIFA World Cup,Suwon,South Korea,True,6,0,Draw
21608,23310,24810,2002,Nigeria,England,0,0,FIFA World Cup,Osaka,Japan,True,0,0,Draw
21609,23311,24811,2002,Slovenia,Paraguay,1,3,FIFA World Cup,Seogwipo,South Korea,True,4,-2,Paraguay
21610,23312,24812,2002,South Africa,Spain,2,3,FIFA World Cup,Daejeon,South Korea,True,5,-1,Spain
21611,23313,24813,2002,Sweden,Argentina,1,1,FIFA World Cup,Rifu,Japan,True,2,0,Draw
21612,23314,24814,2002,Costa Rica,Brazil,2,5,FIFA World Cup,Suwon,South Korea,True,7,-3,Brazil
21613,23315,24815,2002,Ecuador,Croatia,1,0,FIFA World Cup,Yokohama,Japan,True,1,1,Ecuador
21614,23316,24816,2002,Mexico,Italy,1,1,FIFA World Cup,Ōita,Japan,True,2,0,Draw
21615,23318,24818,2002,Belgium,Russia,3,2,FIFA World Cup,Fukuroi,Japan,True,5,1,Belgium
21616,23319,24819,2002,Japan,Tunisia,2,0,FIFA World Cup,Osaka,Japan,False,2,2,Japan
21617,23320,24821,2002,Poland,United States,3,1,FIFA World Cup,Daejeon,South Korea,True,4,2,Poland
21618,23321,24822,2002,Denmark,England,0,3,FIFA World Cup,Niigata,Japan,True,3,-3,England
21619,23322,24823,2002,Germany,Paraguay,1,0,FIFA World Cup,Seogwipo,South Korea,True,1,1,Germany
21620,23323,24824,2002,Spain,Republic of Ireland,1,1,FIFA World Cup,Suwon,South Korea,True,2,0,Draw
21621,23324,24825,2002,Sweden,Senegal,1,2,FIFA World Cup,Ōita,Japan,True,3,-1,Senegal
21622,23325,24826,2002,Brazil,Belgium,2,0,FIFA World Cup,Kobe,Japan,True,2,2,Brazil
21623,23326,24827,2002,Mexico,United States,0,2,FIFA World Cup,Jeonju,South Korea,True,2,-2,United States
21624,23327,24828,2002,Japan,Turkey,0,1,FIFA World Cup,Rifu,Japan,False,1,-1,Turkey
21625,23328,24830,2002,England,Brazil,1,2,FIFA World Cup,Fukuroi,Japan,True,3,-1,Brazil
21626,23329,24831,2002,Germany,United States,1,0,FIFA World Cup,Ulsan,South Korea,True,1,1,Germany
21627,23331,24834,2002,Senegal,Turkey,0,1,FIFA World Cup,Osaka,Japan,True,1,-1,Turkey
21628,23332,24835,2002,Saint Martin,Anguilla,1,0,Friendly,Marigot,Saint Martin,False,1,1,Saint Martin
21629,23333,24837,2002,Mozambique,Angola,1,1,Friendly,Maputo,Mozambique,False,2,0,Draw
21630,23334,24838,2002,Brazil,Turkey,1,0,FIFA World Cup,Saitama,Japan,True,1,1,Brazil
21631,23335,24840,2002,Bhutan,Montserrat,4,0,Friendly,Thimphu,Bhutan,False,4,4,Bhutan
21632,23336,24841,2002,Germany,Brazil,0,2,FIFA World Cup,Yokohama,Japan,True,2,-2,Brazil
21633,23337,24842,2002,Estonia,Azerbaijan,0,0,Friendly,Kuressaare,Estonia,False,0,0,Draw
21634,23339,24844,2002,Papua New Guinea,Solomon Islands,0,0,Oceania Nations Cup,North Shore,New Zealand,True,0,0,Draw
21635,23340,24845,2002,Australia,Vanuatu,2,0,Oceania Nations Cup,Auckland,New Zealand,True,2,2,Australia
21636,23341,24847,2002,Fiji,New Caledonia,2,1,Oceania Nations Cup,Auckland,New Zealand,True,3,1,Fiji
21637,23342,24848,2002,Grenada,Saint Martin,8,3,Gold Cup qualification,St. George's,Grenada,False,11,5,Grenada
21638,23343,24849,2002,Latvia,Azerbaijan,0,0,Friendly,Riga,Latvia,False,0,0,Draw
21639,23344,24850,2002,Zambia,Mozambique,3,0,COSAFA Cup,Lusaka,Zambia,False,3,3,Zambia
21640,23345,24851,2002,Guadeloupe,Puerto Rico,4,0,Gold Cup qualification,Baie-Mahault,Guadeloupe,False,4,4,Guadeloupe
21641,23346,24852,2002,Kazakhstan,Estonia,1,1,Friendly,Almaty,Kazakhstan,False,2,0,Draw
21642,23347,24853,2002,Malawi,Zimbabwe,3,2,Friendly,Blantyre,Malawi,False,5,1,Malawi
21643,23348,24854,2002,New Zealand,Papua New Guinea,9,1,Oceania Nations Cup,North Shore,New Zealand,False,10,8,New Zealand
21644,23350,24856,2002,Australia,New Caledonia,11,0,Oceania Nations Cup,Auckland,New Zealand,True,11,11,Australia
21645,23351,24857,2002,Fiji,Vanuatu,0,1,Oceania Nations Cup,Auckland,New Zealand,True,1,-1,Vanuatu
21646,23352,24858,2002,Malawi,Zimbabwe,2,2,Friendly,Lilongwe,Malawi,False,4,0,Draw
21647,23353,24859,2002,New Zealand,Solomon Islands,6,1,Oceania Nations Cup,North Shore,New Zealand,False,7,5,New Zealand
21648,23355,24861,2002,Australia,Fiji,8,0,Oceania Nations Cup,Auckland,New Zealand,True,8,8,Australia
21649,23356,24862,2002,New Caledonia,Vanuatu,0,1,Oceania Nations Cup,Auckland,New Zealand,True,1,-1,Vanuatu
21650,23358,24864,2002,New Zealand,Vanuatu,3,0,Oceania Nations Cup,Auckland,New Zealand,False,3,3,New Zealand
21651,23359,24866,2002,New Zealand,Australia,1,0,Oceania Nations Cup,Auckland,New Zealand,False,1,1,New Zealand
21652,23360,24868,2002,Malaysia,Singapore,1,2,Friendly,Kuantan,Malaysia,False,3,-1,Singapore
21653,23361,24869,2002,Iraq,Syria,2,0,Friendly,Baghdad,Iraq,False,2,2,Iraq
21654,23362,24870,2002,Puerto Rico,Guadeloupe,0,2,Gold Cup qualification,San Juan,Puerto Rico,False,2,-2,Guadeloupe
21655,23363,24871,2002,South Africa,Madagascar,0,0,COSAFA Cup,Port Elizabeth,South Africa,False,0,0,Draw
21656,23364,24872,2002,Iraq,Syria,2,1,Friendly,Baghdad,Iraq,False,3,1,Iraq
21657,23365,24873,2002,Barbados,Trinidad and Tobago,0,0,SKN Football Festival,Basseterre,Saint Kitts and Nevis,True,0,0,Draw
21658,23367,24875,2002,Ethiopia,Uganda,0,0,Friendly,Khartoum,Sudan,True,0,0,Draw
21659,23368,24876,2002,Sudan,Chad,2,0,Friendly,Khartoum,Sudan,False,2,2,Sudan
21660,23369,24877,2002,Saint Kitts and Nevis,Barbados,3,0,SKN Football Festival,Basseterre,Saint Kitts and Nevis,False,3,3,Saint Kitts and Nevis
21661,23370,24878,2002,Aruba,Suriname,0,2,Gold Cup qualification,Oranjestad,Aruba,False,2,-2,Suriname
21662,23371,24879,2002,Chad,Ethiopia,3,2,Friendly,Khartoum,Sudan,True,5,1,Chad
21663,23372,24880,2002,Guyana,Curaçao,2,1,Gold Cup qualification,Georgetown,Guyana,False,3,1,Guyana
21664,23373,24881,2002,Saint Kitts and Nevis,Trinidad and Tobago,2,1,SKN Football Festival,Basseterre,Saint Kitts and Nevis,False,3,1,Saint Kitts and Nevis
21665,23375,24883,2002,Sudan,Uganda,2,1,Friendly,Khartoum,Sudan,False,3,1,Sudan
21666,23376,24884,2002,Chad,Uganda,0,2,Friendly,Khartoum,Sudan,True,2,-2,Uganda
21667,23378,24886,2002,Sudan,Ethiopia,3,0,Friendly,Khartoum,Sudan,False,3,3,Sudan
21668,23379,24887,2002,Eswatini,Mauritius,0,1,Friendly,Mbabane,Eswatini,False,1,-1,Mauritius
21669,23380,24888,2002,Grenada,Jamaica,0,1,Friendly,St. George's,Grenada,False,1,-1,Jamaica
21670,23381,24889,2002,Kenya,Uganda,0,0,Friendly,Kisumu,Kenya,False,0,0,Draw
21671,23382,24890,2002,Eswatini,Mauritius,0,0,Friendly,Big Bend,Eswatini,False,0,0,Draw
21672,23383,24891,2002,Saint Martin,Grenada,1,7,Gold Cup qualification,Marigot,Saint Martin,False,8,-6,Grenada
21673,23384,24892,2002,Egypt,Ethiopia,4,1,Friendly,Alexandria,Egypt,False,5,3,Egypt
21674,23385,24893,2002,Malawi,Zambia,1,0,COSAFA Cup,Blantyre,Malawi,False,1,1,Malawi
21675,23386,24894,2002,Curaçao,Guyana,1,0,Gold Cup qualification,Willemstad,Netherlands Antilles,False,1,1,Curaçao
21676,23387,24895,2002,Saint Lucia,Jamaica,1,3,Friendly,Vieux Fort,Saint Lucia,False,4,-2,Jamaica
21677,23388,24896,2002,Suriname,Aruba,6,0,Gold Cup qualification,Paramaribo,Suriname,False,6,6,Suriname
21678,23389,24897,2002,Dominican Republic,U.S. Virgin Islands,6,1,Gold Cup qualification,San Cristóbal,Dominican Republic,False,7,5,Dominican Republic
21679,23390,24898,2002,Jordan,Kenya,1,1,Friendly,Amman,Jordan,False,2,0,Draw
21680,23391,24899,2002,Dominican Republic,U.S. Virgin Islands,5,1,Gold Cup qualification,San Cristóbal,Dominican Republic,False,6,4,Dominican Republic
21681,23392,24900,2002,Jordan,Sudan,0,0,Friendly,Amman,Jordan,False,0,0,Draw
21682,23393,24901,2002,Algeria,DR Congo,1,1,Friendly,Blida,Algeria,False,2,0,Draw
21683,23394,24902,2002,Egypt,Uganda,2,0,Friendly,Alexandria,Egypt,False,2,2,Egypt
21684,23395,24903,2002,Azerbaijan,Uzbekistan,2,0,Friendly,Baku,Azerbaijan,False,2,2,Azerbaijan
21685,23396,24904,2002,Bosnia and Herzegovina,Serbia,0,2,Friendly,Sarajevo,Bosnia and Herzegovina,False,2,-2,Serbia
21686,23397,24905,2002,Brazil,Paraguay,0,1,Friendly,Fortaleza,Brazil,False,1,-1,Paraguay
21687,23398,24906,2002,Bulgaria,Germany,2,2,Friendly,Sofia,Bulgaria,False,4,0,Draw
21688,23399,24907,2002,Croatia,Wales,1,1,Friendly,Varaždin,Croatia,False,2,0,Draw
21689,23400,24908,2002,Czech Republic,Slovakia,4,1,Friendly,Olomouc,Czech Republic,False,5,3,Czech Republic
21690,23401,24909,2002,Estonia,Moldova,1,0,Friendly,Tallinn,Estonia,False,1,1,Estonia
21691,23402,24910,2002,Faroe Islands,Liechtenstein,3,1,Friendly,Tórshavn,Faroe Islands,False,4,2,Faroe Islands
21692,23403,24911,2002,Finland,Republic of Ireland,0,3,Friendly,Helsinki,Finland,False,3,-3,Republic of Ireland
21693,23404,24912,2002,Hungary,Spain,1,1,Friendly,Budapest,Hungary,False,2,0,Draw
21694,23405,24913,2002,Iceland,Andorra,3,0,Friendly,Reykjavík,Iceland,False,3,3,Iceland
21695,23406,24914,2002,Italy,Slovenia,0,1,Friendly,Trieste,Italy,False,1,-1,Slovenia
21696,23407,24915,2002,Latvia,Belarus,2,4,Friendly,Riga,Latvia,False,6,-2,Belarus
21697,23408,24916,2002,Lithuania,Israel,2,4,Friendly,Kaunas,Lithuania,False,6,-2,Israel
21698,23409,24917,2002,Luxembourg,Morocco,0,2,Friendly,Luxembourg,Luxembourg,False,2,-2,Morocco
21699,23410,24919,2002,Mauritius,Réunion,1,1,Friendly,Curepipe,Mauritius,False,2,0,Draw
21700,23411,24920,2002,Northern Ireland,Cyprus,0,0,Friendly,Belfast,Northern Ireland,False,0,0,Draw
21701,23412,24921,2002,Norway,Netherlands,0,1,Friendly,Oslo,Norway,False,1,-1,Netherlands
21702,23413,24922,2002,Poland,Belgium,1,1,Friendly,Szczecin,Poland,False,2,0,Draw
21703,23414,24923,2002,Romania,Greece,0,1,Friendly,Constanţa,Romania,False,1,-1,Greece
21704,23415,24924,2002,Russia,Sweden,1,1,Friendly,Moscow,Russia,False,2,0,Draw
21705,23416,24925,2002,Scotland,Denmark,0,1,Friendly,Glasgow,Scotland,False,1,-1,Denmark
21706,23417,24926,2002,Switzerland,Austria,3,2,Friendly,Basel,Switzerland,False,5,1,Switzerland
21707,23418,24927,2002,Tunisia,France,1,1,Friendly,Radès,Tunisia,False,2,0,Draw
21708,23419,24928,2002,Turkey,Georgia,3,0,Friendly,Trabzon,Turkey,False,3,3,Turkey
21709,23420,24929,2002,Ukraine,Iran,0,1,Friendly,Kyïv,Ukraine,False,1,-1,Iran
21710,23421,24930,2002,Venezuela,Bolivia,2,0,Friendly,Caracas,Venezuela,False,2,2,Venezuela
21711,23422,24931,2002,Egypt,Sudan,3,0,Friendly,Cairo,Egypt,False,3,3,Egypt
21712,23423,24932,2002,Rwanda,Kenya,0,0,Friendly,Kigali,Rwanda,False,0,0,Draw
21713,23424,24933,2002,South Africa,Eswatini,4,1,COSAFA Cup,Polokwane,South Africa,False,5,3,South Africa
21714,23425,24934,2002,Angola,Gabon,1,0,Friendly,Luanda,Angola,False,1,1,Angola
21715,23426,24935,2002,Gambia,Sierra Leone,1,0,Friendly,Banjul,Gambia,False,1,1,Gambia
21716,23427,24936,2002,Botswana,Lesotho,0,1,Friendly,Gaborone,Botswana,False,1,-1,Lesotho
21717,23428,24937,2002,Congo,DR Congo,1,3,Friendly,Brazzaville,Congo,False,4,-2,DR Congo
21718,23429,24938,2002,Egypt,Libya,0,1,Friendly,Alexandria,Egypt,False,1,-1,Libya
21719,23430,24939,2002,India,Jamaica,0,3,Friendly,Watford,England,True,3,-3,Jamaica
21720,23431,24940,2002,Jordan,Iran,1,0,WAFF Championship,Damascus,Syria,True,1,1,Jordan
21721,23432,24941,2002,Syria,Palestine,2,1,WAFF Championship,Damascus,Syria,False,3,1,Syria
21722,23433,24942,2002,Zimbabwe,Lesotho,2,0,Friendly,Harare,Zimbabwe,False,2,2,Zimbabwe
21723,23434,24943,2002,Uganda,Zambia,2,2,Friendly,Kampala,Uganda,False,4,0,Draw
21724,23435,24944,2002,Congo,Gabon,0,0,Friendly,Brazzaville,Congo,False,0,0,Draw
21725,23436,24945,2002,Gambia,Guinea,1,0,Friendly,Banjul,Gambia,False,1,1,Gambia
21726,23437,24946,2002,India,Jamaica,0,0,Friendly,Wolverhampton,England,True,0,0,Draw
21727,23438,24947,2002,Lebanon,Jordan,0,1,WAFF Championship,Damascus,Syria,True,1,-1,Jordan
21728,23439,24948,2002,Palestine,Iraq,0,2,WAFF Championship,Damascus,Syria,True,2,-2,Iraq
21729,23440,24949,2002,Libya,Togo,4,0,Friendly,Misurata,Libya,False,4,4,Libya
21730,23442,24951,2002,Iran,Lebanon,2,0,WAFF Championship,Damascus,Syria,True,2,2,Iran
21731,23443,24952,2002,Syria,Iraq,0,1,WAFF Championship,Damascus,Syria,False,1,-1,Iraq
21732,23444,24953,2002,Iraq,Iran,0,0,WAFF Championship,Damascus,Syria,True,0,0,Draw
21733,23445,24954,2002,Luxembourg,Israel,0,5,Friendly,Luxembourg,Luxembourg,False,5,-5,Israel
21734,23446,24955,2002,Syria,Jordan,1,2,WAFF Championship,Damascus,Syria,False,3,-1,Jordan
21735,23447,24956,2002,Czech Republic,Serbia,5,0,Friendly,Prague,Czech Republic,False,5,5,Czech Republic
21736,23449,24958,2002,Armenia,Ukraine,2,2,UEFA Euro qualification,Yerevan,Armenia,False,4,0,Draw
21737,23450,24959,2002,Austria,Moldova,2,0,UEFA Euro qualification,Vienna,Austria,False,2,2,Austria
21738,23451,24960,2002,Azerbaijan,Italy,0,2,UEFA Euro qualification,Baku,Azerbaijan,False,2,-2,Italy
21739,23452,24961,2002,Belgium,Bulgaria,0,2,UEFA Euro qualification,Brussels,Belgium,False,2,-2,Bulgaria
21740,23453,24962,2002,Bosnia and Herzegovina,Romania,0,3,UEFA Euro qualification,Sarajevo,Bosnia and Herzegovina,False,3,-3,Romania
21741,23454,24963,2002,Botswana,Eswatini,0,0,African Cup of Nations qualification,Gaborone,Botswana,False,0,0,Draw
21742,23455,24964,2002,Croatia,Estonia,0,0,UEFA Euro qualification,Osijek,Croatia,False,0,0,Draw
21743,23456,24965,2002,Cyprus,France,1,2,UEFA Euro qualification,Nicosia,Cyprus,False,3,-1,France
21744,23457,24966,2002,England,Portugal,1,1,Friendly,Birmingham,England,False,2,0,Draw
21745,23458,24967,2002,Faroe Islands,Scotland,2,2,UEFA Euro qualification,Toftir,Faroe Islands,False,4,0,Draw
21746,23459,24968,2002,Finland,Wales,0,2,UEFA Euro qualification,Helsinki,Finland,False,2,-2,Wales
21747,23460,24969,2002,Gabon,Morocco,0,1,African Cup of Nations qualification,Libreville,Gabon,False,1,-1,Morocco
21748,23461,24970,2002,Greece,Spain,0,2,UEFA Euro qualification,Athens,Greece,False,2,-2,Spain
21749,23462,24971,2002,Iceland,Hungary,0,2,Friendly,Reykjavík,Iceland,False,2,-2,Hungary
21750,23463,24972,2002,Jordan,Iraq,2,3,WAFF Championship,Damascus,Syria,True,5,-1,Iraq
21751,23464,24973,2002,Kenya,Togo,3,0,African Cup of Nations qualification,Nairobi,Kenya,False,3,3,Kenya
21752,23465,24975,2002,Latvia,Sweden,0,0,UEFA Euro qualification,Riga,Latvia,False,0,0,Draw
21753,23466,24976,2002,Lithuania,Germany,0,2,UEFA Euro qualification,Kaunas,Lithuania,False,2,-2,Germany
21754,23467,24977,2002,Namibia,Algeria,0,1,African Cup of Nations qualification,Windhoek,Namibia,False,1,-1,Algeria
21755,23468,24978,2002,Netherlands,Belarus,3,0,UEFA Euro qualification,Eindhoven,Netherlands,False,3,3,Netherlands
21756,23469,24979,2002,Niger,Ethiopia,3,1,African Cup of Nations qualification,Niamey,Niger,False,4,2,Niger
21757,23470,24980,2002,Norway,Denmark,2,2,UEFA Euro qualification,Oslo,Norway,False,4,0,Draw
21758,23471,24981,2002,Russia,Republic of Ireland,4,2,UEFA Euro qualification,Moscow,Russia,False,6,2,Russia
21759,23472,24982,2002,San Marino,Poland,0,2,UEFA Euro qualification,Serravalle,San Marino,False,2,-2,Poland
21760,23473,24983,2002,Slovenia,Malta,3,0,UEFA Euro qualification,Ljubljana,Slovenia,False,3,3,Slovenia
21761,23474,24984,2002,Syria,Iran,2,2,WAFF Championship,Damascus,Syria,False,4,0,Draw
21762,23475,24985,2002,Turkey,Slovakia,3,0,UEFA Euro qualification,Istanbul,Turkey,False,3,3,Turkey
21763,23476,24986,2002,Uganda,Ghana,1,0,African Cup of Nations qualification,Kampala,Uganda,False,1,1,Uganda
21764,23477,24987,2002,Angola,Nigeria,0,0,African Cup of Nations qualification,Luanda,Angola,False,0,0,Draw
21765,23478,24988,2002,Benin,Tanzania,4,0,African Cup of Nations qualification,Cotonou,Benin,False,4,4,Benin
21766,23479,24989,2002,Congo,Burkina Faso,0,0,African Cup of Nations qualification,Brazzaville,Congo,False,0,0,Draw
21767,23480,24990,2002,Equatorial Guinea,Sierra Leone,1,3,African Cup of Nations qualification,Malabo,Equatorial Guinea,False,4,-2,Sierra Leone
21768,23481,24991,2002,Guinea,Liberia,3,0,African Cup of Nations qualification,Conakry,Guinea,False,3,3,Guinea
21769,23482,24992,2002,Ivory Coast,South Africa,0,0,African Cup of Nations qualification,Abidjan,Ivory Coast,False,0,0,Draw
21770,23483,24993,2002,Lesotho,Senegal,0,1,African Cup of Nations qualification,Maseru,Lesotho,False,1,-1,Senegal
21771,23484,24994,2002,Libya,DR Congo,3,2,African Cup of Nations qualification,Misurata,Libya,False,5,1,Libya
21772,23486,24996,2002,Seychelles,Eritrea,1,0,African Cup of Nations qualification,Victoria,Seychelles,False,1,1,Seychelles
21773,23487,24997,2002,Sudan,Zambia,0,1,African Cup of Nations qualification,Omdurman,Sudan,False,1,-1,Zambia
21774,23488,24998,2002,Switzerland,Georgia,4,1,UEFA Euro qualification,Basel,Switzerland,False,5,3,Switzerland
21775,23489,24999,2002,Zimbabwe,Mali,1,0,African Cup of Nations qualification,Harare,Zimbabwe,False,1,1,Zimbabwe
21776,23490,25000,2002,Central African Republic,Mozambique,1,1,African Cup of Nations qualification,Bangui,Central African Republic,False,2,0,Draw
21777,23491,25001,2002,Iran,Morocco,1,1,Friendly,Tabriz,Iran,False,2,0,Draw
21778,23492,25002,2002,Ivory Coast,Gambia,5,0,Friendly,Bouaké,Ivory Coast,False,5,5,Ivory Coast
21779,23493,25003,2002,Iran,Paraguay,1,1,Friendly,Tabriz,Iran,False,2,0,Draw
21780,23494,25004,2002,Malawi,South Africa,1,3,COSAFA Cup,Blantyre,Malawi,False,4,-2,South Africa
21781,23495,25005,2002,Algeria,Uganda,1,1,Friendly,Annaba,Algeria,False,2,0,Draw
21782,23496,25006,2002,Oman,United Arab Emirates,2,1,Friendly,Muscat,Oman,False,3,1,Oman
21783,23497,25007,2002,Mauritius,Seychelles,1,0,Friendly,Port Louis,Mauritius,False,1,1,Mauritius
21784,23498,25008,2002,South Africa,Malawi,1,0,COSAFA Cup,Durban,South Africa,False,1,1,South Africa
21785,23499,25009,2002,Zimbabwe,Zambia,0,0,Friendly,Harare,Zimbabwe,False,0,0,Draw
21786,23500,25010,2002,Mali,Mauritania,2,1,Friendly,Bamako,Mali,False,3,1,Mali
21787,23501,25011,2002,Morocco,Niger,6,1,Friendly,Rabat,Morocco,False,7,5,Morocco
21788,23502,25012,2002,Mali,Mauritania,2,0,Friendly,Bamako,Mali,False,2,2,Mali
21789,23503,25013,2002,Barbados,Saint Lucia,3,2,Friendly,Bridgetown,Barbados,False,5,1,Barbados
21790,23504,25014,2002,Eswatini,Lesotho,0,0,Friendly,Big Bend,Eswatini,False,0,0,Draw
21791,23505,25015,2002,Ghana,Lesotho,2,1,Friendly,Accra,Ghana,False,3,1,Ghana
21792,23506,25016,2002,Martinique,Saint Lucia,4,0,Friendly,Rivière-Pilote,Martinique,False,4,4,Martinique
21793,23507,25017,2002,Algeria,Chad,4,1,African Cup of Nations qualification,Annaba,Algeria,False,5,3,Algeria
21794,23508,25018,2002,Bosnia and Herzegovina,Germany,1,1,Friendly,Sarajevo,Bosnia and Herzegovina,False,2,0,Draw
21795,23509,25019,2002,Albania,Switzerland,1,1,UEFA Euro qualification,Tirana,Albania,False,2,0,Draw
21796,23510,25020,2002,Andorra,Belgium,0,1,UEFA Euro qualification,Sant Julià de Lòria,Andorra,False,1,-1,Belgium
21797,23511,25021,2002,Belarus,Austria,0,2,UEFA Euro qualification,Minsk,Belarus,False,2,-2,Austria
21798,23512,25022,2002,Bulgaria,Croatia,2,0,UEFA Euro qualification,Sofia,Bulgaria,False,2,2,Bulgaria
21799,23513,25023,2002,Denmark,Luxembourg,2,0,UEFA Euro qualification,Copenhagen,Denmark,False,2,2,Denmark
21800,23514,25024,2002,Eritrea,Zimbabwe,0,1,African Cup of Nations qualification,Asmara,Eritrea,False,1,-1,Zimbabwe
21801,23515,25025,2002,Finland,Azerbaijan,3,0,UEFA Euro qualification,Helsinki,Finland,False,3,3,Finland
21802,23516,25026,2002,France,Slovenia,5,0,UEFA Euro qualification,Saint-Denis,France,False,5,5,France
21803,23517,25027,2002,Iceland,Scotland,0,2,UEFA Euro qualification,Reykjavík,Iceland,False,2,-2,Scotland
21804,23518,25028,2002,Italy,Serbia,1,1,UEFA Euro qualification,Naples,Italy,False,2,0,Draw
21805,23519,25029,2002,Lithuania,Faroe Islands,2,0,UEFA Euro qualification,Kaunas,Lithuania,False,2,2,Lithuania
21806,23520,25031,2002,Malawi,Angola,1,0,African Cup of Nations qualification,Lilongwe,Malawi,False,1,1,Malawi
21807,23521,25032,2002,Malta,Israel,0,2,UEFA Euro qualification,Attard,Malta,False,2,-2,Israel
21808,23522,25033,2002,Mauritius,Madagascar,0,1,African Cup of Nations qualification,Centre de Flacq,Mauritius,False,1,-1,Madagascar
21809,23523,25034,2002,Moldova,Czech Republic,0,2,UEFA Euro qualification,Chişinău,Moldova,False,2,-2,Czech Republic
21810,23524,25035,2002,Poland,Latvia,0,1,UEFA Euro qualification,Warsaw,Poland,False,1,-1,Latvia
21811,23525,25036,2002,Portugal,Tunisia,1,1,Friendly,Lisbon,Portugal,False,2,0,Draw
21812,23526,25037,2002,Romania,Norway,0,1,UEFA Euro qualification,Bucharest,Romania,False,1,-1,Norway
21813,23527,25038,2002,Senegal,Nigeria,2,2,Friendly,Dakar,Senegal,False,4,0,Draw
21814,23528,25039,2002,Sierra Leone,Gabon,2,0,African Cup of Nations qualification,Freetown,Sierra Leone,False,2,2,Sierra Leone
21815,23529,25040,2002,Slovakia,England,1,2,UEFA Euro qualification,Bratislava,Slovakia,False,3,-1,England
21816,23530,25041,2002,Spain,Northern Ireland,3,0,UEFA Euro qualification,Albacete,Spain,False,3,3,Spain
21817,23531,25042,2002,Sweden,Hungary,1,1,UEFA Euro qualification,Solna,Sweden,False,2,0,Draw
21818,23532,25043,2002,Tanzania,Sudan,1,2,African Cup of Nations qualification,Mwanza,Tanzania,False,3,-1,Sudan
21819,23533,25044,2002,Ukraine,Greece,2,0,UEFA Euro qualification,Kyïv,Ukraine,False,2,2,Ukraine
21820,23534,25045,2002,Zambia,Benin,1,1,African Cup of Nations qualification,Lusaka,Zambia,False,2,0,Draw
21821,23535,25046,2002,DR Congo,Botswana,2,0,African Cup of Nations qualification,Kinshasa,DR Congo,False,2,2,DR Congo
21822,23536,25047,2002,Estonia,New Zealand,3,2,Friendly,Tallinn,Estonia,False,5,1,Estonia
21823,23537,25048,2002,Ethiopia,Guinea,1,0,African Cup of Nations qualification,Addis Abeba,Ethiopia,False,1,1,Ethiopia
21824,23538,25049,2002,Ghana,Rwanda,4,2,African Cup of Nations qualification,Accra,Ghana,False,6,2,Ghana
21825,23539,25050,2002,Mali,Seychelles,3,0,African Cup of Nations qualification,Bamako,Mali,False,3,3,Mali
21826,23540,25051,2002,Morocco,Equatorial Guinea,5,0,African Cup of Nations qualification,Rabat,Morocco,False,5,5,Morocco
21827,23541,25052,2002,Mozambique,Congo,0,3,African Cup of Nations qualification,Maputo,Mozambique,False,3,-3,Congo
21828,23542,25053,2002,Eswatini,Libya,2,1,African Cup of Nations qualification,Lobamba,Eswatini,False,3,1,Eswatini
21829,23543,25054,2002,Scotland,Canada,3,1,Friendly,Edinburgh,Scotland,False,4,2,Scotland
21830,23544,25055,2002,Austria,Netherlands,0,3,UEFA Euro qualification,Vienna,Austria,False,3,-3,Netherlands
21831,23545,25056,2002,Bulgaria,Andorra,2,1,UEFA Euro qualification,Sofia,Bulgaria,False,3,1,Bulgaria
21832,23546,25057,2002,Costa Rica,Ecuador,1,1,Friendly,San José,Costa Rica,False,2,0,Draw
21833,23547,25058,2002,Czech Republic,Belarus,2,0,UEFA Euro qualification,Teplice,Czech Republic,False,2,2,Czech Republic
21834,23549,25060,2002,Estonia,Belgium,0,1,UEFA Euro qualification,Tallinn,Estonia,False,1,-1,Belgium
21835,23550,25061,2002,Germany,Faroe Islands,2,1,UEFA Euro qualification,Hanover,Germany,False,3,1,Germany
21836,23551,25062,2002,Greece,Armenia,2,0,UEFA Euro qualification,Athens,Greece,False,2,2,Greece
21837,23552,25063,2002,Hungary,San Marino,3,0,UEFA Euro qualification,Budapest,Hungary,False,3,3,Hungary
21838,23553,25064,2002,Iceland,Lithuania,3,0,UEFA Euro qualification,Reykjavík,Iceland,False,3,3,Iceland
21839,23554,25065,2002,Republic of Ireland,Switzerland,1,2,UEFA Euro qualification,Dublin,Republic of Ireland,False,3,-1,Switzerland
21840,23555,25066,2002,Japan,Jamaica,1,1,Friendly,Tokyo,Japan,False,2,0,Draw
21841,23556,25067,2002,Luxembourg,Romania,0,7,UEFA Euro qualification,Luxembourg,Luxembourg,False,7,-7,Romania
21842,23557,25068,2002,Malta,France,0,4,UEFA Euro qualification,Attard,Malta,False,4,-4,France
21843,23558,25069,2002,Northern Ireland,Ukraine,0,0,UEFA Euro qualification,Belfast,Northern Ireland,False,0,0,Draw
21844,23559,25070,2002,Norway,Bosnia and Herzegovina,2,0,UEFA Euro qualification,Oslo,Norway,False,2,2,Norway
21845,23560,25071,2002,Poland,New Zealand,2,0,Friendly,Ostrowiec Świętokrzyski,Poland,False,2,2,Poland
21846,23561,25072,2002,Russia,Albania,4,1,UEFA Euro qualification,Volgograd,Russia,False,5,3,Russia
21847,23562,25073,2002,Serbia,Finland,2,0,UEFA Euro qualification,Belgrade,Yugoslavia,False,2,2,Serbia
21848,23563,25074,2002,Spain,Paraguay,0,0,Friendly,Logroño,Spain,False,0,0,Draw
21849,23564,25075,2002,Sweden,Portugal,2,3,Friendly,Gothenburg,Sweden,False,5,-1,Portugal
21850,23565,25076,2002,Turkey,Liechtenstein,5,0,UEFA Euro qualification,Istanbul,Turkey,False,5,5,Turkey
21851,23566,25077,2002,Wales,Italy,2,1,UEFA Euro qualification,Cardiff,Wales,False,3,1,Wales
21852,23567,25078,2002,French Guiana,Suriname,1,1,Friendly,Cayenne,French Guiana,False,2,0,Draw
21853,23568,25079,2002,French Guiana,Suriname,0,1,Friendly,Cayenne,French Guiana,False,1,-1,Suriname
21854,23569,25080,2002,Sierra Leone,Ghana,2,1,Friendly,Freetown,Sierra Leone,False,3,1,Sierra Leone
21855,23570,25081,2002,Venezuela,Ecuador,2,0,Friendly,Caracas,Venezuela,False,2,2,Venezuela
21856,23571,25082,2002,Kenya,South Africa,1,1,Friendly,Arusha,Tanzania,True,2,0,Draw
21857,23572,25083,2002,Tanzania,Uganda,0,2,Friendly,Arusha,Tanzania,False,2,-2,Uganda
21858,23573,25084,2002,Kenya,Uganda,1,1,Friendly,Dar es Salaam,Tanzania,True,2,0,Draw
21859,23574,25085,2002,Tanzania,South Africa,1,1,Friendly,Dar es Salaam,Tanzania,False,2,0,Draw
21860,23576,25087,2002,Martinique,Saint Kitts and Nevis,2,1,Friendly,Fort-de-France,Martinique,False,3,1,Martinique
21861,23577,25088,2002,Saint Lucia,Martinique,0,2,Friendly,Vieux Fort,Saint Lucia,False,2,-2,Martinique
21862,23578,25089,2002,Saint Lucia,Antigua and Barbuda,2,1,Friendly,Vieux Fort,Saint Lucia,False,3,1,Saint Lucia
21863,23579,25090,2002,Barbados,Jamaica,1,1,Gold Cup qualification,St. George's,Grenada,True,2,0,Draw
21864,23580,25091,2002,Grenada,Guadeloupe,4,5,Gold Cup qualification,St. George's,Grenada,False,9,-1,Guadeloupe
21865,23581,25092,2002,Singapore,Indonesia,1,1,Friendly,Singapore,Singapore,False,2,0,Draw
21866,23582,25093,2002,Grenada,Barbados,0,2,Gold Cup qualification,St. George's,Grenada,False,2,-2,Barbados
21867,23583,25094,2002,Jamaica,Guadeloupe,2,0,Gold Cup qualification,St. George's,Grenada,True,2,2,Jamaica
21868,23584,25095,2002,Barbados,Guadeloupe,0,1,Gold Cup qualification,St. George's,Grenada,True,1,-1,Guadeloupe
21869,23585,25096,2002,Grenada,Jamaica,1,4,Gold Cup qualification,St. George's,Grenada,False,5,-3,Jamaica
21870,23586,25097,2002,Saint Kitts and Nevis,Saint Lucia,2,1,Gold Cup qualification,Macoya,Trinidad and Tobago,True,3,1,Saint Kitts and Nevis
21871,23587,25098,2002,Trinidad and Tobago,Saint Kitts and Nevis,2,0,Gold Cup qualification,Port of Spain,Trinidad and Tobago,False,2,2,Trinidad and Tobago
21872,23588,25099,2002,Cayman Islands,Nicaragua,0,1,Friendly,George Town,Cayman Islands,False,1,-1,Nicaragua
21873,23589,25100,2002,Trinidad and Tobago,Saint Lucia,0,1,Gold Cup qualification,Macoya,Trinidad and Tobago,False,1,-1,Saint Lucia
21874,23590,25101,2002,United States,El Salvador,2,0,Friendly,Washington,United States,False,2,2,United States
21875,23591,25102,2002,Haiti,Antigua and Barbuda,1,0,Gold Cup qualification,Port-au-Prince,Haiti,False,1,1,Haiti
21876,23592,25103,2002,South Africa,Senegal,1,1,Friendly,Johannesburg,South Africa,False,2,0,Draw
21877,23593,25104,2002,Antigua and Barbuda,Curaçao,1,1,Gold Cup qualification,Port-au-Prince,Haiti,True,2,0,Draw
21878,23594,25105,2002,Austria,Norway,0,1,Friendly,Vienna,Austria,False,1,-1,Norway
21879,23595,25106,2002,Azerbaijan,Wales,0,2,UEFA Euro qualification,Baku,Azerbaijan,False,2,-2,Wales
21880,23596,25107,2002,Cyprus,Malta,2,1,UEFA Euro qualification,Nicosia,Cyprus,False,3,1,Cyprus
21881,23597,25108,2002,Czech Republic,Sweden,3,3,Friendly,Teplice,Czech Republic,False,6,0,Draw
21882,23598,25109,2002,Denmark,Poland,2,0,Friendly,Copenhagen,Denmark,False,2,2,Denmark
21883,23599,25110,2002,Ecuador,Costa Rica,2,2,Friendly,Quito,Ecuador,False,4,0,Draw
21884,23600,25111,2002,Estonia,Iceland,2,0,Friendly,Tallinn,Estonia,False,2,2,Estonia
21885,23601,25112,2002,France,Serbia,3,0,Friendly,Saint-Denis,France,False,3,3,France
21886,23602,25113,2002,Germany,Netherlands,1,3,Friendly,Gelsenkirchen,Germany,False,4,-2,Netherlands
21887,23603,25114,2002,Greece,Republic of Ireland,0,0,Friendly,Athens,Greece,False,0,0,Draw
21888,23604,25115,2002,Honduras,Colombia,1,0,Friendly,San Pedro Sula,Honduras,False,1,1,Honduras
21889,23605,25116,2002,Hungary,Moldova,1,1,Friendly,Budapest,Hungary,False,2,0,Draw
21890,23606,25117,2002,Italy,Turkey,1,1,Friendly,Pescara,Italy,False,2,0,Draw
21891,23607,25118,2002,Japan,Argentina,0,2,Friendly,Saitama,Japan,False,2,-2,Argentina
21892,23609,25122,2002,Morocco,Mali,1,3,Friendly,Rabat,Morocco,False,4,-2,Mali
21893,23610,25123,2002,Nigeria,Jamaica,0,0,Friendly,Lagos,Nigeria,False,0,0,Draw
21894,23611,25124,2002,Portugal,Scotland,2,0,Friendly,Braga,Portugal,False,2,2,Portugal
21895,23612,25125,2002,Qatar,Iraq,2,1,Friendly,Doha,Qatar,False,3,1,Qatar
21896,23613,25126,2002,Romania,Croatia,0,1,Friendly,Timişoara,Romania,False,1,-1,Croatia
21897,23614,25127,2002,San Marino,Latvia,0,1,UEFA Euro qualification,Serravalle,San Marino,False,1,-1,Latvia
21898,23615,25128,2002,Slovakia,Ukraine,1,1,Friendly,Trnava,Slovakia,False,2,0,Draw
21899,23616,25129,2002,Spain,Bulgaria,1,0,Friendly,Granada,Spain,False,1,1,Spain
21900,23617,25130,2002,Tunisia,Egypt,0,0,Friendly,Tunis,Tunisia,False,0,0,Draw
21901,23618,25131,2002,Venezuela,Uruguay,1,0,Friendly,Caracas,Venezuela,False,1,1,Venezuela
21902,23619,25132,2002,Haiti,Curaçao,3,0,Gold Cup qualification,Port-au-Prince,Haiti,False,3,3,Haiti
21903,23620,25133,2002,Bahrain,Iraq,2,2,Friendly,Doha,Qatar,True,4,0,Draw
21904,23622,25135,2002,Nigeria,Egypt,1,1,Friendly,Lagos,Nigeria,False,2,0,Draw
21905,23623,25136,2002,Cayman Islands,Cuba,0,5,Gold Cup qualification,George Town,Cayman Islands,False,5,-5,Cuba
21906,23624,25137,2002,Martinique,Dominican Republic,4,0,Gold Cup qualification,George Town,Cayman Islands,True,4,4,Martinique
21907,23625,25138,2002,Sri Lanka,Vietnam,1,2,Friendly,Colombo,Sri Lanka,False,3,-1,Vietnam
21908,23626,25139,2002,Cayman Islands,Dominican Republic,1,0,Gold Cup qualification,George Town,Cayman Islands,False,1,1,Cayman Islands
21909,23627,25140,2002,Jordan,Malaysia,1,0,Friendly,Abu Dhabi,United Arab Emirates,True,1,1,Jordan
21910,23628,25141,2002,Martinique,Cuba,1,2,Gold Cup qualification,George Town,Cayman Islands,True,3,-1,Cuba
21911,23629,25142,2002,Sri Lanka,Vietnam,1,1,Friendly,Colombo,Sri Lanka,False,2,0,Draw
21912,23630,25143,2002,Jordan,Singapore,3,1,Friendly,Abu Dhabi,United Arab Emirates,True,4,2,Jordan
21913,23632,25145,2002,Tanzania,Kenya,1,0,CECAFA Cup,Mwanza,Tanzania,False,1,1,Tanzania
21914,23633,25146,2002,Burundi,Eritrea,1,1,CECAFA Cup,Mwanza,Tanzania,True,2,0,Draw
21915,23634,25147,2002,Cayman Islands,Martinique,0,3,Gold Cup qualification,George Town,Cayman Islands,False,3,-3,Martinique
21916,23635,25148,2002,Dominican Republic,Cuba,1,2,Gold Cup qualification,George Town,Cayman Islands,True,3,-1,Cuba
21917,23636,25149,2002,Somalia,Uganda,0,2,CECAFA Cup,Arusha,Tanzania,True,2,-2,Uganda
21918,23637,25150,2002,Sri Lanka,Vietnam,2,2,Friendly,Colombo,Sri Lanka,False,4,0,Draw
21919,23639,25152,2002,Tanzania,Sudan,1,1,CECAFA Cup,Mwanza,Tanzania,False,2,0,Draw
21920,23640,25153,2002,Kenya,Burundi,1,1,CECAFA Cup,Mwanza,Tanzania,True,2,0,Draw
21921,23641,25154,2002,Somalia,Rwanda,0,1,CECAFA Cup,Arusha,Tanzania,True,1,-1,Rwanda
21922,23642,25155,2002,Eritrea,Sudan,2,1,CECAFA Cup,Mwanza,Tanzania,True,3,1,Eritrea
21923,23643,25156,2002,Uganda,Ethiopia,3,0,CECAFA Cup,Arusha,Tanzania,True,3,3,Uganda
21924,23644,25157,2002,Tanzania,Burundi,2,0,CECAFA Cup,Mwanza,Tanzania,False,2,2,Tanzania
21925,23645,25159,2002,Kenya,Eritrea,4,1,CECAFA Cup,Mwanza,Tanzania,True,5,3,Kenya
21926,23646,25160,2002,Uganda,Rwanda,2,1,CECAFA Cup,Arusha,Tanzania,True,3,1,Uganda
21927,23647,25161,2002,Bahrain,Jordan,0,3,Prime Minister's Cup,Riffa,Bahrain,False,3,-3,Jordan
21928,23648,25163,2002,Ethiopia,Somalia,0,1,CECAFA Cup,Arusha,Tanzania,True,1,-1,Somalia
21929,23649,25164,2002,Sudan,Burundi,2,1,CECAFA Cup,Mwanza,Tanzania,True,3,1,Sudan
21930,23650,25165,2002,Tanzania,Eritrea,1,1,CECAFA Cup,Mwanza,Tanzania,False,2,0,Draw
21931,23651,25166,2002,Thailand,Vietnam,2,1,Friendly,Bangkok,Thailand,False,3,1,Thailand
21932,23652,25168,2002,Bahrain,Syria,2,3,Prime Minister's Cup,Riffa,Bahrain,False,5,-1,Syria
21933,23653,25170,2002,Rwanda,Ethiopia,1,0,CECAFA Cup,Arusha,Tanzania,True,1,1,Rwanda
21934,23654,25171,2002,Sudan,Kenya,0,1,CECAFA Cup,Mwanza,Tanzania,True,1,-1,Kenya
21935,23655,25172,2002,Chile,Palestine,3,1,Friendly,Independencia,Chile,False,4,2,Chile
21936,23656,25173,2002,Malaysia,Cambodia,5,0,Friendly,Petaling Jaya,Malaysia,False,5,5,Malaysia
21937,23657,25174,2002,Singapore,Philippines,2,0,Friendly,Singapore,Singapore,False,2,2,Singapore
21938,23658,25175,2002,Tanzania,Rwanda,3,0,CECAFA Cup,Mwanza,Tanzania,False,3,3,Tanzania
21939,23660,25177,2002,Jordan,Syria,3,0,Prime Minister's Cup,Riffa,Bahrain,True,3,3,Jordan
21940,23661,25178,2002,Uganda,Kenya,1,3,CECAFA Cup,Arusha,Tanzania,True,4,-2,Kenya
21941,23662,25179,2002,Saudi Arabia,Lebanon,1,1,Friendly,Dammam,Saudi Arabia,False,2,0,Draw
21942,23663,25180,2002,Botswana,Zambia,1,0,Friendly,Gaborone,Botswana,False,1,1,Botswana
21943,23664,25181,2002,Rwanda,Uganda,2,1,CECAFA Cup,Arusha,Tanzania,True,3,1,Rwanda
21944,23665,25182,2002,Tanzania,Kenya,2,3,CECAFA Cup,Mwanza,Tanzania,False,5,-1,Kenya
21945,23666,25183,2002,Ghana,Nigeria,0,1,Friendly,Accra,Ghana,False,1,-1,Nigeria
21946,23667,25184,2002,Indonesia,Burma,0,0,AFF Championship,Jakarta,Indonesia,False,0,0,Draw
21947,23668,25185,2002,Vietnam,Cambodia,9,2,AFF Championship,Jakarta,Indonesia,True,11,7,Vietnam
21948,23669,25186,2002,Palestine,Jordan,1,1,UAFA Cup,Kuwait City,Kuwait,True,2,0,Draw
21949,23670,25187,2002,United Arab Emirates,Egypt,1,2,Friendly,Abu Dhabi,United Arab Emirates,False,3,-1,Egypt
21950,23671,25188,2002,Indonesia,Cambodia,4,2,AFF Championship,Jakarta,Indonesia,False,6,2,Indonesia
21951,23672,25189,2002,Philippines,Burma,1,6,AFF Championship,Jakarta,Indonesia,True,7,-5,Burma
21952,23673,25190,2002,Saudi Arabia,Bahrain,2,1,UAFA Cup,Kuwait City,Kuwait,True,3,1,Saudi Arabia
21953,23674,25191,2002,Yemen,Syria,0,4,UAFA Cup,Kuwait City,Kuwait,True,4,-4,Syria
21954,23675,25192,2002,Kuwait,Sudan,1,0,UAFA Cup,Kuwait City,Kuwait,False,1,1,Kuwait
21955,23676,25193,2002,Singapore,Malaysia,0,4,AFF Championship,Singapore,Singapore,False,4,-4,Malaysia
21956,23677,25194,2002,Thailand,Laos,5,1,AFF Championship,Singapore,Singapore,True,6,4,Thailand
21957,23678,25195,2002,Bahrain,Syria,2,0,UAFA Cup,Kuwait City,Kuwait,True,2,2,Bahrain
21958,23679,25196,2002,Burma,Cambodia,5,0,AFF Championship,Jakarta,Indonesia,True,5,5,Burma
21959,23680,25197,2002,Saudi Arabia,Lebanon,1,0,UAFA Cup,Kuwait City,Kuwait,True,1,1,Saudi Arabia
21960,23681,25198,2002,Vietnam,Philippines,4,1,AFF Championship,Jakarta,Indonesia,True,5,3,Vietnam
21961,23682,25199,2002,Jordan,Sudan,2,1,UAFA Cup,Kuwait City,Kuwait,True,3,1,Jordan
21962,23683,25200,2002,Singapore,Laos,2,1,AFF Championship,Singapore,Singapore,False,3,1,Singapore
21963,23684,25201,2002,Thailand,Malaysia,1,3,AFF Championship,Singapore,Singapore,True,4,-2,Malaysia
21964,23685,25202,2002,Bahrain,Yemen,3,1,UAFA Cup,Kuwait City,Kuwait,True,4,2,Bahrain
21965,23686,25203,2002,Cambodia,Philippines,1,0,AFF Championship,Jakarta,Indonesia,True,1,1,Cambodia
21966,23687,25204,2002,Indonesia,Vietnam,2,2,AFF Championship,Jakarta,Indonesia,False,4,0,Draw
21967,23688,25205,2002,Syria,Lebanon,4,1,UAFA Cup,Kuwait City,Kuwait,True,5,3,Syria
21968,23689,25206,2002,Egypt,Ghana,0,0,Friendly,Cairo,Egypt,False,0,0,Draw
21969,23690,25207,2002,Malaysia,Laos,1,1,AFF Championship,Singapore,Singapore,True,2,0,Draw
21970,23691,25208,2002,Singapore,Thailand,1,1,AFF Championship,Singapore,Singapore,False,2,0,Draw
21971,23692,25209,2002,Burma,Vietnam,2,4,AFF Championship,Jakarta,Indonesia,True,6,-2,Vietnam
21972,23693,25210,2002,Indonesia,Philippines,13,1,AFF Championship,Jakarta,Indonesia,False,14,12,Indonesia
21973,23694,25211,2002,Kuwait,Jordan,1,2,UAFA Cup,Kuwait City,Kuwait,False,3,-1,Jordan
21974,23695,25212,2002,Sudan,Palestine,2,2,UAFA Cup,Kuwait City,Kuwait,True,4,0,Draw
21975,23696,25213,2002,Lebanon,Yemen,4,2,UAFA Cup,Kuwait City,Kuwait,True,6,2,Lebanon
21976,23697,25214,2002,Syria,Saudi Arabia,0,3,UAFA Cup,Kuwait City,Kuwait,True,3,-3,Saudi Arabia
21977,23698,25215,2002,Kuwait,Palestine,3,3,UAFA Cup,Kuwait City,Kuwait,False,6,0,Draw
21978,23699,25216,2002,Lebanon,Bahrain,0,0,UAFA Cup,Kuwait City,Kuwait,True,0,0,Draw
21979,23700,25217,2002,Yemen,Saudi Arabia,2,2,UAFA Cup,Kuwait City,Kuwait,True,4,0,Draw
21980,23701,25218,2002,Indonesia,Malaysia,1,0,AFF Championship,Jakarta,Indonesia,False,1,1,Indonesia
21981,23702,25219,2002,Niger,Burkina Faso,1,1,Friendly,Niamey,Niger,False,2,0,Draw
21982,23703,25220,2002,Vietnam,Thailand,0,4,AFF Championship,Jakarta,Indonesia,True,4,-4,Thailand
21983,23704,25222,2002,Jordan,Bahrain,1,2,UAFA Cup,Kuwait City,Kuwait,True,3,-1,Bahrain
21984,23705,25225,2002,Indonesia,Thailand,2,2,AFF Championship,Jakarta,Indonesia,False,4,0,Draw
21985,23706,25226,2002,Niger,Mali,2,2,Friendly,Niamey,Niger,False,4,0,Draw
21986,23707,25227,2002,Vietnam,Malaysia,2,1,AFF Championship,Jakarta,Indonesia,True,3,1,Vietnam
21987,23708,25228,2002,Saudi Arabia,Bahrain,1,0,UAFA Cup,Kuwait City,Kuwait,True,1,1,Saudi Arabia
21988,23709,25229,2003,India,Pakistan,0,1,SAFF Cup,Dhaka,Bangladesh,True,1,-1,Pakistan
21989,23710,25230,2003,Sri Lanka,Afghanistan,1,0,SAFF Cup,Dhaka,Bangladesh,True,1,1,Sri Lanka
21990,23711,25231,2003,Bangladesh,Nepal,1,0,SAFF Cup,Dhaka,Bangladesh,False,1,1,Bangladesh
21991,23712,25232,2003,Maldives,Bhutan,6,0,SAFF Cup,Dhaka,Bangladesh,True,6,6,Maldives
21992,23713,25233,2003,Afghanistan,India,0,4,SAFF Cup,Dhaka,Bangladesh,True,4,-4,India
21993,23714,25234,2003,Barbados,Jamaica,1,0,Friendly,Bridgetown,Barbados,False,1,1,Barbados
21994,23715,25235,2003,Pakistan,Sri Lanka,2,1,SAFF Cup,Dhaka,Bangladesh,True,3,1,Pakistan
21995,23716,25236,2003,Bangladesh,Maldives,1,0,SAFF Cup,Dhaka,Bangladesh,False,1,1,Bangladesh
21996,23717,25237,2003,Nepal,Bhutan,2,0,SAFF Cup,Dhaka,Bangladesh,True,2,2,Nepal
21997,23718,25238,2003,Afghanistan,Pakistan,0,1,SAFF Cup,Dhaka,Bangladesh,True,1,-1,Pakistan
21998,23719,25239,2003,India,Sri Lanka,1,1,SAFF Cup,Dhaka,Bangladesh,True,2,0,Draw
21999,23720,25240,2003,Bangladesh,Bhutan,3,0,SAFF Cup,Dhaka,Bangladesh,False,3,3,Bangladesh
22000,23721,25241,2003,Nepal,Maldives,2,3,SAFF Cup,Dhaka,Bangladesh,True,5,-1,Maldives
22001,23722,25242,2003,El Salvador,Guatemala,0,0,Friendly,Santa Ana,United States,True,0,0,Draw
22002,23723,25243,2003,Bangladesh,India,2,1,SAFF Cup,Dhaka,Bangladesh,False,3,1,Bangladesh
22003,23724,25244,2003,Pakistan,Maldives,0,1,SAFF Cup,Dhaka,Bangladesh,True,1,-1,Maldives
22004,23725,25245,2003,United States,Canada,4,0,Friendly,Fort Lauderdale,United States,False,4,4,United States
22005,23726,25246,2003,El Salvador,Guatemala,0,0,Friendly,Los Angeles,United States,True,0,0,Draw
22006,23727,25247,2003,Bangladesh,Maldives,1,1,SAFF Cup,Dhaka,Bangladesh,False,2,0,Draw
22007,23728,25248,2003,Pakistan,India,1,2,SAFF Cup,Dhaka,Bangladesh,True,3,-1,India
22008,23729,25249,2003,Uganda,Algeria,0,1,Friendly,Kampala,Uganda,False,1,-1,Algeria
22009,23730,25250,2003,Barbados,Finland,0,0,Friendly,Bridgetown,Barbados,False,0,0,Draw
22010,23731,25251,2003,Ghana,Benin,3,0,Friendly,Kumasi,Ghana,False,3,3,Ghana
22011,23732,25252,2003,United Arab Emirates,Norway,1,1,Friendly,Sharjah,United Arab Emirates,False,2,0,Draw
22012,23733,25253,2003,Oman,Norway,1,2,Friendly,Muscat,Oman,False,3,-1,Norway
22013,23734,25254,2003,Cyprus,Greece,1,2,Friendly,Larnaca,Cyprus,False,3,-1,Greece
22014,23735,25255,2003,Trinidad and Tobago,Finland,1,2,Friendly,Port of Spain,Trinidad and Tobago,False,3,-1,Finland
22015,23736,25256,2003,Honduras,Argentina,1,3,Friendly,San Pedro Sula,Honduras,False,4,-2,Argentina
22016,23737,25257,2003,Mexico,Argentina,0,1,Friendly,Los Angeles,United States,True,1,-1,Argentina
22017,23738,25258,2003,Uruguay,Iran,1,1,Lunar New Year Cup,So Kon Po,Hong Kong,True,2,0,Draw
22018,23739,25259,2003,United States,Argentina,0,1,Friendly,Miami,United States,False,1,-1,Argentina
22019,23741,25261,2003,Ecuador,Estonia,1,0,Friendly,Guayaquil,Ecuador,False,1,1,Ecuador
22020,23742,25262,2003,Panama,El Salvador,1,2,UNCAF Cup,Panama City,Panama,False,3,-1,El Salvador
22021,23743,25263,2003,Cameroon,Ivory Coast,0,3,Friendly,Châteauroux,France,True,3,-3,Ivory Coast
22022,23744,25264,2003,Costa Rica,El Salvador,1,0,UNCAF Cup,Panama City,Panama,True,1,1,Costa Rica
22023,23745,25265,2003,Honduras,Nicaragua,2,0,UNCAF Cup,Panama City,Panama,True,2,2,Honduras
22024,23746,25266,2003,Albania,Vietnam,5,0,Friendly,Bastia Umbra,Italy,True,5,5,Albania
22025,23747,25267,2003,Algeria,Belgium,1,3,Friendly,Annaba,Algeria,False,4,-2,Belgium
22026,23748,25268,2003,Barbados,Martinique,3,3,Friendly,Bridgetown,Barbados,False,6,0,Draw
22027,23749,25269,2003,Bulgaria,Hungary,1,0,Friendly,Larnaca,Cyprus,True,1,1,Bulgaria
22028,23750,25271,2003,Croatia,Poland,0,0,Friendly,Split,Croatia,False,0,0,Draw
22029,23751,25272,2003,Cyprus,Russia,0,1,Cyprus International Tournament,Limassol,Cyprus,False,1,-1,Russia
22030,23752,25273,2003,Ecuador,Estonia,2,1,Friendly,Quito,Ecuador,False,3,1,Ecuador
22031,23753,25274,2003,Egypt,Denmark,1,4,Friendly,Cairo,Egypt,False,5,-3,Denmark
22032,23754,25275,2003,England,Australia,1,3,Friendly,London,England,False,4,-2,Australia
22033,23755,25276,2003,France,Czech Republic,0,2,Friendly,Saint-Denis,France,False,2,-2,Czech Republic
22034,23756,25277,2003,Georgia,Moldova,2,2,Friendly,Tbilisi,Georgia,False,4,0,Draw
22035,23757,25278,2003,Greece,Norway,1,0,Friendly,Heraklion,Greece,False,1,1,Greece
22036,23758,25279,2003,Guinea,Mali,0,1,Friendly,Toulon,France,True,1,-1,Mali
22037,23759,25280,2003,Israel,Armenia,2,0,Friendly,Ramat-Gan,Israel,False,2,2,Israel
22038,23760,25281,2003,Italy,Portugal,1,0,Friendly,Genoa,Italy,False,1,1,Italy
22039,23761,25282,2003,Jamaica,United States,1,2,Friendly,Kingston,Jamaica,False,3,-1,United States
22040,23762,25283,2003,Latvia,Lithuania,2,1,Friendly,Antalya,Turkey,True,3,1,Latvia
22041,23763,25284,2003,Libya,Canada,2,4,Friendly,Tripoli,Libya,False,6,-2,Canada
22042,23764,25285,2003,Malta,Kazakhstan,2,2,Friendly,Attard,Malta,False,4,0,Draw
22043,23765,25286,2003,Mexico,Colombia,0,0,Friendly,Phoenix,United States,True,0,0,Draw
22044,23766,25287,2003,Morocco,Senegal,1,0,Friendly,Paris,France,True,1,1,Morocco
22045,23767,25288,2003,Netherlands,Argentina,1,0,Friendly,Amsterdam,Netherlands,False,1,1,Netherlands
22046,23768,25289,2003,Northern Ireland,Finland,0,1,Friendly,Belfast,Northern Ireland,False,1,-1,Finland
22047,23769,25290,2003,Romania,Slovakia,2,1,Cyprus International Tournament,Larnaca,Cyprus,True,3,1,Romania
22048,23770,25291,2003,Scotland,Republic of Ireland,0,2,Friendly,Glasgow,Scotland,False,2,-2,Republic of Ireland
22049,23771,25292,2003,Serbia,Azerbaijan,2,2,UEFA Euro qualification,Podgorica,Serbia and Montenegro,True,4,0,Draw
22050,23772,25293,2003,Slovenia,Switzerland,1,5,Friendly,Nova Gorica,Slovenia,False,6,-4,Switzerland
22051,23773,25294,2003,Spain,Germany,3,1,Friendly,Palma de Mallorca,Spain,False,4,2,Spain
22052,23774,25295,2003,Tunisia,Sweden,1,0,Friendly,Radès,Tunisia,False,1,1,Tunisia
22053,23775,25296,2003,Turkey,Ukraine,0,0,Friendly,Izmir,Turkey,False,0,0,Draw
22054,23776,25297,2003,Wales,Bosnia and Herzegovina,2,2,Friendly,Cardiff,Wales,False,4,0,Draw
22055,23777,25298,2003,Costa Rica,Guatemala,1,1,UNCAF Cup,Panama City,Panama,True,2,0,Draw
22056,23778,25299,2003,Cyprus,Slovakia,1,3,Cyprus International Tournament,Larnaca,Cyprus,False,4,-2,Slovakia
22057,23779,25300,2003,El Salvador,Nicaragua,3,0,UNCAF Cup,Panama City,Panama,True,3,3,El Salvador
22058,23780,25302,2003,Benin,Ghana,1,0,Friendly,Cotonou,Benin,False,1,1,Benin
22059,23781,25303,2003,Costa Rica,Nicaragua,1,0,UNCAF Cup,Panama City,Panama,True,1,1,Costa Rica
22060,23782,25304,2003,Honduras,El Salvador,0,1,UNCAF Cup,Panama City,Panama,True,1,-1,El Salvador
22061,23783,25306,2003,Gambia,Nigeria,0,1,Friendly,Banjul,Gambia,False,1,-1,Nigeria
22062,23784,25307,2003,Panama,Guatemala,2,0,UNCAF Cup,Panama City,Panama,False,2,2,Panama
22063,23785,25308,2003,Qatar,Sweden,2,3,King's Cup,Bangkok,Thailand,True,5,-1,Sweden
22064,23787,25310,2003,Guatemala,Nicaragua,5,0,UNCAF Cup,Panama City,Panama,True,5,5,Guatemala
22065,23788,25312,2003,Panama,Honduras,1,1,UNCAF Cup,Panama City,Panama,False,2,0,Draw
22066,23789,25313,2003,Thailand,Qatar,1,1,King's Cup,Bangkok,Thailand,False,2,0,Draw
22067,23790,25314,2003,Costa Rica,Honduras,1,0,UNCAF Cup,Panama City,Panama,True,1,1,Costa Rica
22068,23791,25315,2003,El Salvador,Guatemala,0,2,UNCAF Cup,Panama City,Panama,True,2,-2,Guatemala
22069,23792,25317,2003,Thailand,Sweden,1,4,King's Cup,Bangkok,Thailand,False,5,-3,Sweden
22070,23793,25318,2003,Panama,Nicaragua,0,1,UNCAF Cup,Panama City,Panama,False,1,-1,Nicaragua
22071,23795,25321,2003,Macau,Mongolia,2,0,EAFF Championship,So Kon Po,Hong Kong,True,2,2,Macau
22072,23796,25322,2003,Madagascar,Mauritius,2,1,COSAFA Cup,Antananarivo,Madagascar,False,3,1,Madagascar
22073,23797,25323,2003,Malawi,DR Congo,1,1,Friendly,Blantyre,Malawi,False,2,0,Draw
22074,23798,25324,2003,Thailand,Qatar,3,1,King's Cup,Bangkok,Thailand,False,4,2,Thailand
22075,23799,25325,2003,Guatemala,Honduras,2,1,UNCAF Cup,Panama City,Panama,True,3,1,Guatemala
22076,23800,25326,2003,Malawi,DR Congo,2,3,Friendly,Lilongwe,Malawi,False,5,-1,DR Congo
22077,23801,25327,2003,Panama,Costa Rica,0,1,UNCAF Cup,Panama City,Panama,False,1,-1,Costa Rica
22078,23802,25328,2003,Peru,Haiti,5,1,Friendly,Lima,Peru,False,6,4,Peru
22079,23803,25329,2003,Hong Kong,Macau,3,0,EAFF Championship,So Kon Po,Hong Kong,False,3,3,Hong Kong
22080,23804,25330,2003,Mongolia,Guam,2,0,EAFF Championship,So Kon Po,Hong Kong,True,2,2,Mongolia
22081,23805,25331,2003,Guam,Macau,0,2,EAFF Championship,So Kon Po,Hong Kong,True,2,-2,Macau
22082,23807,25333,2003,Hong Kong,Mongolia,10,0,EAFF Championship,So Kon Po,Hong Kong,False,10,10,Hong Kong
22083,23808,25334,2003,Hong Kong,Guam,11,0,EAFF Championship,So Kon Po,Hong Kong,False,11,11,Hong Kong
22084,23810,25336,2003,Singapore,Maldives,4,1,Friendly,Singapore,Singapore,False,5,3,Singapore
22085,23811,25337,2003,Sudan,DR Congo,1,3,Friendly,Khartoum,Sudan,False,4,-2,DR Congo
22086,23812,25338,2003,Israel,Moldova,0,0,Friendly,Ramat-Gan,Israel,False,0,0,Draw
22087,23813,25339,2003,Benin,Niger,1,1,Friendly,Cotonou,Benin,False,2,0,Draw
22088,23814,25340,2003,Botswana,Lesotho,0,1,Friendly,Gaborone,Botswana,False,1,-1,Lesotho
22089,23815,25341,2003,DR Congo,Congo,3,0,Friendly,Kinshasa,DR Congo,False,3,3,DR Congo
22090,23816,25342,2003,Cuba,Jamaica,0,0,Friendly,Havana,Cuba,False,0,0,Draw
22091,23817,25343,2003,Tanzania,Uganda,0,0,Friendly,Arusha,Tanzania,False,0,0,Draw
22092,23818,25344,2003,Cuba,Jamaica,1,0,Friendly,Havana,Cuba,False,1,1,Cuba
22093,23819,25345,2003,Martinique,French Guiana,2,1,Friendly,Fort-de-France,Martinique,False,3,1,Martinique
22094,23820,25346,2003,Guadeloupe,French Guiana,2,2,Friendly,Fort-de-France,Martinique,True,4,0,Draw
22095,23821,25347,2003,Kenya,Uganda,2,2,Friendly,Nairobi,Kenya,False,4,0,Draw
22096,23822,25348,2003,Rwanda,Burundi,4,2,Friendly,Kigali,Rwanda,False,6,2,Rwanda
22097,23823,25349,2003,Kyrgyzstan,Afghanistan,1,2,AFC Asian Cup qualification,Kathmandu,Nepal,True,3,-1,Afghanistan
22098,23824,25350,2003,Lesotho,DR Congo,2,2,Friendly,Maseru,Lesotho,False,4,0,Draw
22099,23825,25351,2003,Zimbabwe,Malawi,0,0,Friendly,Harare,Zimbabwe,False,0,0,Draw
22100,23826,25352,2003,Nepal,Afghanistan,4,0,AFC Asian Cup qualification,Kathmandu,Nepal,False,4,4,Nepal
22101,23827,25353,2003,Egypt,Qatar,6,0,Friendly,Port Said,Egypt,False,6,6,Egypt
22102,23828,25354,2003,Mexico,Bolivia,2,0,Friendly,Dallas,United States,True,2,2,Mexico
22103,23829,25355,2003,Eswatini,Lesotho,1,0,Friendly,Lobamba,Eswatini,False,1,1,Eswatini
22104,23830,25356,2003,Nepal,Kyrgyzstan,0,2,AFC Asian Cup qualification,Kathmandu,Nepal,False,2,-2,Kyrgyzstan
22105,23831,25357,2003,Macau,Pakistan,0,3,AFC Asian Cup qualification,Singapore,Singapore,True,3,-3,Pakistan
22106,23832,25358,2003,Maldives,Brunei,1,1,AFC Asian Cup qualification,Malé,Maldives,False,2,0,Draw
22107,23833,25359,2003,Sri Lanka,East Timor,3,2,AFC Asian Cup qualification,Colombo,Sri Lanka,False,5,1,Sri Lanka
22108,23834,25360,2003,Mozambique,Lesotho,0,0,COSAFA Cup,Maputo,Mozambique,False,0,0,Draw
22109,23835,25361,2003,Rwanda,Zambia,1,1,Friendly,Kigali,Rwanda,False,2,0,Draw
22110,23836,25362,2003,Benin,Equatorial Guinea,2,1,Friendly,Cotonou,Benin,False,3,1,Benin
22111,23837,25363,2003,Burma,Brunei,5,0,AFC Asian Cup qualification,Malé,Maldives,True,5,5,Burma
22112,23838,25364,2003,Jamaica,Barbados,2,1,Friendly,Kingston,Jamaica,False,3,1,Jamaica
22113,23839,25365,2003,Kenya,Tanzania,4,0,Friendly,Nairobi,Kenya,False,4,4,Kenya
22114,23840,25366,2003,Singapore,Macau,2,0,AFC Asian Cup qualification,Singapore,Singapore,False,2,2,Singapore
22115,23841,25368,2003,Rwanda,Zambia,0,3,Friendly,Kigali,Rwanda,False,3,-3,Zambia
22116,23842,25369,2003,Hong Kong,Laos,5,1,AFC Asian Cup qualification,Kowloon,Hong Kong,False,6,4,Hong Kong
22117,23843,25370,2003,Maldives,Burma,0,2,AFC Asian Cup qualification,Malé,Maldives,False,2,-2,Burma
22118,23844,25371,2003,Singapore,Pakistan,3,0,AFC Asian Cup qualification,Singapore,Singapore,False,3,3,Singapore
22119,23846,25373,2003,Austria,Greece,2,2,Friendly,Graz,Austria,False,4,0,Draw
22120,23847,25374,2003,Burundi,Burkina Faso,0,0,Friendly,Bujumbura,Burundi,False,0,0,Draw
22121,23848,25375,2003,Guadeloupe,Cuba,2,3,Gold Cup qualification,Port of Spain,Trinidad and Tobago,True,5,-1,Cuba
22122,23849,25376,2003,Haiti,Martinique,2,1,Gold Cup qualification,Kingston,Jamaica,True,3,1,Haiti
22123,23850,25377,2003,Jamaica,Saint Lucia,5,0,Gold Cup qualification,Kingston,Jamaica,False,5,5,Jamaica
22124,23851,25378,2003,Mexico,Paraguay,1,1,Friendly,San Diego,United States,True,2,0,Draw
22125,23852,25379,2003,Trinidad and Tobago,Antigua and Barbuda,2,0,Gold Cup qualification,Port of Spain,Trinidad and Tobago,False,2,2,Trinidad and Tobago
22126,23853,25380,2003,Cameroon,Madagascar,2,0,Friendly,Tunis,Tunisia,True,2,2,Cameroon
22127,23854,25381,2003,Laos,Bangladesh,2,1,AFC Asian Cup qualification,Kowloon,Hong Kong,True,3,1,Laos
22128,23855,25382,2003,Serbia,Bulgaria,1,2,Friendly,Kruševac,Serbia and Montenegro,False,3,-1,Bulgaria
22129,23856,25383,2003,Tunisia,Ghana,2,2,Friendly,Tunis,Tunisia,False,4,0,Draw
22130,23857,25384,2003,Cuba,Antigua and Barbuda,2,0,Gold Cup qualification,Macoya,Trinidad and Tobago,True,2,2,Cuba
22131,23858,25385,2003,Jamaica,Martinique,2,2,Gold Cup qualification,Kingston,Jamaica,False,4,0,Draw
22132,23859,25386,2003,Japan,Uruguay,2,2,Friendly,Tokyo,Japan,False,4,0,Draw
22133,23860,25387,2003,Saint Lucia,Haiti,2,1,Gold Cup qualification,Kingston,Jamaica,True,3,1,Saint Lucia
22134,23861,25388,2003,Trinidad and Tobago,Guadeloupe,1,0,Gold Cup qualification,Macoya,Trinidad and Tobago,False,1,1,Trinidad and Tobago
22135,23862,25389,2003,Albania,Russia,3,1,UEFA Euro qualification,Shkodër,Albania,False,4,2,Albania
22136,23863,25390,2003,Angola,Algeria,1,1,Friendly,Luanda,Angola,False,2,0,Draw
22137,23864,25391,2003,Armenia,Northern Ireland,1,0,UEFA Euro qualification,Yerevan,Armenia,False,1,1,Armenia
22138,23865,25392,2003,Belarus,Moldova,2,1,UEFA Euro qualification,Minsk,Belarus,False,3,1,Belarus
22139,23866,25393,2003,Bosnia and Herzegovina,Luxembourg,2,0,UEFA Euro qualification,Zenica,Bosnia and Herzegovina,False,2,2,Bosnia and Herzegovina
22140,23867,25395,2003,Costa Rica,Paraguay,2,1,Friendly,Alajuela,Costa Rica,False,3,1,Costa Rica
22141,23868,25396,2003,Croatia,Belgium,4,0,UEFA Euro qualification,Zagreb,Croatia,False,4,4,Croatia
22142,23869,25397,2003,Cyprus,Israel,1,1,UEFA Euro qualification,Limassol,Cyprus,False,2,0,Draw
22143,23870,25398,2003,Estonia,Canada,2,1,Friendly,Tallinn,Estonia,False,3,1,Estonia
22144,23871,25399,2003,France,Malta,6,0,UEFA Euro qualification,Lens,France,False,6,6,France
22145,23872,25400,2003,Gabon,Equatorial Guinea,4,0,African Cup of Nations qualification,Libreville,Gabon,False,4,4,Gabon
22146,23873,25401,2003,Georgia,Republic of Ireland,1,2,UEFA Euro qualification,Tbilisi,Georgia,False,3,-1,Republic of Ireland
22147,23874,25402,2003,Germany,Lithuania,1,1,UEFA Euro qualification,Nuremberg,Germany,False,2,0,Draw
22148,23875,25403,2003,Italy,Finland,2,0,UEFA Euro qualification,Palermo,Italy,False,2,2,Italy
22149,23876,25404,2003,Kenya,Mauritania,4,0,African Cup of Nations qualification,Nairobi,Kenya,False,4,4,Kenya
22150,23877,25406,2003,Liechtenstein,England,0,2,UEFA Euro qualification,Vaduz,Liechtenstein,False,2,-2,England
22151,23878,25408,2003,Malawi,Nigeria,0,1,African Cup of Nations qualification,Blantyre,Malawi,False,1,-1,Nigeria
22152,23879,25409,2003,Mauritius,Egypt,0,1,African Cup of Nations qualification,Rose Hill,Mauritius,False,1,-1,Egypt
22153,23880,25410,2003,Netherlands,Czech Republic,1,1,UEFA Euro qualification,Rotterdam,Netherlands,False,2,0,Draw
22154,23881,25411,2003,Poland,Hungary,0,0,UEFA Euro qualification,Chorzów,Poland,False,0,0,Draw
22155,23882,25412,2003,Portugal,Brazil,2,1,Friendly,Porto,Portugal,False,3,1,Portugal
22156,23883,25413,2003,Romania,Denmark,2,5,UEFA Euro qualification,Bucharest,Romania,False,7,-3,Denmark
22157,23884,25414,2003,Rwanda,Uganda,0,0,African Cup of Nations qualification,Kigali,Rwanda,False,0,0,Draw
22158,23885,25415,2003,Scotland,Iceland,2,1,UEFA Euro qualification,Glasgow,Scotland,False,3,1,Scotland
22159,23886,25416,2003,Sierra Leone,Morocco,0,0,African Cup of Nations qualification,Freetown,Sierra Leone,False,0,0,Draw
22160,23887,25417,2003,South Africa,Madagascar,2,0,Friendly,Johannesburg,South Africa,False,2,2,South Africa
22161,23888,25418,2003,Sudan,Benin,3,0,African Cup of Nations qualification,Khartoum,Sudan,False,3,3,Sudan
22162,23889,25419,2003,Tanzania,Zambia,0,1,African Cup of Nations qualification,Dar es Salaam,Tanzania,False,1,-1,Zambia
22163,23890,25420,2003,Ukraine,Spain,2,2,UEFA Euro qualification,Kyïv,Ukraine,False,4,0,Draw
22164,23891,25421,2003,United States,Venezuela,2,0,Friendly,Seattle,United States,False,2,2,United States
22165,23892,25422,2003,Wales,Azerbaijan,4,0,UEFA Euro qualification,Cardiff,Wales,False,4,4,Wales
22166,23893,25423,2003,Burundi,Ivory Coast,0,1,African Cup of Nations qualification,Bujumbura,Burundi,False,1,-1,Ivory Coast
22167,23894,25424,2003,Chad,Namibia,2,0,African Cup of Nations qualification,N'Djamena,Chad,False,2,2,Chad
22168,23895,25425,2003,Chile,Peru,2,0,Friendly,Santiago,Chile,False,2,2,Chile
22169,23896,25426,2003,Eritrea,Mali,0,2,African Cup of Nations qualification,Asmara,Eritrea,False,2,-2,Mali
22170,23897,25427,2003,Ethiopia,Liberia,1,0,African Cup of Nations qualification,Addis Abeba,Ethiopia,False,1,1,Ethiopia
22171,23898,25428,2003,Gambia,Senegal,0,0,African Cup of Nations qualification,Bakau,Gambia,False,0,0,Draw
22172,23899,25429,2003,Ghana,Madagascar,3,3,Friendly,Tunis,Tunisia,True,6,0,Draw
22173,23900,25430,2003,Guadeloupe,Antigua and Barbuda,2,0,Gold Cup qualification,San Fernando,Trinidad and Tobago,True,2,2,Guadeloupe
22174,23901,25431,2003,Guinea,Niger,2,0,African Cup of Nations qualification,Conakry,Guinea,False,2,2,Guinea
22175,23902,25432,2003,Hong Kong,Bangladesh,2,2,AFC Asian Cup qualification,Kowloon,Hong Kong,False,4,0,Draw
22176,23904,25434,2003,Jamaica,Haiti,3,0,Gold Cup qualification,Kingston,Jamaica,False,3,3,Jamaica
22177,23905,25435,2003,Libya,Botswana,0,0,African Cup of Nations qualification,Tripoli,Libya,False,0,0,Draw
22178,23906,25436,2003,Mozambique,Burkina Faso,1,0,African Cup of Nations qualification,Maputo,Mozambique,False,1,1,Mozambique
22179,23907,25437,2003,Saint Lucia,Martinique,4,5,Gold Cup qualification,Kingston,Jamaica,True,9,-1,Martinique
22180,23908,25438,2003,Eswatini,DR Congo,1,1,African Cup of Nations qualification,Lobamba,Eswatini,False,2,0,Draw
22181,23909,25439,2003,Trinidad and Tobago,Cuba,1,3,Gold Cup qualification,San Fernando,Trinidad and Tobago,False,4,-2,Cuba
22182,23910,25440,2003,Tunisia,Cameroon,1,0,Friendly,Tunis,Tunisia,False,1,1,Tunisia
22183,23911,25441,2003,Zimbabwe,Seychelles,3,1,African Cup of Nations qualification,Harare,Zimbabwe,False,4,2,Zimbabwe
22184,23912,25442,2003,Albania,Republic of Ireland,0,0,UEFA Euro qualification,Tirana,Albania,False,0,0,Draw
22185,23913,25443,2003,Belarus,Uzbekistan,2,2,Friendly,Minsk,Belarus,False,4,0,Draw
22186,23914,25444,2003,Croatia,Andorra,2,0,UEFA Euro qualification,Varaždin,Croatia,False,2,2,Croatia
22187,23915,25445,2003,Czech Republic,Austria,4,0,UEFA Euro qualification,Prague,Czech Republic,False,4,4,Czech Republic
22188,23916,25446,2003,Denmark,Bosnia and Herzegovina,0,2,UEFA Euro qualification,Copenhagen,Denmark,False,2,-2,Bosnia and Herzegovina
22189,23917,25447,2003,England,Turkey,2,0,UEFA Euro qualification,Sunderland,England,False,2,2,England
22190,23918,25448,2003,Estonia,Bulgaria,0,0,UEFA Euro qualification,Tallinn,Estonia,False,0,0,Draw
22191,23919,25449,2003,Georgia,Switzerland,0,0,UEFA Euro qualification,Tbilisi,Georgia,False,0,0,Draw
22192,23920,25450,2003,Honduras,Paraguay,1,1,Friendly,Tegucigalpa,Honduras,False,2,0,Draw
22193,23921,25451,2003,Hungary,Sweden,1,2,UEFA Euro qualification,Budapest,Hungary,False,3,-1,Sweden
22194,23922,25452,2003,Israel,France,1,2,UEFA Euro qualification,Palermo,Italy,True,3,-1,France
22195,23923,25453,2003,Lithuania,Scotland,1,0,UEFA Euro qualification,Kaunas,Lithuania,False,1,1,Lithuania
22196,23924,25454,2003,Luxembourg,Norway,0,2,UEFA Euro qualification,Luxembourg,Luxembourg,False,2,-2,Norway
22197,23925,25456,2003,Moldova,Netherlands,1,2,UEFA Euro qualification,Tiraspol,Moldova,False,3,-1,Netherlands
22198,23926,25457,2003,Northern Ireland,Greece,0,2,UEFA Euro qualification,Belfast,Northern Ireland,False,2,-2,Greece
22199,23927,25458,2003,Peru,Chile,3,0,Friendly,Lima,Peru,False,3,3,Peru
22200,23928,25459,2003,Poland,San Marino,5,0,UEFA Euro qualification,Ostrowiec Świętokrzyski,Poland,False,5,5,Poland
22201,23929,25460,2003,Slovakia,Liechtenstein,4,0,UEFA Euro qualification,Trnava,Slovakia,False,4,4,Slovakia
22202,23930,25461,2003,Slovenia,Cyprus,4,1,UEFA Euro qualification,Ljubljana,Slovenia,False,5,3,Slovenia
22203,23931,25462,2003,Spain,Armenia,3,0,UEFA Euro qualification,León,Spain,False,3,3,Spain
22204,23932,25463,2003,Ukraine,Latvia,1,0,Friendly,Kyïv,Ukraine,False,1,1,Ukraine
22205,23933,25464,2003,Venezuela,Jamaica,2,0,Friendly,Caracas,Venezuela,False,2,2,Venezuela
22206,23934,25466,2003,Zimbabwe,Angola,1,0,COSAFA Cup,Harare,Zimbabwe,False,1,1,Zimbabwe
22207,23935,25467,2003,Bhutan,Guam,6,0,AFC Asian Cup qualification,Thimphu,Bhutan,False,6,6,Bhutan
22208,23936,25468,2003,Martinique,Trinidad and Tobago,3,2,Gold Cup qualification,Fort-de-France,Martinique,False,5,1,Martinique
22209,23937,25469,2003,Algeria,Madagascar,3,1,Friendly,Amiens,France,True,4,2,Algeria
22210,23938,25470,2003,Guam,Mongolia,0,5,AFC Asian Cup qualification,Thimphu,Bhutan,True,5,-5,Mongolia
22211,23939,25471,2003,Trinidad and Tobago,Honduras,0,2,Gold Cup qualification,Rivière-Pilote,Martinique,True,2,-2,Honduras
22212,23940,25472,2003,Bhutan,Mongolia,0,0,AFC Asian Cup qualification,Thimphu,Bhutan,False,0,0,Draw
22213,23941,25473,2003,Faroe Islands,Kazakhstan,3,2,Friendly,Toftir,Faroe Islands,False,5,1,Faroe Islands
22214,23942,25474,2003,Madagascar,Mali,0,2,Friendly,Paris,France,True,2,-2,Mali
22215,23943,25475,2003,Martinique,Honduras,2,4,Gold Cup qualification,Fort-de-France,Martinique,False,6,-2,Honduras
22216,23944,25476,2003,Faroe Islands,Kazakhstan,2,1,Friendly,Tórshavn,Faroe Islands,False,3,1,Faroe Islands
22217,23945,25477,2003,Andorra,Estonia,0,2,UEFA Euro qualification,Sant Julià de Lòria,Andorra,False,2,-2,Estonia
22218,23946,25478,2003,Belgium,Poland,3,1,Friendly,Brussels,Belgium,False,4,2,Belgium
22219,23947,25479,2003,Bulgaria,Albania,2,0,Friendly,Sofia,Bulgaria,False,2,2,Bulgaria
22220,23948,25480,2003,Chile,Costa Rica,1,0,Friendly,Santiago,Chile,False,1,1,Chile
22221,23949,25481,2003,Czech Republic,Turkey,4,0,Friendly,Teplice,Czech Republic,False,4,4,Czech Republic
22222,23950,25482,2003,Denmark,Ukraine,1,0,Friendly,Copenhagen,Denmark,False,1,1,Denmark
22223,23951,25483,2003,Finland,Iceland,3,0,Friendly,Vantaa,Finland,False,3,3,Finland
22224,23952,25484,2003,France,Egypt,5,0,Friendly,Saint-Denis,France,False,5,5,France
22225,23953,25485,2003,Georgia,Russia,1,0,UEFA Euro qualification,Tbilisi,Georgia,False,1,1,Georgia
22226,23954,25486,2003,Germany,Serbia,1,0,Friendly,Bremen,Germany,False,1,1,Germany
22227,23955,25487,2003,Honduras,Colombia,0,0,Friendly,Miami,United States,True,0,0,Draw
22228,23956,25488,2003,Hungary,Luxembourg,5,1,Friendly,Budapest,Hungary,False,6,4,Hungary
22229,23957,25489,2003,Republic of Ireland,Norway,1,0,Friendly,Dublin,Republic of Ireland,False,1,1,Republic of Ireland
22230,23958,25490,2003,Israel,Cyprus,2,0,UEFA Euro qualification,Palermo,Italy,True,2,2,Israel
22231,23959,25491,2003,Latvia,San Marino,3,0,UEFA Euro qualification,Riga,Latvia,False,3,3,Latvia
22232,23960,25492,2003,Libya,Argentina,1,3,Friendly,Tripoli,Libya,False,4,-2,Argentina
22233,23961,25493,2003,Liechtenstein,Saudi Arabia,1,0,Friendly,Vaduz,Liechtenstein,False,1,1,Liechtenstein
22234,23962,25494,2003,Lithuania,Romania,0,1,Friendly,Kaunas,Lithuania,False,1,-1,Romania
22235,23963,25495,2003,Malta,Slovenia,1,3,UEFA Euro qualification,Attard,Malta,False,4,-2,Slovenia
22236,23964,25496,2003,Mexico,Brazil,0,0,Friendly,Guadalajara,Mexico,False,0,0,Draw
22237,23965,25497,2003,Morocco,Ivory Coast,0,1,Friendly,Rabat,Morocco,False,1,-1,Ivory Coast
22238,23966,25498,2003,Netherlands,Portugal,1,1,Friendly,Eindhoven,Netherlands,False,2,0,Draw
22239,23967,25499,2003,Peru,Paraguay,0,1,Friendly,Lima,Peru,False,1,-1,Paraguay
22240,23968,25500,2003,Scotland,Austria,0,2,Friendly,Glasgow,Scotland,False,2,-2,Austria
22241,23969,25501,2003,Slovakia,Greece,2,2,Friendly,Žilina,Slovakia,False,4,0,Draw
22242,23970,25502,2003,South Africa,Jamaica,0,0,Friendly,Cape Town,South Africa,False,0,0,Draw
22243,23971,25503,2003,Spain,Ecuador,4,0,Friendly,Madrid,Spain,False,4,4,Spain
22244,23972,25504,2003,Sweden,Croatia,1,2,Friendly,Solna,Sweden,False,3,-1,Croatia
22245,23973,25505,2003,Switzerland,Italy,1,2,Friendly,Geneva,Switzerland,False,3,-1,Italy
22246,23974,25506,2003,Tunisia,Senegal,1,0,Friendly,Tunis,Tunisia,False,1,1,Tunisia
22247,23975,25507,2003,Uzbekistan,Belarus,1,2,Friendly,Tashkent,Uzbekistan,False,3,-1,Belarus
22248,23976,25508,2003,Venezuela,Trinidad and Tobago,3,0,Friendly,San Cristóbal,Venezuela,False,3,3,Venezuela
22249,23977,25509,2003,Fiji,Tuvalu,9,0,Friendly,Suva,Fiji,False,9,9,Fiji
22250,23978,25510,2003,Congo,Central African Republic,2,1,African Cup of Nations qualification,Brazzaville,Congo,False,3,1,Congo
22251,23979,25511,2003,Guernsey,Jersey,3,3,Friendly,St. Sampson,Guernsey,False,6,0,Draw
22252,23980,25512,2003,United States,Mexico,0,0,Friendly,Houston,United States,False,0,0,Draw
22253,23981,25513,2003,Lesotho,Botswana,1,2,Friendly,Maseru,Lesotho,False,3,-1,Botswana
22254,23982,25514,2003,Malawi,Zambia,0,1,Friendly,Blantyre,Malawi,False,1,-1,Zambia
22255,23983,25515,2003,Jersey,Guernsey,1,0,Friendly,St. Helier,Jersey,False,1,1,Jersey
22256,23984,25516,2003,Lesotho,Malawi,0,0,Friendly,Maseru,Lesotho,False,0,0,Draw
22257,23985,25517,2003,Uganda,Sudan,0,0,Friendly,Kampala,Uganda,False,0,0,Draw
22258,23986,25518,2003,Norway,Finland,2,0,Friendly,Oslo,Norway,False,2,2,Norway
22259,23987,25519,2003,South Africa,England,1,2,Friendly,Durban,South Africa,False,3,-1,England
22260,23988,25520,2003,Botswana,Malawi,1,1,COSAFA Cup,Gaborone,Botswana,False,2,0,Draw
22261,23989,25521,2003,Sudan,Kenya,1,1,Friendly,Khartoum,Sudan,False,2,0,Draw
22262,23990,25522,2003,Jamaica,Nigeria,3,2,Friendly,Kingston,Jamaica,False,5,1,Jamaica
22263,23991,25523,2003,Lesotho,Eswatini,2,1,Friendly,Maseru,Lesotho,False,3,1,Lesotho
22264,23992,25524,2003,Togo,Benin,3,1,Friendly,Lomé,Togo,False,4,2,Togo
22265,23993,25525,2003,United States,Wales,2,0,Friendly,San Jose,United States,False,2,2,United States
22266,23994,25526,2003,Scotland,New Zealand,1,1,Friendly,Edinburgh,Scotland,False,2,0,Draw
22267,23995,25527,2003,Algeria,Burkina Faso,0,1,Friendly,Amiens,France,True,1,-1,Burkina Faso
22268,23996,25528,2003,Nigeria,Ghana,3,1,Friendly,Abuja,Nigeria,False,4,2,Nigeria
22269,23997,25529,2003,Gabon,Angola,1,1,Friendly,Libreville,Gabon,False,2,0,Draw
22270,23998,25530,2003,Gambia,Mauritania,4,1,Friendly,Banjul,Gambia,False,5,3,Gambia
22271,24000,25532,2003,Kenya,Trinidad and Tobago,1,1,Friendly,Nairobi,Kenya,False,2,0,Draw
22272,24002,25534,2003,Uganda,Tanzania,1,0,Friendly,Kampala,Uganda,False,1,1,Uganda
22273,24003,25535,2003,Germany,Canada,4,1,Friendly,Wolfsburg,Germany,False,5,3,Germany
22274,24004,25536,2003,England,Serbia,2,1,Friendly,Leicester,England,False,3,1,England
22275,24005,25537,2003,Guadeloupe,French Guiana,1,0,Friendly,Saint-Brieuc,France,True,1,1,Guadeloupe
22276,24006,25538,2003,Italy,Northern Ireland,2,0,Friendly,Campobasso,Italy,False,2,2,Italy
22277,24007,25539,2003,Uganda,Libya,3,2,Friendly,Kampala,Uganda,False,5,1,Uganda
22278,24008,25540,2003,Mauritania,Kenya,0,0,African Cup of Nations qualification,Nouakchott,Mauritania,False,0,0,Draw
22279,24009,25541,2003,Poland,Kazakhstan,3,0,Friendly,Poznań,Poland,False,3,3,Poland
22280,24010,25542,2003,Portugal,Paraguay,0,0,Friendly,Braga,Portugal,False,0,0,Draw
22281,24011,25543,2003,Belarus,Netherlands,0,2,UEFA Euro qualification,Minsk,Belarus,False,2,-2,Netherlands
22282,24012,25544,2003,Botswana,Libya,0,1,African Cup of Nations qualification,Gaborone,Botswana,False,1,-1,Libya
22283,24013,25545,2003,Bulgaria,Belgium,2,2,UEFA Euro qualification,Sofia,Bulgaria,False,4,0,Draw
22284,24014,25546,2003,Burkina Faso,Mozambique,4,0,African Cup of Nations qualification,Ouagadougou,Burkina Faso,False,4,4,Burkina Faso
22285,24015,25547,2003,Denmark,Norway,1,0,UEFA Euro qualification,Copenhagen,Denmark,False,1,1,Denmark
22286,24016,25548,2003,Estonia,Andorra,2,0,UEFA Euro qualification,Tallinn,Estonia,False,2,2,Estonia
22287,24017,25549,2003,Finland,Serbia,3,0,UEFA Euro qualification,Helsinki,Finland,False,3,3,Finland
22288,24018,25550,2003,Hungary,Latvia,3,1,UEFA Euro qualification,Budapest,Hungary,False,4,2,Hungary
22289,24019,25551,2003,Iceland,Faroe Islands,2,1,UEFA Euro qualification,Reykjavík,Iceland,False,3,1,Iceland
22290,24020,25552,2003,Republic of Ireland,Albania,2,1,UEFA Euro qualification,Dublin,Republic of Ireland,False,3,1,Republic of Ireland
22291,24021,25553,2003,Israel,Slovenia,0,0,UEFA Euro qualification,Antalya,Turkey,True,0,0,Draw
22292,24022,25555,2003,Mali,Eritrea,1,0,African Cup of Nations qualification,Bamako,Mali,False,1,1,Mali
22293,24023,25556,2003,Malta,Cyprus,1,2,UEFA Euro qualification,Attard,Malta,False,3,-1,Cyprus
22294,24024,25557,2003,Moldova,Austria,1,0,UEFA Euro qualification,Tiraspol,Moldova,False,1,1,Moldova
22295,24025,25558,2003,Namibia,Chad,2,1,African Cup of Nations qualification,Windhoek,Namibia,False,3,1,Namibia
22296,24026,25559,2003,Niger,Guinea,1,0,African Cup of Nations qualification,Niamey,Niger,False,1,1,Niger
22297,24027,25560,2003,Nigeria,Malawi,4,1,African Cup of Nations qualification,Abuja,Nigeria,False,5,3,Nigeria
22298,24028,25561,2003,Romania,Bosnia and Herzegovina,2,0,UEFA Euro qualification,Craiova,Romania,False,2,2,Romania
22299,24029,25562,2003,San Marino,Sweden,0,6,UEFA Euro qualification,Serravalle,San Marino,False,6,-6,Sweden
22300,24030,25563,2003,Scotland,Germany,1,1,UEFA Euro qualification,Glasgow,Scotland,False,2,0,Draw
22301,24031,25564,2003,Senegal,Gambia,3,1,African Cup of Nations qualification,Dakar,Senegal,False,4,2,Senegal
22302,24032,25565,2003,Seychelles,Zimbabwe,2,1,African Cup of Nations qualification,Victoria,Seychelles,False,3,1,Seychelles
22303,24033,25566,2003,Slovakia,Turkey,0,1,UEFA Euro qualification,Bratislava,Slovakia,False,1,-1,Turkey
22304,24034,25567,2003,Spain,Greece,0,1,UEFA Euro qualification,Zaragoza,Spain,False,1,-1,Greece
22305,24035,25568,2003,Switzerland,Russia,2,2,UEFA Euro qualification,Basel,Switzerland,False,4,0,Draw
22306,24036,25569,2003,Uganda,Rwanda,0,1,African Cup of Nations qualification,Kampala,Uganda,False,1,-1,Rwanda
22307,24037,25570,2003,Ukraine,Armenia,4,3,UEFA Euro qualification,L'viv,Ukraine,False,7,1,Ukraine
22308,24038,25571,2003,Venezuela,Honduras,2,1,Friendly,Miami,United States,True,3,1,Venezuela
22309,24039,25572,2003,Zambia,Tanzania,2,0,African Cup of Nations qualification,Lusaka,Zambia,False,2,2,Zambia
22310,24040,25573,2003,Benin,Sudan,3,0,African Cup of Nations qualification,Cotonou,Benin,False,3,3,Benin
22311,24041,25574,2003,Central African Republic,Congo,0,0,African Cup of Nations qualification,Bangui,Central African Republic,False,0,0,Draw
22312,24042,25575,2003,Colombia,Ecuador,0,0,Friendly,Madrid,Spain,True,0,0,Draw
22313,24043,25576,2003,DR Congo,Eswatini,2,0,African Cup of Nations qualification,Kinshasa,DR Congo,False,2,2,DR Congo
22314,24044,25577,2003,Costa Rica,Chile,1,0,Friendly,San José,Costa Rica,False,1,1,Costa Rica
22315,24045,25578,2003,Egypt,Mauritius,7,0,African Cup of Nations qualification,Cairo,Egypt,False,7,7,Egypt
22316,24046,25579,2003,Equatorial Guinea,Gabon,2,1,African Cup of Nations qualification,Bata,Equatorial Guinea,False,3,1,Equatorial Guinea
22317,24047,25580,2003,Ivory Coast,Burundi,6,1,African Cup of Nations qualification,Abidjan,Ivory Coast,False,7,5,Ivory Coast
22318,24048,25581,2003,Japan,Argentina,1,4,Kirin Cup,Osaka,Japan,False,5,-3,Argentina
22319,24049,25583,2003,Liberia,Ethiopia,1,0,African Cup of Nations qualification,Monrovia,Liberia,False,1,1,Liberia
22320,24050,25584,2003,Morocco,Sierra Leone,1,0,African Cup of Nations qualification,Casablanca,Morocco,False,1,1,Morocco
22321,24052,25586,2003,United States,New Zealand,2,1,Friendly,Richmond,United States,False,3,1,United States
22322,24053,25587,2003,Botswana,Trinidad and Tobago,0,0,Friendly,Gaborone,Botswana,False,0,0,Draw
22323,24054,25588,2003,Portugal,Bolivia,4,0,Friendly,Oeiras,Portugal,False,4,4,Portugal
22324,24055,25589,2003,Austria,Belarus,5,0,UEFA Euro qualification,Innsbruck,Austria,False,5,5,Austria
22325,24056,25590,2003,Azerbaijan,Serbia,2,1,UEFA Euro qualification,Baku,Azerbaijan,False,3,1,Azerbaijan
22326,24057,25591,2003,Belgium,Andorra,3,0,UEFA Euro qualification,Ghent,Belgium,False,3,3,Belgium
22327,24058,25592,2003,Czech Republic,Moldova,5,0,UEFA Euro qualification,Olomouc,Czech Republic,False,5,5,Czech Republic
22328,24059,25593,2003,Ecuador,Peru,2,2,Friendly,East Rutherford,United States,True,4,0,Draw
22329,24060,25594,2003,England,Slovakia,2,1,UEFA Euro qualification,Middlesbrough,England,False,3,1,England
22330,24061,25595,2003,Estonia,Croatia,0,1,UEFA Euro qualification,Tallinn,Estonia,False,1,-1,Croatia
22331,24062,25596,2003,Faroe Islands,Germany,0,2,UEFA Euro qualification,Tórshavn,Faroe Islands,False,2,-2,Germany
22332,24063,25597,2003,Finland,Italy,0,2,UEFA Euro qualification,Helsinki,Finland,False,2,-2,Italy
22333,24064,25598,2003,Greece,Ukraine,1,0,UEFA Euro qualification,Athens,Greece,False,1,1,Greece
22334,24065,25599,2003,Honduras,Chile,1,2,Friendly,San Pedro Sula,Honduras,False,3,-1,Chile
22335,24066,25600,2003,Republic of Ireland,Georgia,2,0,UEFA Euro qualification,Dublin,Republic of Ireland,False,2,2,Republic of Ireland
22336,24067,25601,2003,Japan,Paraguay,0,0,Kirin Cup,Saitama,Japan,False,0,0,Draw
22337,24068,25603,2003,Lithuania,Iceland,0,3,UEFA Euro qualification,Kaunas,Lithuania,False,3,-3,Iceland
22338,24069,25604,2003,Luxembourg,Denmark,0,2,UEFA Euro qualification,Luxembourg,Luxembourg,False,2,-2,Denmark
22339,24070,25605,2003,Nigeria,Brazil,0,3,Friendly,Abuja,Nigeria,False,3,-3,Brazil
22340,24071,25606,2003,Northern Ireland,Spain,0,0,UEFA Euro qualification,Belfast,Northern Ireland,False,0,0,Draw
22341,24072,25607,2003,Norway,Romania,1,1,UEFA Euro qualification,Oslo,Norway,False,2,0,Draw
22342,24073,25608,2003,San Marino,Hungary,0,5,UEFA Euro qualification,Serravalle,San Marino,False,5,-5,Hungary
22343,24074,25609,2003,Sweden,Poland,3,0,UEFA Euro qualification,Solna,Sweden,False,3,3,Sweden
22344,24075,25610,2003,Switzerland,Albania,3,2,UEFA Euro qualification,Geneva,Switzerland,False,5,1,Switzerland
22345,24077,25612,2003,Andorra,Gabon,0,2,Friendly,Sant Julià de Lòria,Andorra,False,2,-2,Gabon
22346,24078,25613,2003,Ghana,Kenya,1,3,Friendly,Accra,Ghana,False,4,-2,Kenya
22347,24079,25614,2003,Papua New Guinea,Solomon Islands,3,5,Friendly,Port Moresby,Papua New Guinea,False,8,-2,Solomon Islands
22348,24080,25615,2003,Senegal,Lesotho,3,0,African Cup of Nations qualification,Dakar,Senegal,False,3,3,Senegal
22349,24081,25616,2003,South Africa,Trinidad and Tobago,2,1,Friendly,Port Elizabeth,South Africa,False,3,1,South Africa
22350,24082,25617,2003,France,Colombia,1,0,Confederations Cup,Lyon,France,False,1,1,France
22351,24083,25618,2003,New Zealand,Japan,0,3,Confederations Cup,Saint-Denis,France,True,3,-3,Japan
22352,24084,25619,2003,Brazil,Cameroon,0,1,Confederations Cup,Saint-Denis,France,True,1,-1,Cameroon
22353,24085,25620,2003,Turkey,United States,2,1,Confederations Cup,Saint-Étienne,France,True,3,1,Turkey
22354,24086,25621,2003,Algeria,Namibia,1,0,African Cup of Nations qualification,Blida,Algeria,False,1,1,Algeria
22355,24087,25622,2003,Colombia,New Zealand,3,1,Confederations Cup,Lyon,France,True,4,2,Colombia
22356,24088,25623,2003,Egypt,Madagascar,6,0,African Cup of Nations qualification,Port Said,Egypt,False,6,6,Egypt
22357,24089,25624,2003,France,Japan,2,1,Confederations Cup,Saint-Étienne,France,False,3,1,France
22358,24090,25625,2003,Morocco,Gabon,2,0,African Cup of Nations qualification,Rabat,Morocco,False,2,2,Morocco
22359,24091,25626,2003,Brazil,United States,1,0,Confederations Cup,Lyon,France,True,1,1,Brazil
22360,24092,25627,2003,Burkina Faso,Congo,3,0,African Cup of Nations qualification,Ouagadougou,Burkina Faso,False,3,3,Burkina Faso
22361,24093,25628,2003,Cameroon,Turkey,1,0,Confederations Cup,Saint-Denis,France,True,1,1,Cameroon
22362,24094,25630,2003,Eritrea,Seychelles,1,0,African Cup of Nations qualification,Asmara,Eritrea,False,1,1,Eritrea
22363,24095,25631,2003,Liberia,Guinea,1,2,African Cup of Nations qualification,Accra,Ghana,True,3,-1,Guinea
22364,24096,25632,2003,Nigeria,Angola,2,2,African Cup of Nations qualification,Benin City,Nigeria,False,4,0,Draw
22365,24097,25633,2003,Zambia,Sudan,1,1,African Cup of Nations qualification,Lusaka,Zambia,False,2,0,Draw
22366,24098,25634,2003,DR Congo,Libya,2,1,African Cup of Nations qualification,Kinshasa,DR Congo,False,3,1,DR Congo
22367,24099,25635,2003,Ethiopia,Niger,2,0,African Cup of Nations qualification,Addis Abeba,Ethiopia,False,2,2,Ethiopia
22368,24100,25636,2003,France,New Zealand,5,0,Confederations Cup,Saint-Denis,France,False,5,5,France
22369,24101,25637,2003,Ghana,Uganda,1,1,African Cup of Nations qualification,Kumasi,Ghana,False,2,0,Draw
22370,24102,25638,2003,Guatemala,Honduras,1,2,Friendly,Carson,United States,True,3,-1,Honduras
22371,24103,25639,2003,Japan,Colombia,0,1,Confederations Cup,Saint-Étienne,France,True,1,-1,Colombia
22372,24104,25640,2003,Mali,Zimbabwe,0,0,African Cup of Nations qualification,Bamako,Mali,False,0,0,Draw
22373,24105,25641,2003,Mozambique,Central African Republic,1,0,African Cup of Nations qualification,Maputo,Mozambique,False,1,1,Mozambique
22374,24106,25642,2003,Sierra Leone,Equatorial Guinea,2,0,African Cup of Nations qualification,Freetown,Sierra Leone,False,2,2,Sierra Leone
22375,24107,25643,2003,South Africa,Ivory Coast,2,1,African Cup of Nations qualification,Polokwane,South Africa,False,3,1,South Africa
22376,24108,25644,2003,Eswatini,Botswana,3,2,African Cup of Nations qualification,Lobamba,Eswatini,False,5,1,Eswatini
22377,24109,25645,2003,Tanzania,Benin,0,1,African Cup of Nations qualification,Dar es Salaam,Tanzania,False,1,-1,Benin
22378,24110,25646,2003,Togo,Kenya,2,0,African Cup of Nations qualification,Lomé,Togo,False,2,2,Togo
22379,24111,25647,2003,Brazil,Turkey,2,2,Confederations Cup,Saint-Étienne,France,True,4,0,Draw
22380,24112,25648,2003,United States,Cameroon,0,0,Confederations Cup,Lyon,France,True,0,0,Draw
22381,24113,25649,2003,Cameroon,Colombia,1,0,Confederations Cup,Lyon,France,True,1,1,Cameroon
22382,24114,25650,2003,France,Turkey,3,2,Confederations Cup,Saint-Denis,France,False,5,1,France
22383,24115,25651,2003,Peru,Venezuela,1,0,Friendly,Miami,United States,True,1,1,Peru
22384,24116,25652,2003,Panama,Cuba,2,0,Friendly,Panama City,Panama,False,2,2,Panama
22385,24117,25653,2003,Colombia,Turkey,1,2,Confederations Cup,Saint-Étienne,France,True,3,-1,Turkey
22386,24118,25654,2003,France,Cameroon,1,0,Confederations Cup,Saint-Denis,France,False,1,1,France
22387,24119,25655,2003,Honduras,El Salvador,1,1,Friendly,Tegucigalpa,Honduras,False,2,0,Draw
22388,24120,25656,2003,Panama,Cuba,1,0,Friendly,Panama City,Panama,False,1,1,Panama
22389,24123,25663,2003,Fiji,Vanuatu,0,0,South Pacific Games,Suva,Fiji,False,0,0,Draw
22390,24124,25664,2003,Papua New Guinea,New Caledonia,0,2,South Pacific Games,Suva,Fiji,True,2,-2,New Caledonia
22391,24125,25666,2003,Tuvalu,Kiribati,3,2,South Pacific Games,Suva,Fiji,True,5,1,Tuvalu
22392,24129,25672,2003,Gibraltar,Greenland,2,0,Island Games,St. Martin,Guernsey,True,2,2,Gibraltar
22393,24130,25673,2003,Fiji,Tuvalu,4,0,South Pacific Games,Suva,Fiji,False,4,4,Fiji
22394,24131,25674,2003,Micronesia,New Caledonia,0,18,South Pacific Games,Suva,Fiji,True,18,-18,New Caledonia
22395,24132,25675,2003,Papua New Guinea,Tonga,2,2,South Pacific Games,Suva,Fiji,True,4,0,Draw
22396,24133,25676,2003,Solomon Islands,Vanuatu,2,2,South Pacific Games,Suva,Fiji,True,4,0,Draw
22397,24136,25683,2003,El Salvador,Paraguay,0,1,Friendly,San Francisco,United States,True,1,-1,Paraguay
22398,24137,25684,2003,Guatemala,Peru,1,2,Friendly,San Francisco,United States,True,3,-1,Peru
22399,24138,25685,2003,Estonia,Lithuania,1,5,Baltic Cup,Valga,Estonia,False,6,-4,Lithuania
22400,24139,25686,2003,Solomon Islands,Kiribati,7,0,South Pacific Games,Suva,Fiji,True,7,7,Solomon Islands
22401,24140,25688,2003,Tonga,New Caledonia,0,4,South Pacific Games,Suva,Fiji,True,4,-4,New Caledonia
22402,24141,25689,2003,Trinidad and Tobago,Venezuela,2,2,Friendly,Port of Spain,Trinidad and Tobago,False,4,0,Draw
22403,24142,25690,2003,Tuvalu,Vanuatu,0,1,South Pacific Games,Suva,Fiji,True,1,-1,Vanuatu
22404,24143,25695,2003,Isle of Man,Jersey,2,1,Island Games,St. Sampson,Guernsey,True,3,1,Isle of Man
22405,24145,25697,2003,Latvia,Lithuania,2,1,Baltic Cup,Valga,Estonia,True,3,1,Latvia
22406,24148,25703,2003,Guernsey,Isle of Man,3,1,Island Games,St. Peter Port,Guernsey,False,4,2,Guernsey
22407,24149,25704,2003,Botswana,DR Congo,0,0,African Cup of Nations qualification,Gaborone,Botswana,False,0,0,Draw
22408,24150,25705,2003,Estonia,Latvia,0,0,Baltic Cup,Tallinn,Estonia,False,0,0,Draw
22409,24151,25706,2003,Fiji,Kiribati,12,0,South Pacific Games,Nausori,Fiji,False,12,12,Fiji
22410,24153,25708,2003,Libya,Eswatini,6,2,African Cup of Nations qualification,Tripoli,Libya,False,8,4,Libya
22411,24154,25709,2003,Mauritania,Togo,0,0,African Cup of Nations qualification,Nouakchott,Mauritania,False,0,0,Draw
22412,24155,25710,2003,Niger,Liberia,1,0,African Cup of Nations qualification,Niamey,Niger,False,1,1,Niger
22413,24156,25711,2003,Seychelles,Mali,0,2,African Cup of Nations qualification,Victoria,Seychelles,False,2,-2,Mali
22414,24157,25713,2003,Tonga,Micronesia,7,0,South Pacific Games,Nausori,Fiji,True,7,7,Tonga
22415,24158,25714,2003,Tuvalu,Solomon Islands,0,4,South Pacific Games,Nausori,Fiji,True,4,-4,Solomon Islands
22416,24159,25715,2003,Zimbabwe,Eritrea,2,0,African Cup of Nations qualification,Harare,Zimbabwe,False,2,2,Zimbabwe
22417,24160,25716,2003,Angola,Malawi,5,1,African Cup of Nations qualification,Luanda,Angola,False,6,4,Angola
22418,24161,25717,2003,Benin,Zambia,3,0,African Cup of Nations qualification,Cotonou,Benin,False,3,3,Benin
22419,24162,25718,2003,Burundi,South Africa,0,2,African Cup of Nations qualification,Bujumbura,Burundi,False,2,-2,South Africa
22420,24163,25719,2003,Central African Republic,Burkina Faso,0,3,African Cup of Nations qualification,Bangui,Central African Republic,False,3,-3,Burkina Faso
22421,24164,25720,2003,Chad,Algeria,0,0,African Cup of Nations qualification,N'Djamena,Chad,False,0,0,Draw
22422,24165,25721,2003,Congo,Mozambique,0,0,African Cup of Nations qualification,Brazzaville,Congo,False,0,0,Draw
22423,24166,25722,2003,El Salvador,Mexico,2,1,Friendly,Carson,United States,True,3,1,El Salvador
22424,24167,25723,2003,Equatorial Guinea,Morocco,0,1,African Cup of Nations qualification,Malabo,Equatorial Guinea,False,1,-1,Morocco
22425,24168,25724,2003,Gabon,Sierra Leone,2,0,African Cup of Nations qualification,Libreville,Gabon,False,2,2,Gabon
22426,24169,25725,2003,Guinea,Ethiopia,3,0,African Cup of Nations qualification,Conakry,Guinea,False,3,3,Guinea
22427,24170,25726,2003,Jamaica,Cuba,1,2,Friendly,Kingston,Jamaica,False,3,-1,Cuba
22428,24171,25727,2003,Lesotho,Gambia,1,0,African Cup of Nations qualification,Maseru,Lesotho,False,1,1,Lesotho
22429,24172,25728,2003,Madagascar,Mauritius,0,2,African Cup of Nations qualification,Antananarivo,Madagascar,False,2,-2,Mauritius
22430,24173,25729,2003,Rwanda,Ghana,1,0,African Cup of Nations qualification,Kigali,Rwanda,False,1,1,Rwanda
22431,24174,25730,2003,United States,Paraguay,2,0,Friendly,Columbus,United States,False,2,2,United States
22432,24175,25731,2003,Fiji,Solomon Islands,2,1,South Pacific Games,Lautoka,Fiji,False,3,1,Fiji
22433,24176,25732,2003,Kiribati,Vanuatu,0,18,South Pacific Games,Lautoka,Fiji,True,18,-18,Vanuatu
22434,24177,25733,2003,Papua New Guinea,Micronesia,10,0,South Pacific Games,Lautoka,Fiji,True,10,10,Papua New Guinea
22435,24178,25735,2003,El Salvador,Guatemala,1,2,Friendly,Houston,United States,True,3,-1,Guatemala
22436,24180,25737,2003,Jamaica,Paraguay,2,0,Friendly,Kingston,Jamaica,False,2,2,Jamaica
22437,24181,25738,2003,New Caledonia,Vanuatu,1,1,South Pacific Games,Lautoka,Fiji,True,2,0,Draw
22438,24182,25739,2003,Fiji,New Caledonia,2,0,South Pacific Games,Suva,Fiji,False,2,2,Fiji
22439,24183,25741,2003,Costa Rica,Canada,0,1,Gold Cup,Foxborough,United States,True,1,-1,Canada
22440,24184,25742,2003,United States,El Salvador,2,0,Gold Cup,Foxborough,United States,False,2,2,United States
22441,24185,25743,2003,Jamaica,Colombia,0,1,Gold Cup,Miami,United States,True,1,-1,Colombia
22442,24186,25744,2003,Mexico,Brazil,1,0,Gold Cup,Mexico City,Mexico,False,1,1,Mexico
22443,24187,25745,2003,Eswatini,Madagascar,2,0,COSAFA Cup,Lobamba,Eswatini,False,2,2,Eswatini
22444,24188,25746,2003,Canada,Cuba,0,2,Gold Cup,Foxborough,United States,True,2,-2,Cuba
22445,24189,25747,2003,United States,Martinique,2,0,Gold Cup,Foxborough,United States,False,2,2,United States
22446,24190,25748,2003,Brazil,Honduras,2,1,Gold Cup,Mexico City,Mexico,True,3,1,Brazil
22447,24191,25749,2003,Guatemala,Jamaica,0,2,Gold Cup,Miami,United States,True,2,-2,Jamaica
22448,24192,25750,2003,Argentina,Uruguay,2,2,Friendly,La Plata,Argentina,False,4,0,Draw
22449,24193,25751,2003,Cuba,Costa Rica,0,3,Gold Cup,Foxborough,United States,True,3,-3,Costa Rica
22450,24194,25752,2003,El Salvador,Martinique,1,0,Gold Cup,Foxborough,United States,True,1,1,El Salvador
22451,24195,25753,2003,Colombia,Guatemala,1,1,Gold Cup,Miami,United States,True,2,0,Draw
22452,24196,25754,2003,Mexico,Honduras,0,0,Gold Cup,Mexico City,Mexico,False,0,0,Draw
22453,24197,25755,2003,Colombia,Brazil,0,2,Gold Cup,Miami,United States,True,2,-2,Brazil
22454,24198,25756,2003,Costa Rica,El Salvador,5,2,Gold Cup,Foxborough,United States,True,7,3,Costa Rica
22455,24199,25757,2003,South Africa,Zimbabwe,0,1,COSAFA Cup,East London,South Africa,False,1,-1,Zimbabwe
22456,24200,25758,2003,United States,Cuba,5,0,Gold Cup,Foxborough,United States,False,5,5,United States
22457,24201,25759,2003,Mexico,Jamaica,5,0,Gold Cup,Mexico City,Mexico,False,5,5,Mexico
22458,24202,25760,2003,United States,Brazil,1,2,Gold Cup,Miami,United States,False,3,-1,Brazil
22459,24203,25761,2003,Mexico,Costa Rica,2,0,Gold Cup,Mexico City,Mexico,False,2,2,Mexico
22460,24204,25762,2003,Peru,Uruguay,3,4,Friendly,Lima,Peru,False,7,-1,Uruguay
22461,24205,25763,2003,Nigeria,Venezuela,1,0,Friendly,Watford,England,True,1,1,Nigeria
22462,24206,25764,2003,United States,Costa Rica,3,2,Gold Cup,Miami,United States,False,5,1,United States
22463,24207,25765,2003,Mexico,Brazil,1,0,Gold Cup,Mexico City,Mexico,False,1,1,Mexico
22464,24208,25766,2003,Saint Kitts and Nevis,Haiti,1,0,SKN Football Festival,Basseterre,Saint Kitts and Nevis,False,1,1,Saint Kitts and Nevis
22465,24209,25767,2003,Uruguay,Peru,1,0,Friendly,Montevideo,Uruguay,False,1,1,Uruguay
22466,24210,25768,2003,Haiti,Trinidad and Tobago,2,0,SKN Football Festival,Basseterre,Saint Kitts and Nevis,True,2,2,Haiti
22467,24211,25769,2003,Saint Kitts and Nevis,Trinidad and Tobago,1,2,SKN Football Festival,Basseterre,Saint Kitts and Nevis,False,3,-1,Trinidad and Tobago
22468,24212,25770,2003,Singapore,Hong Kong,4,1,Friendly,Singapore,Singapore,False,5,3,Singapore
22469,24213,25771,2003,Iran,Iraq,0,1,Friendly,Teheran,Iran,False,1,-1,Iraq
22470,24214,25772,2003,Iraq,Uruguay,2,5,Friendly,Teheran,Iran,True,7,-3,Uruguay
22471,24215,25773,2003,Malawi,Zambia,1,1,COSAFA Cup,Blantyre,Malawi,False,2,0,Draw
22472,24216,25774,2003,Mayotte,Réunion,1,1,Friendly,Mamoutzou,Mayotte,False,2,0,Draw
22473,24217,25775,2003,Republic of Ireland,Australia,2,1,Friendly,Dublin,Republic of Ireland,False,3,1,Republic of Ireland
22474,24218,25776,2003,Luxembourg,Malta,1,1,Friendly,Esch-sur-Alzette,Luxembourg,False,2,0,Draw
22475,24219,25777,2003,Angola,DR Congo,0,2,Friendly,Luanda,Angola,False,2,-2,DR Congo
22476,24220,25778,2003,Argentina,Uruguay,3,2,Friendly,Florence,Italy,True,5,1,Argentina
22477,24221,25779,2003,Austria,Costa Rica,2,0,Friendly,Vienna,Austria,False,2,2,Austria
22478,24222,25780,2003,Belarus,Iran,2,1,Friendly,Minsk,Belarus,False,3,1,Belarus
22479,24223,25781,2003,Belgium,Netherlands,1,1,Friendly,Brussels,Belgium,False,2,0,Draw
22480,24224,25782,2003,Bulgaria,Lithuania,3,0,Friendly,Sofia,Bulgaria,False,3,3,Bulgaria
22481,24225,25784,2003,Colombia,Slovakia,0,0,Friendly,New York,United States,True,0,0,Draw
22482,24226,25785,2003,Denmark,Finland,1,1,Friendly,Copenhagen,Denmark,False,2,0,Draw
22483,24227,25786,2003,Ecuador,Guatemala,2,0,Friendly,Ambato,Ecuador,False,2,2,Ecuador
22484,24228,25787,2003,England,Croatia,3,1,Friendly,Ipswich,England,False,4,2,England
22485,24229,25788,2003,Estonia,Poland,1,2,Friendly,Tallinn,Estonia,False,3,-1,Poland
22486,24230,25789,2003,Faroe Islands,Iceland,1,2,UEFA Euro qualification,Tórshavn,Faroe Islands,False,3,-1,Iceland
22487,24231,25790,2003,Germany,Italy,0,1,Friendly,Stuttgart,Germany,False,1,-1,Italy
22488,24232,25791,2003,Japan,Nigeria,3,0,Friendly,Tokyo,Japan,False,3,3,Japan
22489,24233,25792,2003,Latvia,Uzbekistan,0,3,Friendly,Riga,Latvia,False,3,-3,Uzbekistan
22490,24234,25793,2003,Liechtenstein,San Marino,2,2,Friendly,Vaduz,Liechtenstein,False,4,0,Draw
22491,24235,25795,2003,Mexico,Peru,1,3,Friendly,East Rutherford,United States,True,4,-2,Peru
22492,24236,25796,2003,Norway,Scotland,0,0,Friendly,Oslo,Norway,False,0,0,Draw
22493,24237,25797,2003,Panama,Paraguay,1,2,Friendly,Panama City,Panama,False,3,-1,Paraguay
22494,24238,25798,2003,Portugal,Kazakhstan,1,0,Friendly,Chaves,Portugal,False,1,1,Portugal
22495,24239,25799,2003,Russia,Israel,1,2,Friendly,Moscow,Russia,False,3,-1,Israel
22496,24240,25800,2003,Serbia,Wales,1,0,UEFA Euro qualification,Belgrade,Serbia and Montenegro,False,1,1,Serbia
22497,24241,25801,2003,Slovenia,Hungary,2,1,Friendly,Murska Sobota,Slovenia,False,3,1,Slovenia
22498,24242,25802,2003,Sweden,Greece,1,2,Friendly,Norrköping,Sweden,False,3,-1,Greece
22499,24243,25803,2003,Switzerland,France,0,2,Friendly,Geneva,Switzerland,False,2,-2,France
22500,24244,25804,2003,Tunisia,Guinea,0,0,Friendly,Tunis,Tunisia,False,0,0,Draw
22501,24245,25805,2003,Turkey,Moldova,2,0,Friendly,Ankara,Turkey,False,2,2,Turkey
22502,24246,25806,2003,Ukraine,Romania,0,2,Friendly,Donets'k,Ukraine,False,2,-2,Romania
22503,24247,25807,2003,Venezuela,Haiti,3,2,Friendly,Maracaibo,Venezuela,False,5,1,Venezuela
22504,24248,25808,2003,Lebanon,Syria,1,0,Friendly,Beirut,Lebanon,False,1,1,Lebanon
22505,24249,25809,2003,Jordan,Iraq,2,1,Friendly,Amman,Jordan,False,3,1,Jordan
22506,24250,25810,2003,Peru,Guatemala,0,0,Friendly,Lima,Peru,False,0,0,Draw
22507,24251,25811,2003,Bolivia,Panama,3,0,Friendly,La Paz,Bolivia,False,3,3,Bolivia
22508,24253,25813,2003,Zimbabwe,Eswatini,2,0,COSAFA Cup,Bulawayo,Zimbabwe,False,2,2,Zimbabwe
22509,24254,25814,2003,Algeria,Qatar,1,0,Friendly,Dinard,France,True,1,1,Algeria
22510,24255,25816,2003,Singapore,Kuwait,1,3,AFC Asian Cup qualification,Singapore,Singapore,False,4,-2,Kuwait
22511,24256,25817,2003,Iran,Jordan,4,1,AFC Asian Cup qualification,Teheran,Iran,False,5,3,Iran
22512,24257,25818,2003,Andorra,Croatia,0,3,UEFA Euro qualification,Sant Julià de Lòria,Andorra,False,3,-3,Croatia
22513,24258,25819,2003,Argentina,Chile,2,2,FIFA World Cup qualification,Buenos Aires,Argentina,False,4,0,Draw
22514,24259,25820,2003,Armenia,Greece,0,1,UEFA Euro qualification,Yerevan,Armenia,False,1,-1,Greece
22515,24260,25821,2003,Azerbaijan,Finland,1,2,UEFA Euro qualification,Baku,Azerbaijan,False,3,-1,Finland
22516,24261,25822,2003,Belarus,Czech Republic,1,3,UEFA Euro qualification,Minsk,Belarus,False,4,-2,Czech Republic
22517,24262,25823,2003,Bosnia and Herzegovina,Norway,1,0,UEFA Euro qualification,Zenica,Bosnia and Herzegovina,False,1,1,Bosnia and Herzegovina
22518,24263,25824,2003,Bulgaria,Estonia,2,0,UEFA Euro qualification,Sofia,Bulgaria,False,2,2,Bulgaria
22519,24264,25825,2003,Ecuador,Venezuela,2,0,FIFA World Cup qualification,Quito,Ecuador,False,2,2,Ecuador
22520,24265,25826,2003,France,Cyprus,5,0,UEFA Euro qualification,Saint-Denis,France,False,5,5,France
22521,24266,25827,2003,Georgia,Albania,3,0,UEFA Euro qualification,Tbilisi,Georgia,False,3,3,Georgia
22522,24267,25828,2003,Iceland,Germany,0,0,UEFA Euro qualification,Reykjavík,Iceland,False,0,0,Draw
22523,24268,25829,2003,Republic of Ireland,Russia,1,1,UEFA Euro qualification,Dublin,Republic of Ireland,False,2,0,Draw
22524,24269,25830,2003,Italy,Wales,4,0,UEFA Euro qualification,Milan,Italy,False,4,4,Italy
22525,24270,25831,2003,Latvia,Poland,0,2,UEFA Euro qualification,Riga,Latvia,False,2,-2,Poland
22526,24271,25832,2003,Liechtenstein,Turkey,0,3,UEFA Euro qualification,Vaduz,Liechtenstein,False,3,-3,Turkey
22527,24272,25834,2003,Netherlands,Austria,3,1,UEFA Euro qualification,Rotterdam,Netherlands,False,4,2,Netherlands
22528,24273,25835,2003,Peru,Paraguay,4,1,FIFA World Cup qualification,Lima,Peru,False,5,3,Peru
22529,24274,25836,2003,Portugal,Spain,0,3,Friendly,Guimarães,Portugal,False,3,-3,Spain
22530,24275,25837,2003,Romania,Luxembourg,4,0,UEFA Euro qualification,Ploieşti,Romania,False,4,4,Romania
22531,24276,25838,2003,Scotland,Faroe Islands,3,1,UEFA Euro qualification,Glasgow,Scotland,False,4,2,Scotland
22532,24277,25839,2003,Slovenia,Israel,3,1,UEFA Euro qualification,Ljubljana,Slovenia,False,4,2,Slovenia
22533,24278,25840,2003,Eswatini,Botswana,0,3,Friendly,Mbabane,Eswatini,False,3,-3,Botswana
22534,24279,25841,2003,Sweden,San Marino,5,0,UEFA Euro qualification,Gothenburg,Sweden,False,5,5,Sweden
22535,24280,25842,2003,Ukraine,Northern Ireland,0,0,UEFA Euro qualification,Donets'k,Ukraine,False,0,0,Draw
22536,24281,25843,2003,Angola,Namibia,2,0,Friendly,Luanda,Angola,False,2,2,Angola
22537,24282,25844,2003,Australia,Jamaica,2,1,Friendly,Reading,England,True,3,1,Australia
22538,24283,25845,2003,Colombia,Brazil,1,2,FIFA World Cup qualification,Barranquilla,Colombia,False,3,-1,Brazil
22539,24285,25847,2003,Uruguay,Bolivia,5,0,FIFA World Cup qualification,Montevideo,Uruguay,False,5,5,Uruguay
22540,24286,25848,2003,Chile,Peru,2,1,FIFA World Cup qualification,Santiago,Chile,False,3,1,Chile
22541,24287,25849,2003,Republic of Ireland,Turkey,2,2,Friendly,Dublin,Republic of Ireland,False,4,0,Draw
22542,24288,25850,2003,Venezuela,Argentina,0,3,FIFA World Cup qualification,Caracas,Venezuela,False,3,-3,Argentina
22543,24289,25851,2003,Albania,Georgia,3,1,UEFA Euro qualification,Tirana,Albania,False,4,2,Albania
22544,24290,25852,2003,Andorra,Bulgaria,0,3,UEFA Euro qualification,Sant Julià de Lòria,Andorra,False,3,-3,Bulgaria
22545,24291,25853,2003,Belgium,Croatia,2,1,UEFA Euro qualification,Brussels,Belgium,False,3,1,Belgium
22546,24292,25854,2003,Bolivia,Colombia,4,0,FIFA World Cup qualification,La Paz,Bolivia,False,4,4,Bolivia
22547,24293,25855,2003,Brazil,Ecuador,1,0,FIFA World Cup qualification,Manaus,Brazil,False,1,1,Brazil
22548,24294,25856,2003,Czech Republic,Netherlands,3,1,UEFA Euro qualification,Prague,Czech Republic,False,4,2,Czech Republic
22549,24295,25857,2003,Denmark,Romania,2,2,UEFA Euro qualification,Copenhagen,Denmark,False,4,0,Draw
22550,24296,25858,2003,England,Liechtenstein,2,0,UEFA Euro qualification,Manchester,England,False,2,2,England
22551,24297,25859,2003,Faroe Islands,Lithuania,1,3,UEFA Euro qualification,Toftir,Faroe Islands,False,4,-2,Lithuania
22552,24298,25860,2003,Germany,Scotland,2,1,UEFA Euro qualification,Dortmund,Germany,False,3,1,Germany
22553,24299,25861,2003,Israel,Malta,2,2,UEFA Euro qualification,Antalya,Turkey,True,4,0,Draw
22554,24300,25862,2003,Japan,Senegal,0,1,Friendly,Niigata,Japan,False,1,-1,Senegal
22555,24301,25863,2003,Latvia,Hungary,3,1,UEFA Euro qualification,Riga,Latvia,False,4,2,Latvia
22556,24302,25864,2003,Luxembourg,Bosnia and Herzegovina,0,1,UEFA Euro qualification,Luxembourg,Luxembourg,False,1,-1,Bosnia and Herzegovina
22557,24303,25865,2003,Moldova,Belarus,2,1,UEFA Euro qualification,Tiraspol,Moldova,False,3,1,Moldova
22558,24304,25866,2003,Morocco,Trinidad and Tobago,2,0,Friendly,Marrakech,Morocco,False,2,2,Morocco
22559,24305,25867,2003,Northern Ireland,Armenia,0,1,UEFA Euro qualification,Belfast,Northern Ireland,False,1,-1,Armenia
22560,24306,25868,2003,Norway,Portugal,0,1,Friendly,Oslo,Norway,False,1,-1,Portugal
22561,24307,25869,2003,Oman,Bahrain,1,0,Friendly,Muscat,Oman,False,1,1,Oman
22562,24308,25870,2003,Paraguay,Uruguay,4,1,FIFA World Cup qualification,Asunción,Paraguay,False,5,3,Paraguay
22563,24309,25871,2003,Poland,Sweden,0,2,UEFA Euro qualification,Chorzów,Poland,False,2,-2,Sweden
22564,24310,25872,2003,Russia,Switzerland,4,1,UEFA Euro qualification,Moscow,Russia,False,5,3,Russia
22565,24311,25873,2003,Serbia,Italy,1,1,UEFA Euro qualification,Belgrade,Serbia and Montenegro,False,2,0,Draw
22566,24313,25875,2003,Slovenia,France,0,2,UEFA Euro qualification,Ljubljana,Slovenia,False,2,-2,France
22567,24314,25876,2003,Spain,Ukraine,2,1,UEFA Euro qualification,Elche,Spain,False,3,1,Spain
22568,24315,25877,2003,Tunisia,Ivory Coast,3,2,Friendly,Tunis,Tunisia,False,5,1,Tunisia
22569,24316,25878,2003,Wales,Finland,1,1,UEFA Euro qualification,Cardiff,Wales,False,2,0,Draw
22570,24317,25879,2003,Kuwait,Qatar,2,1,AFC Asian Cup qualification,Kuwait City,Kuwait,False,3,1,Kuwait
22571,24318,25880,2003,Rwanda,Kenya,0,1,Friendly,Kigali,Rwanda,False,1,-1,Kenya
22572,24319,25881,2003,Singapore,Oman,1,3,Friendly,Singapore,Singapore,False,4,-2,Oman
22573,24320,25882,2003,Yemen,Sudan,3,2,Friendly,Sana'a,Yemen,False,5,1,Yemen
22574,24321,25883,2003,Bahrain,Lebanon,4,3,Friendly,Manama,Bahrain,False,7,1,Bahrain
22575,24322,25884,2003,Jordan,Syria,0,0,Friendly,Amman,Jordan,False,0,0,Draw
22576,24323,25885,2003,Yemen,Sudan,1,2,Friendly,Sana'a,Yemen,False,3,-1,Sudan
22577,24324,25886,2003,Namibia,Angola,1,3,Friendly,Windhoek,Namibia,False,4,-2,Angola
22578,24325,25887,2003,Qatar,Kuwait,2,2,AFC Asian Cup qualification,Doha,Qatar,False,4,0,Draw
22579,24326,25888,2003,Algeria,Gabon,2,2,Friendly,Algiers,Algeria,False,4,0,Draw
22580,24327,25889,2003,Benin,Burkina Faso,0,1,Friendly,Algiers,Algeria,True,1,-1,Burkina Faso
22581,24328,25890,2003,Qatar,Palestine,1,1,AFC Asian Cup qualification,Doha,Qatar,False,2,0,Draw
22582,24329,25892,2003,Nepal,Oman,0,7,AFC Asian Cup qualification,Incheon,South Korea,True,7,-7,Oman
22583,24330,25893,2003,Algeria,Burkina Faso,0,0,Friendly,Algiers,Algeria,False,0,0,Draw
22584,24331,25894,2003,Benin,Gabon,0,4,Friendly,Algiers,Algeria,True,4,-4,Gabon
22585,24332,25895,2003,Jordan,Iran,3,2,AFC Asian Cup qualification,Amman,Jordan,False,5,1,Jordan
22586,24333,25896,2003,Malaysia,Indonesia,1,1,Friendly,Kuala Lumpur,Malaysia,False,2,0,Draw
22587,24334,25898,2003,Kuwait,Singapore,4,0,AFC Asian Cup qualification,Kuwait City,Kuwait,False,4,4,Kuwait
22588,24335,25899,2003,Malawi,Zimbabwe,1,2,COSAFA Cup,Blantyre,Malawi,False,3,-1,Zimbabwe
22589,24336,25900,2003,Qatar,Palestine,2,1,AFC Asian Cup qualification,Doha,Qatar,False,3,1,Qatar
22590,24337,25901,2003,Syria,Yemen,8,2,Friendly,Jeddah,Saudi Arabia,True,10,6,Syria
22591,24338,25902,2003,Vietnam,Nepal,5,0,AFC Asian Cup qualification,Incheon,South Korea,True,5,5,Vietnam
22592,24339,25904,2003,Vietnam,Oman,0,6,AFC Asian Cup qualification,Incheon,South Korea,True,6,-6,Oman
22593,24340,25905,2003,Saudi Arabia,Syria,1,1,Friendly,Riyadh,Saudi Arabia,False,2,0,Draw
22594,24341,25906,2003,Lesotho,Eswatini,5,2,Friendly,Maseru,Lesotho,False,7,3,Lesotho
22595,24342,25907,2003,Kuwait,Palestine,2,1,AFC Asian Cup qualification,Kuwait City,Kuwait,False,3,1,Kuwait
22596,24343,25908,2003,Zimbabwe,Malawi,2,0,COSAFA Cup,Harare,Zimbabwe,False,2,2,Zimbabwe
22597,24344,25909,2003,Indonesia,Bhutan,2,0,AFC Asian Cup qualification,Jeddah,Saudi Arabia,True,2,2,Indonesia
22598,24345,25910,2003,Saudi Arabia,Yemen,7,0,AFC Asian Cup qualification,Jeddah,Saudi Arabia,False,7,7,Saudi Arabia
22599,24346,25911,2003,Iraq,Bahrain,5,1,AFC Asian Cup qualification,Kuala Lumpur,Malaysia,True,6,4,Iraq
22600,24347,25912,2003,Kuwait,Palestine,4,0,AFC Asian Cup qualification,Kuwait City,Kuwait,False,4,4,Kuwait
22601,24348,25913,2003,Lesotho,South Africa,0,3,Friendly,Maseru,Lesotho,False,3,-3,South Africa
22602,24349,25914,2003,Malaysia,Burma,4,0,AFC Asian Cup qualification,Kuala Lumpur,Malaysia,False,4,4,Malaysia
22603,24350,25915,2003,Oman,Jordan,2,1,Friendly,Muscat,Oman,False,3,1,Oman
22604,24351,25916,2003,Saudi Arabia,Bhutan,6,0,AFC Asian Cup qualification,Jeddah,Saudi Arabia,False,6,6,Saudi Arabia
22605,24352,25917,2003,Tunisia,Japan,0,1,Friendly,Tunis,Tunisia,False,1,-1,Japan
22606,24353,25918,2003,Yemen,Indonesia,0,3,AFC Asian Cup qualification,Jeddah,Saudi Arabia,True,3,-3,Indonesia
22607,24354,25919,2003,Bhutan,Yemen,0,8,AFC Asian Cup qualification,Jeddah,Saudi Arabia,True,8,-8,Yemen
22608,24355,25920,2003,Burma,Bahrain,1,3,AFC Asian Cup qualification,Kuala Lumpur,Malaysia,True,4,-2,Bahrain
22609,24356,25921,2003,Egypt,Senegal,1,0,Friendly,Cairo,Egypt,False,1,1,Egypt
22610,24357,25922,2003,Guinea-Bissau,Mali,1,2,FIFA World Cup qualification,Bissau,Guinea-Bissau,False,3,-1,Mali
22611,24358,25923,2003,Malaysia,Iraq,0,0,AFC Asian Cup qualification,Kuala Lumpur,Malaysia,False,0,0,Draw
22612,24359,25924,2003,Saudi Arabia,Indonesia,5,0,AFC Asian Cup qualification,Jeddah,Saudi Arabia,False,5,5,Saudi Arabia
22613,24360,25925,2003,Armenia,Spain,0,4,UEFA Euro qualification,Yerevan,Armenia,False,4,-4,Spain
22614,24361,25926,2003,Austria,Czech Republic,2,3,UEFA Euro qualification,Vienna,Austria,False,5,-1,Czech Republic
22615,24362,25927,2003,Belgium,Estonia,2,0,UEFA Euro qualification,Liège,Belgium,False,2,2,Belgium
22616,24363,25928,2003,Bolivia,Honduras,1,0,Friendly,Washington,United States,True,1,1,Bolivia
22617,24364,25929,2003,Bosnia and Herzegovina,Denmark,1,1,UEFA Euro qualification,Sarajevo,Bosnia and Herzegovina,False,2,0,Draw
22618,24365,25930,2003,Botswana,Lesotho,4,1,FIFA World Cup qualification,Gaborone,Botswana,False,5,3,Botswana
22619,24366,25931,2003,Croatia,Bulgaria,1,0,UEFA Euro qualification,Zagreb,Croatia,False,1,1,Croatia
22620,24367,25932,2003,Cyprus,Slovenia,2,2,UEFA Euro qualification,Limassol,Cyprus,False,4,0,Draw
22621,24368,25933,2003,Equatorial Guinea,Togo,1,0,FIFA World Cup qualification,Bata,Equatorial Guinea,False,1,1,Equatorial Guinea
22622,24369,25934,2003,Finland,Canada,3,2,Friendly,Tampere,Finland,False,5,1,Finland
22623,24370,25935,2003,France,Israel,3,0,UEFA Euro qualification,Saint-Denis,France,False,3,3,France
22624,24371,25936,2003,Germany,Iceland,3,0,UEFA Euro qualification,Hamburg,Germany,False,3,3,Germany
22625,24372,25937,2003,Greece,Northern Ireland,1,0,UEFA Euro qualification,Athens,Greece,False,1,1,Greece
22626,24373,25938,2003,Hungary,Poland,1,2,UEFA Euro qualification,Budapest,Hungary,False,3,-1,Poland
22627,24374,25939,2003,Italy,Azerbaijan,4,0,UEFA Euro qualification,Reggio di Calabria,Italy,False,4,4,Italy
22628,24375,25940,2003,Liechtenstein,Slovakia,0,2,UEFA Euro qualification,Vaduz,Liechtenstein,False,2,-2,Slovakia
22629,24376,25941,2003,Madagascar,Benin,1,1,FIFA World Cup qualification,Antananarivo,Madagascar,False,2,0,Draw
22630,24377,25942,2003,Netherlands,Moldova,5,0,UEFA Euro qualification,Eindhoven,Netherlands,False,5,5,Netherlands
22631,24378,25943,2003,Niger,Algeria,0,1,FIFA World Cup qualification,Niamey,Niger,False,1,-1,Algeria
22632,24379,25944,2003,Norway,Luxembourg,1,0,UEFA Euro qualification,Oslo,Norway,False,1,1,Norway
22633,24380,25945,2003,Portugal,Albania,5,3,Friendly,Lisbon,Portugal,False,8,2,Portugal
22634,24381,25946,2003,Romania,Japan,1,1,Friendly,Bucharest,Romania,False,2,0,Draw
22635,24382,25947,2003,Russia,Georgia,3,1,UEFA Euro qualification,Moscow,Russia,False,4,2,Russia
22636,24383,25948,2003,São Tomé and Príncipe,Libya,0,1,FIFA World Cup qualification,São Tomé,São Tomé and Príncipe,False,1,-1,Libya
22637,24384,25949,2003,Scotland,Lithuania,1,0,UEFA Euro qualification,Glasgow,Scotland,False,1,1,Scotland
22638,24385,25950,2003,Seychelles,Zambia,0,4,FIFA World Cup qualification,Victoria,Seychelles,False,4,-4,Zambia
22639,24386,25951,2003,South Africa,Costa Rica,2,1,Friendly,Potchefstroom,South Africa,False,3,1,South Africa
22640,24387,25952,2003,Sweden,Latvia,0,1,UEFA Euro qualification,Solna,Sweden,False,1,-1,Latvia
22641,24388,25953,2003,Switzerland,Republic of Ireland,2,0,UEFA Euro qualification,Basel,Switzerland,False,2,2,Switzerland
22642,24389,25954,2003,Tanzania,Kenya,0,0,FIFA World Cup qualification,Dar es Salaam,Tanzania,False,0,0,Draw
22643,24390,25955,2003,Tunisia,Morocco,0,0,Friendly,Tunis,Tunisia,False,0,0,Draw
22644,24391,25956,2003,Turkey,England,0,0,UEFA Euro qualification,Istanbul,Turkey,False,0,0,Draw
22645,24392,25957,2003,Uganda,Mauritius,3,0,FIFA World Cup qualification,Kampala,Uganda,False,3,3,Uganda
22646,24394,25959,2003,United Arab Emirates,Uzbekistan,2,2,Friendly,Dubai,United Arab Emirates,False,4,0,Draw
22647,24395,25960,2003,Wales,Serbia,2,3,UEFA Euro qualification,Cardiff,Wales,False,5,-1,Serbia
22648,24396,25962,2003,Brazil,Jamaica,1,0,Friendly,Leicester,England,True,1,1,Brazil
22649,24397,25963,2003,Burundi,Gabon,0,0,FIFA World Cup qualification,Bujumbura,Burundi,False,0,0,Draw
22650,24398,25964,2003,Chad,Angola,3,1,FIFA World Cup qualification,N'Djamena,Chad,False,4,2,Chad
22651,24399,25965,2003,Congo,Sierra Leone,1,0,FIFA World Cup qualification,Brazzaville,Congo,False,1,1,Congo
22652,24400,25966,2003,Ethiopia,Malawi,1,3,FIFA World Cup qualification,Addis Abeba,Ethiopia,False,4,-2,Malawi
22653,24401,25967,2003,Gambia,Liberia,2,0,FIFA World Cup qualification,Bakau,Gambia,False,2,2,Gambia
22654,24402,25968,2003,Guinea,Mozambique,1,0,FIFA World Cup qualification,Conakry,Guinea,False,1,1,Guinea
22655,24403,25969,2003,Iran,New Zealand,3,0,Friendly,Teheran,Iran,False,3,3,Iran
22656,24404,25970,2003,Iraq,Burma,3,0,AFC Asian Cup qualification,Kuala Lumpur,Malaysia,True,3,3,Iraq
22657,24405,25971,2003,Malaysia,Bahrain,2,2,AFC Asian Cup qualification,Kuala Lumpur,Malaysia,False,4,0,Draw
22658,24406,25972,2003,Rwanda,Namibia,3,0,FIFA World Cup qualification,Kigali,Rwanda,False,3,3,Rwanda
22659,24407,25973,2003,Sudan,Eritrea,3,0,FIFA World Cup qualification,Khartoum,Sudan,False,3,3,Sudan
22660,24409,25975,2003,Zimbabwe,Mauritania,3,0,FIFA World Cup qualification,Harare,Zimbabwe,False,3,3,Zimbabwe
22661,24410,25976,2003,Bhutan,Indonesia,0,2,AFC Asian Cup qualification,Jeddah,Saudi Arabia,True,2,-2,Indonesia
22662,24411,25977,2003,Saudi Arabia,Yemen,3,1,AFC Asian Cup qualification,Jeddah,Saudi Arabia,False,4,2,Saudi Arabia
22663,24412,25978,2003,Indonesia,Yemen,2,2,AFC Asian Cup qualification,Jeddah,Saudi Arabia,True,4,0,Draw
22664,24413,25979,2003,Mexico,Uruguay,0,2,Friendly,Chicago,United States,True,2,-2,Uruguay
22665,24414,25980,2003,Saudi Arabia,Bhutan,4,0,AFC Asian Cup qualification,Jeddah,Saudi Arabia,False,4,4,Saudi Arabia
22666,24415,25981,2003,Syria,Sri Lanka,5,0,AFC Asian Cup qualification,Damascus,Syria,False,5,5,Syria
22667,24416,25982,2003,Thailand,India,2,0,Friendly,Bangkok,Thailand,False,2,2,Thailand
22668,24417,25983,2003,Jordan,Lebanon,1,0,AFC Asian Cup qualification,Amman,Jordan,False,1,1,Jordan
22669,24418,25984,2003,Saudi Arabia,Indonesia,6,0,AFC Asian Cup qualification,Jeddah,Saudi Arabia,False,6,6,Saudi Arabia
22670,24419,25985,2003,Yemen,Bhutan,4,0,AFC Asian Cup qualification,Jeddah,Saudi Arabia,True,4,4,Yemen
22671,24420,25986,2003,Syria,Sri Lanka,8,0,AFC Asian Cup qualification,Damascus,Syria,False,8,8,Syria
22672,24421,25987,2003,Oman,Nepal,6,0,AFC Asian Cup qualification,Muscat,Oman,False,6,6,Oman
22673,24422,25988,2003,Singapore,Palestine,2,0,AFC Asian Cup qualification,Singapore,Singapore,False,2,2,Singapore
22674,24423,25989,2003,Turkmenistan,United Arab Emirates,1,0,AFC Asian Cup qualification,Ashgabat,Turkmenistan,False,1,1,Turkmenistan
22675,24425,25991,2003,Bahrain,Burma,4,0,AFC Asian Cup qualification,Riffa,Bahrain,False,4,4,Bahrain
22676,24426,25992,2003,Iraq,Malaysia,5,1,AFC Asian Cup qualification,Riffa,Bahrain,True,6,4,Iraq
22677,24427,25993,2003,Nepal,Vietnam,0,2,AFC Asian Cup qualification,Muscat,Oman,True,2,-2,Vietnam
22678,24429,25995,2003,Bahrain,Malaysia,3,1,AFC Asian Cup qualification,Riffa,Bahrain,False,4,2,Bahrain
22679,24430,25996,2003,Burma,Iraq,1,3,AFC Asian Cup qualification,Riffa,Bahrain,True,4,-2,Iraq
22680,24431,25997,2003,India,Rwanda,3,1,Friendly,Hyderabad,India,False,4,2,India
22681,24432,25998,2003,Singapore,Palestine,0,0,AFC Asian Cup qualification,Singapore,Singapore,False,0,0,Draw
22682,24433,25999,2003,Burkina Faso,Zimbabwe,1,4,Friendly,Hyderabad,India,True,5,-3,Zimbabwe
22683,24434,26000,2003,Bahrain,Iraq,1,0,AFC Asian Cup qualification,Riffa,Bahrain,False,1,1,Bahrain
22684,24435,26001,2003,Burma,Malaysia,2,1,AFC Asian Cup qualification,Riffa,Bahrain,True,3,1,Burma
22685,24437,26003,2003,Oman,Vietnam,2,0,AFC Asian Cup qualification,Muscat,Oman,False,2,2,Oman
22686,24438,26005,2003,India,Zimbabwe,5,3,Friendly,Hyderabad,India,False,8,2,India
22687,24439,26006,2003,United Arab Emirates,Turkmenistan,1,1,AFC Asian Cup qualification,Sharjah,United Arab Emirates,False,2,0,Draw
22688,24440,26007,2003,Rwanda,Zimbabwe,2,2,Friendly,Hyderabad,India,True,4,0,Draw
22689,24442,26009,2003,Thailand,Tajikistan,0,1,AFC Asian Cup qualification,Tashkent,Uzbekistan,True,1,-1,Tajikistan
22690,24443,26010,2003,Uzbekistan,Hong Kong,4,1,AFC Asian Cup qualification,Tashkent,Uzbekistan,False,5,3,Uzbekistan
22691,24444,26011,2003,Syria,United Arab Emirates,1,3,AFC Asian Cup qualification,Damascus,Syria,False,4,-2,United Arab Emirates
22692,24445,26012,2003,Gabon,Burkina Faso,0,0,Friendly,Moanda,Gabon,False,0,0,Draw
22693,24446,26013,2003,Hong Kong,Tajikistan,0,0,AFC Asian Cup qualification,Tashkent,Uzbekistan,True,0,0,Draw
22694,24447,26014,2003,Uzbekistan,Thailand,3,0,AFC Asian Cup qualification,Tashkent,Uzbekistan,False,3,3,Uzbekistan
22695,24448,26015,2003,Mozambique,Eswatini,2,0,Friendly,Maputo,Mozambique,False,2,2,Mozambique
22696,24449,26016,2003,Turkmenistan,Sri Lanka,1,0,AFC Asian Cup qualification,Balkanabat,Turkmenistan,False,1,1,Turkmenistan
22697,24450,26017,2003,Hong Kong,Thailand,2,1,AFC Asian Cup qualification,Tashkent,Uzbekistan,True,3,1,Hong Kong
22698,24451,26018,2003,Uzbekistan,Tajikistan,0,0,AFC Asian Cup qualification,Tashkent,Uzbekistan,False,0,0,Draw
22699,24452,26019,2003,Uganda,Tanzania,2,1,Friendly,Kampala,Uganda,False,3,1,Uganda
22700,24453,26020,2003,Equatorial Guinea,São Tomé and Príncipe,3,1,Friendly,Malabo,Equatorial Guinea,False,4,2,Equatorial Guinea
22701,24455,26022,2003,Lebanon,Jordan,0,2,AFC Asian Cup qualification,Beirut,Lebanon,False,2,-2,Jordan
22702,24456,26023,2003,Poland,Italy,3,1,Friendly,Warsaw,Poland,False,4,2,Poland
22703,24457,26024,2003,Turkmenistan,Sri Lanka,3,0,AFC Asian Cup qualification,Ashgabat,Turkmenistan,False,3,3,Turkmenistan
22704,24458,26025,2003,Algeria,Niger,6,0,FIFA World Cup qualification,Algiers,Algeria,False,6,6,Algeria
22705,24459,26026,2003,Mali,Guinea-Bissau,2,0,FIFA World Cup qualification,Bamako,Mali,False,2,2,Mali
22706,24460,26027,2003,Mauritania,Zimbabwe,2,1,FIFA World Cup qualification,Nouakchott,Mauritania,False,3,1,Mauritania
22707,24461,26028,2003,United Arab Emirates,Syria,3,1,AFC Asian Cup qualification,Sharjah,United Arab Emirates,False,4,2,United Arab Emirates
22708,24462,26029,2003,Albania,Estonia,2,0,Friendly,Tirana,Albania,False,2,2,Albania
22709,24463,26030,2003,Argentina,Bolivia,3,0,FIFA World Cup qualification,Buenos Aires,Argentina,False,3,3,Argentina
22710,24464,26031,2003,Colombia,Venezuela,0,1,FIFA World Cup qualification,Barranquilla,Colombia,False,1,-1,Venezuela
22711,24465,26032,2003,Croatia,Slovenia,1,1,UEFA Euro qualification,Zagreb,Croatia,False,2,0,Draw
22712,24466,26033,2003,Czech Republic,Canada,5,1,Friendly,Teplice,Czech Republic,False,6,4,Czech Republic
22713,24467,26034,2003,Egypt,South Africa,2,1,Friendly,Cairo,Egypt,False,3,1,Egypt
22714,24468,26035,2003,Gabon,Burundi,4,1,FIFA World Cup qualification,Libreville,Gabon,False,5,3,Gabon
22715,24469,26036,2003,Germany,France,0,3,Friendly,Gelsenkirchen,Germany,False,3,-3,France
22716,24470,26037,2003,Kenya,Tanzania,3,0,FIFA World Cup qualification,Nairobi,Kenya,False,3,3,Kenya
22717,24471,26038,2003,Latvia,Turkey,1,0,UEFA Euro qualification,Riga,Latvia,False,1,1,Latvia
22718,24472,26039,2003,Malawi,Ethiopia,0,0,FIFA World Cup qualification,Blantyre,Malawi,False,0,0,Draw
22719,24473,26040,2003,Morocco,Burkina Faso,1,0,Friendly,Meknès,Morocco,False,1,1,Morocco
22720,24474,26041,2003,Namibia,Rwanda,1,1,FIFA World Cup qualification,Windhoek,Namibia,False,2,0,Draw
22721,24475,26042,2003,Paraguay,Ecuador,2,1,FIFA World Cup qualification,Asunción,Paraguay,False,3,1,Paraguay
22722,24476,26043,2003,Portugal,Greece,1,1,Friendly,Aveiro,Portugal,False,2,0,Draw
22723,24477,26044,2003,Russia,Wales,0,0,UEFA Euro qualification,Moscow,Russia,False,0,0,Draw
22724,24478,26045,2003,Scotland,Netherlands,1,0,UEFA Euro qualification,Glasgow,Scotland,False,1,1,Scotland
22725,24479,26046,2003,Senegal,Ivory Coast,1,0,Friendly,Dakar,Senegal,False,1,1,Senegal
22726,24480,26047,2003,Spain,Norway,2,1,UEFA Euro qualification,Valencia,Spain,False,3,1,Spain
22727,24481,26048,2003,Uruguay,Chile,2,1,FIFA World Cup qualification,Montevideo,Uruguay,False,3,1,Uruguay
22728,24482,26049,2003,Zambia,Seychelles,1,1,FIFA World Cup qualification,Lusaka,Zambia,False,2,0,Draw
22729,24483,26050,2003,Angola,Chad,2,0,FIFA World Cup qualification,Luanda,Angola,False,2,2,Angola
22730,24484,26051,2003,Benin,Madagascar,3,2,FIFA World Cup qualification,Cotonou,Benin,False,5,1,Benin
22731,24485,26053,2003,England,Denmark,2,3,Friendly,Manchester,England,False,5,-1,Denmark
22732,24486,26054,2003,Eritrea,Sudan,0,0,FIFA World Cup qualification,Asmara,Eritrea,False,0,0,Draw
22733,24487,26055,2003,Ghana,Somalia,5,0,FIFA World Cup qualification,Accra,Ghana,False,5,5,Ghana
22734,24488,26056,2003,Honduras,Finland,1,2,Friendly,Houston,United States,True,3,-1,Finland
22735,24489,26057,2003,Italy,Romania,1,0,Friendly,Ancona,Italy,False,1,1,Italy
22736,24490,26058,2003,Jamaica,El Salvador,3,0,Friendly,Kingston,Jamaica,False,3,3,Jamaica
22737,24491,26059,2003,Lesotho,Botswana,0,0,FIFA World Cup qualification,Maseru,Lesotho,False,0,0,Draw
22738,24492,26060,2003,Liberia,Gambia,3,0,FIFA World Cup qualification,Monrovia,Liberia,False,3,3,Liberia
22739,24493,26061,2003,Libya,São Tomé and Príncipe,8,0,FIFA World Cup qualification,Benghazi,Libya,False,8,8,Libya
22740,24494,26062,2003,Mauritius,Uganda,3,1,FIFA World Cup qualification,Curepipe,Mauritius,False,4,2,Mauritius
22741,24495,26063,2003,Mozambique,Guinea,3,4,FIFA World Cup qualification,Maputo,Mozambique,False,7,-1,Guinea
22742,24496,26064,2003,Peru,Brazil,1,1,FIFA World Cup qualification,Lima,Peru,False,2,0,Draw
22743,24497,26065,2003,Poland,Serbia,4,3,Friendly,Płock,Poland,False,7,1,Poland
22744,24498,26066,2003,Sierra Leone,Congo,1,1,FIFA World Cup qualification,Freetown,Sierra Leone,False,2,0,Draw
22745,24499,26067,2003,Togo,Equatorial Guinea,2,0,FIFA World Cup qualification,Lomé,Togo,False,2,2,Togo
22746,24500,26068,2003,Tajikistan,Uzbekistan,1,4,AFC Asian Cup qualification,Bangkok,Thailand,True,5,-3,Uzbekistan
22747,24501,26069,2003,Thailand,Hong Kong,4,0,AFC Asian Cup qualification,Bangkok,Thailand,False,4,4,Thailand
22748,24502,26070,2003,Chile,Paraguay,0,1,FIFA World Cup qualification,Santiago,Chile,False,1,-1,Paraguay
22749,24503,26071,2003,Egypt,Sweden,1,0,Friendly,Cairo,Egypt,False,1,1,Egypt
22750,24504,26072,2003,Republic of Ireland,Canada,3,0,Friendly,Dublin,Republic of Ireland,False,3,3,Republic of Ireland
22751,24506,26075,2003,United Arab Emirates,Sri Lanka,3,1,AFC Asian Cup qualification,Dubai,United Arab Emirates,False,4,2,United Arab Emirates
22752,24507,26076,2003,Venezuela,Bolivia,2,1,FIFA World Cup qualification,Maracaibo,Venezuela,False,3,1,Venezuela
22753,24508,26077,2003,Brazil,Uruguay,3,3,FIFA World Cup qualification,Curitiba,Brazil,False,6,0,Draw
22754,24509,26078,2003,Colombia,Argentina,1,1,FIFA World Cup qualification,Barranquilla,Colombia,False,2,0,Draw
22755,24510,26079,2003,Costa Rica,Finland,2,1,Friendly,Alajuela,Costa Rica,False,3,1,Costa Rica
22756,24511,26080,2003,Ecuador,Peru,0,0,FIFA World Cup qualification,Quito,Ecuador,False,0,0,Draw
22757,24512,26081,2003,Ghana,Somalia,2,0,FIFA World Cup qualification,Kumasi,Ghana,False,2,2,Ghana
22758,24513,26082,2003,Hong Kong,Uzbekistan,0,1,AFC Asian Cup qualification,Bangkok,Thailand,True,1,-1,Uzbekistan
22759,24514,26083,2003,Hungary,Estonia,0,1,Friendly,Budapest,Hungary,False,1,-1,Estonia
22760,24515,26084,2003,Japan,Cameroon,0,0,Friendly,Ōita,Japan,False,0,0,Draw
22761,24516,26085,2003,Lebanon,Iran,0,3,AFC Asian Cup qualification,Beirut,Lebanon,False,3,-3,Iran
22762,24517,26086,2003,Mexico,Iceland,0,0,Friendly,San Francisco,United States,True,0,0,Draw
22763,24518,26087,2003,Morocco,Mali,0,1,Friendly,Casablanca,Morocco,False,1,-1,Mali
22764,24519,26088,2003,Netherlands,Scotland,6,0,UEFA Euro qualification,Amsterdam,Netherlands,False,6,6,Netherlands
22765,24520,26089,2003,Norway,Spain,0,3,UEFA Euro qualification,Oslo,Norway,False,3,-3,Spain
22766,24521,26090,2003,Portugal,Kuwait,8,0,Friendly,Leiria,Portugal,False,8,8,Portugal
22767,24522,26091,2003,Qatar,Singapore,2,0,AFC Asian Cup qualification,Doha,Qatar,False,2,2,Qatar
22768,24523,26092,2003,Slovenia,Croatia,0,1,UEFA Euro qualification,Ljubljana,Slovenia,False,1,-1,Croatia
22769,24524,26093,2003,Thailand,Tajikistan,1,0,AFC Asian Cup qualification,Bangkok,Thailand,False,1,1,Thailand
22770,24525,26094,2003,Trinidad and Tobago,Cuba,2,1,Friendly,Port of Spain,Trinidad and Tobago,False,3,1,Trinidad and Tobago
22771,24526,26095,2003,Tunisia,South Africa,2,0,Friendly,Tunis,Tunisia,False,2,2,Tunisia
22772,24527,26096,2003,Turkey,Latvia,2,2,UEFA Euro qualification,Istanbul,Turkey,False,4,0,Draw
22773,24528,26097,2003,Turkmenistan,Afghanistan,11,0,FIFA World Cup qualification,Ashgabat,Turkmenistan,False,11,11,Turkmenistan
22774,24529,26098,2003,Wales,Russia,0,1,UEFA Euro qualification,Cardiff,Wales,False,1,-1,Russia
22775,24530,26099,2003,Luxembourg,Moldova,1,2,Friendly,Hesperange,Luxembourg,False,3,-1,Moldova
22776,24531,26100,2003,Tajikistan,Hong Kong,1,0,AFC Asian Cup qualification,Bangkok,Thailand,True,1,1,Tajikistan
22777,24532,26101,2003,Thailand,Uzbekistan,4,1,AFC Asian Cup qualification,Bangkok,Thailand,False,5,3,Thailand
22778,24533,26102,2003,United Arab Emirates,Sri Lanka,3,0,AFC Asian Cup qualification,Dubai,United Arab Emirates,False,3,3,United Arab Emirates
22779,24534,26103,2003,Afghanistan,Turkmenistan,0,2,FIFA World Cup qualification,Kabul,Afghanistan,False,2,-2,Turkmenistan
22780,24535,26104,2003,Bangladesh,Tajikistan,0,2,FIFA World Cup qualification,Dhaka,Bangladesh,False,2,-2,Tajikistan
22781,24536,26105,2003,Iran,Lebanon,1,0,AFC Asian Cup qualification,Teheran,Iran,False,1,1,Iran
22782,24537,26106,2003,Syria,Turkmenistan,1,1,AFC Asian Cup qualification,Aleppo,Syria,False,2,0,Draw
22783,24538,26107,2003,Laos,Sri Lanka,0,0,FIFA World Cup qualification,Vientiane,Laos,False,0,0,Draw
22784,24540,26109,2003,Mongolia,Maldives,0,1,FIFA World Cup qualification,Ulaanbaatar,Mongolia,False,1,-1,Maldives
22785,24541,26110,2003,Pakistan,Kyrgyzstan,0,2,FIFA World Cup qualification,Karachi,Pakistan,False,2,-2,Kyrgyzstan
22786,24542,26111,2003,Singapore,Qatar,0,2,Friendly,Singapore,Singapore,False,2,-2,Qatar
22787,24544,26113,2003,Tajikistan,Bangladesh,2,0,FIFA World Cup qualification,Dushanbe,Tajikistan,False,2,2,Tajikistan
22788,24545,26114,2003,Uganda,Eritrea,2,1,CECAFA Cup,Kassala,Sudan,True,3,1,Uganda
22789,24546,26115,2003,Kenya,Eritrea,3,2,CECAFA Cup,Kassala,Sudan,True,5,1,Kenya
22790,24548,26117,2003,Kyrgyzstan,Pakistan,4,0,FIFA World Cup qualification,Bishkek,Kyrgyzstan,False,4,4,Kyrgyzstan
22791,24549,26118,2003,Maldives,Mongolia,12,0,FIFA World Cup qualification,Malé,Maldives,False,12,12,Maldives
22792,24550,26119,2003,Sri Lanka,Laos,3,0,FIFA World Cup qualification,Colombo,Sri Lanka,False,3,3,Sri Lanka
22793,24553,26122,2003,Sudan,Rwanda,3,0,CECAFA Cup,Khartoum,Sudan,False,3,3,Sudan
22794,24554,26123,2003,Uganda,Kenya,1,1,CECAFA Cup,Kassala,Sudan,True,2,0,Draw
22795,24555,26124,2003,Congo,Gabon,3,2,Friendly,Brazzaville,Congo,False,5,1,Congo
22796,24556,26126,2003,Kenya,Rwanda,1,1,CECAFA Cup,Khartoum,Sudan,True,2,0,Draw
22797,24557,26127,2003,Sudan,Uganda,0,0,CECAFA Cup,Khartoum,Sudan,False,0,0,Draw
22798,24558,26128,2003,Congo,Gabon,1,1,Friendly,Brazzaville,Congo,False,2,0,Draw
22799,24560,26131,2003,Sudan,Kenya,1,2,CECAFA Cup,Khartoum,Sudan,False,3,-1,Kenya
22800,24561,26132,2003,Uganda,Rwanda,2,0,CECAFA Cup,Khartoum,Sudan,True,2,2,Uganda
22801,24562,26133,2003,Central African Republic,Gabon,2,0,Friendly,Brazzaville,Congo,True,2,2,Central African Republic
22802,24563,26134,2003,Malta,Poland,0,4,Friendly,Attard,Malta,False,4,-4,Poland
22803,24564,26135,2003,Bahrain,Iraq,2,2,Prime Minister's Cup,Riffa,Bahrain,False,4,0,Draw
22804,24565,26136,2003,Kenya,Egypt,0,1,Prime Minister's Cup,Riffa,Bahrain,True,1,-1,Egypt
22805,24566,26137,2003,Botswana,Zimbabwe,0,2,Friendly,Selebi-Phikwe,Botswana,False,2,-2,Zimbabwe
22806,24567,26138,2003,Congo,Gabon,1,0,Friendly,Brazzaville,Congo,False,1,1,Congo
22807,24568,26139,2003,Lithuania,Poland,1,3,Friendly,Attard,Malta,True,4,-2,Poland
22808,24569,26140,2003,United Arab Emirates,Azerbaijan,3,3,Friendly,Dubai,United Arab Emirates,False,6,0,Draw
22809,24570,26141,2003,Bahrain,Egypt,0,1,Prime Minister's Cup,Riffa,Bahrain,False,1,-1,Egypt
22810,24571,26142,2003,Iraq,Kenya,2,0,Prime Minister's Cup,Riffa,Bahrain,True,2,2,Iraq
22811,24572,26143,2003,Kuwait,Lebanon,2,0,Friendly,Paphos,Cyprus,True,2,2,Kuwait
22812,24573,26144,2003,Bahrain,Kenya,2,1,Prime Minister's Cup,Riffa,Bahrain,False,3,1,Bahrain
22813,24574,26145,2003,Egypt,Iraq,2,0,Prime Minister's Cup,Riffa,Bahrain,True,2,2,Egypt
22814,24575,26146,2003,Kuwait,Lebanon,0,0,Friendly,Paphos,Cyprus,True,0,0,Draw
22815,24576,26147,2003,Latvia,Kuwait,0,2,Friendly,Paphos,Cyprus,True,2,-2,Kuwait
22816,24577,26148,2003,Oman,Estonia,3,1,Friendly,Muscat,Oman,False,4,2,Oman
22817,24578,26149,2003,Saudi Arabia,Azerbaijan,1,0,Friendly,Riyadh,Saudi Arabia,False,1,1,Saudi Arabia
22818,24579,26150,2003,Qatar,Iraq,0,0,Friendly,Doha,Qatar,False,0,0,Draw
22819,24580,26151,2003,United Arab Emirates,Kenya,2,2,Friendly,Abu Dhabi,United Arab Emirates,False,4,0,Draw
22820,24581,26152,2003,Bermuda,Barbados,1,2,Friendly,Hamilton,Bermuda,False,3,-1,Barbados
22821,24582,26153,2003,Kuwait,Oman,0,0,Gulf Cup,Kuwait City,Kuwait,False,0,0,Draw
22822,24583,26154,2003,United Arab Emirates,Saudi Arabia,0,2,Gulf Cup,Kuwait City,Kuwait,True,2,-2,Saudi Arabia
22823,24584,26155,2003,Bahamas,Haiti,0,6,Friendly,Miami,United States,True,6,-6,Haiti
22824,24585,26156,2003,Bahrain,Qatar,0,0,Gulf Cup,Kuwait City,Kuwait,True,0,0,Draw
22825,24586,26159,2003,Yemen,Oman,1,1,Gulf Cup,Kuwait City,Kuwait,True,2,0,Draw
22826,24587,26161,2003,Kuwait,United Arab Emirates,0,2,Gulf Cup,Kuwait City,Kuwait,False,2,-2,United Arab Emirates
22827,24588,26162,2003,Saudi Arabia,Qatar,0,0,Gulf Cup,Kuwait City,Kuwait,True,0,0,Draw
22828,24589,26163,2003,Bahrain,Yemen,5,1,Gulf Cup,Kuwait City,Kuwait,True,6,4,Bahrain
22829,24590,26164,2003,Oman,United Arab Emirates,2,0,Gulf Cup,Kuwait City,Kuwait,True,2,2,Oman
22830,24591,26165,2004,Bahrain,Saudi Arabia,0,1,Gulf Cup,Kuwait City,Kuwait,True,1,-1,Saudi Arabia
22831,24592,26166,2004,Bermuda,Barbados,0,4,Friendly,Hamilton,Bermuda,False,4,-4,Barbados
22832,24593,26167,2004,Kuwait,Yemen,4,0,Gulf Cup,Kuwait City,Kuwait,False,4,4,Kuwait
22833,24594,26168,2004,Oman,Bahrain,0,1,Gulf Cup,Kuwait City,Kuwait,True,1,-1,Bahrain
22834,24595,26169,2004,United Arab Emirates,Qatar,0,0,Gulf Cup,Kuwait City,Kuwait,True,0,0,Draw
22835,24596,26170,2004,Kuwait,Saudi Arabia,1,1,Gulf Cup,Kuwait City,Kuwait,False,2,0,Draw
22836,24597,26171,2004,Qatar,Yemen,3,0,Gulf Cup,Kuwait City,Kuwait,True,3,3,Qatar
22837,24598,26172,2004,Oman,Saudi Arabia,1,2,Gulf Cup,Kuwait City,Kuwait,True,3,-1,Saudi Arabia
22838,24599,26173,2004,United Arab Emirates,Bahrain,1,3,Gulf Cup,Kuwait City,Kuwait,True,4,-2,Bahrain
22839,24600,26174,2004,Cuba,Martinique,0,0,Friendly,Havana,Cuba,False,0,0,Draw
22840,24601,26175,2004,Egypt,Rwanda,5,1,Friendly,Port Said,Egypt,False,6,4,Egypt
22841,24602,26176,2004,Kuwait,Qatar,1,2,Gulf Cup,Kuwait City,Kuwait,False,3,-1,Qatar
22842,24603,26177,2004,Yemen,Saudi Arabia,0,2,Gulf Cup,Kuwait City,Kuwait,True,2,-2,Saudi Arabia
22843,24604,26178,2004,Kuwait,Bahrain,0,4,Gulf Cup,Kuwait City,Kuwait,False,4,-4,Bahrain
22844,24605,26179,2004,Mauritius,South Africa,2,0,COSAFA Cup,Curepipe,Mauritius,False,2,2,Mauritius
22845,24606,26180,2004,Suriname,Curaçao,1,1,Friendly,Paramaribo,Suriname,False,2,0,Draw
22846,24607,26181,2004,Barbados,Grenada,2,0,Friendly,Bridgetown,Barbados,False,2,2,Barbados
22847,24608,26182,2004,Oman,Qatar,2,0,Gulf Cup,Kuwait City,Kuwait,True,2,2,Oman
22848,24609,26183,2004,Yemen,United Arab Emirates,0,3,Gulf Cup,Kuwait City,Kuwait,True,3,-3,United Arab Emirates
22849,24610,26184,2004,Egypt,DR Congo,2,2,Friendly,Port Said,Egypt,False,4,0,Draw
22850,24611,26185,2004,Tunisia,Benin,2,0,Friendly,Houmet Souk,Tunisia,False,2,2,Tunisia
22851,24612,26186,2004,Algeria,Mali,0,2,Friendly,Algiers,Algeria,False,2,-2,Mali
22852,24613,26187,2004,Libya,Kenya,2,0,Friendly,Az Zawiyah,Libya,False,2,2,Libya
22853,24614,26188,2004,Curaçao,Suriname,2,0,Friendly,Willemstad,Netherlands Antilles,False,2,2,Curaçao
22854,24615,26189,2004,Egypt,Burkina Faso,1,1,Friendly,Port Said,Egypt,False,2,0,Draw
22855,24616,26190,2004,Tunisia,Benin,2,1,Friendly,Sfax,Tunisia,False,3,1,Tunisia
22856,24617,26191,2004,Barbados,Canada,0,1,Friendly,Bridgetown,Barbados,False,1,-1,Canada
22857,24618,26192,2004,Guadeloupe,Saint Lucia,2,0,Friendly,Basse-Terre,Guadeloupe,False,2,2,Guadeloupe
22858,24619,26193,2004,Senegal,South Africa,2,1,Friendly,Dakar,Senegal,False,3,1,Senegal
22859,24620,26194,2004,Libya,Kenya,2,0,Friendly,Tripoli,Libya,False,2,2,Libya
22860,24621,26195,2004,Guinea,Burkina Faso,1,0,Friendly,Toulon,France,True,1,1,Guinea
22861,24622,26196,2004,Sweden,Norway,0,3,Lunar New Year Cup,So Kon Po,Hong Kong,True,3,-3,Norway
22862,24623,26197,2004,Tunisia,Rwanda,2,1,African Cup of Nations,Radès,Tunisia,False,3,1,Tunisia
22863,24624,26198,2004,Cameroon,Algeria,1,1,African Cup of Nations,Sousse,Tunisia,True,2,0,Draw
22864,24625,26199,2004,DR Congo,Guinea,1,2,African Cup of Nations,Tunis,Tunisia,True,3,-1,Guinea
22865,24626,26200,2004,Norway,Honduras,3,1,Lunar New Year Cup,So Kon Po,Hong Kong,True,4,2,Norway
22866,24627,26201,2004,Zimbabwe,Egypt,1,2,African Cup of Nations,Sfax,Tunisia,True,3,-1,Egypt
22867,24628,26202,2004,Kenya,Mali,1,3,African Cup of Nations,Bizerte,Tunisia,True,4,-2,Mali
22868,24629,26203,2004,Senegal,Burkina Faso,0,0,African Cup of Nations,Tunis,Tunisia,True,0,0,Draw
22869,24630,26205,2004,Nigeria,Morocco,0,1,African Cup of Nations,Monastir,Tunisia,True,1,-1,Morocco
22870,24631,26206,2004,South Africa,Benin,2,0,African Cup of Nations,Sfax,Tunisia,True,2,2,South Africa
22871,24632,26208,2004,Curaçao,Aruba,6,1,Friendly,Willemstad,Netherlands Antilles,False,7,5,Curaçao
22872,24633,26209,2004,El Salvador,Panama,1,1,Friendly,San Salvador,El Salvador,False,2,0,Draw
22873,24634,26210,2004,Rwanda,Guinea,1,1,African Cup of Nations,Bizerte,Tunisia,True,2,0,Draw
22874,24635,26211,2004,Singapore,Norway,2,5,Friendly,Singapore,Singapore,False,7,-3,Norway
22875,24636,26212,2004,Tunisia,DR Congo,3,0,African Cup of Nations,Radès,Tunisia,False,3,3,Tunisia
22876,24637,26213,2004,Algeria,Egypt,2,1,African Cup of Nations,Sousse,Tunisia,True,3,1,Algeria
22877,24638,26214,2004,Cameroon,Zimbabwe,5,3,African Cup of Nations,Sfax,Tunisia,True,8,2,Cameroon
22878,24639,26217,2004,Burkina Faso,Mali,1,3,African Cup of Nations,Tunis,Tunisia,True,4,-2,Mali
22879,24640,26218,2004,Senegal,Kenya,3,0,African Cup of Nations,Bizerte,Tunisia,True,3,3,Senegal
22880,24641,26219,2004,Dominica,U.S. Virgin Islands,5,0,Friendly,Spanish Town,British Virgin Islands,True,5,5,Dominica
22881,24642,26220,2004,Grenada,Barbados,0,1,Friendly,St. George's,Grenada,False,1,-1,Barbados
22882,24643,26221,2004,Haiti,Nicaragua,1,1,Friendly,West Palm Beach,United States,True,2,0,Draw
22883,24644,26222,2004,Morocco,Benin,4,0,African Cup of Nations,Sfax,Tunisia,True,4,4,Morocco
22884,24645,26223,2004,Nigeria,South Africa,4,0,African Cup of Nations,Monastir,Tunisia,True,4,4,Nigeria
22885,24646,26225,2004,Rwanda,DR Congo,1,0,African Cup of Nations,Bizerte,Tunisia,True,1,1,Rwanda
22886,24647,26226,2004,Tunisia,Guinea,1,1,African Cup of Nations,Radès,Tunisia,False,2,0,Draw
22887,24648,26227,2004,Burkina Faso,Kenya,0,3,African Cup of Nations,Bizerte,Tunisia,True,3,-3,Kenya
22888,24649,26228,2004,Senegal,Mali,1,1,African Cup of Nations,Tunis,Tunisia,True,2,0,Draw
22889,24650,26229,2004,Algeria,Zimbabwe,1,2,African Cup of Nations,Sousse,Tunisia,True,3,-1,Zimbabwe
22890,24651,26230,2004,Cameroon,Egypt,0,0,African Cup of Nations,Monastir,Tunisia,True,0,0,Draw
22891,24652,26232,2004,Morocco,South Africa,1,1,African Cup of Nations,Sousse,Tunisia,True,2,0,Draw
22892,24653,26233,2004,Nigeria,Benin,2,1,African Cup of Nations,Sfax,Tunisia,True,3,1,Nigeria
22893,24654,26235,2004,Japan,Malaysia,4,0,Friendly,Kashima,Japan,False,4,4,Japan
22894,24655,26236,2004,Mali,Guinea,2,1,African Cup of Nations,Tunis,Tunisia,True,3,1,Mali
22895,24656,26237,2004,Tunisia,Senegal,1,0,African Cup of Nations,Radès,Tunisia,False,1,1,Tunisia
22896,24657,26238,2004,Cameroon,Nigeria,1,2,African Cup of Nations,Monastir,Tunisia,True,3,-1,Nigeria
22897,24658,26239,2004,Lebanon,Bahrain,2,1,Friendly,Beirut,Lebanon,False,3,1,Lebanon
22898,24659,26240,2004,Morocco,Algeria,3,1,African Cup of Nations,Sfax,Tunisia,True,4,2,Morocco
22899,24660,26241,2004,Saint Lucia,Saint Vincent and the Grenadines,1,2,Friendly,Castries,Saint Lucia,False,3,-1,Saint Vincent and the Grenadines
22900,24661,26242,2004,Bermuda,Trinidad and Tobago,0,1,Friendly,Hamilton,Bermuda,False,1,-1,Trinidad and Tobago
22901,24662,26243,2004,Morocco,Mali,4,0,African Cup of Nations,Sousse,Tunisia,True,4,4,Morocco
22902,24663,26244,2004,Tunisia,Nigeria,1,1,African Cup of Nations,Radès,Tunisia,False,2,0,Draw
22903,24664,26245,2004,Bermuda,Trinidad and Tobago,2,2,Friendly,Hamilton,Bermuda,False,4,0,Draw
22904,24665,26246,2004,Japan,Iraq,2,0,Friendly,Tokyo,Japan,False,2,2,Japan
22905,24666,26247,2004,Jordan,Indonesia,2,1,Friendly,Amman,Jordan,False,3,1,Jordan
22906,24667,26248,2004,Nigeria,Mali,2,1,African Cup of Nations,Monastir,Tunisia,True,3,1,Nigeria
22907,24668,26249,2004,Qatar,Bahrain,2,0,Friendly,Doha,Qatar,False,2,2,Qatar
22908,24669,26251,2004,Malta,Moldova,0,0,Malta International Tournament,Attard,Malta,False,0,0,Draw
22909,24670,26252,2004,Tunisia,Morocco,2,1,African Cup of Nations,Radès,Tunisia,False,3,1,Tunisia
22910,24671,26253,2004,Barbados,Guyana,0,2,Friendly,Bridgetown,Barbados,False,2,-2,Guyana
22911,24672,26254,2004,Malta,Estonia,5,2,Malta International Tournament,Attard,Malta,False,7,3,Malta
22912,24673,26255,2004,Albania,Sweden,2,1,Friendly,Tirana,Albania,False,3,1,Albania
22913,24674,26256,2004,Antigua and Barbuda,Curaçao,2,0,FIFA World Cup qualification,St. John's,Antigua and Barbuda,False,2,2,Antigua and Barbuda
22914,24675,26257,2004,Bahrain,Syria,2,1,FIFA World Cup qualification,Muharraq,Bahrain,False,3,1,Bahrain
22915,24676,26258,2004,Belgium,France,0,2,Friendly,Brussels,Belgium,False,2,-2,France
22916,24677,26260,2004,Croatia,Germany,1,2,Friendly,Split,Croatia,False,3,-1,Germany
22917,24678,26261,2004,Cyprus,Belarus,0,2,Cyprus International Tournament,Achna,Cyprus,False,2,-2,Belarus
22918,24679,26262,2004,Estonia,Moldova,1,0,Malta International Tournament,Attard,Malta,True,1,1,Estonia
22919,24680,26263,2004,Greece,Bulgaria,2,0,Friendly,Athens,Greece,False,2,2,Greece
22920,24681,26264,2004,Haiti,Turks and Caicos Islands,5,0,FIFA World Cup qualification,Miami,United States,True,5,5,Haiti
22921,24682,26265,2004,Honduras,Colombia,1,1,Friendly,Tegucigalpa,Honduras,False,2,0,Draw
22922,24683,26266,2004,Hungary,Armenia,2,0,Cyprus International Tournament,Paphos,Cyprus,True,2,2,Hungary
22923,24684,26267,2004,India,Singapore,1,0,FIFA World Cup qualification,Margao,India,False,1,1,India
22924,24685,26268,2004,Iran,Qatar,3,1,FIFA World Cup qualification,Teheran,Iran,False,4,2,Iran
22925,24686,26269,2004,Republic of Ireland,Brazil,0,0,Friendly,Dublin,Republic of Ireland,False,0,0,Draw
22926,24687,26270,2004,Italy,Czech Republic,2,2,Friendly,Palermo,Italy,False,4,0,Draw
22927,24688,26271,2004,Jamaica,Uruguay,2,0,Friendly,Kingston,Jamaica,False,2,2,Jamaica
22928,24689,26272,2004,Japan,Oman,1,0,FIFA World Cup qualification,Saitama,Japan,False,1,1,Japan
22929,24690,26273,2004,Jordan,Laos,5,0,FIFA World Cup qualification,Amman,Jordan,False,5,5,Jordan
22930,24691,26275,2004,Kyrgyzstan,Tajikistan,1,2,FIFA World Cup qualification,Bishkek,Kyrgyzstan,False,3,-1,Tajikistan
22931,24692,26276,2004,Latvia,Kazakhstan,3,1,Cyprus International Tournament,Larnaca,Cyprus,True,4,2,Latvia
22932,24693,26277,2004,Libya,Ukraine,1,1,Friendly,Tripoli,Libya,False,2,0,Draw
22933,24694,26279,2004,Malaysia,Hong Kong,1,3,FIFA World Cup qualification,Kuantan,Malaysia,False,4,-2,Hong Kong
22934,24695,26280,2004,Mexico,Chile,1,1,Friendly,Carson,United States,True,2,0,Draw
22935,24696,26281,2004,Morocco,Switzerland,2,1,Friendly,Rabat,Morocco,False,3,1,Morocco
22936,24697,26282,2004,Netherlands,United States,1,0,Friendly,Amsterdam,Netherlands,False,1,1,Netherlands
22937,24698,26283,2004,Northern Ireland,Norway,1,4,Friendly,Belfast,Northern Ireland,False,5,-3,Norway
22938,24700,26285,2004,Poland,Slovenia,2,0,Friendly,San Fernando,Spain,True,2,2,Poland
22939,24701,26286,2004,Portugal,England,1,1,Friendly,Faro,Portugal,False,2,0,Draw
22940,24702,26287,2004,Romania,Georgia,3,0,Cyprus International Tournament,Larnaca,Cyprus,True,3,3,Romania
22941,24703,26288,2004,Saudi Arabia,Indonesia,3,0,FIFA World Cup qualification,Riyadh,Saudi Arabia,False,3,3,Saudi Arabia
22942,24704,26289,2004,Spain,Peru,2,1,Friendly,Barcelona,Spain,False,3,1,Spain
22943,24705,26290,2004,Turkmenistan,Sri Lanka,2,0,FIFA World Cup qualification,Ashgabat,Turkmenistan,False,2,2,Turkmenistan
22944,24706,26291,2004,United Arab Emirates,Thailand,1,0,FIFA World Cup qualification,Al Ain,United Arab Emirates,False,1,1,United Arab Emirates
22945,24707,26292,2004,Uzbekistan,Iraq,1,1,FIFA World Cup qualification,Tashkent,Uzbekistan,False,2,0,Draw
22946,24708,26293,2004,Venezuela,Australia,1,1,Friendly,Caracas,Venezuela,False,2,0,Draw
22947,24709,26294,2004,Vietnam,Maldives,4,0,FIFA World Cup qualification,Hanoi,Vietnam,False,4,4,Vietnam
22948,24710,26295,2004,U.S. Virgin Islands,Saint Kitts and Nevis,0,4,FIFA World Cup qualification,Charlotte Amalie,U.S. Virgin Islands,False,4,-4,Saint Kitts and Nevis
22949,24711,26296,2004,Wales,Scotland,4,0,Friendly,Cardiff,Wales,False,4,4,Wales
22950,24713,26298,2004,Cyprus,Georgia,3,1,Cyprus International Tournament,Nicosia,Cyprus,False,4,2,Cyprus
22951,24714,26299,2004,Kazakhstan,Armenia,3,3,Cyprus International Tournament,Paphos,Cyprus,True,6,0,Draw
22952,24715,26300,2004,Latvia,Hungary,1,2,Cyprus International Tournament,Limassol,Cyprus,True,3,-1,Hungary
22953,24716,26301,2004,Belarus,Latvia,4,1,Cyprus International Tournament,Larnaca,Cyprus,True,5,3,Belarus
22954,24717,26302,2004,Cyprus,Kazakhstan,2,1,Cyprus International Tournament,Limassol,Cyprus,False,3,1,Cyprus
22955,24718,26303,2004,Georgia,Armenia,0,2,Cyprus International Tournament,Nicosia,Cyprus,True,2,-2,Armenia
22956,24719,26304,2004,Poland,Faroe Islands,6,0,Friendly,San Fernando,Spain,True,6,6,Poland
22957,24720,26305,2004,Turks and Caicos Islands,Haiti,0,2,FIFA World Cup qualification,Hialeah,United States,True,2,-2,Haiti
22958,24721,26307,2004,Cayman Islands,Cuba,1,2,FIFA World Cup qualification,George Town,Cayman Islands,False,3,-1,Cuba
22959,24722,26308,2004,Faroe Islands,Luxembourg,4,2,Friendly,San Fernando,Spain,True,6,2,Faroe Islands
22960,24723,26309,2004,Aruba,Suriname,1,2,FIFA World Cup qualification,Oranjestad,Aruba,False,3,-1,Suriname
22961,24724,26310,2004,Grenada,Guyana,5,0,FIFA World Cup qualification,St. George's,Grenada,False,5,5,Grenada
22962,24725,26311,2004,Lesotho,Botswana,0,0,COSAFA Cup,Maseru,Lesotho,False,0,0,Draw
22963,24726,26312,2004,Bermuda,Montserrat,13,0,FIFA World Cup qualification,Hamilton,Bermuda,False,13,13,Bermuda
22964,24727,26313,2004,Nicaragua,Haiti,1,1,Friendly,Estelí,Nicaragua,False,2,0,Draw
22965,24728,26314,2004,Trinidad and Tobago,Guyana,1,0,Friendly,Macoya,Trinidad and Tobago,False,1,1,Trinidad and Tobago
22966,24729,26315,2004,Mexico,Ecuador,2,1,Friendly,Tuxtla Gutiérrez,Mexico,False,3,1,Mexico
22967,24730,26316,2004,Venezuela,Honduras,2,1,Friendly,Maracaibo,Venezuela,False,3,1,Venezuela
22968,24731,26317,2004,Barbados,Dominica,2,1,Friendly,Bridgetown,Barbados,False,3,1,Barbados
22969,24732,26318,2004,United States,Haiti,1,1,Friendly,Miami,United States,False,2,0,Draw
22970,24733,26319,2004,Guyana,Grenada,1,3,FIFA World Cup qualification,Blairmont,Guyana,False,4,-2,Grenada
22971,24734,26320,2004,Cuba,Panama,1,1,Friendly,Havana,Cuba,False,2,0,Draw
22972,24735,26322,2004,Malaysia,Indonesia,0,0,Friendly,Johor Baharu,Malaysia,False,0,0,Draw
22973,24736,26323,2004,Yemen,Turkmenistan,1,2,Friendly,Sana'a,Yemen,False,3,-1,Turkmenistan
22974,24737,26324,2004,Cuba,Panama,3,0,Friendly,Havana,Cuba,False,3,3,Cuba
22975,24738,26325,2004,Dominican Republic,Anguilla,0,0,FIFA World Cup qualification,Santo Domingo,Dominican Republic,False,0,0,Draw
22976,24740,26327,2004,Bahrain,Jordan,0,0,Friendly,Muharraq,Bahrain,False,0,0,Draw
22977,24741,26328,2004,Dominican Republic,Anguilla,6,0,FIFA World Cup qualification,Santo Domingo,Dominican Republic,False,6,6,Dominican Republic
22978,24742,26329,2004,Montserrat,Bermuda,0,7,FIFA World Cup qualification,Lookout,Montserrat,False,7,-7,Bermuda
22979,24743,26330,2004,Saint Kitts and Nevis,Antigua and Barbuda,2,3,Friendly,Basseterre,Saint Kitts and Nevis,False,5,-1,Antigua and Barbuda
22980,24744,26331,2004,Saint Vincent and the Grenadines,Saint Lucia,1,1,Friendly,Kingstown,Saint Vincent and the Grenadines,False,2,0,Draw
22981,24745,26332,2004,Bahrain,Jordan,0,2,Friendly,Muharraq,Bahrain,False,2,-2,Jordan
22982,24746,26333,2004,Lebanon,Syria,0,1,Friendly,Jounieh,Lebanon,False,1,-1,Syria
22983,24747,26334,2004,Bahamas,Dominica,1,1,FIFA World Cup qualification,Nassau,Bahamas,False,2,0,Draw
22984,24748,26335,2004,Libya,Qatar,1,0,Friendly,Rome,Italy,True,1,1,Libya
22985,24749,26336,2004,Syria,Palestine,1,1,Friendly,Damascus,Syria,False,2,0,Draw
22986,24750,26337,2004,Cuba,Cayman Islands,3,0,FIFA World Cup qualification,Havana,Cuba,False,3,3,Cuba
22987,24751,26338,2004,Suriname,Aruba,8,1,FIFA World Cup qualification,Paramaribo,Suriname,False,9,7,Suriname
22988,24752,26339,2004,Bahamas,Dominica,1,3,FIFA World Cup qualification,Nassau,Bahamas,False,4,-2,Dominica
22989,24754,26341,2004,Argentina,Ecuador,1,0,FIFA World Cup qualification,Buenos Aires,Argentina,False,1,1,Argentina
22990,24755,26342,2004,Australia,South Africa,1,0,Friendly,London,England,True,1,1,Australia
22991,24756,26343,2004,Bolivia,Chile,0,2,FIFA World Cup qualification,La Paz,Bolivia,False,2,-2,Chile
22992,24757,26344,2004,Israel,Lithuania,2,1,Friendly,Ramat-Gan,Israel,False,3,1,Israel
22993,24758,26345,2004,Albania,Iceland,2,1,Friendly,Tirana,Albania,False,3,1,Albania
22994,24759,26346,2004,Bermuda,Nicaragua,3,0,Friendly,Hamilton,Bermuda,False,3,3,Bermuda
22995,24760,26347,2004,Bulgaria,Russia,2,2,Friendly,Sofia,Bulgaria,False,4,0,Draw
22996,24761,26348,2004,Croatia,Turkey,2,2,Friendly,Zagreb,Croatia,False,4,0,Draw
22997,24762,26349,2004,Curaçao,Antigua and Barbuda,3,0,FIFA World Cup qualification,Willemstad,Netherlands Antilles,True,3,3,Curaçao
22998,24763,26350,2004,Egypt,Trinidad and Tobago,2,1,Friendly,Cairo,Egypt,False,3,1,Egypt
22999,24764,26351,2004,El Salvador,Guatemala,0,3,Friendly,San Salvador,El Salvador,False,3,-3,Guatemala
23000,24765,26352,2004,Germany,Belgium,3,0,Friendly,Cologne,Germany,False,3,3,Germany
23001,24766,26353,2004,Greece,Switzerland,1,0,Friendly,Heraklion,Greece,False,1,1,Greece
23002,24768,26355,2004,India,Oman,1,5,FIFA World Cup qualification,Cochin,India,False,6,-4,Oman
23003,24769,26356,2004,Republic of Ireland,Czech Republic,2,1,Friendly,Dublin,Republic of Ireland,False,3,1,Republic of Ireland
23004,24770,26357,2004,Jamaica,Honduras,2,2,Friendly,Kingston,Jamaica,False,4,0,Draw
23005,24771,26358,2004,Jordan,Qatar,1,0,FIFA World Cup qualification,Amman,Jordan,False,1,1,Jordan
23006,24772,26360,2004,Kyrgyzstan,Syria,1,1,FIFA World Cup qualification,Bishkek,Kyrgyzstan,False,2,0,Draw
23007,24773,26361,2004,Laos,Iran,0,7,FIFA World Cup qualification,Vientiane,Laos,False,7,-7,Iran
23008,24774,26362,2004,Luxembourg,Bosnia and Herzegovina,1,2,Friendly,Luxembourg,Luxembourg,False,3,-1,Bosnia and Herzegovina
23009,24775,26364,2004,Malaysia,Kuwait,0,2,FIFA World Cup qualification,Kuantan,Malaysia,False,2,-2,Kuwait
23010,24777,26366,2004,Malta,Finland,1,2,Friendly,Attard,Malta,False,3,-1,Finland
23011,24778,26367,2004,Mexico,Costa Rica,2,0,Friendly,Carson,United States,True,2,2,Mexico
23012,24779,26368,2004,Moldova,Azerbaijan,2,1,Friendly,Chişinău,Moldova,False,3,1,Moldova
23013,24780,26369,2004,Morocco,Angola,3,1,Friendly,Casablanca,Morocco,False,4,2,Morocco
23014,24781,26370,2004,Netherlands,France,0,0,Friendly,Rotterdam,Netherlands,False,0,0,Draw
23015,24782,26371,2004,Palestine,Iraq,1,1,FIFA World Cup qualification,al-Wakrah,Qatar,True,2,0,Draw
23016,24783,26372,2004,Paraguay,Brazil,0,0,FIFA World Cup qualification,Asunción,Paraguay,False,0,0,Draw
23017,24784,26373,2004,Peru,Colombia,0,2,FIFA World Cup qualification,Lima,Peru,False,2,-2,Colombia
23018,24785,26374,2004,Poland,United States,0,1,Friendly,Płock,Poland,False,1,-1,United States
23019,24786,26375,2004,Portugal,Italy,1,2,Friendly,Braga,Portugal,False,3,-1,Italy
23020,24787,26376,2004,Scotland,Romania,1,2,Friendly,Glasgow,Scotland,False,3,-1,Romania
23021,24788,26377,2004,Serbia,Norway,0,1,Friendly,Belgrade,Serbia and Montenegro,False,1,-1,Norway
23022,24789,26378,2004,Singapore,Japan,1,2,FIFA World Cup qualification,Singapore,Singapore,False,3,-1,Japan
23023,24790,26379,2004,Slovakia,Austria,1,1,Friendly,Bratislava,Slovakia,False,2,0,Draw
23024,24791,26380,2004,Slovenia,Latvia,0,1,Friendly,Celje,Slovenia,False,1,-1,Latvia
23025,24792,26381,2004,Spain,Denmark,2,0,Friendly,Gijón,Spain,False,2,2,Spain
23026,24793,26382,2004,Sri Lanka,Saudi Arabia,0,1,FIFA World Cup qualification,Colombo,Sri Lanka,False,1,-1,Saudi Arabia
23027,24794,26383,2004,Saint Kitts and Nevis,U.S. Virgin Islands,7,0,FIFA World Cup qualification,Basseterre,Saint Kitts and Nevis,False,7,7,Saint Kitts and Nevis
23028,24795,26384,2004,Sweden,England,1,0,Friendly,Gothenburg,Sweden,False,1,1,Sweden
23029,24796,26385,2004,Tajikistan,Bahrain,0,0,FIFA World Cup qualification,Dushanbe,Tajikistan,False,0,0,Draw
23030,24797,26386,2004,Tunisia,Ivory Coast,0,2,Friendly,Tunis,Tunisia,False,2,-2,Ivory Coast
23031,24798,26387,2004,Turkmenistan,Indonesia,3,1,FIFA World Cup qualification,Ashgabat,Turkmenistan,False,4,2,Turkmenistan
23032,24799,26388,2004,Uruguay,Venezuela,0,3,FIFA World Cup qualification,Montevideo,Uruguay,False,3,-3,Venezuela
23033,24800,26389,2004,Vietnam,Lebanon,0,2,FIFA World Cup qualification,Nam Định,Vietnam,False,2,-2,Lebanon
23034,24801,26390,2004,Yemen,Thailand,0,3,FIFA World Cup qualification,Sana'a,Yemen,False,3,-3,Thailand
23035,24802,26391,2004,Bermuda,Nicaragua,2,1,Friendly,Hamilton,Bermuda,False,3,1,Bermuda
23036,24803,26392,2004,Vanuatu,Solomon Islands,1,2,Friendly,Port Vila,Vanuatu,False,3,-1,Solomon Islands
23037,24804,26393,2004,Vanuatu,Solomon Islands,1,2,Friendly,Port Vila,Vanuatu,False,3,-1,Solomon Islands
23038,24805,26394,2004,Honduras,Panama,0,0,Friendly,La Ceiba,Honduras,False,0,0,Draw
23039,24806,26395,2004,Mozambique,Eswatini,2,0,Friendly,Maputo,Mozambique,False,2,2,Mozambique
23040,24808,26397,2004,Mozambique,Madagascar,2,0,COSAFA Cup,Maputo,Mozambique,False,2,2,Mozambique
23041,24809,26398,2004,Sudan,Syria,1,2,Friendly,Khartoum,Sudan,False,3,-1,Syria
23042,24810,26399,2004,Sudan,Syria,0,0,Friendly,Khartoum,Sudan,False,0,0,Draw
23043,24811,26400,2004,Hungary,Japan,3,2,Friendly,Zalaegerszeg,Hungary,False,5,1,Hungary
23044,24812,26401,2004,Curaçao,Dominican Republic,3,1,Friendly,Willemstad,Netherlands Antilles,False,4,2,Curaçao
23045,24814,26403,2004,Armenia,Turkmenistan,1,0,Friendly,Yerevan,Armenia,False,1,1,Armenia
23046,24815,26404,2004,Austria,Luxembourg,4,1,Friendly,Innsbruck,Austria,False,5,3,Austria
23047,24816,26405,2004,Belarus,Lithuania,1,0,Friendly,Minsk,Belarus,False,1,1,Belarus
23048,24817,26406,2004,Belgium,Turkey,2,3,Friendly,Brussels,Belgium,False,5,-1,Turkey
23049,24818,26407,2004,Bosnia and Herzegovina,Finland,1,0,Friendly,Zenica,Bosnia and Herzegovina,False,1,1,Bosnia and Herzegovina
23050,24819,26408,2004,Bulgaria,Cameroon,3,0,Friendly,Sofia,Bulgaria,False,3,3,Bulgaria
23051,24820,26409,2004,Chile,Peru,1,1,Friendly,Antofagasta,Chile,False,2,0,Draw
23052,24821,26410,2004,Czech Republic,Japan,0,1,Friendly,Prague,Czech Republic,False,1,-1,Japan
23053,24822,26411,2004,Denmark,Scotland,1,0,Friendly,Copenhagen,Denmark,False,1,1,Denmark
23054,24823,26412,2004,El Salvador,Colombia,0,2,Friendly,Washington,United States,True,2,-2,Colombia
23055,24824,26413,2004,Estonia,Albania,1,1,Friendly,Tallinn,Estonia,False,2,0,Draw
23056,24825,26414,2004,Ghana,Angola,1,1,Friendly,Accra,Ghana,False,2,0,Draw
23057,24826,26415,2004,Honduras,Ecuador,1,1,Friendly,Fort Lauderdale,United States,True,2,0,Draw
23058,24827,26416,2004,Hungary,Brazil,1,4,Friendly,Budapest,Hungary,False,5,-3,Brazil
23059,24828,26417,2004,Israel,Moldova,1,1,Friendly,Ramat-Gan,Israel,False,2,0,Draw
23060,24829,26418,2004,Italy,Spain,1,1,Friendly,Genoa,Italy,False,2,0,Draw
23061,24830,26419,2004,Ivory Coast,Guinea,4,2,Friendly,Chambéry,France,True,6,2,Ivory Coast
23062,24831,26420,2004,Jamaica,Venezuela,2,1,Friendly,Kingston,Jamaica,False,3,1,Jamaica
23063,24832,26421,2004,Kazakhstan,Azerbaijan,2,3,Friendly,Almaty,Kazakhstan,False,5,-1,Azerbaijan
23064,24833,26423,2004,Latvia,Iceland,0,0,Friendly,Riga,Latvia,False,0,0,Draw
23065,24834,26425,2004,Morocco,Argentina,0,1,Friendly,Casablanca,Morocco,False,1,-1,Argentina
23066,24835,26426,2004,Namibia,Botswana,0,0,Friendly,Windhoek,Namibia,False,0,0,Draw
23067,24836,26427,2004,Netherlands,Greece,4,0,Friendly,Eindhoven,Netherlands,False,4,4,Netherlands
23068,24837,26428,2004,Northern Ireland,Serbia,1,1,Friendly,Belfast,Northern Ireland,False,2,0,Draw
23069,24838,26429,2004,Norway,Russia,3,2,Friendly,Oslo,Norway,False,5,1,Norway
23070,24839,26430,2004,Panama,Bermuda,4,1,Friendly,Panama City,Panama,False,5,3,Panama
23071,24840,26431,2004,Poland,Republic of Ireland,0,0,Friendly,Bydgoszcz,Poland,False,0,0,Draw
23072,24841,26432,2004,Portugal,Sweden,2,2,Friendly,Coimbra,Portugal,False,4,0,Draw
23073,24842,26433,2004,Romania,Germany,5,1,Friendly,Bucharest,Romania,False,6,4,Romania
23074,24843,26434,2004,San Marino,Liechtenstein,1,0,Friendly,Serravalle,San Marino,False,1,1,San Marino
23075,24844,26435,2004,Switzerland,Slovenia,2,1,Friendly,Geneva,Switzerland,False,3,1,Switzerland
23076,24845,26436,2004,Tunisia,Mali,1,0,Friendly,Sfax,Tunisia,False,1,1,Tunisia
23077,24846,26437,2004,Ukraine,Slovakia,1,1,Friendly,Kyïv,Ukraine,False,2,0,Draw
23078,24847,26438,2004,United States,Mexico,1,0,Friendly,Dallas,United States,False,1,1,United States
23079,24848,26439,2004,Libya,Jordan,1,0,Friendly,Lagos,Nigeria,True,1,1,Libya
23080,24849,26440,2004,Nicaragua,Bermuda,2,0,Friendly,Diriamba,Nicaragua,False,2,2,Nicaragua
23081,24850,26441,2004,Guatemala,Panama,1,2,Friendly,Guatemala,Guatemala,False,3,-1,Panama
23082,24851,26442,2004,Zambia,Zimbabwe,1,1,Friendly,Lusaka,Zambia,False,2,0,Draw
23083,24852,26443,2004,Nicaragua,Bermuda,2,0,Friendly,Estelí,Nicaragua,False,2,2,Nicaragua
23084,24853,26444,2004,Jersey,Guernsey,3,0,Friendly,St. Helier,Jersey,False,3,3,Jersey
23085,24854,26445,2004,Cook Islands,Samoa,0,0,Friendly,Auckland,New Zealand,True,0,0,Draw
23086,24855,26446,2004,Guatemala,Haiti,1,0,Friendly,Guatemala,Guatemala,False,1,1,Guatemala
23087,24856,26447,2004,Grenada,Saint Vincent and the Grenadines,1,1,Friendly,St. George's,Grenada,False,2,0,Draw
23088,24857,26448,2004,Angola,Namibia,2,1,COSAFA Cup,Luanda,Angola,False,3,1,Angola
23089,24858,26449,2004,Papua New Guinea,Vanuatu,1,1,FIFA World Cup qualification,Apia,Samoa,True,2,0,Draw
23090,24859,26450,2004,Samoa,American Samoa,4,0,FIFA World Cup qualification,Apia,Samoa,False,4,4,Samoa
23091,24860,26451,2004,Solomon Islands,Tonga,6,0,FIFA World Cup qualification,Honiara,Solomon Islands,False,6,6,Solomon Islands
23092,24861,26453,2004,American Samoa,Vanuatu,1,9,FIFA World Cup qualification,Apia,Samoa,True,10,-8,Vanuatu
23093,24862,26454,2004,El Salvador,Haiti,3,3,Friendly,Houston,United States,True,6,0,Draw
23094,24863,26455,2004,Fiji,Papua New Guinea,4,2,FIFA World Cup qualification,Apia,Samoa,True,6,2,Fiji
23095,24864,26456,2004,Solomon Islands,Cook Islands,5,0,FIFA World Cup qualification,Honiara,Solomon Islands,False,5,5,Solomon Islands
23096,24865,26458,2004,Fiji,American Samoa,11,0,FIFA World Cup qualification,Apia,Samoa,True,11,11,Fiji
23097,24866,26459,2004,Samoa,Vanuatu,0,3,FIFA World Cup qualification,Apia,Samoa,False,3,-3,Vanuatu
23098,24867,26460,2004,Solomon Islands,New Caledonia,2,0,FIFA World Cup qualification,Honiara,Solomon Islands,False,2,2,Solomon Islands
23099,24868,26461,2004,Tonga,Cook Islands,2,1,FIFA World Cup qualification,Honiara,Solomon Islands,True,3,1,Tonga
23100,24869,26462,2004,Zimbabwe,Zambia,0,0,Friendly,Harare,Zimbabwe,False,0,0,Draw
23101,24870,26463,2004,American Samoa,Papua New Guinea,0,10,FIFA World Cup qualification,Apia,Samoa,True,10,-10,Papua New Guinea
23102,24871,26464,2004,New Caledonia,Cook Islands,8,0,FIFA World Cup qualification,Honiara,Solomon Islands,True,8,8,New Caledonia
23103,24872,26465,2004,Samoa,Fiji,0,4,FIFA World Cup qualification,Apia,Samoa,False,4,-4,Fiji
23104,24873,26467,2004,Cyprus,Jordan,0,0,Friendly,Nicosia,Cyprus,False,0,0,Draw
23105,24874,26468,2004,Fiji,Vanuatu,0,3,FIFA World Cup qualification,Apia,Samoa,True,3,-3,Vanuatu
23106,24875,26469,2004,New Caledonia,Tonga,8,0,FIFA World Cup qualification,Honiara,Solomon Islands,True,8,8,New Caledonia
23107,24876,26470,2004,Samoa,Papua New Guinea,1,4,FIFA World Cup qualification,Apia,Samoa,False,5,-3,Papua New Guinea
23108,24878,26472,2004,Benin,Togo,0,1,Friendly,Cotonou,Benin,False,1,-1,Togo
23109,24879,26473,2004,Cuba,Grenada,2,2,Friendly,Havana,Cuba,False,4,0,Draw
23110,24880,26474,2004,France,Brazil,0,0,Friendly,Saint-Denis,France,False,0,0,Draw
23111,24881,26475,2004,Australia,Turkey,1,3,Friendly,Sydney,Australia,False,4,-2,Turkey
23112,24882,26476,2004,Sudan,Uganda,2,1,Friendly,Khartoum,Sudan,False,3,1,Sudan
23113,24883,26477,2004,Zambia,Malawi,0,2,Friendly,Kitwe,Zambia,False,2,-2,Malawi
23114,24884,26478,2004,DR Congo,Angola,1,3,Friendly,Kinshasa,DR Congo,False,4,-2,Angola
23115,24885,26479,2004,Saint Kitts and Nevis,Saint Vincent and the Grenadines,3,2,Friendly,Basseterre,Saint Kitts and Nevis,False,5,1,Saint Kitts and Nevis
23116,24886,26480,2004,Togo,Benin,1,1,Friendly,Lomé,Togo,False,2,0,Draw
23117,24887,26481,2004,Trinidad and Tobago,Iraq,2,0,Friendly,West Bromwich,England,True,2,2,Trinidad and Tobago
23118,24888,26482,2004,Australia,Turkey,0,1,Friendly,Melbourne,Australia,False,1,-1,Turkey
23119,24889,26483,2004,Egypt,Zimbabwe,2,0,Friendly,Cairo,Egypt,False,2,2,Egypt
23120,24890,26484,2004,Austria,Russia,0,0,Friendly,Graz,Austria,False,0,0,Draw
23121,24891,26485,2004,Sudan,Zambia,0,2,Friendly,Khartoum,Sudan,False,2,-2,Zambia
23122,24892,26487,2004,Benin,Burkina Faso,1,0,Friendly,Cotonou,Benin,False,1,1,Benin
23123,24893,26488,2004,Lebanon,Bahrain,2,2,Friendly,Beirut,Lebanon,False,4,0,Draw
23124,24894,26489,2004,Mozambique,Botswana,0,0,Friendly,Maputo,Mozambique,False,0,0,Draw
23125,24895,26490,2004,Estonia,Scotland,0,1,Friendly,Tallinn,Estonia,False,1,-1,Scotland
23126,24896,26491,2004,Georgia,Israel,0,1,Friendly,Tbilisi,Georgia,False,1,-1,Israel
23127,24897,26492,2004,Germany,Malta,7,0,Friendly,Freiburg,Germany,False,7,7,Germany
23128,24898,26493,2004,Republic of Ireland,Romania,1,0,Friendly,Dublin,Republic of Ireland,False,1,1,Republic of Ireland
23129,24899,26494,2004,Norway,Wales,0,0,Friendly,Oslo,Norway,False,0,0,Draw
23130,24900,26495,2004,Azerbaijan,Uzbekistan,3,1,Friendly,Baku,Azerbaijan,False,4,2,Azerbaijan
23131,24901,26496,2004,Finland,Sweden,1,3,Friendly,Tampere,Finland,False,4,-2,Sweden
23132,24902,26497,2004,France,Andorra,4,0,Friendly,Montpellier,France,False,4,4,France
23133,24903,26498,2004,Mali,Morocco,0,0,Friendly,Bamako,Mali,False,0,0,Draw
23134,24904,26499,2004,Rwanda,Uganda,1,1,Friendly,Kigali,Rwanda,False,2,0,Draw
23135,24905,26500,2004,Australia,New Zealand,1,0,FIFA World Cup qualification,Adelaide,Australia,False,1,1,Australia
23136,24906,26501,2004,Croatia,Slovakia,1,0,Friendly,Rijeka,Croatia,False,1,1,Croatia
23137,24907,26502,2004,Egypt,Gabon,2,0,Friendly,Cairo,Egypt,False,2,2,Egypt
23138,24908,26503,2004,Republic of Ireland,Nigeria,0,3,Friendly,London,England,True,3,-3,Nigeria
23139,24909,26504,2004,Netherlands,Belgium,0,1,Friendly,Eindhoven,Netherlands,False,1,-1,Belgium
23140,24910,26505,2004,Poland,Greece,1,0,Friendly,Szczecin,Poland,False,1,1,Poland
23141,24911,26506,2004,Portugal,Luxembourg,3,0,Friendly,Águeda,Portugal,False,3,3,Portugal
23142,24912,26507,2004,Senegal,Guinea,1,1,Friendly,Paris,France,True,2,0,Draw
23143,24913,26509,2004,Vanuatu,Solomon Islands,0,1,FIFA World Cup qualification,Adelaide,Australia,True,1,-1,Solomon Islands
23144,24914,26510,2004,Algeria,Jordan,1,1,Friendly,Annaba,Algeria,False,2,0,Draw
23145,24915,26511,2004,Barbados,Northern Ireland,1,1,Friendly,Bridgetown,Barbados,False,2,0,Draw
23146,24916,26512,2004,Burkina Faso,Libya,3,2,Friendly,Ouagadougou,Burkina Faso,False,5,1,Burkina Faso
23147,24917,26513,2004,Estonia,Denmark,2,2,Friendly,Tallinn,Estonia,False,4,0,Draw
23148,24918,26514,2004,Iceland,Japan,2,3,Friendly,Manchester,England,True,5,-1,Japan
23149,24919,26515,2004,Scotland,Trinidad and Tobago,4,1,Friendly,Edinburgh,Scotland,False,5,3,Scotland
23150,24920,26516,2004,Saint Vincent and the Grenadines,Martinique,2,0,Friendly,Kingstown,Saint Vincent and the Grenadines,False,2,2,Saint Vincent and the Grenadines
23151,24921,26517,2004,Tunisia,Italy,0,4,Friendly,Radès,Tunisia,False,4,-4,Italy
23152,24922,26518,2004,Wales,Canada,1,0,Friendly,Wrexham,Wales,False,1,1,Wales
23153,24924,26520,2004,Fiji,Vanuatu,1,0,FIFA World Cup qualification,Adelaide,Australia,True,1,1,Fiji
23154,24925,26521,2004,Mozambique,Eswatini,1,1,Friendly,Maputo,Mozambique,False,2,0,Draw
23155,24926,26522,2004,New Zealand,Solomon Islands,3,0,FIFA World Cup qualification,Adelaide,Australia,True,3,3,New Zealand
23156,24927,26523,2004,Nigeria,Jamaica,2,0,Friendly,London,England,True,2,2,Nigeria
23157,24928,26524,2004,Oman,Maldives,3,0,Friendly,Muscat,Oman,False,3,3,Oman
23158,24929,26525,2004,Qatar,Turkmenistan,5,0,Friendly,Doha,Qatar,False,5,5,Qatar
23159,24930,26526,2004,United Arab Emirates,Bahrain,2,3,Friendly,Dubai,United Arab Emirates,False,5,-1,Bahrain
23160,24931,26527,2004,Bolivia,Paraguay,2,1,FIFA World Cup qualification,La Paz,Bolivia,False,3,1,Bolivia
23161,24932,26529,2004,England,Japan,1,1,Friendly,Manchester,England,False,2,0,Draw
23162,24933,26530,2004,Kuwait,Syria,0,1,Friendly,Kuwait City,Kuwait,False,1,-1,Syria
23163,24934,26531,2004,Netherlands,Faroe Islands,3,0,Friendly,Lausanne,Switzerland,True,3,3,Netherlands
23164,24935,26532,2004,Uruguay,Peru,1,3,FIFA World Cup qualification,Montevideo,Uruguay,False,4,-2,Peru
23165,24936,26533,2004,Venezuela,Chile,0,1,FIFA World Cup qualification,San Cristóbal,Venezuela,False,1,-1,Chile
23166,24937,26534,2004,Australia,Fiji,6,1,FIFA World Cup qualification,Adelaide,Australia,False,7,5,Australia
23167,24938,26535,2004,Brazil,Argentina,3,1,FIFA World Cup qualification,Belo Horizonte,Brazil,False,4,2,Brazil
23168,24939,26536,2004,Czech Republic,Bulgaria,3,1,Friendly,Prague,Czech Republic,False,4,2,Czech Republic
23169,24940,26537,2004,Ecuador,Colombia,2,1,FIFA World Cup qualification,Quito,Ecuador,False,3,1,Ecuador
23170,24941,26538,2004,Grenada,Saint Lucia,2,0,Friendly,St. George's,Grenada,False,2,2,Grenada
23171,24942,26539,2004,Republic of Ireland,Jamaica,1,0,Friendly,London,England,True,1,1,Republic of Ireland
23172,24943,26541,2004,New Zealand,Vanuatu,2,4,FIFA World Cup qualification,Adelaide,Australia,True,6,-2,Vanuatu
23173,24944,26542,2004,Saint Kitts and Nevis,Northern Ireland,0,2,Friendly,Basseterre,Saint Kitts and Nevis,False,2,-2,Northern Ireland
23174,24945,26543,2004,Switzerland,Germany,0,2,Friendly,Basel,Switzerland,False,2,-2,Germany
23175,24946,26545,2004,United States,Honduras,4,0,Friendly,Foxborough,United States,False,4,4,United States
23176,24947,26546,2004,Indonesia,India,1,1,Friendly,Jakarta,Indonesia,False,2,0,Draw
23177,24948,26547,2004,Kuwait,Syria,1,2,Friendly,Kuwait City,Kuwait,False,3,-1,Syria
23178,24949,26548,2004,Liechtenstein,Greece,0,2,Friendly,Vaduz,Liechtenstein,False,2,-2,Greece
23179,24950,26549,2004,Oman,Maldives,4,1,Friendly,Muscat,Oman,False,5,3,Oman
23180,24951,26550,2004,Australia,Vanuatu,3,0,FIFA World Cup qualification,Adelaide,Australia,False,3,3,Australia
23181,24952,26551,2004,Costa Rica,Nicaragua,5,1,Friendly,San Carlos,Costa Rica,False,6,4,Costa Rica
23182,24953,26552,2004,Fiji,Solomon Islands,1,2,FIFA World Cup qualification,Adelaide,Australia,True,3,-1,Solomon Islands
23183,24955,26554,2004,Algeria,Angola,0,0,FIFA World Cup qualification,Annaba,Algeria,False,0,0,Draw
23184,24956,26555,2004,Burkina Faso,Ghana,1,0,FIFA World Cup qualification,Ouagadougou,Burkina Faso,False,1,1,Burkina Faso
23185,24957,26556,2004,Denmark,Croatia,1,2,Friendly,Copenhagen,Denmark,False,3,-1,Croatia
23186,24958,26557,2004,Ecuador,Bolivia,3,2,FIFA World Cup qualification,Quito,Ecuador,False,5,1,Ecuador
23187,24959,26558,2004,England,Iceland,6,1,Friendly,Manchester,England,False,7,5,England
23188,24960,26559,2004,Gabon,Zimbabwe,1,1,FIFA World Cup qualification,Libreville,Gabon,False,2,0,Draw
23189,24961,26561,2004,Malawi,Morocco,1,1,FIFA World Cup qualification,Blantyre,Malawi,False,2,0,Draw
23190,24962,26562,2004,Netherlands,Republic of Ireland,0,1,Friendly,Amsterdam,Netherlands,False,1,-1,Republic of Ireland
23191,24963,26563,2004,Nigeria,Rwanda,2,0,FIFA World Cup qualification,Abuja,Nigeria,False,2,2,Nigeria
23192,24964,26564,2004,Portugal,Lithuania,4,1,Friendly,Setúbal,Portugal,False,5,3,Portugal
23193,24965,26565,2004,Qatar,Kyrgyzstan,0,0,Friendly,Doha,Qatar,False,0,0,Draw
23194,24966,26566,2004,Senegal,Congo,2,0,FIFA World Cup qualification,Dakar,Senegal,False,2,2,Senegal
23195,24968,26568,2004,Spain,Andorra,4,0,Friendly,Getafe,Spain,False,4,4,Spain
23196,24969,26569,2004,Sweden,Poland,3,1,Friendly,Solna,Sweden,False,4,2,Sweden
23197,24970,26570,2004,Tunisia,Botswana,4,1,FIFA World Cup qualification,Radès,Tunisia,False,5,3,Tunisia
23198,24971,26571,2004,Zambia,Togo,1,0,FIFA World Cup qualification,Lusaka,Zambia,False,1,1,Zambia
23199,24972,26572,2004,Argentina,Paraguay,0,0,FIFA World Cup qualification,Buenos Aires,Argentina,False,0,0,Draw
23200,24973,26573,2004,Australia,Solomon Islands,2,2,FIFA World Cup qualification,Adelaide,Australia,False,4,0,Draw
23201,24974,26574,2004,Cameroon,Benin,2,1,FIFA World Cup qualification,Yaoundé,Cameroon,False,3,1,Cameroon
23202,24975,26575,2004,Chile,Brazil,1,1,FIFA World Cup qualification,Santiago,Chile,False,2,0,Draw
23203,24976,26576,2004,Colombia,Uruguay,5,0,FIFA World Cup qualification,Barranquilla,Colombia,False,5,5,Colombia
23204,24977,26577,2004,Czech Republic,Estonia,2,0,Friendly,Teplice,Czech Republic,False,2,2,Czech Republic
23205,24978,26578,2004,Fiji,New Zealand,0,2,FIFA World Cup qualification,Adelaide,Australia,True,2,-2,New Zealand
23206,24979,26579,2004,France,Ukraine,1,0,Friendly,Saint-Denis,France,False,1,1,France
23207,24980,26580,2004,Germany,Hungary,0,2,Friendly,Kaiserslautern,Germany,False,2,-2,Hungary
23208,24981,26581,2004,Ivory Coast,Libya,2,0,FIFA World Cup qualification,Abidjan,Ivory Coast,False,2,2,Ivory Coast
23209,24982,26582,2004,Latvia,Azerbaijan,2,2,Friendly,Riga,Latvia,False,4,0,Draw
23210,24983,26583,2004,Liberia,Mali,1,0,FIFA World Cup qualification,Paynesville,Liberia,False,1,1,Liberia
23211,24984,26584,2004,Peru,Venezuela,0,0,FIFA World Cup qualification,Lima,Peru,False,0,0,Draw
23212,24985,26585,2004,Sudan,Egypt,0,3,FIFA World Cup qualification,Khartoum,Sudan,False,3,-3,Egypt
23213,24986,26586,2004,Switzerland,Liechtenstein,1,0,Friendly,Zürich,Switzerland,False,1,1,Switzerland
23214,24987,26588,2004,Trinidad and Tobago,Northern Ireland,0,3,Friendly,Bacolet,Trinidad and Tobago,False,3,-3,Northern Ireland
23215,24988,26589,2004,Uganda,DR Congo,1,0,FIFA World Cup qualification,Kampala,Uganda,False,1,1,Uganda
23216,24989,26590,2004,Bahrain,Kyrgyzstan,5,0,FIFA World Cup qualification,Muharraq,Bahrain,False,5,5,Bahrain
23217,24990,26592,2004,Indonesia,Sri Lanka,1,0,FIFA World Cup qualification,Jakarta,Indonesia,False,1,1,Indonesia
23218,24991,26593,2004,Iran,Jordan,0,1,FIFA World Cup qualification,Teheran,Iran,False,1,-1,Jordan
23219,24993,26595,2004,Japan,India,7,0,FIFA World Cup qualification,Saitama,Japan,False,7,7,Japan
23220,24994,26597,2004,Kuwait,Hong Kong,4,0,FIFA World Cup qualification,Kuwait City,Kuwait,False,4,4,Kuwait
23221,24995,26598,2004,Lebanon,Maldives,3,0,FIFA World Cup qualification,Beirut,Lebanon,False,3,3,Lebanon
23222,24996,26599,2004,Oman,Singapore,7,0,FIFA World Cup qualification,Muscat,Oman,False,7,7,Oman
23223,24997,26600,2004,Qatar,Laos,5,0,FIFA World Cup qualification,Doha,Qatar,False,5,5,Qatar
23224,24998,26601,2004,Saudi Arabia,Turkmenistan,3,0,FIFA World Cup qualification,Riyadh,Saudi Arabia,False,3,3,Saudi Arabia
23225,25000,26603,2004,United Arab Emirates,Yemen,3,0,FIFA World Cup qualification,Al Ain,United Arab Emirates,False,3,3,United Arab Emirates
23226,25001,26604,2004,Uzbekistan,Palestine,3,0,FIFA World Cup qualification,Tashkent,Uzbekistan,False,3,3,Uzbekistan
23227,25002,26605,2004,Syria,Tajikistan,2,1,FIFA World Cup qualification,Homs,Syria,False,3,1,Syria
23228,25004,26607,2004,Cuba,Costa Rica,2,2,FIFA World Cup qualification,Havana,Cuba,False,4,0,Draw
23229,25005,26608,2004,Curaçao,Honduras,1,2,FIFA World Cup qualification,Willemstad,Netherlands Antilles,True,3,-1,Honduras
23230,25006,26609,2004,Haiti,Jamaica,1,1,FIFA World Cup qualification,Miami,United States,True,2,0,Draw
23231,25007,26610,2004,Portugal,Greece,1,2,UEFA Euro,Porto,Portugal,False,3,-1,Greece
23232,25008,26611,2004,Spain,Russia,1,0,UEFA Euro,Faro,Portugal,True,1,1,Spain
23233,25009,26612,2004,Suriname,Guatemala,1,1,FIFA World Cup qualification,Paramaribo,Suriname,False,2,0,Draw
23234,25010,26613,2004,Barbados,Saint Kitts and Nevis,0,2,FIFA World Cup qualification,Bridgetown,Barbados,False,2,-2,Saint Kitts and Nevis
23235,25011,26614,2004,Burkina Faso,Benin,4,2,Friendly,Ouagadougou,Burkina Faso,False,6,2,Burkina Faso
23236,25012,26615,2004,Canada,Belize,4,0,FIFA World Cup qualification,Kingston,Canada,False,4,4,Canada
23237,25013,26617,2004,Dominican Republic,Trinidad and Tobago,0,2,FIFA World Cup qualification,Santo Domingo,Dominican Republic,False,2,-2,Trinidad and Tobago
23238,25014,26618,2004,El Salvador,Bermuda,2,1,FIFA World Cup qualification,San Salvador,El Salvador,False,3,1,El Salvador
23239,25015,26619,2004,France,England,2,1,UEFA Euro,Lisbon,Portugal,True,3,1,France
23240,25016,26620,2004,Mozambique,Malawi,2,0,COSAFA Cup,Maputo,Mozambique,False,2,2,Mozambique
23241,25017,26621,2004,Panama,Saint Lucia,4,0,FIFA World Cup qualification,Panama City,Panama,False,4,4,Panama
23242,25018,26622,2004,Switzerland,Croatia,0,0,UEFA Euro,Leiria,Portugal,True,0,0,Draw
23243,25019,26623,2004,United States,Grenada,3,0,FIFA World Cup qualification,Columbus,United States,False,3,3,United States
23244,25020,26624,2004,Denmark,Italy,0,0,UEFA Euro,Guimarães,Portugal,True,0,0,Draw
23245,25021,26625,2004,Ghana,Togo,0,0,Friendly,Kumasi,Ghana,False,0,0,Draw
23246,25022,26626,2004,Sweden,Bulgaria,5,0,UEFA Euro,Lisbon,Portugal,True,5,5,Sweden
23247,25023,26627,2004,Czech Republic,Latvia,2,1,UEFA Euro,Aveiro,Portugal,True,3,1,Czech Republic
23248,25024,26628,2004,Germany,Netherlands,1,1,UEFA Euro,Porto,Portugal,True,2,0,Draw
23249,25025,26629,2004,Canada,Belize,4,0,FIFA World Cup qualification,Kingston,Canada,False,4,4,Canada
23250,25026,26630,2004,Greece,Spain,1,1,UEFA Euro,Porto,Portugal,True,2,0,Draw
23251,25027,26631,2004,Portugal,Russia,2,0,UEFA Euro,Lisbon,Portugal,False,2,2,Portugal
23252,25028,26632,2004,Croatia,France,2,2,UEFA Euro,Leiria,Portugal,True,4,0,Draw
23253,25029,26633,2004,England,Switzerland,3,0,UEFA Euro,Coimbra,Portugal,True,3,3,England
23254,25030,26634,2004,Iran,Lebanon,4,0,WAFF Championship,Teheran,Iran,False,4,4,Iran
23255,25031,26635,2004,Palestine,Jordan,1,1,WAFF Championship,Teheran,Iran,True,2,0,Draw
23256,25032,26636,2004,Bulgaria,Denmark,0,2,UEFA Euro,Braga,Portugal,True,2,-2,Denmark
23257,25033,26637,2004,Italy,Sweden,1,1,UEFA Euro,Porto,Portugal,True,2,0,Draw
23258,25034,26638,2004,Libya,Cameroon,0,0,FIFA World Cup qualification,Misurata,Libya,False,0,0,Draw
23259,25035,26639,2004,Botswana,Malawi,2,0,FIFA World Cup qualification,Gaborone,Botswana,False,2,2,Botswana
23260,25036,26641,2004,Dominica,Mexico,0,10,FIFA World Cup qualification,San Antonio,United States,True,10,-10,Mexico
23261,25037,26642,2004,Honduras,Curaçao,4,0,FIFA World Cup qualification,San Pedro Sula,Honduras,False,4,4,Honduras
23262,25038,26643,2004,Iraq,Palestine,2,1,WAFF Championship,Teheran,Iran,True,3,1,Iraq
23263,25039,26644,2004,Latvia,Germany,0,0,UEFA Euro,Porto,Portugal,True,0,0,Draw
23264,25040,26645,2004,Mali,Zambia,1,1,FIFA World Cup qualification,Bamako,Mali,False,2,0,Draw
23265,25041,26646,2004,Netherlands,Czech Republic,2,3,UEFA Euro,Aveiro,Portugal,True,5,-1,Czech Republic
23266,25042,26647,2004,Rwanda,Gabon,3,1,FIFA World Cup qualification,Kigali,Rwanda,False,4,2,Rwanda
23267,25043,26648,2004,Saint Kitts and Nevis,Barbados,3,2,FIFA World Cup qualification,Basseterre,Saint Kitts and Nevis,False,5,1,Saint Kitts and Nevis
23268,25044,26649,2004,Syria,Lebanon,3,1,WAFF Championship,Teheran,Iran,True,4,2,Syria
23269,25045,26650,2004,Angola,Nigeria,1,0,FIFA World Cup qualification,Luanda,Angola,False,1,1,Angola
23270,25046,26651,2004,Benin,Sudan,1,1,FIFA World Cup qualification,Cotonou,Benin,False,2,0,Draw
23271,25047,26652,2004,Bermuda,El Salvador,2,2,FIFA World Cup qualification,Hamilton,Bermuda,False,4,0,Draw
23272,25048,26653,2004,Congo,Liberia,3,0,FIFA World Cup qualification,Brazzaville,Congo,False,3,3,Congo
23273,25049,26654,2004,DR Congo,Burkina Faso,3,2,FIFA World Cup qualification,Kinshasa,DR Congo,False,5,1,DR Congo
23274,25050,26655,2004,Costa Rica,Cuba,1,1,FIFA World Cup qualification,Alajuela,Costa Rica,False,2,0,Draw
23275,25051,26656,2004,Egypt,Ivory Coast,1,2,FIFA World Cup qualification,Alexandria,Egypt,False,3,-1,Ivory Coast
23276,25052,26657,2004,Ghana,South Africa,3,0,FIFA World Cup qualification,Kumasi,Ghana,False,3,3,Ghana
23277,25053,26658,2004,Grenada,United States,2,3,FIFA World Cup qualification,St. George's,Grenada,False,5,-1,United States
23278,25054,26659,2004,Guatemala,Suriname,3,1,FIFA World Cup qualification,Guatemala,Guatemala,False,4,2,Guatemala
23279,25055,26660,2004,Guinea,Tunisia,2,1,FIFA World Cup qualification,Conakry,Guinea,False,3,1,Guinea
23280,25056,26661,2004,Jamaica,Haiti,3,0,FIFA World Cup qualification,Kingston,Jamaica,False,3,3,Jamaica
23281,25057,26662,2004,Portugal,Spain,1,0,UEFA Euro,Lisbon,Portugal,False,1,1,Portugal
23282,25058,26663,2004,Russia,Greece,2,1,UEFA Euro,Faro,Portugal,True,3,1,Russia
23283,25059,26664,2004,Saint Lucia,Panama,0,3,FIFA World Cup qualification,Vieux Fort,Saint Lucia,False,3,-3,Panama
23284,25060,26665,2004,Togo,Senegal,3,1,FIFA World Cup qualification,Lomé,Togo,False,4,2,Togo
23285,25061,26666,2004,Trinidad and Tobago,Dominican Republic,4,0,FIFA World Cup qualification,San Fernando,Trinidad and Tobago,False,4,4,Trinidad and Tobago
23286,25062,26667,2004,Zimbabwe,Algeria,1,1,FIFA World Cup qualification,Harare,Zimbabwe,False,2,0,Draw
23287,25063,26668,2004,Croatia,England,2,4,UEFA Euro,Lisbon,Portugal,True,6,-2,England
23288,25064,26669,2004,Iran,Syria,7,1,WAFF Championship,Teheran,Iran,False,8,6,Iran
23289,25065,26670,2004,Jordan,Iraq,2,0,WAFF Championship,Teheran,Iran,True,2,2,Jordan
23290,25066,26671,2004,Switzerland,France,1,3,UEFA Euro,Coimbra,Portugal,True,4,-2,France
23291,25067,26672,2004,Denmark,Sweden,2,2,UEFA Euro,Porto,Portugal,True,4,0,Draw
23292,25068,26673,2004,Italy,Bulgaria,2,1,UEFA Euro,Guimarães,Portugal,True,3,1,Italy
23293,25069,26674,2004,Germany,Czech Republic,1,2,UEFA Euro,Lisbon,Portugal,True,3,-1,Czech Republic
23294,25070,26675,2004,Iran,Iraq,2,1,WAFF Championship,Teheran,Iran,False,3,1,Iran
23295,25071,26676,2004,Jordan,Syria,1,1,WAFF Championship,Teheran,Iran,True,2,0,Draw
23296,25072,26677,2004,Netherlands,Latvia,3,0,UEFA Euro,Braga,Portugal,True,3,3,Netherlands
23297,25073,26678,2004,Portugal,England,2,2,UEFA Euro,Lisbon,Portugal,False,4,0,Draw
23298,25074,26679,2004,France,Greece,0,1,UEFA Euro,Lisbon,Portugal,True,1,-1,Greece
23299,25075,26680,2004,Iran,Syria,4,1,WAFF Championship,Teheran,Iran,False,5,3,Iran
23300,25076,26681,2004,Iraq,Jordan,1,3,WAFF Championship,Teheran,Iran,True,4,-2,Jordan
23301,25077,26682,2004,Sweden,Netherlands,0,0,UEFA Euro,Faro,Portugal,True,0,0,Draw
23302,25078,26683,2004,Argentina,Colombia,0,2,Friendly,Miami,United States,True,2,-2,Colombia
23303,25079,26684,2004,Czech Republic,Denmark,3,0,UEFA Euro,Porto,Portugal,True,3,3,Czech Republic
23304,25080,26685,2004,Mexico,Dominica,8,0,FIFA World Cup qualification,Aguascalientes,Mexico,False,8,8,Mexico
23305,25081,26686,2004,Eswatini,Zimbabwe,0,5,COSAFA Cup,Lobamba,Eswatini,False,5,-5,Zimbabwe
23306,25082,26687,2004,Argentina,Peru,2,1,Friendly,East Rutherford,United States,True,3,1,Argentina
23307,25083,26688,2004,Portugal,Netherlands,2,1,UEFA Euro,Lisbon,Portugal,False,3,1,Portugal
23308,25084,26689,2004,Greece,Czech Republic,1,0,UEFA Euro,Porto,Portugal,True,1,1,Greece
23309,25085,26690,2004,Botswana,Morocco,0,1,FIFA World Cup qualification,Gaborone,Botswana,False,1,-1,Morocco
23310,25086,26693,2004,Gabon,Angola,2,2,FIFA World Cup qualification,Libreville,Gabon,False,4,0,Draw
23311,25087,26694,2004,Malawi,Guinea,1,1,FIFA World Cup qualification,Blantyre,Malawi,False,2,0,Draw
23312,25088,26695,2004,Nigeria,Algeria,1,0,FIFA World Cup qualification,Abuja,Nigeria,False,1,1,Nigeria
23313,25089,26696,2004,Rwanda,Zimbabwe,0,2,FIFA World Cup qualification,Kigali,Rwanda,False,2,-2,Zimbabwe
23314,25090,26697,2004,Senegal,Zambia,1,0,FIFA World Cup qualification,Dakar,Senegal,False,1,1,Senegal
23315,25091,26698,2004,South Africa,Burkina Faso,2,0,FIFA World Cup qualification,Johannesburg,South Africa,False,2,2,South Africa
23316,25092,26699,2004,Sudan,Libya,0,1,FIFA World Cup qualification,Khartoum,Sudan,False,1,-1,Libya
23317,25093,26700,2004,Uganda,Ghana,1,1,FIFA World Cup qualification,Kampala,Uganda,False,2,0,Draw
23318,25094,26701,2004,Benin,Egypt,3,3,FIFA World Cup qualification,Cotonou,Benin,False,6,0,Draw
23319,25095,26702,2004,Cameroon,Ivory Coast,2,0,FIFA World Cup qualification,Yaoundé,Cameroon,False,2,2,Cameroon
23320,25096,26703,2004,Liberia,Togo,0,0,FIFA World Cup qualification,Paynesville,Liberia,False,0,0,Draw
23321,25097,26704,2004,Portugal,Greece,0,1,UEFA Euro,Lisbon,Portugal,False,1,-1,Greece
23322,25098,26705,2004,Thailand,Bahrain,0,2,Friendly,Bangkok,Thailand,False,2,-2,Bahrain
23323,25099,26706,2004,Malawi,Eswatini,1,2,Friendly,Blantyre,Malawi,False,3,-1,Eswatini
23324,25100,26707,2004,Peru,Bolivia,2,2,Copa América,Lima,Peru,False,4,0,Draw
23325,25101,26708,2004,Venezuela,Colombia,0,1,Copa América,Lima,Peru,True,1,-1,Colombia
23326,25102,26709,2004,Argentina,Ecuador,6,1,Copa América,Chiclayo,Peru,True,7,5,Argentina
23327,25103,26710,2004,Mexico,Uruguay,2,2,Copa América,Chiclayo,Peru,True,4,0,Draw
23328,25104,26711,2004,Brazil,Chile,1,0,Copa América,Arequipa,Peru,True,1,1,Brazil
23329,25105,26712,2004,Costa Rica,Paraguay,0,1,Copa América,Arequipa,Peru,True,1,-1,Paraguay
23330,25106,26713,2004,Malawi,Eswatini,1,1,Friendly,Lilongwe,Malawi,False,2,0,Draw
23331,25107,26714,2004,Thailand,Jordan,0,0,Friendly,Bangkok,Thailand,False,0,0,Draw
23332,25108,26715,2004,Colombia,Bolivia,1,0,Copa América,Lima,Peru,True,1,1,Colombia
23333,25109,26716,2004,Japan,Slovakia,3,1,Kirin Cup,Hiroshima,Japan,False,4,2,Japan
23334,25110,26717,2004,Peru,Venezuela,3,1,Copa América,Lima,Peru,False,4,2,Peru
23335,25111,26718,2004,Argentina,Mexico,0,1,Copa América,Chiclayo,Peru,True,1,-1,Mexico
23336,25112,26721,2004,Thailand,Trinidad and Tobago,3,2,Friendly,Bangkok,Thailand,False,5,1,Thailand
23337,25113,26722,2004,Uruguay,Ecuador,2,1,Copa América,Chiclayo,Peru,True,3,1,Uruguay
23338,25114,26723,2004,Brazil,Costa Rica,4,1,Copa América,Arequipa,Peru,True,5,3,Brazil
23339,25115,26724,2004,Paraguay,Chile,1,1,Copa América,Arequipa,Peru,True,2,0,Draw
23340,25116,26725,2004,Serbia,Slovakia,2,0,Kirin Cup,Fukuoka,Japan,True,2,2,Serbia
23341,25117,26726,2004,United States,Poland,1,1,Friendly,Chicago,United States,False,2,0,Draw
23342,25118,26727,2004,Malaysia,Singapore,2,0,Friendly,Kuala Lumpur,Malaysia,False,2,2,Malaysia
23343,25119,26728,2004,Peru,Colombia,2,2,Copa América,Trujillo,Peru,False,4,0,Draw
23344,25120,26729,2004,Venezuela,Bolivia,1,1,Copa América,Trujillo,Peru,True,2,0,Draw
23345,25121,26730,2004,Argentina,Uruguay,4,2,Copa América,Piura,Peru,True,6,2,Argentina
23346,25122,26731,2004,Japan,Serbia,1,0,Kirin Cup,Yokohama,Japan,False,1,1,Japan
23347,25123,26732,2004,Mexico,Ecuador,2,1,Copa América,Piura,Peru,True,3,1,Mexico
23348,25124,26733,2004,Brazil,Paraguay,1,2,Copa América,Arequipa,Peru,True,3,-1,Paraguay
23349,25125,26734,2004,Costa Rica,Chile,2,1,Copa América,Tacna,Peru,True,3,1,Costa Rica
23350,25126,26737,2004,Colombia,Costa Rica,2,0,Copa América,Trujillo,Peru,True,2,2,Colombia
23351,25127,26738,2004,Peru,Argentina,0,1,Copa América,Chiclayo,Peru,False,1,-1,Argentina
23352,25128,26739,2004,Angola,Botswana,1,1,COSAFA Cup,Luanda,Angola,False,2,0,Draw
23353,25129,26740,2004,El Salvador,Guatemala,0,1,Friendly,Los Angeles,United States,True,1,-1,Guatemala
23354,25130,26741,2004,Iraq,Uzbekistan,0,1,AFC Asian Cup,Chengdu,China PR,True,1,-1,Uzbekistan
23355,25131,26742,2004,Mexico,Brazil,0,4,Copa América,Piura,Peru,True,4,-4,Brazil
23356,25132,26743,2004,Paraguay,Uruguay,1,3,Copa América,Tacna,Peru,True,4,-2,Uruguay
23357,25133,26744,2004,Qatar,Indonesia,1,2,AFC Asian Cup,Beijing,China PR,True,3,-1,Indonesia
23358,25134,26745,2004,Saudi Arabia,Turkmenistan,2,2,AFC Asian Cup,Chengdu,China PR,True,4,0,Draw
23359,25135,26747,2004,Kuwait,United Arab Emirates,3,1,AFC Asian Cup,Jinan,China PR,True,4,2,Kuwait
23360,25136,26748,2004,Argentina,Colombia,3,0,Copa América,Lima,Peru,True,3,3,Argentina
23361,25137,26749,2004,Iran,Thailand,3,0,AFC Asian Cup,Chongqing,China PR,True,3,3,Iran
23362,25138,26750,2004,Japan,Oman,1,0,AFC Asian Cup,Chongqing,China PR,True,1,1,Japan
23363,25139,26751,2004,Bahrain,Qatar,1,1,AFC Asian Cup,Beijing,China PR,True,2,0,Draw
23364,25140,26753,2004,Uruguay,Brazil,1,1,Copa América,Lima,Peru,True,2,0,Draw
23365,25141,26754,2004,Turkmenistan,Iraq,2,3,AFC Asian Cup,Chengdu,China PR,True,5,-1,Iraq
23366,25142,26755,2004,Uzbekistan,Saudi Arabia,1,0,AFC Asian Cup,Chengdu,China PR,True,1,1,Uzbekistan
23367,25143,26756,2004,Jordan,Kuwait,2,0,AFC Asian Cup,Jinan,China PR,True,2,2,Jordan
23368,25144,26757,2004,Panama,Guatemala,1,1,Friendly,Panama City,Panama,False,2,0,Draw
23369,25146,26759,2004,Colombia,Uruguay,1,2,Copa América,Cusco,Peru,True,3,-1,Uruguay
23370,25147,26760,2004,Oman,Iran,2,2,AFC Asian Cup,Chongqing,China PR,True,4,0,Draw
23371,25148,26761,2004,Thailand,Japan,1,4,AFC Asian Cup,Chongqing,China PR,True,5,-3,Japan
23372,25149,26762,2004,Argentina,Brazil,2,2,Copa América,Lima,Peru,True,4,0,Draw
23373,25150,26763,2004,Bahrain,Indonesia,3,1,AFC Asian Cup,Jinan,China PR,True,4,2,Bahrain
23374,25151,26765,2004,Saudi Arabia,Iraq,1,2,AFC Asian Cup,Chengdu,China PR,True,3,-1,Iraq
23375,25152,26766,2004,Turkmenistan,Uzbekistan,0,1,AFC Asian Cup,Chongqing,China PR,True,1,-1,Uzbekistan
23376,25153,26767,2004,Jordan,United Arab Emirates,0,0,AFC Asian Cup,Beijing,China PR,True,0,0,Draw
23377,25154,26769,2004,Honduras,Panama,0,0,Friendly,Tegucigalpa,Honduras,False,0,0,Draw
23378,25155,26770,2004,Japan,Iran,0,0,AFC Asian Cup,Chongqing,China PR,True,0,0,Draw
23379,25156,26771,2004,Oman,Thailand,2,0,AFC Asian Cup,Chengdu,China PR,True,2,2,Oman
23380,25157,26773,2004,Uzbekistan,Bahrain,2,2,AFC Asian Cup,Chengdu,China PR,True,4,0,Draw
23381,25158,26774,2004,Japan,Jordan,1,1,AFC Asian Cup,Chongqing,China PR,True,2,0,Draw
23382,25159,26776,2004,Zambia,Mauritius,3,1,COSAFA Cup,Lusaka,Zambia,False,4,2,Zambia
23383,25160,26777,2004,Bahrain,Japan,3,4,AFC Asian Cup,Jinan,China PR,True,7,-1,Japan
23384,25161,26779,2004,El Salvador,Honduras,0,4,Friendly,San Salvador,El Salvador,False,4,-4,Honduras
23385,25162,26780,2004,El Salvador,Guatemala,0,2,Friendly,Washington,United States,True,2,-2,Guatemala
23386,25163,26781,2004,Iran,Bahrain,4,2,AFC Asian Cup,Beijing,China PR,True,6,2,Iran
23387,25164,26783,2004,Uganda,Kenya,1,1,Friendly,Kampala,Uganda,False,2,0,Draw
23388,25165,26784,2004,Guatemala,Trinidad and Tobago,4,1,Friendly,Guatemala,Guatemala,False,5,3,Guatemala
23389,25166,26785,2004,Uganda,Rwanda,1,2,Friendly,Kampala,Uganda,False,3,-1,Rwanda
23390,25167,26786,2004,Algeria,Burkina Faso,2,2,Friendly,Blida,Algeria,False,4,0,Draw
23391,25168,26787,2004,Austria,Germany,1,3,Friendly,Vienna,Austria,False,4,-2,Germany
23392,25169,26788,2004,Canada,Guatemala,0,2,FIFA World Cup qualification,Burnaby,Canada,False,2,-2,Guatemala
23393,25170,26789,2004,DR Congo,Mali,0,3,Friendly,Colombes,France,True,3,-3,Mali
23394,25171,26790,2004,Costa Rica,Honduras,2,5,FIFA World Cup qualification,Alajuela,Costa Rica,False,7,-3,Honduras
23395,25172,26791,2004,Croatia,Israel,1,0,Friendly,Varaždin,Croatia,False,1,1,Croatia
23396,25173,26792,2004,Cyprus,Albania,2,1,Friendly,Limassol,Cyprus,False,3,1,Cyprus
23397,25174,26793,2004,Czech Republic,Greece,0,0,Friendly,Prague,Czech Republic,False,0,0,Draw
23398,25175,26794,2004,El Salvador,Panama,2,1,FIFA World Cup qualification,San Salvador,El Salvador,False,3,1,El Salvador
23399,25176,26795,2004,England,Ukraine,3,0,Friendly,Newcastle,England,False,3,3,England
23400,25177,26796,2004,Faroe Islands,Malta,3,2,Friendly,Toftir,Faroe Islands,False,5,1,Faroe Islands
23401,25178,26797,2004,France,Bosnia and Herzegovina,1,1,Friendly,Rennes,France,False,2,0,Draw
23402,25179,26798,2004,Haiti,Brazil,0,6,Friendly,Port-au-Prince,Haiti,False,6,-6,Brazil
23403,25180,26799,2004,Iceland,Italy,2,0,Friendly,Reykjavík,Iceland,False,2,2,Iceland
23404,25181,26800,2004,Republic of Ireland,Bulgaria,1,1,Friendly,Dublin,Republic of Ireland,False,2,0,Draw
23405,25182,26801,2004,Jamaica,United States,1,1,FIFA World Cup qualification,Kingston,Jamaica,False,2,0,Draw
23406,25183,26802,2004,Japan,Argentina,1,2,Friendly,Fukuroi,Japan,False,3,-1,Argentina
23407,25184,26803,2004,Jordan,Azerbaijan,1,1,Friendly,Amman,Jordan,False,2,0,Draw
23408,25185,26804,2004,Kenya,Uganda,4,1,Friendly,Nairobi,Kenya,False,5,3,Kenya
23409,25186,26805,2004,Latvia,Wales,0,2,Friendly,Riga,Latvia,False,2,-2,Wales
23410,25187,26806,2004,Liechtenstein,Estonia,1,2,FIFA World Cup qualification,Vaduz,Liechtenstein,False,3,-1,Estonia
23411,25188,26807,2004,Moldova,Georgia,1,0,Friendly,Tiraspol,Moldova,False,1,1,Moldova
23412,25189,26808,2004,Norway,Belgium,2,2,Friendly,Oslo,Norway,False,4,0,Draw
23413,25190,26809,2004,Poland,Denmark,1,5,Friendly,Poznań,Poland,False,6,-4,Denmark
23414,25191,26810,2004,Romania,Finland,2,1,FIFA World Cup qualification,Bucharest,Romania,False,3,1,Romania
23415,25192,26811,2004,Russia,Lithuania,4,3,Friendly,Moscow,Russia,False,7,1,Russia
23416,25193,26812,2004,Scotland,Hungary,0,3,Friendly,Glasgow,Scotland,False,3,-3,Hungary
23417,25194,26813,2004,Senegal,Ivory Coast,1,2,Friendly,Avignon,France,True,3,-1,Ivory Coast
23418,25195,26814,2004,Slovakia,Luxembourg,3,1,FIFA World Cup qualification,Bratislava,Slovakia,False,4,2,Slovakia
23419,25196,26815,2004,Slovenia,Serbia,1,1,Friendly,Ljubljana,Slovenia,False,2,0,Draw
23420,25197,26816,2004,Spain,Venezuela,3,2,Friendly,Las Palmas,Spain,False,5,1,Spain
23421,25198,26817,2004,Sweden,Netherlands,2,2,Friendly,Solna,Sweden,False,4,0,Draw
23422,25199,26818,2004,Switzerland,Northern Ireland,0,0,Friendly,Zürich,Switzerland,False,0,0,Draw
23423,25200,26819,2004,Tunisia,South Africa,0,2,Friendly,Tunis,Tunisia,False,2,-2,South Africa
23424,25201,26820,2004,Turkey,Belarus,1,2,Friendly,Denizli,Turkey,False,3,-1,Belarus
23425,25202,26821,2004,Zimbabwe,Botswana,2,0,Friendly,Bulawayo,Zimbabwe,False,2,2,Zimbabwe
23426,25203,26822,2004,Thailand,Malaysia,1,2,Friendly,Bangkok,Thailand,False,3,-1,Malaysia
23427,25204,26823,2004,Vietnam,Burma,5,0,Friendly,Ho Chi Minh City,Vietnam,False,5,5,Vietnam
23428,25205,26824,2004,India,Burma,2,1,Friendly,Ho Chi Minh City,Vietnam,True,3,1,India
23429,25206,26825,2004,Zimbabwe,Uganda,2,0,Friendly,Harare,Zimbabwe,False,2,2,Zimbabwe
23430,25207,26826,2004,Vietnam,India,2,1,Friendly,Ho Chi Minh City,Vietnam,False,3,1,Vietnam
23431,25208,26827,2004,Bahrain,Kuwait,0,0,Friendly,Muharraq,Bahrain,False,0,0,Draw
23432,25209,26828,2004,Yemen,Syria,1,2,Friendly,Sana'a,Yemen,False,3,-1,Syria
23433,25210,26829,2004,Yemen,Syria,2,1,Friendly,Sana'a,Yemen,False,3,1,Yemen
23434,25211,26830,2004,Zambia,Rwanda,2,1,Friendly,Kitwe,Zambia,False,3,1,Zambia
23435,25212,26831,2004,Jordan,Lebanon,2,2,Friendly,Amman,Jordan,False,4,0,Draw
23436,25213,26832,2004,Maldives,Oman,0,1,Friendly,Malé,Maldives,False,1,-1,Oman
23437,25214,26833,2004,Saudi Arabia,Kuwait,1,1,Friendly,Riyadh,Saudi Arabia,False,2,0,Draw
23438,25215,26834,2004,Bahrain,Palestine,1,0,Friendly,Muharraq,Bahrain,False,1,1,Bahrain
23439,25216,26835,2004,Libya,Benin,4,1,FIFA World Cup qualification,Tripoli,Libya,False,5,3,Libya
23440,25217,26836,2004,Maldives,Oman,1,2,Friendly,Malé,Maldives,False,3,-1,Oman
23441,25218,26837,2004,Netherlands,Liechtenstein,3,0,Friendly,Utrecht,Netherlands,False,3,3,Netherlands
23442,25219,26838,2004,Spain,Scotland,1,1,Friendly,Valencia,Spain,False,2,0,Draw
23443,25220,26839,2004,Albania,Greece,2,1,FIFA World Cup qualification,Tirana,Albania,False,3,1,Albania
23444,25221,26840,2004,Austria,England,2,2,FIFA World Cup qualification,Vienna,Austria,False,4,0,Draw
23445,25222,26841,2004,Azerbaijan,Wales,1,1,FIFA World Cup qualification,Baku,Azerbaijan,False,2,0,Draw
23446,25223,26842,2004,Belgium,Lithuania,1,1,FIFA World Cup qualification,Charleroi,Belgium,False,2,0,Draw
23447,25224,26843,2004,Burkina Faso,Uganda,2,0,FIFA World Cup qualification,Ouagadougou,Burkina Faso,False,2,2,Burkina Faso
23448,25225,26844,2004,Canada,Honduras,1,1,FIFA World Cup qualification,Edmonton,Canada,False,2,0,Draw
23449,25226,26845,2004,Croatia,Hungary,3,0,FIFA World Cup qualification,Zagreb,Croatia,False,3,3,Croatia
23450,25227,26846,2004,Denmark,Ukraine,1,1,FIFA World Cup qualification,Copenhagen,Denmark,False,2,0,Draw
23451,25228,26847,2004,Estonia,Luxembourg,4,0,FIFA World Cup qualification,Tallinn,Estonia,False,4,4,Estonia
23452,25229,26848,2004,Finland,Andorra,3,0,FIFA World Cup qualification,Tampere,Finland,False,3,3,Finland
23453,25230,26849,2004,France,Israel,0,0,FIFA World Cup qualification,Saint-Denis,France,False,0,0,Draw
23454,25231,26850,2004,Iceland,Bulgaria,1,3,FIFA World Cup qualification,Reykjavík,Iceland,False,4,-2,Bulgaria
23455,25232,26851,2004,Republic of Ireland,Cyprus,3,0,FIFA World Cup qualification,Dublin,Republic of Ireland,False,3,3,Republic of Ireland
23456,25233,26852,2004,Italy,Norway,2,1,FIFA World Cup qualification,Palermo,Italy,False,3,1,Italy
23457,25234,26853,2004,Jamaica,Panama,1,2,FIFA World Cup qualification,Kingston,Jamaica,False,3,-1,Panama
23458,25235,26854,2004,Kenya,Malawi,3,2,FIFA World Cup qualification,Nairobi,Kenya,False,5,1,Kenya
23459,25236,26855,2004,Latvia,Portugal,0,2,FIFA World Cup qualification,Riga,Latvia,False,2,-2,Portugal
23460,25237,26856,2004,Malta,Sweden,0,7,FIFA World Cup qualification,Attard,Malta,False,7,-7,Sweden
23461,25238,26857,2004,Morocco,Tunisia,1,1,FIFA World Cup qualification,Rabat,Morocco,False,2,0,Draw
23462,25239,26858,2004,Northern Ireland,Poland,0,3,FIFA World Cup qualification,Belfast,Northern Ireland,False,3,-3,Poland
23463,25240,26859,2004,Peru,Argentina,1,3,FIFA World Cup qualification,Lima,Peru,False,4,-2,Argentina
23464,25242,26861,2004,Russia,Slovakia,1,1,FIFA World Cup qualification,Moscow,Russia,False,2,0,Draw
23465,25243,26862,2004,San Marino,Serbia,0,3,FIFA World Cup qualification,Serravalle,San Marino,False,3,-3,Serbia
23466,25244,26863,2004,Singapore,Indonesia,2,0,Friendly,Singapore,Singapore,False,2,2,Singapore
23467,25245,26864,2004,Slovenia,Moldova,3,0,FIFA World Cup qualification,Celje,Slovenia,False,3,3,Slovenia
23468,25246,26865,2004,Saint Kitts and Nevis,Trinidad and Tobago,1,2,FIFA World Cup qualification,Basseterre,Saint Kitts and Nevis,False,3,-1,Trinidad and Tobago
23469,25247,26866,2004,Switzerland,Faroe Islands,6,0,FIFA World Cup qualification,Basel,Switzerland,False,6,6,Switzerland
23470,25248,26867,2004,Turkey,Georgia,1,1,FIFA World Cup qualification,Trabzon,Turkey,False,2,0,Draw
23471,25249,26868,2004,United States,El Salvador,2,0,FIFA World Cup qualification,Foxborough,United States,False,2,2,United States
23472,25250,26869,2004,Zambia,Liberia,1,0,FIFA World Cup qualification,Lusaka,Zambia,False,1,1,Zambia
23473,25251,26870,2004,Algeria,Gabon,0,3,FIFA World Cup qualification,Annaba,Algeria,False,3,-3,Gabon
23474,25252,26871,2004,Angola,Rwanda,1,0,FIFA World Cup qualification,Luanda,Angola,False,1,1,Angola
23475,25253,26872,2004,Brazil,Bolivia,3,1,FIFA World Cup qualification,São Paulo,Brazil,False,4,2,Brazil
23476,25254,26873,2004,Chile,Colombia,0,0,FIFA World Cup qualification,Santiago,Chile,False,0,0,Draw
23477,25255,26874,2004,DR Congo,South Africa,1,0,FIFA World Cup qualification,Kinshasa,DR Congo,False,1,1,DR Congo
23478,25256,26875,2004,Egypt,Cameroon,3,2,FIFA World Cup qualification,Cairo,Egypt,False,5,1,Egypt
23479,25258,26877,2004,Guatemala,Costa Rica,2,1,FIFA World Cup qualification,Guatemala,Guatemala,False,3,1,Guatemala
23480,25259,26878,2004,Guinea,Botswana,4,0,FIFA World Cup qualification,Conakry,Guinea,False,4,4,Guinea
23481,25260,26879,2004,Ivory Coast,Sudan,5,0,FIFA World Cup qualification,Abidjan,Ivory Coast,False,5,5,Ivory Coast
23482,25261,26880,2004,Mali,Senegal,2,2,FIFA World Cup qualification,Bamako,Mali,False,4,0,Draw
23483,25262,26881,2004,Paraguay,Venezuela,1,0,FIFA World Cup qualification,Asunción,Paraguay,False,1,1,Paraguay
23484,25263,26882,2004,Togo,Congo,2,0,FIFA World Cup qualification,Lomé,Togo,False,2,2,Togo
23485,25264,26883,2004,Uruguay,Ecuador,1,0,FIFA World Cup qualification,Montevideo,Uruguay,False,1,1,Uruguay
23486,25265,26884,2004,Zimbabwe,Nigeria,0,3,FIFA World Cup qualification,Harare,Zimbabwe,False,3,-3,Nigeria
23487,25266,26885,2004,Andorra,Romania,1,5,FIFA World Cup qualification,Sant Julià de Lòria,Andorra,False,6,-4,Romania
23488,25267,26886,2004,Armenia,Finland,0,2,FIFA World Cup qualification,Yerevan,Armenia,False,2,-2,Finland
23489,25268,26887,2004,Austria,Azerbaijan,2,0,FIFA World Cup qualification,Vienna,Austria,False,2,2,Austria
23490,25269,26888,2004,Bosnia and Herzegovina,Spain,1,1,FIFA World Cup qualification,Zenica,Bosnia and Herzegovina,False,2,0,Draw
23491,25270,26889,2004,Costa Rica,Canada,1,0,FIFA World Cup qualification,San José,Costa Rica,False,1,1,Costa Rica
23492,25271,26890,2004,El Salvador,Jamaica,0,3,FIFA World Cup qualification,San Salvador,El Salvador,False,3,-3,Jamaica
23493,25272,26891,2004,Faroe Islands,France,0,2,FIFA World Cup qualification,Tórshavn,Faroe Islands,False,2,-2,France
23494,25273,26892,2004,Georgia,Albania,2,0,FIFA World Cup qualification,Tbilisi,Georgia,False,2,2,Georgia
23495,25274,26893,2004,Germany,Brazil,1,1,Friendly,Berlin,Germany,False,2,0,Draw
23496,25275,26894,2004,Greece,Turkey,0,0,FIFA World Cup qualification,Piraeus,Greece,False,0,0,Draw
23497,25276,26895,2004,Honduras,Guatemala,2,2,FIFA World Cup qualification,San Pedro Sula,Honduras,False,4,0,Draw
23498,25277,26896,2004,Hong Kong,Kuwait,0,2,FIFA World Cup qualification,Siu Sai Wan,Hong Kong,False,2,-2,Kuwait
23499,25278,26897,2004,Hungary,Iceland,3,2,FIFA World Cup qualification,Budapest,Hungary,False,5,1,Hungary
23500,25279,26898,2004,India,Japan,0,4,FIFA World Cup qualification,Calcutta,India,False,4,-4,Japan
23501,25280,26899,2004,Israel,Cyprus,2,1,FIFA World Cup qualification,Ramat-Gan,Israel,False,3,1,Israel
23502,25281,26900,2004,Jordan,Iran,0,2,FIFA World Cup qualification,Amman,Jordan,False,2,-2,Iran
23503,25282,26901,2004,Kazakhstan,Ukraine,1,2,FIFA World Cup qualification,Almaty,Kazakhstan,False,3,-1,Ukraine
23504,25283,26903,2004,Kyrgyzstan,Bahrain,1,2,FIFA World Cup qualification,Bishkek,Kyrgyzstan,False,3,-1,Bahrain
23505,25284,26904,2004,Laos,Qatar,1,6,FIFA World Cup qualification,Vientiane,Laos,False,7,-5,Qatar
23506,25285,26905,2004,Lithuania,San Marino,4,0,FIFA World Cup qualification,Kaunas,Lithuania,False,4,4,Lithuania
23507,25286,26906,2004,Luxembourg,Latvia,3,4,FIFA World Cup qualification,Luxembourg,Luxembourg,False,7,-1,Latvia
23508,25288,26908,2004,Maldives,Lebanon,2,5,FIFA World Cup qualification,Malé,Maldives,False,7,-3,Lebanon
23509,25289,26909,2004,Moldova,Italy,0,1,FIFA World Cup qualification,Chişinău,Moldova,False,1,-1,Italy
23510,25290,26910,2004,Netherlands,Czech Republic,2,0,FIFA World Cup qualification,Amsterdam,Netherlands,False,2,2,Netherlands
23511,25291,26911,2004,Norway,Belarus,1,1,FIFA World Cup qualification,Oslo,Norway,False,2,0,Draw
23512,25292,26912,2004,Palestine,Uzbekistan,0,3,FIFA World Cup qualification,Rayyan,Qatar,True,3,-3,Uzbekistan
23513,25293,26913,2004,Panama,United States,1,1,FIFA World Cup qualification,Panama City,Panama,False,2,0,Draw
23514,25294,26914,2004,Poland,England,1,2,FIFA World Cup qualification,Chorzów,Poland,False,3,-1,England
23515,25295,26915,2004,Portugal,Estonia,4,0,FIFA World Cup qualification,Leiria,Portugal,False,4,4,Portugal
23516,25296,26916,2004,Scotland,Slovenia,0,0,FIFA World Cup qualification,Glasgow,Scotland,False,0,0,Draw
23517,25297,26917,2004,Singapore,Oman,0,2,FIFA World Cup qualification,Singapore,Singapore,False,2,-2,Oman
23518,25298,26918,2004,Slovakia,Liechtenstein,7,0,FIFA World Cup qualification,Bratislava,Slovakia,False,7,7,Slovakia
23519,25299,26919,2004,Sri Lanka,Indonesia,2,2,FIFA World Cup qualification,Colombo,Sri Lanka,False,4,0,Draw
23520,25300,26920,2004,Sweden,Croatia,0,1,FIFA World Cup qualification,Gothenburg,Sweden,False,1,-1,Croatia
23521,25301,26921,2004,Switzerland,Republic of Ireland,1,1,FIFA World Cup qualification,Basel,Switzerland,False,2,0,Draw
23522,25302,26922,2004,Tajikistan,Syria,0,1,FIFA World Cup qualification,Dushanbe,Tajikistan,False,1,-1,Syria
23523,25303,26923,2004,Trinidad and Tobago,Mexico,1,3,FIFA World Cup qualification,Port of Spain,Trinidad and Tobago,False,4,-2,Mexico
23524,25304,26924,2004,Turkmenistan,Saudi Arabia,0,1,FIFA World Cup qualification,Ashgabat,Turkmenistan,False,1,-1,Saudi Arabia
23525,25306,26926,2004,Wales,Northern Ireland,2,2,FIFA World Cup qualification,Cardiff,Wales,False,4,0,Draw
23526,25307,26927,2004,Yemen,United Arab Emirates,3,1,FIFA World Cup qualification,Sana'a,Yemen,False,4,2,Yemen
23527,25308,26928,2004,Saint Vincent and the Grenadines,Saint Kitts and Nevis,1,0,FIFA World Cup qualification,Kingstown,Saint Vincent and the Grenadines,False,1,1,Saint Vincent and the Grenadines
23528,25309,26929,2004,Mozambique,Angola,0,1,COSAFA Cup,Maputo,Mozambique,False,1,-1,Angola
23529,25310,26931,2004,Kuwait,Syria,1,1,Friendly,Tripoli,Lebanon,True,2,0,Draw
23530,25311,26932,2004,Botswana,Zambia,1,0,Friendly,Gaborone,Botswana,False,1,1,Botswana
23531,25312,26933,2004,Jamaica,Guatemala,2,2,Friendly,Fort Lauderdale,United States,True,4,0,Draw
23532,25313,26934,2004,Gabon,Benin,2,0,Friendly,Libreville,Gabon,False,2,2,Gabon
23533,25314,26935,2004,Lebanon,Kuwait,1,3,Friendly,Tripoli,Lebanon,False,4,-2,Kuwait
23534,25315,26936,2004,Lebanon,Kuwait,1,1,Friendly,Beirut,Lebanon,False,2,0,Draw
23535,25316,26937,2004,Saudi Arabia,Syria,2,2,Friendly,Riyadh,Saudi Arabia,False,4,0,Draw
23536,25317,26938,2004,Oman,Iraq,1,0,Friendly,Muscat,Oman,False,1,1,Oman
23537,25318,26939,2004,Libya,Egypt,2,1,FIFA World Cup qualification,Tripoli,Libya,False,3,1,Libya
23538,25319,26940,2004,Qatar,Syria,1,2,Friendly,Doha,Qatar,False,3,-1,Syria
23539,25320,26941,2004,Singapore,United Arab Emirates,1,2,Friendly,Singapore,Singapore,False,3,-1,United Arab Emirates
23540,25321,26942,2004,Thailand,Jordan,2,3,Friendly,Bangkok,Thailand,False,5,-1,Jordan
23541,25322,26943,2004,Albania,Denmark,0,2,FIFA World Cup qualification,Tirana,Albania,False,2,-2,Denmark
23542,25323,26944,2004,Argentina,Uruguay,4,2,FIFA World Cup qualification,Buenos Aires,Argentina,False,6,2,Argentina
23543,25324,26945,2004,Austria,Poland,1,3,FIFA World Cup qualification,Vienna,Austria,False,4,-2,Poland
23544,25325,26946,2004,Azerbaijan,Northern Ireland,0,0,FIFA World Cup qualification,Baku,Azerbaijan,False,0,0,Draw
23545,25326,26947,2004,Belarus,Moldova,4,0,FIFA World Cup qualification,Minsk,Belarus,False,4,4,Belarus
23546,25327,26948,2004,Bolivia,Peru,1,0,FIFA World Cup qualification,La Paz,Bolivia,False,1,1,Bolivia
23547,25328,26949,2004,Bosnia and Herzegovina,Serbia,0,0,FIFA World Cup qualification,Sarajevo,Bosnia and Herzegovina,False,0,0,Draw
23548,25329,26950,2004,Botswana,Kenya,2,1,FIFA World Cup qualification,Gaborone,Botswana,False,3,1,Botswana
23549,25330,26952,2004,Colombia,Paraguay,1,1,FIFA World Cup qualification,Barranquilla,Colombia,False,2,0,Draw
23550,25331,26953,2004,Costa Rica,Guatemala,5,0,FIFA World Cup qualification,San José,Costa Rica,False,5,5,Costa Rica
23551,25332,26954,2004,Croatia,Bulgaria,2,2,FIFA World Cup qualification,Zagreb,Croatia,False,4,0,Draw
23552,25333,26955,2004,Cyprus,Faroe Islands,2,2,FIFA World Cup qualification,Nicosia,Cyprus,False,4,0,Draw
23553,25334,26956,2004,Czech Republic,Romania,1,0,FIFA World Cup qualification,Prague,Czech Republic,False,1,1,Czech Republic
23554,25335,26957,2004,El Salvador,United States,0,2,FIFA World Cup qualification,San Salvador,El Salvador,False,2,-2,United States
23555,25336,26958,2004,England,Wales,2,0,FIFA World Cup qualification,Manchester,England,False,2,2,England
23556,25337,26959,2004,Finland,Armenia,3,1,FIFA World Cup qualification,Tampere,Finland,False,4,2,Finland
23557,25338,26960,2004,France,Republic of Ireland,0,0,FIFA World Cup qualification,Saint-Denis,France,False,0,0,Draw
23558,25339,26961,2004,Gabon,Nigeria,1,1,FIFA World Cup qualification,Libreville,Gabon,False,2,0,Draw
23559,25340,26962,2004,Honduras,Canada,1,1,FIFA World Cup qualification,San Pedro Sula,Honduras,False,2,0,Draw
23560,25341,26963,2004,Iran,Germany,0,2,Friendly,Teheran,Iran,False,2,-2,Germany
23561,25342,26964,2004,Israel,Switzerland,2,2,FIFA World Cup qualification,Ramat-Gan,Israel,False,4,0,Draw
23562,25343,26965,2004,Liechtenstein,Portugal,2,2,FIFA World Cup qualification,Vaduz,Liechtenstein,False,4,0,Draw
23563,25344,26966,2004,Luxembourg,Russia,0,4,FIFA World Cup qualification,Luxembourg,Luxembourg,False,4,-4,Russia
23564,25345,26968,2004,Malawi,Tunisia,2,2,FIFA World Cup qualification,Blantyre,Malawi,False,4,0,Draw
23565,25346,26969,2004,Malta,Iceland,0,0,FIFA World Cup qualification,Attard,Malta,False,0,0,Draw
23566,25347,26970,2004,Panama,Jamaica,1,1,FIFA World Cup qualification,Panama City,Panama,False,2,0,Draw
23567,25348,26971,2004,Rwanda,Algeria,1,1,FIFA World Cup qualification,Kigali,Rwanda,False,2,0,Draw
23568,25349,26972,2004,Scotland,Norway,0,1,FIFA World Cup qualification,Glasgow,Scotland,False,1,-1,Norway
23569,25350,26973,2004,Slovakia,Latvia,4,1,FIFA World Cup qualification,Bratislava,Slovakia,False,5,3,Slovakia
23570,25351,26974,2004,Slovenia,Italy,1,0,FIFA World Cup qualification,Celje,Slovenia,False,1,1,Slovenia
23571,25352,26975,2004,Solomon Islands,Australia,1,5,Oceania Nations Cup,Honiara,Solomon Islands,False,6,-4,Australia
23572,25353,26976,2004,Spain,Belgium,2,0,FIFA World Cup qualification,Santander,Spain,False,2,2,Spain
23573,25354,26977,2004,Sri Lanka,Turkmenistan,2,2,FIFA World Cup qualification,Colombo,Sri Lanka,False,4,0,Draw
23574,25355,26978,2004,Sudan,Cameroon,1,1,FIFA World Cup qualification,Omdurman,Sudan,False,2,0,Draw
23575,25356,26979,2004,Sweden,Hungary,3,0,FIFA World Cup qualification,Solna,Sweden,False,3,3,Sweden
23576,25357,26980,2004,Turkey,Kazakhstan,4,0,FIFA World Cup qualification,Istanbul,Turkey,False,4,4,Turkey
23577,25358,26981,2004,Ukraine,Greece,1,1,FIFA World Cup qualification,Kyïv,Ukraine,False,2,0,Draw
23578,25359,26982,2004,Venezuela,Brazil,2,5,FIFA World Cup qualification,Maracaibo,Venezuela,False,7,-3,Brazil
23579,25360,26983,2004,Angola,Zimbabwe,1,0,FIFA World Cup qualification,Luanda,Angola,False,1,1,Angola
23580,25361,26984,2004,Benin,Ivory Coast,0,1,FIFA World Cup qualification,Cotonou,Benin,False,1,-1,Ivory Coast
23581,25362,26985,2004,Congo,Zambia,2,3,FIFA World Cup qualification,Brazzaville,Congo,False,5,-1,Zambia
23582,25363,26986,2004,Ecuador,Chile,2,0,FIFA World Cup qualification,Quito,Ecuador,False,2,2,Ecuador
23583,25364,26987,2004,Ghana,DR Congo,0,0,FIFA World Cup qualification,Kumasi,Ghana,False,0,0,Draw
23584,25365,26988,2004,Guinea,Morocco,1,1,FIFA World Cup qualification,Conakry,Guinea,False,2,0,Draw
23585,25366,26989,2004,Liberia,Senegal,0,3,FIFA World Cup qualification,Paynesville,Liberia,False,3,-3,Senegal
23586,25367,26990,2004,Togo,Mali,1,0,FIFA World Cup qualification,Lomé,Togo,False,1,1,Togo
23587,25368,26991,2004,Trinidad and Tobago,Saint Kitts and Nevis,5,1,FIFA World Cup qualification,San Fernando,Trinidad and Tobago,False,6,4,Trinidad and Tobago
23588,25369,26992,2004,Uganda,South Africa,0,1,FIFA World Cup qualification,Kampala,Uganda,False,1,-1,South Africa
23589,25370,26993,2004,Australia,Solomon Islands,6,0,Oceania Nations Cup,Sydney,Australia,False,6,6,Australia
23590,25371,26994,2004,Bolivia,Uruguay,0,0,FIFA World Cup qualification,La Paz,Bolivia,False,0,0,Draw
23591,25372,26995,2004,Indonesia,Saudi Arabia,1,3,FIFA World Cup qualification,Jakarta,Indonesia,False,4,-2,Saudi Arabia
23592,25374,26997,2004,Armenia,Czech Republic,0,3,FIFA World Cup qualification,Yerevan,Armenia,False,3,-3,Czech Republic
23593,25375,26998,2004,Azerbaijan,England,0,1,FIFA World Cup qualification,Baku,Azerbaijan,False,1,-1,England
23594,25376,26999,2004,Brazil,Colombia,0,0,FIFA World Cup qualification,Maceió,Brazil,False,0,0,Draw
23595,25377,27000,2004,Bulgaria,Malta,4,1,FIFA World Cup qualification,Sofia,Bulgaria,False,5,3,Bulgaria
23596,25378,27001,2004,Canada,Costa Rica,1,3,FIFA World Cup qualification,Burnaby,Canada,False,4,-2,Costa Rica
23597,25379,27002,2004,Chile,Argentina,0,0,FIFA World Cup qualification,Santiago,Chile,False,0,0,Draw
23598,25380,27003,2004,Cyprus,France,0,2,FIFA World Cup qualification,Nicosia,Cyprus,False,2,-2,France
23599,25381,27004,2004,Denmark,Turkey,1,1,FIFA World Cup qualification,Copenhagen,Denmark,False,2,0,Draw
23600,25382,27005,2004,Guatemala,Honduras,1,0,FIFA World Cup qualification,Guatemala,Guatemala,False,1,1,Guatemala
23601,25383,27006,2004,Hong Kong,Malaysia,2,0,FIFA World Cup qualification,Kowloon,Hong Kong,False,2,2,Hong Kong
23602,25384,27007,2004,Iceland,Sweden,1,4,FIFA World Cup qualification,Reykjavík,Iceland,False,5,-3,Sweden
23603,25385,27008,2004,Iraq,Uzbekistan,1,2,FIFA World Cup qualification,Amman,Jordan,True,3,-1,Uzbekistan
23604,25386,27009,2004,Republic of Ireland,Faroe Islands,2,0,FIFA World Cup qualification,Dublin,Republic of Ireland,False,2,2,Republic of Ireland
23605,25387,27010,2004,Italy,Belarus,4,3,FIFA World Cup qualification,Parma,Italy,False,7,1,Italy
23606,25388,27011,2004,Jamaica,El Salvador,0,0,FIFA World Cup qualification,Kingston,Jamaica,False,0,0,Draw
23607,25389,27012,2004,Kazakhstan,Albania,0,1,FIFA World Cup qualification,Almaty,Kazakhstan,False,1,-1,Albania
23608,25391,27015,2004,Laos,Jordan,2,3,FIFA World Cup qualification,Vientiane,Laos,False,5,-1,Jordan
23609,25392,27016,2004,Latvia,Estonia,2,2,FIFA World Cup qualification,Riga,Latvia,False,4,0,Draw
23610,25394,27018,2004,Lithuania,Spain,0,0,FIFA World Cup qualification,Vilnius,Lithuania,False,0,0,Draw
23611,25395,27019,2004,Luxembourg,Liechtenstein,0,4,FIFA World Cup qualification,Luxembourg,Luxembourg,False,4,-4,Liechtenstein
23612,25396,27020,2004,Maldives,Vietnam,3,0,FIFA World Cup qualification,Malé,Maldives,False,3,3,Maldives
23613,25397,27021,2004,Mexico,Trinidad and Tobago,3,0,FIFA World Cup qualification,Puebla,Mexico,False,3,3,Mexico
23614,25398,27022,2004,Moldova,Scotland,1,1,FIFA World Cup qualification,Chişinău,Moldova,False,2,0,Draw
23615,25399,27023,2004,Netherlands,Finland,3,1,FIFA World Cup qualification,Amsterdam,Netherlands,False,4,2,Netherlands
23616,25400,27024,2004,Northern Ireland,Austria,3,3,FIFA World Cup qualification,Belfast,Northern Ireland,False,6,0,Draw
23617,25401,27025,2004,Norway,Slovenia,3,0,FIFA World Cup qualification,Oslo,Norway,False,3,3,Norway
23618,25402,27026,2004,Oman,Japan,0,1,FIFA World Cup qualification,Muscat,Oman,False,1,-1,Japan
23619,25403,27027,2004,Paraguay,Peru,1,1,FIFA World Cup qualification,Asunción,Paraguay,False,2,0,Draw
23620,25404,27028,2004,Portugal,Russia,7,1,FIFA World Cup qualification,Lisbon,Portugal,False,8,6,Portugal
23621,25405,27029,2004,Qatar,Iran,2,3,FIFA World Cup qualification,Doha,Qatar,False,5,-1,Iran
23622,25406,27030,2004,Serbia,San Marino,5,0,FIFA World Cup qualification,Belgrade,Serbia and Montenegro,True,5,5,Serbia
23623,25407,27031,2004,Singapore,India,2,0,FIFA World Cup qualification,Singapore,Singapore,False,2,2,Singapore
23624,25408,27032,2004,Saint Kitts and Nevis,Saint Vincent and the Grenadines,0,3,FIFA World Cup qualification,Basseterre,Saint Kitts and Nevis,False,3,-3,Saint Vincent and the Grenadines
23625,25409,27033,2004,Syria,Bahrain,2,2,FIFA World Cup qualification,Damascus,Syria,False,4,0,Draw
23626,25410,27034,2004,Tajikistan,Kyrgyzstan,2,1,FIFA World Cup qualification,Dushanbe,Tajikistan,False,3,1,Tajikistan
23627,25411,27035,2004,Thailand,United Arab Emirates,3,0,FIFA World Cup qualification,Bangkok,Thailand,False,3,3,Thailand
23628,25412,27036,2004,Ukraine,Georgia,2,0,FIFA World Cup qualification,L'viv,Ukraine,False,2,2,Ukraine
23629,25413,27037,2004,United States,Panama,6,0,FIFA World Cup qualification,Washington,United States,False,6,6,United States
23630,25414,27038,2004,Wales,Poland,2,3,FIFA World Cup qualification,Cardiff,Wales,False,5,-1,Poland
23631,25415,27039,2004,Venezuela,Ecuador,3,1,FIFA World Cup qualification,San Cristóbal,Venezuela,False,4,2,Venezuela
23632,25417,27041,2004,Saint Lucia,Grenada,3,1,Friendly,Castries,Saint Lucia,False,4,2,Saint Lucia
23633,25418,27042,2004,Suriname,French Guiana,1,2,Friendly,Paramaribo,Suriname,False,3,-1,French Guiana
23634,25419,27043,2004,Ecuador,Jordan,0,3,Friendly,Tripoli,Libya,True,3,-3,Jordan
23635,25420,27044,2004,Libya,Jordan,1,0,Friendly,Tripoli,Libya,False,1,1,Libya
23636,25421,27045,2004,Nigeria,Ecuador,2,2,Friendly,Tripoli,Libya,True,4,0,Draw
23637,25422,27046,2004,Zimbabwe,Zambia,0,0,COSAFA Cup,Harare,Zimbabwe,False,0,0,Draw
23638,25423,27047,2004,Mexico,Ecuador,2,1,Friendly,East Rutherford,United States,True,3,1,Mexico
23639,25424,27048,2004,Saint Kitts and Nevis,Montserrat,6,1,CFU Caribbean Cup qualification,Basseterre,Saint Kitts and Nevis,False,7,5,Saint Kitts and Nevis
23640,25425,27049,2004,Yemen,Zambia,2,2,Friendly,Dubai,United Arab Emirates,True,4,0,Draw
23641,25426,27050,2004,Montserrat,Antigua and Barbuda,4,5,CFU Caribbean Cup qualification,Basseterre,Saint Kitts and Nevis,True,9,-1,Antigua and Barbuda
23642,25427,27051,2004,Saint Kitts and Nevis,Saint Lucia,1,1,CFU Caribbean Cup qualification,Basseterre,Saint Kitts and Nevis,False,2,0,Draw
23643,25428,27052,2004,Saint Kitts and Nevis,Antigua and Barbuda,2,0,CFU Caribbean Cup qualification,Basseterre,Saint Kitts and Nevis,False,2,2,Saint Kitts and Nevis
23644,25429,27053,2004,Kuwait,India,2,3,Friendly,Kuwait City,Kuwait,False,5,-1,India
23645,25430,27054,2004,Antigua and Barbuda,Saint Lucia,1,2,CFU Caribbean Cup qualification,Basseterre,Saint Kitts and Nevis,True,3,-1,Saint Lucia
23646,25431,27055,2004,Guadeloupe,French Guiana,0,1,CFU Caribbean Cup qualification,Fort-de-France,Martinique,True,1,-1,French Guiana
23647,25432,27056,2004,Kuwait,Kyrgyzstan,3,0,Friendly,Kuwait City,Kuwait,False,3,3,Kuwait
23648,25433,27057,2004,Martinique,Dominica,5,1,CFU Caribbean Cup qualification,Fort-de-France,Martinique,False,6,4,Martinique
23649,25434,27058,2004,Mexico,Guatemala,2,0,Friendly,San Antonio,United States,True,2,2,Mexico
23650,25435,27059,2004,United Arab Emirates,Jordan,4,0,Friendly,Abu Dhabi,United Arab Emirates,False,4,4,United Arab Emirates
23651,25436,27060,2004,Guadeloupe,Dominica,7,0,CFU Caribbean Cup qualification,Rivière-Pilote,Martinique,True,7,7,Guadeloupe
23652,25437,27061,2004,Martinique,French Guiana,0,0,CFU Caribbean Cup qualification,Rivière-Pilote,Martinique,False,0,0,Draw
23653,25438,27062,2004,Guatemala,Bolivia,1,0,Friendly,Washington,United States,True,1,1,Guatemala
23654,25439,27063,2004,Saint Kitts and Nevis,Mexico,0,5,FIFA World Cup qualification,Miami,United States,True,5,-5,Mexico
23655,25440,27064,2004,Dominica,French Guiana,0,4,CFU Caribbean Cup qualification,Fort-de-France,Martinique,True,4,-4,French Guiana
23656,25441,27065,2004,Martinique,Guadeloupe,0,0,CFU Caribbean Cup qualification,Fort-de-France,Martinique,False,0,0,Draw
23657,25442,27066,2004,Australia,Norway,2,2,Friendly,London,England,True,4,0,Draw
23658,25443,27067,2004,Iraq,Palestine,4,1,FIFA World Cup qualification,Doha,Qatar,True,5,3,Iraq
23659,25444,27068,2004,Republic of Ireland,Croatia,1,0,Friendly,Dublin,Republic of Ireland,False,1,1,Republic of Ireland
23660,25445,27069,2004,Algeria,Senegal,1,2,Friendly,Toulon,France,True,3,-1,Senegal
23661,25446,27070,2004,Andorra,Netherlands,0,3,FIFA World Cup qualification,Barcelona,Spain,True,3,-3,Netherlands
23662,25447,27071,2004,Argentina,Venezuela,3,2,FIFA World Cup qualification,Buenos Aires,Argentina,False,5,1,Argentina
23663,25448,27072,2004,Armenia,Romania,1,1,FIFA World Cup qualification,Yerevan,Armenia,False,2,0,Draw
23664,25449,27073,2004,Azerbaijan,Bulgaria,0,0,Friendly,Baku,Azerbaijan,False,0,0,Draw
23665,25450,27074,2004,Bahrain,Tajikistan,4,0,FIFA World Cup qualification,Riffa,Bahrain,False,4,4,Bahrain
23666,25451,27075,2004,Belgium,Serbia,0,2,FIFA World Cup qualification,Brussels,Belgium,False,2,-2,Serbia
23667,25452,27077,2004,Colombia,Bolivia,1,0,FIFA World Cup qualification,Barranquilla,Colombia,False,1,1,Colombia
23668,25453,27078,2004,Cyprus,Israel,1,2,FIFA World Cup qualification,Nicosia,Cyprus,False,3,-1,Israel
23669,25454,27079,2004,Ecuador,Brazil,1,0,FIFA World Cup qualification,Quito,Ecuador,False,1,1,Ecuador
23670,25455,27080,2004,France,Poland,0,0,Friendly,Saint-Denis,France,False,0,0,Draw
23671,25456,27081,2004,Georgia,Denmark,2,2,FIFA World Cup qualification,Tbilisi,Georgia,False,4,0,Draw
23672,25457,27082,2004,Germany,Cameroon,3,0,Friendly,Leipzig,Germany,False,3,3,Germany
23673,25458,27083,2004,Greece,Kazakhstan,3,1,FIFA World Cup qualification,Piraeus,Greece,False,4,2,Greece
23674,25459,27084,2004,Guatemala,Canada,0,1,FIFA World Cup qualification,Guatemala,Guatemala,False,1,-1,Canada
23675,25460,27085,2004,Honduras,Costa Rica,0,0,FIFA World Cup qualification,San Pedro Sula,Honduras,False,0,0,Draw
23676,25461,27086,2004,Indonesia,Turkmenistan,3,1,FIFA World Cup qualification,Jakarta,Indonesia,False,4,2,Indonesia
23677,25462,27087,2004,Iran,Laos,7,0,FIFA World Cup qualification,Teheran,Iran,False,7,7,Iran
23678,25463,27088,2004,Italy,Finland,1,0,Friendly,Messina,Italy,False,1,1,Italy
23679,25464,27089,2004,Japan,Singapore,1,0,FIFA World Cup qualification,Saitama,Japan,False,1,1,Japan
23680,25465,27090,2004,Kenya,Guinea,2,1,FIFA World Cup qualification,Nairobi,Kenya,False,3,1,Kenya
23681,25466,27092,2004,Kuwait,Malaysia,6,1,FIFA World Cup qualification,Kuwait City,Kuwait,False,7,5,Kuwait
23682,25467,27093,2004,Lebanon,Vietnam,0,0,FIFA World Cup qualification,Beirut,Lebanon,False,0,0,Draw
23683,25468,27094,2004,Liechtenstein,Latvia,1,3,FIFA World Cup qualification,Vaduz,Liechtenstein,False,4,-2,Latvia
23684,25469,27095,2004,Luxembourg,Portugal,0,5,FIFA World Cup qualification,Luxembourg,Luxembourg,False,5,-5,Portugal
23685,25470,27097,2004,Malta,Hungary,0,2,FIFA World Cup qualification,Attard,Malta,False,2,-2,Hungary
23686,25471,27098,2004,Mexico,Saint Kitts and Nevis,8,0,FIFA World Cup qualification,Monterrey,Mexico,False,8,8,Mexico
23687,25472,27099,2004,Morocco,Burkina Faso,4,0,Friendly,Rabat,Morocco,False,4,4,Morocco
23688,25473,27100,2004,Oman,India,0,0,FIFA World Cup qualification,Muscat,Oman,False,0,0,Draw
23689,25474,27101,2004,Panama,El Salvador,3,0,FIFA World Cup qualification,Panama City,Panama,False,3,3,Panama
23690,25475,27102,2004,Peru,Chile,2,1,FIFA World Cup qualification,Lima,Peru,False,3,1,Peru
23691,25476,27103,2004,Qatar,Jordan,2,0,FIFA World Cup qualification,Doha,Qatar,False,2,2,Qatar
23692,25477,27104,2004,Russia,Estonia,4,0,FIFA World Cup qualification,Krasnodar,Russia,False,4,4,Russia
23693,25478,27105,2004,San Marino,Lithuania,0,1,FIFA World Cup qualification,Serravalle,San Marino,False,1,-1,Lithuania
23694,25479,27106,2004,Saudi Arabia,Sri Lanka,3,0,FIFA World Cup qualification,Dammam,Saudi Arabia,False,3,3,Saudi Arabia
23695,25480,27107,2004,Scotland,Sweden,1,4,Friendly,Edinburgh,Scotland,False,5,-3,Sweden
23696,25481,27108,2004,Slovakia,Slovenia,0,0,Friendly,Trnava,Slovakia,False,0,0,Draw
23697,25482,27109,2004,South Africa,Nigeria,2,1,Friendly,Johannesburg,South Africa,False,3,1,South Africa
23698,25483,27110,2004,Spain,England,1,0,Friendly,Madrid,Spain,False,1,1,Spain
23699,25484,27111,2004,Syria,Kyrgyzstan,0,1,FIFA World Cup qualification,Damascus,Syria,False,1,-1,Kyrgyzstan
23700,25485,27112,2004,Thailand,Yemen,1,1,FIFA World Cup qualification,Bangkok,Thailand,False,2,0,Draw
23701,25486,27113,2004,Turkey,Ukraine,0,3,FIFA World Cup qualification,Istanbul,Turkey,False,3,-3,Ukraine
23702,25488,27115,2004,Uruguay,Paraguay,1,0,FIFA World Cup qualification,Montevideo,Uruguay,False,1,1,Uruguay
23703,25489,27116,2004,United States,Jamaica,1,1,FIFA World Cup qualification,Columbus,United States,False,2,0,Draw
23704,25491,27118,2004,Zambia,Angola,0,0,COSAFA Cup,Lusaka,Zambia,False,0,0,Draw
23705,25492,27119,2004,United Arab Emirates,Belarus,2,3,Friendly,Dubai,United Arab Emirates,False,5,-1,Belarus
23706,25493,27120,2004,Cayman Islands,Bermuda,1,2,CFU Caribbean Cup qualification,Kingstown,Saint Vincent and the Grenadines,True,3,-1,Bermuda
23707,25494,27121,2004,Grenada,Suriname,2,2,CFU Caribbean Cup qualification,Macoya,Trinidad and Tobago,True,4,0,Draw
23708,25495,27122,2004,Haiti,U.S. Virgin Islands,11,0,CFU Caribbean Cup qualification,Kingston,Jamaica,True,11,11,Haiti
23709,25496,27123,2004,Jamaica,Saint Martin,12,0,CFU Caribbean Cup qualification,Kingston,Jamaica,False,12,12,Jamaica
23710,25497,27124,2004,Trinidad and Tobago,Puerto Rico,5,0,CFU Caribbean Cup qualification,Macoya,Trinidad and Tobago,False,5,5,Trinidad and Tobago
23711,25498,27126,2004,Jamaica,U.S. Virgin Islands,11,1,CFU Caribbean Cup qualification,Montego Bay,Jamaica,False,12,10,Jamaica
23712,25499,27127,2004,Puerto Rico,Suriname,1,1,CFU Caribbean Cup qualification,San Fernando,Trinidad and Tobago,True,2,0,Draw
23713,25500,27128,2004,Saint Martin,Haiti,0,2,CFU Caribbean Cup qualification,Montego Bay,Jamaica,True,2,-2,Haiti
23714,25501,27129,2004,Trinidad and Tobago,Grenada,2,0,CFU Caribbean Cup qualification,San Fernando,Trinidad and Tobago,False,2,2,Trinidad and Tobago
23715,25502,27130,2004,United Arab Emirates,Kuwait,0,1,Friendly,Abu Dhabi,United Arab Emirates,False,1,-1,Kuwait
23716,25504,27132,2004,Grenada,Puerto Rico,5,2,CFU Caribbean Cup qualification,Arima,Trinidad and Tobago,True,7,3,Grenada
23717,25505,27133,2004,Jamaica,Haiti,3,1,CFU Caribbean Cup qualification,Kingston,Jamaica,False,4,2,Jamaica
23718,25506,27134,2004,Singapore,Burma,1,0,Friendly,Singapore,Singapore,False,1,1,Singapore
23719,25507,27135,2004,Trinidad and Tobago,Suriname,1,0,CFU Caribbean Cup qualification,Arima,Trinidad and Tobago,False,1,1,Trinidad and Tobago
23720,25508,27136,2004,U.S. Virgin Islands,Saint Martin,0,0,CFU Caribbean Cup qualification,Kingston,Jamaica,True,0,0,Draw
23721,25509,27137,2004,Egypt,Bulgaria,1,1,Friendly,Cairo,Egypt,False,2,0,Draw
23722,25510,27138,2004,Hungary,Slovakia,0,1,King's Cup,Bangkok,Thailand,True,1,-1,Slovakia
23723,25511,27139,2004,Singapore,Hong Kong,0,0,Friendly,Singapore,Singapore,False,0,0,Draw
23724,25512,27140,2004,Thailand,Estonia,0,0,King's Cup,Bangkok,Thailand,False,0,0,Draw
23725,25513,27141,2004,Bahrain,Finland,1,2,Prime Minister's Cup,Riffa,Bahrain,False,3,-1,Finland
23726,25514,27142,2004,Latvia,Oman,2,3,Prime Minister's Cup,Riffa,Bahrain,True,5,-1,Oman
23727,25515,27143,2004,Qatar,Lebanon,4,1,Friendly,Doha,Qatar,False,5,3,Qatar
23728,25516,27144,2004,Hong Kong,Burma,2,2,Friendly,Singapore,Singapore,True,4,0,Draw
23729,25517,27145,2004,Hungary,Estonia,5,0,King's Cup,Bangkok,Thailand,True,5,5,Hungary
23730,25518,27146,2004,Thailand,Slovakia,1,1,King's Cup,Bangkok,Thailand,False,2,0,Draw
23731,25519,27147,2004,Bahrain,Latvia,2,2,Prime Minister's Cup,Riffa,Bahrain,False,4,0,Draw
23732,25520,27148,2004,Finland,Oman,0,0,Prime Minister's Cup,Riffa,Bahrain,True,0,0,Draw
23733,25521,27149,2004,Iraq,Yemen,3,1,Friendly,Dubai,United Arab Emirates,True,4,2,Iraq
23734,25522,27150,2004,United Arab Emirates,Kuwait,1,1,Friendly,Dubai,United Arab Emirates,False,2,0,Draw
23735,25523,27151,2004,Qatar,Yemen,3,0,Friendly,Doha,Qatar,False,3,3,Qatar
23736,25524,27152,2004,Kuwait,Tajikistan,3,0,Friendly,Kuwait City,Kuwait,False,3,3,Kuwait
23737,25525,27153,2004,Laos,Indonesia,0,6,AFF Championship,Ho Chi Minh City,Vietnam,True,6,-6,Indonesia
23738,25526,27154,2004,Vietnam,Singapore,1,1,AFF Championship,Ho Chi Minh City,Vietnam,False,2,0,Draw
23739,25527,27155,2004,Malaysia,East Timor,5,0,AFF Championship,Kuala Lumpur,Malaysia,False,5,5,Malaysia
23740,25528,27156,2004,Philippines,Burma,0,1,AFF Championship,Kuala Lumpur,Malaysia,True,1,-1,Burma
23741,25529,27157,2004,Indonesia,Singapore,0,0,AFF Championship,Ho Chi Minh City,Vietnam,True,0,0,Draw
23742,25530,27158,2004,Vietnam,Cambodia,9,1,AFF Championship,Ho Chi Minh City,Vietnam,False,10,8,Vietnam
23743,25531,27159,2004,Iraq,Oman,1,3,Gulf Cup,Doha,Qatar,True,4,-2,Oman
23744,25532,27160,2004,Malaysia,Philippines,4,1,AFF Championship,Kuala Lumpur,Malaysia,False,5,3,Malaysia
23745,25533,27161,2004,Qatar,United Arab Emirates,2,2,Gulf Cup,Doha,Qatar,False,4,0,Draw
23746,25534,27162,2004,Thailand,Burma,1,1,AFF Championship,Kuala Lumpur,Malaysia,True,2,0,Draw
23747,25535,27163,2004,Bahrain,Yemen,1,1,Gulf Cup,Rayyan,Qatar,True,2,0,Draw
23748,25536,27164,2004,Ethiopia,Burundi,2,1,CECAFA Cup,Addis Abeba,Ethiopia,False,3,1,Ethiopia
23749,25537,27165,2004,Laos,Cambodia,2,1,AFF Championship,Hanoi,Vietnam,True,3,1,Laos
23750,25539,27167,2004,Saudi Arabia,Kuwait,1,2,Gulf Cup,Rayyan,Qatar,True,3,-1,Kuwait
23751,25540,27168,2004,Vietnam,Indonesia,0,3,AFF Championship,Hanoi,Vietnam,False,3,-3,Indonesia
23752,25541,27170,2004,Cuba,Martinique,2,0,CFU Caribbean Cup qualification,Havana,Cuba,False,2,2,Cuba
23753,25542,27171,2004,East Timor,Thailand,0,8,AFF Championship,Kuala Lumpur,Malaysia,True,8,-8,Thailand
23754,25543,27172,2004,Haiti,Saint Kitts and Nevis,1,0,CFU Caribbean Cup qualification,Fort Lauderdale,United States,True,1,1,Haiti
23755,25544,27173,2004,Kenya,Sudan,2,2,CECAFA Cup,Addis Abeba,Ethiopia,True,4,0,Draw
23756,25545,27174,2004,Malaysia,Burma,0,1,AFF Championship,Kuala Lumpur,Malaysia,False,1,-1,Burma
23757,25546,27175,2004,Saint Lucia,Jamaica,1,1,CFU Caribbean Cup qualification,Vieux Fort,Saint Lucia,False,2,0,Draw
23758,25547,27176,2004,Uganda,Somalia,2,0,CECAFA Cup,Addis Abeba,Ethiopia,True,2,2,Uganda
23759,25548,27177,2004,Burundi,Rwanda,3,1,CECAFA Cup,Addis Abeba,Ethiopia,True,4,2,Burundi
23760,25549,27178,2004,Indonesia,Cambodia,8,0,AFF Championship,Hanoi,Vietnam,True,8,8,Indonesia
23761,25550,27179,2004,Oman,United Arab Emirates,2,1,Gulf Cup,Doha,Qatar,True,3,1,Oman
23762,25551,27180,2004,Qatar,Iraq,3,3,Gulf Cup,Doha,Qatar,False,6,0,Draw
23763,25552,27181,2004,Singapore,Laos,6,2,AFF Championship,Hanoi,Vietnam,True,8,4,Singapore
23764,25553,27183,2004,Kuwait,Bahrain,1,1,Gulf Cup,Rayyan,Qatar,True,2,0,Draw
23765,25554,27184,2004,Malaysia,Thailand,2,1,AFF Championship,Kuala Lumpur,Malaysia,False,3,1,Malaysia
23766,25555,27185,2004,Philippines,East Timor,2,1,AFF Championship,Kuala Lumpur,Malaysia,True,3,1,Philippines
23767,25556,27186,2004,Saudi Arabia,Yemen,2,0,Gulf Cup,Rayyan,Qatar,True,2,2,Saudi Arabia
23768,25557,27187,2004,Somalia,Kenya,0,1,CECAFA Cup,Addis Abeba,Ethiopia,True,1,-1,Kenya
23769,25558,27188,2004,Sudan,Uganda,2,1,CECAFA Cup,Addis Abeba,Ethiopia,True,3,1,Sudan
23770,25559,27189,2004,Cambodia,Singapore,0,3,AFF Championship,Hải Phòng,Vietnam,True,3,-3,Singapore
23771,25560,27190,2004,Ethiopia,Rwanda,0,0,CECAFA Cup,Addis Abeba,Ethiopia,False,0,0,Draw
23772,25561,27191,2004,Lesotho,Botswana,1,1,Friendly,Maseru,Lesotho,False,2,0,Draw
23773,25562,27192,2004,Saint Kitts and Nevis,Haiti,0,2,CFU Caribbean Cup qualification,Basseterre,Saint Kitts and Nevis,False,2,-2,Haiti
23774,25563,27193,2004,Tanzania,Burundi,0,2,CECAFA Cup,Addis Abeba,Ethiopia,True,2,-2,Burundi
23775,25564,27194,2004,Vietnam,Laos,3,0,AFF Championship,Hanoi,Vietnam,False,3,3,Vietnam
23776,25565,27195,2004,Burma,East Timor,3,1,AFF Championship,Kuala Lumpur,Malaysia,True,4,2,Burma
23777,25566,27196,2004,Iraq,United Arab Emirates,1,1,Gulf Cup,Rayyan,Qatar,True,2,0,Draw
23778,25567,27197,2004,Japan,Germany,0,3,Friendly,Yokohama,Japan,False,3,-3,Germany
23779,25568,27198,2004,Qatar,Oman,2,1,Gulf Cup,Doha,Qatar,False,3,1,Qatar
23780,25569,27199,2004,Thailand,Philippines,3,1,AFF Championship,Kuala Lumpur,Malaysia,True,4,2,Thailand
23781,25570,27200,2004,Bahrain,Saudi Arabia,3,0,Gulf Cup,Rayyan,Qatar,True,3,3,Bahrain
23782,25572,27202,2004,Ethiopia,Tanzania,2,0,CECAFA Cup,Addis Abeba,Ethiopia,False,2,2,Ethiopia
23783,25573,27203,2004,Kuwait,Yemen,3,0,Gulf Cup,Doha,Qatar,True,3,3,Kuwait
23784,25574,27204,2004,Iran,Panama,1,0,Friendly,Teheran,Iran,False,1,1,Iran
23785,25575,27205,2004,Kenya,Uganda,1,1,CECAFA Cup,Addis Abeba,Ethiopia,True,2,0,Draw
23786,25576,27206,2004,Maldives,Sri Lanka,0,0,Friendly,Malé,Maldives,False,0,0,Draw
23787,25577,27207,2004,Sudan,Somalia,4,0,CECAFA Cup,Addis Abeba,Ethiopia,True,4,4,Sudan
23788,25579,27209,2004,Jamaica,Saint Lucia,2,1,CFU Caribbean Cup qualification,Kingston,Jamaica,False,3,1,Jamaica
23789,25580,27211,2004,Tanzania,Rwanda,1,5,CECAFA Cup,Addis Abeba,Ethiopia,True,6,-4,Rwanda
23790,25582,27213,2004,Oman,Bahrain,3,2,Gulf Cup,Rayyan,Qatar,True,5,1,Oman
23791,25583,27214,2004,Qatar,Kuwait,2,0,Gulf Cup,Doha,Qatar,False,2,2,Qatar
23792,25584,27215,2004,Martinique,Cuba,0,2,CFU Caribbean Cup qualification,Fort-de-France,Martinique,False,2,-2,Cuba
23793,25585,27216,2004,Thailand,Germany,1,5,Friendly,Bangkok,Thailand,False,6,-4,Germany
23794,25586,27217,2004,Venezuela,Guatemala,0,1,Friendly,Caracas,Venezuela,False,1,-1,Guatemala
23795,25587,27218,2004,Ethiopia,Kenya,2,2,CECAFA Cup,Addis Abeba,Ethiopia,False,4,0,Draw
23796,25588,27219,2004,Sudan,Burundi,1,2,CECAFA Cup,Addis Abeba,Ethiopia,True,3,-1,Burundi
23797,25589,27220,2004,Bahrain,Kuwait,3,1,Gulf Cup,Doha,Qatar,True,4,2,Bahrain
23798,25590,27221,2004,Qatar,Oman,1,1,Gulf Cup,Doha,Qatar,False,2,0,Draw
23799,25591,27222,2004,Ethiopia,Burundi,3,0,CECAFA Cup,Addis Abeba,Ethiopia,False,3,3,Ethiopia
23800,25592,27223,2004,Kenya,Sudan,1,2,CECAFA Cup,Addis Abeba,Ethiopia,True,3,-1,Sudan
23801,25593,27224,2004,Indonesia,Malaysia,1,2,AFF Championship,Jakarta,Indonesia,False,3,-1,Malaysia
23802,25594,27225,2004,Burma,Singapore,3,4,AFF Championship,Kuala Lumpur,Malaysia,True,7,-1,Singapore
23803,25595,27229,2005,Singapore,Burma,4,2,AFF Championship,Singapore,Singapore,False,6,2,Singapore
23804,25596,27230,2005,Malaysia,Indonesia,1,4,AFF Championship,Kuala Lumpur,Malaysia,False,5,-3,Indonesia
23805,25597,27231,2005,Egypt,Uganda,3,0,Friendly,Cairo,Egypt,False,3,3,Egypt
23806,25598,27232,2005,Indonesia,Singapore,1,3,AFF Championship,Jakarta,Indonesia,False,4,-2,Singapore
23807,25599,27233,2005,Jamaica,French Guiana,5,0,CFU Caribbean Cup qualification,Kingston,Jamaica,False,5,5,Jamaica
23808,25600,27234,2005,Haiti,Cuba,0,1,CFU Caribbean Cup qualification,Port-au-Prince,Haiti,False,1,-1,Cuba
23809,25601,27235,2005,Antigua and Barbuda,Trinidad and Tobago,2,1,Friendly,St. John's,Antigua and Barbuda,False,3,1,Antigua and Barbuda
23810,25602,27236,2005,Costa Rica,Haiti,3,3,Friendly,San José,Costa Rica,False,6,0,Draw
23811,25604,27238,2005,French Guiana,Jamaica,0,0,CFU Caribbean Cup qualification,Cayenne,French Guiana,False,0,0,Draw
23812,25605,27239,2005,Malaysia,Burma,2,1,AFF Championship,Singapore,Singapore,True,3,1,Malaysia
23813,25606,27240,2005,Cuba,Haiti,1,1,CFU Caribbean Cup qualification,Havana,Cuba,False,2,0,Draw
23814,25607,27241,2005,Singapore,Indonesia,2,1,AFF Championship,Singapore,Singapore,False,3,1,Singapore
23815,25608,27242,2005,Guatemala,Colombia,1,1,Friendly,Los Angeles,United States,True,2,0,Draw
23816,25610,27244,2005,Trinidad and Tobago,Azerbaijan,1,0,Friendly,Port of Spain,Trinidad and Tobago,False,1,1,Trinidad and Tobago
23817,25611,27245,2005,Kuwait,Norway,1,1,Friendly,Kuwait City,Kuwait,False,2,0,Draw
23818,25613,27247,2005,Barbados,Grenada,3,0,Friendly,Bridgetown,Barbados,False,3,3,Barbados
23819,25614,27248,2005,Guatemala,Paraguay,1,2,Friendly,Los Angeles,United States,True,3,-1,Paraguay
23820,25615,27249,2005,Trinidad and Tobago,Azerbaijan,2,0,Friendly,San Fernando,Trinidad and Tobago,False,2,2,Trinidad and Tobago
23821,25616,27250,2005,Bahrain,Norway,0,1,Friendly,Riffa,Bahrain,False,1,-1,Norway
23822,25617,27251,2005,Saudi Arabia,Tajikistan,3,0,Friendly,Riyadh,Saudi Arabia,False,3,3,Saudi Arabia
23823,25618,27252,2005,Ecuador,Panama,2,0,Friendly,Ambato,Ecuador,False,2,2,Ecuador
23824,25619,27253,2005,Kuwait,Syria,3,2,Friendly,Kuwait City,Kuwait,False,5,1,Kuwait
23825,25620,27254,2005,Mexico,Sweden,0,0,Friendly,San Diego,United States,True,0,0,Draw
23826,25621,27255,2005,Jordan,Norway,0,0,Friendly,Amman,Jordan,False,0,0,Draw
23827,25622,27256,2005,Ecuador,Panama,2,0,Friendly,Babahoyo,Ecuador,False,2,2,Ecuador
23828,25623,27257,2005,Japan,Kazakhstan,4,0,Friendly,Yokohama,Japan,False,4,4,Japan
23829,25624,27258,2005,Saudi Arabia,Turkmenistan,1,0,Friendly,Riyadh,Saudi Arabia,False,1,1,Saudi Arabia
23830,25625,27259,2005,Trinidad and Tobago,Haiti,1,0,Friendly,Port of Spain,Trinidad and Tobago,False,1,1,Trinidad and Tobago
23831,25626,27260,2005,Bahrain,Lebanon,2,1,Friendly,Doha,Qatar,True,3,1,Bahrain
23832,25627,27261,2005,Hungary,Saudi Arabia,0,0,Friendly,Istanbul,Turkey,True,0,0,Draw
23833,25628,27262,2005,Iran,Bosnia and Herzegovina,2,1,Friendly,Teheran,Iran,False,3,1,Iran
23834,25629,27263,2005,Japan,Syria,3,0,Friendly,Saitama,Japan,False,3,3,Japan
23835,25630,27265,2005,Gabon,Central African Republic,4,0,Friendly,Libreville,Gabon,False,4,4,Gabon
23836,25631,27266,2005,Trinidad and Tobago,Haiti,2,1,Friendly,Port of Spain,Trinidad and Tobago,False,3,1,Trinidad and Tobago
23837,25632,27268,2005,Central African Republic,Congo,0,1,Friendly,Libreville,Gabon,True,1,-1,Congo
23838,25633,27269,2005,Barbados,Antigua and Barbuda,3,2,Friendly,Bridgetown,Barbados,False,5,1,Barbados
23839,25634,27270,2005,Trinidad and Tobago,Haiti,0,1,Friendly,Scarborough,Trinidad and Tobago,False,1,-1,Haiti
23840,25635,27271,2005,Cyprus,Austria,1,1,Cyprus International Tournament,Limassol,Cyprus,False,2,0,Draw
23841,25636,27272,2005,Gabon,Congo,1,0,Friendly,Libreville,Gabon,False,1,1,Gabon
23842,25637,27273,2005,Ivory Coast,DR Congo,2,2,Friendly,Rouen,France,True,4,0,Draw
23843,25638,27274,2005,Latvia,Finland,1,2,Cyprus International Tournament,Nicosia,Cyprus,True,3,-1,Finland
23844,25639,27275,2005,Albania,Ukraine,0,2,FIFA World Cup qualification,Tirana,Albania,False,2,-2,Ukraine
23845,25640,27276,2005,Algeria,Burkina Faso,3,0,Friendly,Algiers,Algeria,False,3,3,Algeria
23846,25641,27277,2005,Austria,Latvia,1,1,Cyprus International Tournament,Limassol,Cyprus,True,2,0,Draw
23847,25642,27278,2005,Azerbaijan,Moldova,0,0,Friendly,Baku,Azerbaijan,False,0,0,Draw
23848,25643,27279,2005,Bahrain,Iran,0,0,FIFA World Cup qualification,Riffa,Bahrain,False,0,0,Draw
23849,25644,27280,2005,Bulgaria,Serbia,0,0,Friendly,Sofia,Bulgaria,False,0,0,Draw
23850,25645,27281,2005,Cameroon,Senegal,1,0,Friendly,Créteil,France,True,1,1,Cameroon
23851,25646,27282,2005,Chile,Ecuador,3,0,Friendly,Viña del Mar,Chile,False,3,3,Chile
23852,25647,27283,2005,Costa Rica,Mexico,1,2,FIFA World Cup qualification,San José,Costa Rica,False,3,-1,Mexico
23853,25648,27284,2005,Cyprus,Finland,1,2,Cyprus International Tournament,Nicosia,Cyprus,False,3,-1,Finland
23854,25649,27285,2005,Egypt,Belgium,4,0,Friendly,Cairo,Egypt,False,4,4,Egypt
23855,25650,27286,2005,England,Netherlands,0,0,Friendly,Birmingham,England,False,0,0,Draw
23856,25651,27287,2005,France,Sweden,1,1,Friendly,Saint-Denis,France,False,2,0,Draw
23857,25652,27288,2005,Georgia,Lithuania,1,0,Friendly,Tbilisi,Georgia,False,1,1,Georgia
23858,25653,27289,2005,Germany,Argentina,2,2,Friendly,Düsseldorf,Germany,False,4,0,Draw
23859,25654,27290,2005,Greece,Denmark,2,1,FIFA World Cup qualification,Piraeus,Greece,False,3,1,Greece
23860,25655,27291,2005,Guinea,Mali,2,2,Friendly,Saint-Denis,France,True,4,0,Draw
23861,25656,27292,2005,Hong Kong,Brazil,1,7,Lunar New Year Cup,So Kon Po,Hong Kong,False,8,-6,Brazil
23862,25657,27293,2005,Republic of Ireland,Portugal,1,0,Friendly,Dublin,Republic of Ireland,False,1,1,Republic of Ireland
23863,25658,27294,2005,Israel,Croatia,3,3,Friendly,Jerusalem,Israel,False,6,0,Draw
23864,25659,27295,2005,Italy,Russia,2,0,Friendly,Cagliari,Italy,False,2,2,Italy
23865,25661,27299,2005,Malta,Norway,0,3,Friendly,Attard,Malta,False,3,-3,Norway
23866,25662,27300,2005,Morocco,Kenya,5,1,FIFA World Cup qualification,Rabat,Morocco,False,6,4,Morocco
23867,25663,27301,2005,Northern Ireland,Canada,0,1,Friendly,Belfast,Northern Ireland,False,1,-1,Canada
23868,25664,27302,2005,Panama,Guatemala,0,0,FIFA World Cup qualification,Panama City,Panama,False,0,0,Draw
23869,25665,27303,2005,Poland,Belarus,1,3,Friendly,Grodzisk Wielkopolski,Poland,False,4,-2,Belarus
23870,25666,27304,2005,Romania,Slovakia,2,2,Friendly,Larnaca,Cyprus,True,4,0,Draw
23871,25667,27305,2005,Slovenia,Czech Republic,0,3,Friendly,Celje,Slovenia,False,3,-3,Czech Republic
23872,25668,27306,2005,South Africa,Australia,1,1,Friendly,Durban,South Africa,False,2,0,Draw
23873,25669,27307,2005,Spain,San Marino,5,0,FIFA World Cup qualification,Almería,Spain,False,5,5,Spain
23874,25670,27308,2005,Trinidad and Tobago,United States,1,2,FIFA World Cup qualification,Port of Spain,Trinidad and Tobago,False,3,-1,United States
23875,25671,27309,2005,United Arab Emirates,Switzerland,1,2,Friendly,Dubai,United Arab Emirates,False,3,-1,Switzerland
23876,25672,27310,2005,Uzbekistan,Saudi Arabia,1,1,FIFA World Cup qualification,Tashkent,Uzbekistan,False,2,0,Draw
23877,25673,27311,2005,Venezuela,Estonia,3,0,Friendly,Maracaibo,Venezuela,False,3,3,Venezuela
23878,25674,27312,2005,Wales,Hungary,2,0,Friendly,Cardiff,Wales,False,2,2,Wales
23879,25675,27313,2005,Gabon,Chad,2,3,Friendly,Libreville,Gabon,False,5,-1,Chad
23880,25676,27314,2005,Gabon,Congo,2,1,Friendly,Libreville,Gabon,False,3,1,Gabon
23881,25677,27315,2005,Barbados,Guyana,3,3,Friendly,Bridgetown,Barbados,False,6,0,Draw
23882,25678,27316,2005,Guatemala,Haiti,2,1,Friendly,Fort Lauderdale,United States,True,3,1,Guatemala
23883,25679,27317,2005,Costa Rica,Ecuador,1,2,Friendly,Heredia,Costa Rica,False,3,-1,Ecuador
23884,25680,27318,2005,El Salvador,Panama,0,1,UNCAF Cup,Guatemala,Guatemala,True,1,-1,Panama
23885,25681,27319,2005,Guatemala,Belize,2,0,UNCAF Cup,Guatemala,Guatemala,False,2,2,Guatemala
23886,25682,27320,2005,Honduras,Nicaragua,5,1,UNCAF Cup,Guatemala,Guatemala,True,6,4,Honduras
23887,25683,27321,2005,Barbados,Cuba,0,3,CFU Caribbean Cup,Bridgetown,Barbados,False,3,-3,Cuba
23888,25684,27322,2005,Jamaica,Trinidad and Tobago,2,1,CFU Caribbean Cup,Bridgetown,Barbados,True,3,1,Jamaica
23889,25685,27323,2005,Belize,Honduras,0,4,UNCAF Cup,Guatemala,Guatemala,True,4,-4,Honduras
23890,25686,27324,2005,Costa Rica,El Salvador,2,1,UNCAF Cup,Guatemala,Guatemala,True,3,1,Costa Rica
23891,25687,27325,2005,Guatemala,Nicaragua,4,0,UNCAF Cup,Guatemala,Guatemala,False,4,4,Guatemala
23892,25688,27326,2005,Barbados,Jamaica,0,1,CFU Caribbean Cup,Bridgetown,Barbados,False,1,-1,Jamaica
23893,25689,27327,2005,Congo,Angola,0,2,Friendly,Brazzaville,Congo,False,2,-2,Angola
23894,25690,27328,2005,Trinidad and Tobago,Cuba,1,2,CFU Caribbean Cup,Bridgetown,Barbados,True,3,-1,Cuba
23895,25691,27329,2005,Guatemala,Honduras,1,1,UNCAF Cup,Guatemala,Guatemala,False,2,0,Draw
23896,25692,27330,2005,Mexico,Colombia,1,1,Friendly,Culiacán,Mexico,False,2,0,Draw
23897,25693,27331,2005,Nicaragua,Belize,1,0,UNCAF Cup,Guatemala,Guatemala,True,1,1,Nicaragua
23898,25694,27332,2005,Panama,Costa Rica,0,1,UNCAF Cup,Guatemala,Guatemala,True,1,-1,Costa Rica
23899,25695,27333,2005,Barbados,Trinidad and Tobago,2,3,CFU Caribbean Cup,Bridgetown,Barbados,False,5,-1,Trinidad and Tobago
23900,25696,27334,2005,Cuba,Jamaica,0,1,CFU Caribbean Cup,Bridgetown,Barbados,True,1,-1,Jamaica
23901,25697,27335,2005,Guatemala,Costa Rica,0,4,UNCAF Cup,Guatemala,Guatemala,False,4,-4,Costa Rica
23902,25698,27336,2005,Honduras,Panama,1,0,UNCAF Cup,Guatemala,Guatemala,True,1,1,Honduras
23903,25699,27337,2005,Botswana,Zambia,0,0,Friendly,Gaborone,Botswana,False,0,0,Draw
23904,25700,27338,2005,Mauritius,Madagascar,2,0,COSAFA Cup,Curepipe,Mauritius,False,2,2,Mauritius
23905,25701,27339,2005,Seychelles,South Africa,0,3,COSAFA Cup,Curepipe,Mauritius,True,3,-3,South Africa
23906,25702,27340,2005,Costa Rica,Honduras,1,1,UNCAF Cup,Guatemala,Guatemala,True,2,0,Draw
23907,25703,27341,2005,Guatemala,Panama,3,0,UNCAF Cup,Guatemala,Guatemala,False,3,3,Guatemala
23908,25704,27342,2005,Malawi,Zimbabwe,2,1,Friendly,Blantyre,Malawi,False,3,1,Malawi
23909,25705,27343,2005,Mauritius,South Africa,0,1,COSAFA Cup,Curepipe,Mauritius,False,1,-1,South Africa
23910,25706,27344,2005,Hong Kong,Mongolia,6,0,EAFF Championship,Taipei,Chinese Taipei,True,6,6,Hong Kong
23911,25707,27345,2005,Guam,Hong Kong,0,15,EAFF Championship,Taipei,Chinese Taipei,True,15,-15,Hong Kong
23912,25708,27347,2005,Mexico,Argentina,1,1,Friendly,Los Angeles,United States,True,2,0,Draw
23913,25709,27348,2005,Mongolia,Guam,4,1,EAFF Championship,Taipei,Chinese Taipei,True,5,3,Mongolia
23914,25710,27349,2005,United States,Colombia,3,0,Friendly,Fullerton,United States,False,3,3,United States
23915,25712,27351,2005,Kenya,Rwanda,1,1,Friendly,Nairobi,Kenya,False,2,0,Draw
23916,25713,27352,2005,Kuwait,Finland,0,1,Friendly,Kuwait City,Kuwait,False,1,-1,Finland
23917,25714,27353,2005,Sudan,Ethiopia,3,1,Friendly,Khartoum,Sudan,False,4,2,Sudan
23918,25716,27355,2005,Saudi Arabia,Egypt,0,1,Friendly,Dammam,Saudi Arabia,False,1,-1,Egypt
23919,25717,27356,2005,Zimbabwe,Botswana,1,1,Friendly,Harare,Zimbabwe,False,2,0,Draw
23920,25718,27357,2005,Kuwait,Armenia,3,1,Friendly,al-Ain,United Arab Emirates,True,4,2,Kuwait
23921,25719,27358,2005,Saudi Arabia,Finland,1,4,Friendly,Dammam,Saudi Arabia,False,5,-3,Finland
23922,25720,27359,2005,Gabon,Congo,0,0,Friendly,Libreville,Gabon,False,0,0,Draw
23923,25721,27360,2005,Lesotho,Namibia,1,2,Friendly,Maseru,Lesotho,False,3,-1,Namibia
23924,25722,27361,2005,United States,Honduras,1,0,Friendly,Albuquerque,United States,False,1,1,United States
23925,25723,27363,2005,Kenya,Ghana,2,2,Friendly,Nairobi,Kenya,False,4,0,Draw
23926,25724,27364,2005,Iran,Japan,2,1,FIFA World Cup qualification,Teheran,Iran,False,3,1,Iran
23927,25725,27366,2005,Kuwait,Uzbekistan,2,1,FIFA World Cup qualification,Kuwait City,Kuwait,False,3,1,Kuwait
23928,25727,27368,2005,Armenia,Andorra,2,1,FIFA World Cup qualification,Yerevan,Armenia,False,3,1,Armenia
23929,25728,27369,2005,Australia,Iraq,2,1,Friendly,Sydney,Australia,False,3,1,Australia
23930,25729,27370,2005,Belgium,Bosnia and Herzegovina,4,1,FIFA World Cup qualification,Brussels,Belgium,False,5,3,Belgium
23931,25730,27371,2005,Bolivia,Argentina,1,2,FIFA World Cup qualification,La Paz,Bolivia,False,3,-1,Argentina
23932,25731,27372,2005,Bulgaria,Sweden,0,3,FIFA World Cup qualification,Sofia,Bulgaria,False,3,-3,Sweden
23933,25733,27374,2005,Chile,Uruguay,1,1,FIFA World Cup qualification,Santiago,Chile,False,2,0,Draw
23934,25734,27375,2005,Costa Rica,Panama,2,1,FIFA World Cup qualification,San José,Costa Rica,False,3,1,Costa Rica
23935,25735,27376,2005,Croatia,Iceland,4,0,FIFA World Cup qualification,Zagreb,Croatia,False,4,4,Croatia
23936,25736,27377,2005,Cyprus,Jordan,2,1,Friendly,Larnaca,Cyprus,False,3,1,Cyprus
23937,25737,27378,2005,Czech Republic,Finland,4,3,FIFA World Cup qualification,Teplice,Czech Republic,False,7,1,Czech Republic
23938,25738,27379,2005,Denmark,Kazakhstan,3,0,FIFA World Cup qualification,Copenhagen,Denmark,False,3,3,Denmark
23939,25739,27380,2005,England,Northern Ireland,4,0,FIFA World Cup qualification,Manchester,England,False,4,4,England
23940,25740,27381,2005,Estonia,Slovakia,1,2,FIFA World Cup qualification,Tallinn,Estonia,False,3,-1,Slovakia
23941,25741,27382,2005,France,Switzerland,0,0,FIFA World Cup qualification,Saint-Denis,France,False,0,0,Draw
23942,25742,27383,2005,Georgia,Greece,1,3,FIFA World Cup qualification,Tbilisi,Georgia,False,4,-2,Greece
23943,25743,27384,2005,Guatemala,Trinidad and Tobago,5,1,FIFA World Cup qualification,Guatemala,Guatemala,False,6,4,Guatemala
23944,25744,27385,2005,Israel,Republic of Ireland,1,1,FIFA World Cup qualification,Ramat-Gan,Israel,False,2,0,Draw
23945,25745,27386,2005,Italy,Scotland,2,0,FIFA World Cup qualification,Milan,Italy,False,2,2,Italy
23946,25746,27387,2005,Kenya,Botswana,1,0,FIFA World Cup qualification,Nairobi,Kenya,False,1,1,Kenya
23947,25747,27388,2005,Liechtenstein,Russia,1,2,FIFA World Cup qualification,Vaduz,Liechtenstein,False,3,-1,Russia
23948,25748,27389,2005,Morocco,Guinea,1,0,FIFA World Cup qualification,Rabat,Morocco,False,1,1,Morocco
23949,25749,27390,2005,Nigeria,Gabon,2,0,FIFA World Cup qualification,Port Harcourt,Nigeria,False,2,2,Nigeria
23950,25750,27391,2005,Poland,Azerbaijan,8,0,FIFA World Cup qualification,Warsaw,Poland,False,8,8,Poland
23951,25751,27392,2005,Portugal,Canada,4,1,Friendly,Barcelos,Portugal,False,5,3,Portugal
23952,25752,27393,2005,Romania,Netherlands,0,2,FIFA World Cup qualification,Bucharest,Romania,False,2,-2,Netherlands
23953,25753,27394,2005,Senegal,Liberia,6,1,FIFA World Cup qualification,Dakar,Senegal,False,7,5,Senegal
23954,25754,27395,2005,Slovenia,Germany,0,1,Friendly,Celje,Slovenia,False,1,-1,Germany
23955,25755,27396,2005,South Africa,Uganda,2,1,FIFA World Cup qualification,Johannesburg,South Africa,False,3,1,South Africa
23956,25757,27398,2005,Tunisia,Malawi,7,0,FIFA World Cup qualification,Radès,Tunisia,False,7,7,Tunisia
23957,25758,27399,2005,Turkey,Albania,2,0,FIFA World Cup qualification,Istanbul,Turkey,False,2,2,Turkey
23958,25759,27400,2005,Venezuela,Colombia,0,0,FIFA World Cup qualification,Maracaibo,Venezuela,False,0,0,Draw
23959,25760,27401,2005,Wales,Austria,0,2,FIFA World Cup qualification,Cardiff,Wales,False,2,-2,Austria
23960,25761,27402,2005,Zambia,Congo,2,0,FIFA World Cup qualification,Chililabombwe,Zambia,False,2,2,Zambia
23961,25762,27403,2005,Algeria,Rwanda,1,0,FIFA World Cup qualification,Oran,Algeria,False,1,1,Algeria
23962,25763,27404,2005,Brazil,Peru,1,0,FIFA World Cup qualification,Goiânia,Brazil,False,1,1,Brazil
23963,25764,27405,2005,Cameroon,Sudan,2,1,FIFA World Cup qualification,Yaoundé,Cameroon,False,3,1,Cameroon
23964,25765,27406,2005,DR Congo,Ghana,1,1,FIFA World Cup qualification,Kinshasa,DR Congo,False,2,0,Draw
23965,25766,27407,2005,Ecuador,Paraguay,5,2,FIFA World Cup qualification,Quito,Ecuador,False,7,3,Ecuador
23966,25767,27408,2005,Egypt,Libya,4,1,FIFA World Cup qualification,Cairo,Egypt,False,5,3,Egypt
23967,25768,27409,2005,Ivory Coast,Benin,3,0,FIFA World Cup qualification,Abidjan,Ivory Coast,False,3,3,Ivory Coast
23968,25769,27410,2005,Mali,Togo,1,2,FIFA World Cup qualification,Bamako,Mali,False,3,-1,Togo
23969,25770,27411,2005,Mexico,United States,2,1,FIFA World Cup qualification,Mexico City,Mexico,False,3,1,Mexico
23970,25771,27412,2005,Zimbabwe,Angola,2,0,FIFA World Cup qualification,Harare,Zimbabwe,False,2,2,Zimbabwe
23971,25772,27413,2005,Australia,Indonesia,3,0,Friendly,Perth,Australia,False,3,3,Australia
23972,25773,27414,2005,Bolivia,Venezuela,3,1,FIFA World Cup qualification,La Paz,Bolivia,False,4,2,Bolivia
23973,25775,27416,2005,Andorra,Czech Republic,0,4,FIFA World Cup qualification,Sant Julià de Lòria,Andorra,False,4,-4,Czech Republic
23974,25776,27417,2005,Argentina,Colombia,1,0,FIFA World Cup qualification,Buenos Aires,Argentina,False,1,1,Argentina
23975,25777,27418,2005,Austria,Wales,1,0,FIFA World Cup qualification,Vienna,Austria,False,1,1,Austria
23976,25778,27419,2005,Bosnia and Herzegovina,Lithuania,1,1,FIFA World Cup qualification,Sarajevo,Bosnia and Herzegovina,False,2,0,Draw
23977,25779,27420,2005,Croatia,Malta,3,0,FIFA World Cup qualification,Zagreb,Croatia,False,3,3,Croatia
23978,25780,27421,2005,England,Azerbaijan,2,0,FIFA World Cup qualification,Newcastle,England,False,2,2,England
23979,25781,27422,2005,Estonia,Russia,1,1,FIFA World Cup qualification,Tallinn,Estonia,False,2,0,Draw
23980,25782,27423,2005,Georgia,Turkey,2,5,FIFA World Cup qualification,Tbilisi,Georgia,False,7,-3,Turkey
23981,25783,27424,2005,Greece,Albania,2,0,FIFA World Cup qualification,Piraeus,Greece,False,2,2,Greece
23982,25784,27425,2005,Hungary,Bulgaria,1,1,FIFA World Cup qualification,Budapest,Hungary,False,2,0,Draw
23983,25785,27426,2005,Israel,France,1,1,FIFA World Cup qualification,Ramat-Gan,Israel,False,2,0,Draw
23984,25786,27427,2005,Italy,Iceland,0,0,Friendly,Padua,Italy,False,0,0,Draw
23985,25787,27428,2005,Japan,Bahrain,1,0,FIFA World Cup qualification,Saitama,Japan,False,1,1,Japan
23986,25788,27431,2005,Kuwait,Saudi Arabia,0,0,FIFA World Cup qualification,Kuwait City,Kuwait,False,0,0,Draw
23987,25789,27432,2005,Latvia,Luxembourg,4,0,FIFA World Cup qualification,Riga,Latvia,False,4,4,Latvia
23988,25790,27434,2005,Moldova,Norway,0,0,FIFA World Cup qualification,Chişinău,Moldova,False,0,0,Draw
23989,25791,27435,2005,Netherlands,Armenia,2,0,FIFA World Cup qualification,Eindhoven,Netherlands,False,2,2,Netherlands
23990,25792,27436,2005,Panama,Mexico,1,1,FIFA World Cup qualification,Panama City,Panama,False,2,0,Draw
23991,25793,27437,2005,Paraguay,Chile,2,1,FIFA World Cup qualification,Asunción,Paraguay,False,3,1,Paraguay
23992,25794,27438,2005,Peru,Ecuador,2,2,FIFA World Cup qualification,Lima,Peru,False,4,0,Draw
23993,25795,27439,2005,Poland,Northern Ireland,1,0,FIFA World Cup qualification,Warsaw,Poland,False,1,1,Poland
23994,25796,27440,2005,San Marino,Belgium,1,2,FIFA World Cup qualification,Serravalle,San Marino,False,3,-1,Belgium
23995,25797,27441,2005,Serbia,Spain,0,0,FIFA World Cup qualification,Belgrade,Serbia and Montenegro,True,0,0,Draw
23996,25798,27442,2005,Slovakia,Portugal,1,1,FIFA World Cup qualification,Bratislava,Slovakia,False,2,0,Draw
23997,25799,27443,2005,Slovenia,Belarus,1,1,FIFA World Cup qualification,Celje,Slovenia,False,2,0,Draw
23998,25800,27444,2005,Switzerland,Cyprus,1,0,FIFA World Cup qualification,Zürich,Switzerland,False,1,1,Switzerland
23999,25801,27445,2005,Trinidad and Tobago,Costa Rica,0,0,FIFA World Cup qualification,Port of Spain,Trinidad and Tobago,False,0,0,Draw
24000,25802,27446,2005,Ukraine,Denmark,1,0,FIFA World Cup qualification,Kyïv,Ukraine,False,1,1,Ukraine
24001,25803,27447,2005,Uruguay,Brazil,1,1,FIFA World Cup qualification,Montevideo,Uruguay,False,2,0,Draw
24002,25804,27448,2005,United States,Guatemala,2,0,FIFA World Cup qualification,Birmingham,United States,False,2,2,United States
24003,25805,27449,2005,Mozambique,Zimbabwe,0,3,COSAFA Cup,Windhoek,Namibia,True,3,-3,Zimbabwe
24004,25806,27450,2005,Namibia,Botswana,1,1,COSAFA Cup,Windhoek,Namibia,False,2,0,Draw
24005,25807,27451,2005,Botswana,Zimbabwe,0,2,COSAFA Cup,Windhoek,Namibia,True,2,-2,Zimbabwe
24006,25808,27452,2005,Estonia,Norway,1,2,Friendly,Tallinn,Estonia,False,3,-1,Norway
24007,25809,27453,2005,Guatemala,Jamaica,0,1,Friendly,Atlanta,United States,True,1,-1,Jamaica
24008,25810,27454,2005,Brazil,Guatemala,3,0,Friendly,São Paulo,Brazil,False,3,3,Brazil
24009,25811,27455,2005,Mexico,Poland,1,1,Friendly,Chicago,United States,True,2,0,Draw
24010,25812,27456,2005,Guernsey,Jersey,0,0,Friendly,St. Sampson,Guernsey,False,0,0,Draw
24011,25813,27457,2005,Ecuador,Paraguay,1,0,Friendly,East Rutherford,United States,True,1,1,Ecuador
24012,25814,27458,2005,Jersey,Guernsey,3,3,Friendly,St. Helier,Jersey,False,6,0,Draw
24013,25815,27459,2005,Lithuania,Latvia,2,0,Baltic Cup,Kaunas,Lithuania,False,2,2,Lithuania
24014,25816,27460,2005,Japan,Peru,0,1,Kirin Cup,Niigata,Japan,False,1,-1,Peru
24015,25817,27461,2005,Sudan,Chad,4,1,Friendly,Khartoum,Sudan,False,5,3,Sudan
24016,25818,27462,2005,Norway,Costa Rica,1,0,Friendly,Oslo,Norway,False,1,1,Norway
24017,25819,27463,2005,Peru,United Arab Emirates,0,0,Kirin Cup,Toyota,Japan,True,0,0,Draw
24018,25820,27464,2005,Trinidad and Tobago,Bermuda,4,0,Friendly,Port of Spain,Trinidad and Tobago,False,4,4,Trinidad and Tobago
24019,25821,27465,2005,Venezuela,Panama,1,1,Friendly,Caracas,Venezuela,False,2,0,Draw
24020,25822,27466,2005,Gibraltar,Monaco,4,0,Friendly,Gibraltar,Gibraltar,False,4,4,Gibraltar
24021,25823,27467,2005,Japan,United Arab Emirates,0,1,Kirin Cup,Tokyo,Japan,False,1,-1,United Arab Emirates
24022,25824,27468,2005,Kuwait,Egypt,0,1,Friendly,Kuwait City,Kuwait,False,1,-1,Egypt
24023,25825,27469,2005,Libya,Malawi,1,1,Friendly,Tripoli,Libya,False,2,0,Draw
24024,25826,27470,2005,Saudi Arabia,Bahrain,1,1,Friendly,Riyadh,Saudi Arabia,False,2,0,Draw
24025,25827,27471,2005,Sudan,Chad,1,1,Friendly,Khartoum,Sudan,False,2,0,Draw
24026,25828,27472,2005,Trinidad and Tobago,Bermuda,1,0,Friendly,San Fernando,Trinidad and Tobago,False,1,1,Trinidad and Tobago
24027,25829,27473,2005,Tunisia,Angola,4,1,Friendly,Tunis,Tunisia,False,5,3,Tunisia
24028,25830,27474,2005,United States,England,1,2,Friendly,Chicago,United States,False,3,-1,England
24029,25831,27475,2005,Hong Kong,Macau,8,1,Friendly,Victoria,Hong Kong,False,9,7,Hong Kong
24030,25832,27476,2005,Iran,Azerbaijan,2,1,Friendly,Teheran,Iran,False,3,1,Iran
24031,25833,27477,2005,Poland,Albania,1,0,Friendly,Szczecin,Poland,False,1,1,Poland
24032,25834,27478,2005,Togo,Burkina Faso,1,0,Friendly,Lomé,Togo,False,1,1,Togo
24033,25835,27479,2005,Colombia,England,2,3,Friendly,East Rutherford,United States,True,5,-1,England
24034,25836,27480,2005,France,Hungary,2,1,Friendly,Metz,France,False,3,1,France
24035,25837,27481,2005,Gabon,Zambia,0,1,Friendly,Johannesburg,South Africa,True,1,-1,Zambia
24036,25838,27482,2005,Lesotho,Eswatini,3,4,Friendly,Maseru,Lesotho,False,7,-1,Eswatini
24037,25839,27483,2005,Finland,Denmark,0,1,Friendly,Tampere,Finland,False,1,-1,Denmark
24038,25840,27484,2005,Bahrain,Japan,0,1,FIFA World Cup qualification,Riffa,Bahrain,False,1,-1,Japan
24039,25842,27486,2005,Libya,Ivory Coast,0,0,FIFA World Cup qualification,Tripoli,Libya,False,0,0,Draw
24040,25843,27487,2005,Saudi Arabia,Kuwait,3,0,FIFA World Cup qualification,Riyadh,Saudi Arabia,False,3,3,Saudi Arabia
24041,25845,27489,2005,Albania,Georgia,3,2,FIFA World Cup qualification,Tirana,Albania,False,5,1,Albania
24042,25847,27491,2005,Azerbaijan,Poland,0,3,FIFA World Cup qualification,Baku,Azerbaijan,False,3,-3,Poland
24043,25848,27492,2005,Belarus,Slovenia,1,1,FIFA World Cup qualification,Minsk,Belarus,False,2,0,Draw
24044,25849,27493,2005,Benin,Cameroon,1,4,FIFA World Cup qualification,Cotonou,Benin,False,5,-3,Cameroon
24045,25850,27494,2005,Botswana,Tunisia,1,3,FIFA World Cup qualification,Gaborone,Botswana,False,4,-2,Tunisia
24046,25851,27495,2005,Bulgaria,Croatia,1,3,FIFA World Cup qualification,Sofia,Bulgaria,False,4,-2,Croatia
24047,25852,27497,2005,Chile,Bolivia,3,1,FIFA World Cup qualification,Santiago,Chile,False,4,2,Chile
24048,25853,27498,2005,Colombia,Peru,5,0,FIFA World Cup qualification,Barranquilla,Colombia,False,5,5,Colombia
24049,25854,27499,2005,Czech Republic,Andorra,8,1,FIFA World Cup qualification,Liberec,Czech Republic,False,9,7,Czech Republic
24050,25855,27500,2005,Ecuador,Argentina,2,0,FIFA World Cup qualification,Quito,Ecuador,False,2,2,Ecuador
24051,25856,27501,2005,Estonia,Liechtenstein,2,0,FIFA World Cup qualification,Tallinn,Estonia,False,2,2,Estonia
24052,25857,27502,2005,Faroe Islands,Switzerland,1,3,FIFA World Cup qualification,Toftir,Faroe Islands,False,4,-2,Switzerland
24053,25858,27503,2005,Guatemala,Mexico,0,2,FIFA World Cup qualification,Guatemala,Guatemala,False,2,-2,Mexico
24054,25859,27504,2005,Iceland,Hungary,2,3,FIFA World Cup qualification,Reykjavík,Iceland,False,5,-1,Hungary
24055,25860,27505,2005,Republic of Ireland,Israel,2,2,FIFA World Cup qualification,Dublin,Republic of Ireland,False,4,0,Draw
24056,25861,27506,2005,Jamaica,Honduras,0,0,Friendly,Atlanta,United States,True,0,0,Draw
24057,25862,27507,2005,Morocco,Malawi,4,1,FIFA World Cup qualification,Rabat,Morocco,False,5,3,Morocco
24058,25863,27508,2005,Netherlands,Romania,2,0,FIFA World Cup qualification,Rotterdam,Netherlands,False,2,2,Netherlands
24059,25864,27509,2005,Northern Ireland,Germany,1,4,Friendly,Belfast,Northern Ireland,False,5,-3,Germany
24060,25865,27510,2005,Norway,Italy,0,0,FIFA World Cup qualification,Oslo,Norway,False,0,0,Draw
24061,25866,27511,2005,Portugal,Slovakia,2,0,FIFA World Cup qualification,Lisbon,Portugal,False,2,2,Portugal
24062,25867,27512,2005,Russia,Latvia,2,0,FIFA World Cup qualification,St. Petersburg,Russia,False,2,2,Russia
24063,25868,27513,2005,San Marino,Bosnia and Herzegovina,1,3,FIFA World Cup qualification,Serravalle,San Marino,False,4,-2,Bosnia and Herzegovina
24064,25869,27514,2005,Scotland,Moldova,2,0,FIFA World Cup qualification,Glasgow,Scotland,False,2,2,Scotland
24065,25870,27515,2005,Serbia,Belgium,0,0,FIFA World Cup qualification,Belgrade,Serbia and Montenegro,True,0,0,Draw
24066,25871,27516,2005,Singapore,Malaysia,2,0,Friendly,Singapore,Singapore,False,2,2,Singapore
24067,25872,27517,2005,Spain,Lithuania,1,0,FIFA World Cup qualification,Valencia,Spain,False,1,1,Spain
24068,25873,27518,2005,Sweden,Malta,6,0,FIFA World Cup qualification,Gothenburg,Sweden,False,6,6,Sweden
24069,25874,27519,2005,Trinidad and Tobago,Panama,2,0,FIFA World Cup qualification,Port of Spain,Trinidad and Tobago,False,2,2,Trinidad and Tobago
24070,25875,27520,2005,Turkey,Greece,0,0,FIFA World Cup qualification,Istanbul,Turkey,False,0,0,Draw
24071,25876,27521,2005,Ukraine,Kazakhstan,2,0,FIFA World Cup qualification,Kyïv,Ukraine,False,2,2,Ukraine
24072,25877,27522,2005,United States,Costa Rica,3,0,FIFA World Cup qualification,Salt Lake City,United States,False,3,3,United States
24073,25878,27523,2005,Venezuela,Uruguay,1,1,FIFA World Cup qualification,Maracaibo,Venezuela,False,2,0,Draw
24074,25879,27524,2005,Angola,Algeria,2,1,FIFA World Cup qualification,Luanda,Angola,False,3,1,Angola
24075,25880,27525,2005,Brazil,Paraguay,4,1,FIFA World Cup qualification,Porto Alegre,Brazil,False,5,3,Brazil
24076,25881,27526,2005,Congo,Senegal,0,0,FIFA World Cup qualification,Brazzaville,Congo,False,0,0,Draw
24077,25882,27527,2005,DR Congo,Uganda,4,0,FIFA World Cup qualification,Kinshasa,DR Congo,False,4,4,DR Congo
24078,25883,27528,2005,Egypt,Sudan,6,1,FIFA World Cup qualification,Cairo,Egypt,False,7,5,Egypt
24079,25884,27529,2005,Ghana,Burkina Faso,2,1,FIFA World Cup qualification,Kumasi,Ghana,False,3,1,Ghana
24080,25885,27530,2005,Guinea,Kenya,1,0,FIFA World Cup qualification,Conakry,Guinea,False,1,1,Guinea
24081,25886,27531,2005,Mali,Liberia,4,1,FIFA World Cup qualification,Ségou,Mali,False,5,3,Mali
24082,25887,27532,2005,Rwanda,Nigeria,1,1,FIFA World Cup qualification,Kigali,Rwanda,False,2,0,Draw
24083,25888,27533,2005,Togo,Zambia,4,1,FIFA World Cup qualification,Lomé,Togo,False,5,3,Togo
24084,25889,27534,2005,Zimbabwe,Gabon,1,0,FIFA World Cup qualification,Harare,Zimbabwe,False,1,1,Zimbabwe
24085,25890,27535,2005,Peru,Uruguay,0,0,FIFA World Cup qualification,Lima,Peru,False,0,0,Draw
24086,25891,27536,2005,Argentina,Brazil,3,1,FIFA World Cup qualification,Buenos Aires,Argentina,False,4,2,Argentina
24087,25892,27537,2005,Belarus,Scotland,0,0,FIFA World Cup qualification,Minsk,Belarus,False,0,0,Draw
24088,25893,27538,2005,Chile,Venezuela,2,1,FIFA World Cup qualification,Santiago,Chile,False,3,1,Chile
24089,25894,27539,2005,Colombia,Ecuador,3,0,FIFA World Cup qualification,Barranquilla,Colombia,False,3,3,Colombia
24090,25895,27540,2005,Costa Rica,Guatemala,3,2,FIFA World Cup qualification,San José,Costa Rica,False,5,1,Costa Rica
24091,25897,27542,2005,Denmark,Albania,3,1,FIFA World Cup qualification,Copenhagen,Denmark,False,4,2,Denmark
24092,25898,27543,2005,Estonia,Portugal,0,1,FIFA World Cup qualification,Tallinn,Estonia,False,1,-1,Portugal
24093,25899,27544,2005,Faroe Islands,Republic of Ireland,0,2,FIFA World Cup qualification,Tórshavn,Faroe Islands,False,2,-2,Republic of Ireland
24094,25900,27545,2005,Finland,Netherlands,0,4,FIFA World Cup qualification,Helsinki,Finland,False,4,-4,Netherlands
24095,25901,27546,2005,Germany,Russia,2,2,Friendly,Mönchengladbach,Germany,False,4,0,Draw
24096,25902,27547,2005,Greece,Ukraine,0,1,FIFA World Cup qualification,Piraeus,Greece,False,1,-1,Ukraine
24097,25903,27548,2005,Iceland,Malta,4,1,FIFA World Cup qualification,Reykjavík,Iceland,False,5,3,Iceland
24098,25904,27549,2005,Iran,Bahrain,1,0,FIFA World Cup qualification,Teheran,Iran,False,1,1,Iran
24099,25905,27550,2005,Italy,Serbia,1,1,Friendly,Toronto,Canada,True,2,0,Draw
24100,25906,27551,2005,Jordan,Iraq,0,1,Friendly,Amman,Jordan,False,1,-1,Iraq
24101,25907,27552,2005,Kazakhstan,Turkey,0,6,FIFA World Cup qualification,Almaty,Kazakhstan,False,6,-6,Turkey
24102,25909,27555,2005,Latvia,Liechtenstein,1,0,FIFA World Cup qualification,Riga,Latvia,False,1,1,Latvia
24103,25910,27556,2005,Luxembourg,Slovakia,0,4,FIFA World Cup qualification,Luxembourg,Luxembourg,False,4,-4,Slovakia
24104,25911,27557,2005,Malaysia,Singapore,1,2,Friendly,George Town,Malaysia,False,3,-1,Singapore
24105,25912,27558,2005,Mexico,Trinidad and Tobago,2,0,FIFA World Cup qualification,Monterrey,Mexico,False,2,2,Mexico
24106,25913,27559,2005,Panama,United States,0,3,FIFA World Cup qualification,Panama City,Panama,False,3,-3,United States
24107,25914,27560,2005,Paraguay,Bolivia,4,1,FIFA World Cup qualification,Asunción,Paraguay,False,5,3,Paraguay
24108,25915,27561,2005,Romania,Armenia,3,0,FIFA World Cup qualification,Constanţa,Romania,False,3,3,Romania
24109,25916,27562,2005,Saudi Arabia,Uzbekistan,3,0,FIFA World Cup qualification,Riyadh,Saudi Arabia,False,3,3,Saudi Arabia
24110,25917,27563,2005,Spain,Bosnia and Herzegovina,1,1,FIFA World Cup qualification,Valencia,Spain,False,2,0,Draw
24111,25918,27564,2005,Sweden,Norway,2,3,Friendly,Solna,Sweden,False,5,-1,Norway
24112,25919,27565,2005,Australia,New Zealand,1,0,Friendly,London,England,True,1,1,Australia
24113,25920,27566,2005,Gambia,Guinea,2,3,Friendly,Freetown,Sierra Leone,True,5,-1,Guinea
24114,25921,27567,2005,Sierra Leone,Liberia,2,0,Friendly,Freetown,Sierra Leone,False,2,2,Sierra Leone
24115,25922,27568,2005,Ecuador,Italy,1,1,Friendly,East Rutherford,United States,True,2,0,Draw
24116,25923,27569,2005,Lesotho,Malawi,1,2,COSAFA Cup,Lusaka,Zambia,True,3,-1,Malawi
24117,25924,27570,2005,Tunisia,Guinea,2,0,FIFA World Cup qualification,Radès,Tunisia,False,2,2,Tunisia
24118,25925,27571,2005,Zambia,Eswatini,3,0,COSAFA Cup,Lusaka,Zambia,False,3,3,Zambia
24119,25926,27572,2005,Algeria,Mali,0,3,Friendly,Arles,France,True,3,-3,Mali
24120,25927,27573,2005,Pakistan,India,1,1,Friendly,Quetta,Pakistan,False,2,0,Draw
24121,25928,27574,2005,Sierra Leone,Gambia,1,0,Friendly,Freetown,Sierra Leone,False,1,1,Sierra Leone
24122,25929,27575,2005,Zambia,Malawi,2,1,COSAFA Cup,Lusaka,Zambia,False,3,1,Zambia
24123,25930,27576,2005,Sierra Leone,Guinea,2,0,Friendly,Freetown,Sierra Leone,False,2,2,Sierra Leone
24124,25931,27577,2005,Argentina,Tunisia,2,1,Confederations Cup,Cologne,Germany,True,3,1,Argentina
24125,25932,27578,2005,Germany,Australia,4,3,Confederations Cup,Frankfurt am Main,Germany,False,7,1,Germany
24126,25933,27579,2005,Brazil,Greece,3,0,Confederations Cup,Leipzig,Germany,True,3,3,Brazil
24127,25934,27580,2005,Japan,Mexico,1,2,Confederations Cup,Hanover,Germany,True,3,-1,Mexico
24128,25935,27581,2005,Pakistan,India,0,1,Friendly,Peshawar,Pakistan,False,1,-1,India
24129,25936,27582,2005,Australia,Argentina,2,4,Confederations Cup,Nuremberg,Germany,True,6,-2,Argentina
24130,25937,27583,2005,Burkina Faso,DR Congo,2,0,FIFA World Cup qualification,Ouagadougou,Burkina Faso,False,2,2,Burkina Faso
24131,25938,27584,2005,Gabon,Rwanda,3,0,FIFA World Cup qualification,Libreville,Gabon,False,3,3,Gabon
24132,25939,27585,2005,Germany,Tunisia,3,0,Confederations Cup,Cologne,Germany,False,3,3,Germany
24133,25940,27586,2005,Kenya,Morocco,0,0,FIFA World Cup qualification,Nairobi,Kenya,False,0,0,Draw
24134,25941,27587,2005,Malawi,Botswana,1,3,FIFA World Cup qualification,Blantyre,Malawi,False,4,-2,Botswana
24135,25942,27588,2005,Nigeria,Angola,1,1,FIFA World Cup qualification,Kano,Nigeria,False,2,0,Draw
24136,25943,27589,2005,Pakistan,India,3,0,Friendly,Lahore,Pakistan,False,3,3,Pakistan
24137,25944,27590,2005,Senegal,Togo,2,2,FIFA World Cup qualification,Dakar,Senegal,False,4,0,Draw
24138,25945,27591,2005,South Africa,Ghana,0,2,FIFA World Cup qualification,Johannesburg,South Africa,False,2,-2,Ghana
24139,25947,27593,2005,Zambia,Mali,2,1,FIFA World Cup qualification,Chililabombwe,Zambia,False,3,1,Zambia
24140,25948,27594,2005,Algeria,Zimbabwe,2,2,FIFA World Cup qualification,Oran,Algeria,False,4,0,Draw
24141,25949,27595,2005,Cameroon,Libya,1,0,FIFA World Cup qualification,Yaoundé,Cameroon,False,1,1,Cameroon
24142,25950,27597,2005,Greece,Japan,0,1,Confederations Cup,Frankfurt am Main,Germany,True,1,-1,Japan
24143,25951,27598,2005,Ivory Coast,Egypt,2,0,FIFA World Cup qualification,Abidjan,Ivory Coast,False,2,2,Ivory Coast
24144,25952,27599,2005,Liberia,Congo,0,2,FIFA World Cup qualification,Paynesville,Liberia,False,2,-2,Congo
24145,25953,27600,2005,Mexico,Brazil,1,0,Confederations Cup,Hanover,Germany,True,1,1,Mexico
24146,25954,27601,2005,Australia,Tunisia,0,2,Confederations Cup,Leipzig,Germany,True,2,-2,Tunisia
24147,25955,27602,2005,Germany,Argentina,2,2,Confederations Cup,Nuremberg,Germany,False,4,0,Draw
24148,25956,27604,2005,Greece,Mexico,0,0,Confederations Cup,Frankfurt am Main,Germany,True,0,0,Draw
24149,25957,27605,2005,Japan,Brazil,2,2,Confederations Cup,Cologne,Germany,True,4,0,Draw
24150,25958,27606,2005,Germany,Brazil,2,3,Confederations Cup,Nuremberg,Germany,False,5,-1,Brazil
24151,25959,27607,2005,Mexico,Argentina,1,1,Confederations Cup,Hanover,Germany,True,2,0,Draw
24152,25960,27608,2005,Mozambique,Lesotho,1,0,Friendly,Maputo,Mozambique,False,1,1,Mozambique
24153,25961,27609,2005,Brazil,Argentina,4,1,Confederations Cup,Frankfurt am Main,Germany,True,5,3,Brazil
24154,25962,27610,2005,Germany,Mexico,4,3,Confederations Cup,Leipzig,Germany,False,7,1,Germany
24155,25963,27611,2005,Botswana,DR Congo,0,0,Friendly,Gaborone,Botswana,False,0,0,Draw
24156,25964,27612,2005,Canada,Honduras,1,2,Friendly,Burnaby,Canada,False,3,-1,Honduras
24157,25965,27613,2005,Congo,Mali,1,0,FIFA World Cup qualification,Brazzaville,Congo,False,1,1,Congo
24158,25966,27614,2005,Colombia,Panama,0,1,Gold Cup,Miami,United States,True,1,-1,Panama
24159,25967,27615,2005,Trinidad and Tobago,Honduras,1,1,Gold Cup,Miami,United States,True,2,0,Draw
24160,25968,27616,2005,Canada,Costa Rica,0,1,Gold Cup,Seattle,United States,True,1,-1,Costa Rica
24161,25969,27617,2005,United States,Cuba,4,1,Gold Cup,Seattle,United States,False,5,3,United States
24162,25970,27618,2005,Guatemala,Jamaica,3,4,Gold Cup,Carson,United States,True,7,-1,Jamaica
24163,25971,27619,2005,South Africa,Mexico,2,1,Gold Cup,Carson,United States,True,3,1,South Africa
24164,25972,27620,2005,Costa Rica,Cuba,3,1,Gold Cup,Seattle,United States,True,4,2,Costa Rica
24165,25973,27621,2005,United States,Canada,2,0,Gold Cup,Seattle,United States,False,2,2,United States
24166,25974,27622,2005,Honduras,Colombia,2,1,Gold Cup,Miami,United States,True,3,1,Honduras
24167,25975,27623,2005,Jamaica,South Africa,3,3,Gold Cup,Los Angeles,United States,True,6,0,Draw
24168,25976,27624,2005,Mexico,Guatemala,4,0,Gold Cup,Los Angeles,United States,True,4,4,Mexico
24169,25977,27625,2005,Panama,Trinidad and Tobago,2,2,Gold Cup,Miami,United States,True,4,0,Draw
24170,25982,27634,2005,Canada,Cuba,2,1,Gold Cup,Foxborough,United States,True,3,1,Canada
24171,25983,27635,2005,Colombia,Trinidad and Tobago,2,0,Gold Cup,Miami,United States,True,2,2,Colombia
24172,25984,27636,2005,Honduras,Panama,1,0,Gold Cup,Miami,United States,True,1,1,Honduras
24173,25985,27637,2005,United States,Costa Rica,0,0,Gold Cup,Foxborough,United States,False,0,0,Draw
24174,25986,27639,2005,Åland Islands,Isle of Man,0,1,Island Games,Shetland,Scotland,True,1,-1,Isle of Man
24175,25987,27642,2005,Guatemala,South Africa,1,1,Gold Cup,Houston,United States,True,2,0,Draw
24176,25988,27643,2005,Mexico,Jamaica,1,0,Gold Cup,Houston,United States,True,1,1,Mexico
24177,25989,27645,2005,Falkland Islands,Isle of Man,0,9,Island Games,Shetland,Scotland,True,9,-9,Isle of Man
24178,25990,27647,2005,Greenland,Guernsey,0,6,Island Games,Shetland,Scotland,True,6,-6,Guernsey
24179,25991,27649,2005,Åland Islands,Falkland Islands,2,1,Island Games,Shetland,Scotland,True,3,1,Åland Islands
24180,25993,27653,2005,Åland Islands,Greenland,3,2,Island Games,Shetland,Scotland,True,5,1,Åland Islands
24181,25994,27657,2005,Honduras,Costa Rica,3,2,Gold Cup,Foxborough,United States,True,5,1,Honduras
24182,25995,27658,2005,United States,Jamaica,3,1,Gold Cup,Foxborough,United States,False,4,2,United States
24183,25996,27659,2005,Mexico,Colombia,1,2,Gold Cup,Houston,United States,True,3,-1,Colombia
24184,25997,27660,2005,South Africa,Panama,1,1,Gold Cup,Houston,United States,True,2,0,Draw
24185,25998,27661,2005,Colombia,Panama,2,3,Gold Cup,East Rutherford,United States,True,5,-1,Panama
24186,25999,27662,2005,United States,Honduras,2,1,Gold Cup,East Rutherford,United States,False,3,1,United States
24187,26000,27663,2005,United States,Panama,0,0,Gold Cup,East Rutherford,United States,False,0,0,Draw
24188,26001,27664,2005,Kuwait,United Arab Emirates,1,1,Friendly,Geneva,Switzerland,True,2,0,Draw
24189,26002,27665,2005,Egypt,United Arab Emirates,0,0,Friendly,Geneva,Switzerland,True,0,0,Draw
24190,26003,27668,2005,Bahrain,Turkmenistan,5,0,Friendly,Manama,Bahrain,False,5,5,Bahrain
24191,26005,27671,2005,Bahrain,Iraq,2,2,Friendly,Manama,Bahrain,False,4,0,Draw
24192,26006,27674,2005,Botswana,Angola,0,0,Friendly,Johannesburg,South Africa,True,0,0,Draw
24193,26007,27675,2005,Angola,Botswana,0,0,Friendly,Johannesburg,South Africa,True,0,0,Draw
24194,26008,27676,2005,Fiji,India,1,0,Friendly,Lautoka,Fiji,False,1,1,Fiji
24195,26009,27677,2005,Angola,Zimbabwe,1,2,COSAFA Cup,Mafikeng,South Africa,True,3,-1,Zimbabwe
24196,26010,27678,2005,Cyprus,Iraq,2,1,Friendly,Limassol,Cyprus,False,3,1,Cyprus
24197,26011,27679,2005,South Africa,Zambia,2,2,COSAFA Cup,Mafikeng,South Africa,False,4,0,Draw
24198,26012,27680,2005,Fiji,India,2,1,Friendly,Suva,Fiji,False,3,1,Fiji
24199,26013,27682,2005,Zambia,Zimbabwe,0,1,COSAFA Cup,Mafikeng,South Africa,True,1,-1,Zimbabwe
24200,26014,27683,2005,Poland,Serbia,3,2,Friendly,Kyïv,Ukraine,True,5,1,Poland
24201,26015,27684,2005,Ukraine,Israel,0,0,Friendly,Kyïv,Ukraine,False,0,0,Draw
24202,26016,27685,2005,DR Congo,Guinea,3,1,Friendly,Colombes,France,True,4,2,DR Congo
24203,26017,27686,2005,Albania,Azerbaijan,2,1,Friendly,Tirana,Albania,False,3,1,Albania
24204,26019,27688,2005,Austria,Scotland,2,2,Friendly,Graz,Austria,False,4,0,Draw
24205,26021,27690,2005,Belgium,Greece,2,0,Friendly,Brussels,Belgium,False,2,2,Belgium
24206,26022,27691,2005,Bulgaria,Turkey,3,1,Friendly,Sofia,Bulgaria,False,4,2,Bulgaria
24207,26023,27692,2005,Croatia,Brazil,1,1,Friendly,Split,Croatia,False,2,0,Draw
24208,26024,27693,2005,Denmark,England,4,1,Friendly,Copenhagen,Denmark,False,5,3,Denmark
24209,26025,27694,2005,Ecuador,Venezuela,3,1,Friendly,Loja,Ecuador,False,4,2,Ecuador
24210,26026,27695,2005,Estonia,Bosnia and Herzegovina,1,0,Friendly,Tallinn,Estonia,False,1,1,Estonia
24211,26027,27696,2005,Faroe Islands,Cyprus,0,3,FIFA World Cup qualification,Toftir,Faroe Islands,False,3,-3,Cyprus
24212,26028,27697,2005,France,Ivory Coast,3,0,Friendly,Montpellier,France,False,3,3,France
24213,26029,27698,2005,Guatemala,Panama,2,1,FIFA World Cup qualification,Guatemala,Guatemala,False,3,1,Guatemala
24214,26030,27699,2005,Hungary,Argentina,1,2,Friendly,Budapest,Hungary,False,3,-1,Argentina
24215,26031,27700,2005,Iceland,South Africa,4,1,Friendly,Reykjavík,Iceland,False,5,3,Iceland
24216,26032,27701,2005,Republic of Ireland,Italy,1,2,Friendly,Dublin,Republic of Ireland,False,3,-1,Italy
24217,26033,27702,2005,Japan,Iran,2,1,FIFA World Cup qualification,Yokohama,Japan,False,3,1,Japan
24218,26034,27703,2005,Jordan,Armenia,0,0,Friendly,Amman,Jordan,False,0,0,Draw
24219,26035,27704,2005,Kazakhstan,Georgia,1,2,FIFA World Cup qualification,Almaty,Kazakhstan,False,3,-1,Georgia
24220,26036,27706,2005,Latvia,Russia,1,1,FIFA World Cup qualification,Riga,Latvia,False,2,0,Draw
24221,26037,27707,2005,Libya,Nigeria,0,1,Friendly,Tripoli,Libya,False,1,-1,Nigeria
24222,26038,27708,2005,Liechtenstein,Slovakia,0,0,FIFA World Cup qualification,Vaduz,Liechtenstein,False,0,0,Draw
24223,26039,27709,2005,Lithuania,Belarus,1,0,Friendly,Vilnius,Lithuania,False,1,1,Lithuania
24224,26040,27711,2005,Malta,Northern Ireland,1,1,Friendly,Attard,Malta,False,2,0,Draw
24225,26041,27712,2005,Mexico,Costa Rica,2,0,FIFA World Cup qualification,Mexico City,Mexico,False,2,2,Mexico
24226,26042,27713,2005,Morocco,Togo,0,1,Friendly,Rouen,France,True,1,-1,Togo
24227,26043,27714,2005,Netherlands,Germany,2,2,Friendly,Rotterdam,Netherlands,False,4,0,Draw
24228,26044,27715,2005,Norway,Switzerland,0,2,Friendly,Oslo,Norway,False,2,-2,Switzerland
24229,26045,27716,2005,Paraguay,El Salvador,3,0,Friendly,Ciudad del Este,Paraguay,False,3,3,Paraguay
24230,26046,27717,2005,Peru,Chile,3,1,Friendly,Tacna,Peru,False,4,2,Peru
24231,26047,27718,2005,Poland,Israel,3,2,Friendly,Kyïv,Ukraine,True,5,1,Poland
24232,26048,27719,2005,Portugal,Egypt,2,0,Friendly,Ponta Delgada,Portugal,False,2,2,Portugal
24233,26049,27720,2005,Romania,Andorra,2,0,FIFA World Cup qualification,Constanţa,Romania,False,2,2,Romania
24234,26050,27721,2005,Senegal,Ghana,0,0,Friendly,London,England,True,0,0,Draw
24235,26051,27722,2005,Spain,Uruguay,2,0,Friendly,Gijón,Spain,False,2,2,Spain
24236,26052,27723,2005,Sudan,Benin,1,0,FIFA World Cup qualification,Omdurman,Sudan,False,1,1,Sudan
24237,26053,27724,2005,Sweden,Czech Republic,2,1,Friendly,Gothenburg,Sweden,False,3,1,Sweden
24238,26054,27725,2005,Tunisia,Kenya,1,0,FIFA World Cup qualification,Radès,Tunisia,False,1,1,Tunisia
24239,26055,27726,2005,Ukraine,Serbia,2,1,Friendly,Kyïv,Ukraine,False,3,1,Ukraine
24240,26056,27727,2005,United States,Trinidad and Tobago,1,0,FIFA World Cup qualification,Hartford,United States,False,1,1,United States
24241,26057,27728,2005,Uzbekistan,Kuwait,3,2,FIFA World Cup qualification,Tashkent,Uzbekistan,False,5,1,Uzbekistan
24242,26058,27729,2005,Wales,Slovenia,0,0,Friendly,Swansea,Wales,False,0,0,Draw
24243,26059,27730,2005,Iran,Libya,4,0,Friendly,Teheran,Iran,False,4,4,Iran
24244,26060,27731,2005,Zimbabwe,Mozambique,0,0,Friendly,Mutare,Zimbabwe,False,0,0,Draw
24245,26061,27732,2005,Libya,Sudan,0,0,FIFA World Cup qualification,Tripoli,Libya,False,0,0,Draw
24246,26062,27733,2005,Albania,Kazakhstan,2,1,FIFA World Cup qualification,Tirana,Albania,False,3,1,Albania
24247,26063,27734,2005,Andorra,Finland,0,0,FIFA World Cup qualification,Sant Julià de Lòria,Andorra,False,0,0,Draw
24248,26064,27735,2005,Armenia,Netherlands,0,1,FIFA World Cup qualification,Yerevan,Armenia,False,1,-1,Netherlands
24249,26065,27736,2005,Australia,Solomon Islands,7,0,FIFA World Cup qualification,Sydney,Australia,False,7,7,Australia
24250,26066,27737,2005,Bolivia,Ecuador,1,2,FIFA World Cup qualification,La Paz,Bolivia,False,3,-1,Ecuador
24251,26067,27738,2005,Bosnia and Herzegovina,Belgium,1,0,FIFA World Cup qualification,Zenica,Bosnia and Herzegovina,False,1,1,Bosnia and Herzegovina
24252,26068,27739,2005,Burkina Faso,South Africa,3,1,FIFA World Cup qualification,Ouagadougou,Burkina Faso,False,4,2,Burkina Faso
24253,26069,27740,2005,Estonia,Latvia,2,1,FIFA World Cup qualification,Tallinn,Estonia,False,3,1,Estonia
24254,26070,27741,2005,France,Faroe Islands,3,0,FIFA World Cup qualification,Lens,France,False,3,3,France
24255,26071,27742,2005,Georgia,Ukraine,1,1,FIFA World Cup qualification,Tbilisi,Georgia,False,2,0,Draw
24256,26072,27743,2005,Hungary,Malta,4,0,FIFA World Cup qualification,Budapest,Hungary,False,4,4,Hungary
24257,26073,27744,2005,Iceland,Croatia,1,3,FIFA World Cup qualification,Reykjavík,Iceland,False,4,-2,Croatia
24258,26074,27745,2005,Kenya,Tunisia,0,2,FIFA World Cup qualification,Nairobi,Kenya,False,2,-2,Tunisia
24259,26075,27746,2005,Mali,Congo,2,0,FIFA World Cup qualification,Bamako,Mali,False,2,2,Mali
24260,26076,27747,2005,Moldova,Belarus,2,0,FIFA World Cup qualification,Chişinău,Moldova,False,2,2,Moldova
24261,26077,27748,2005,Morocco,Botswana,1,0,FIFA World Cup qualification,Rabat,Morocco,False,1,1,Morocco
24262,26078,27749,2005,Northern Ireland,Azerbaijan,2,0,FIFA World Cup qualification,Belfast,Northern Ireland,False,2,2,Northern Ireland
24263,26079,27750,2005,Panama,Costa Rica,1,3,FIFA World Cup qualification,Panama City,Panama,False,4,-2,Costa Rica
24264,26080,27751,2005,Paraguay,Argentina,1,0,FIFA World Cup qualification,Asunción,Paraguay,False,1,1,Paraguay
24265,26081,27752,2005,Poland,Austria,3,2,FIFA World Cup qualification,Chorzów,Poland,False,5,1,Poland
24266,26082,27753,2005,Portugal,Luxembourg,6,0,FIFA World Cup qualification,Faro,Portugal,False,6,6,Portugal
24267,26083,27754,2005,Romania,Czech Republic,2,0,FIFA World Cup qualification,Constanţa,Romania,False,2,2,Romania
24268,26084,27755,2005,Russia,Liechtenstein,2,0,FIFA World Cup qualification,Moscow,Russia,False,2,2,Russia
24269,26085,27756,2005,Scotland,Italy,1,1,FIFA World Cup qualification,Glasgow,Scotland,False,2,0,Draw
24270,26086,27757,2005,Serbia,Lithuania,2,0,FIFA World Cup qualification,Belgrade,Serbia and Montenegro,True,2,2,Serbia
24271,26087,27758,2005,Slovakia,Germany,2,0,Friendly,Bratislava,Slovakia,False,2,2,Slovakia
24272,26088,27759,2005,Slovenia,Norway,2,3,FIFA World Cup qualification,Celje,Slovenia,False,5,-1,Norway
24273,26089,27760,2005,Spain,Canada,2,1,Friendly,Santander,Spain,False,3,1,Spain
24274,26090,27761,2005,Sweden,Bulgaria,3,0,FIFA World Cup qualification,Solna,Sweden,False,3,3,Sweden
24275,26091,27762,2005,Switzerland,Israel,1,1,FIFA World Cup qualification,Basel,Switzerland,False,2,0,Draw
24276,26092,27763,2005,Trinidad and Tobago,Guatemala,3,2,FIFA World Cup qualification,Port of Spain,Trinidad and Tobago,False,5,1,Trinidad and Tobago
24277,26093,27764,2005,Turkey,Denmark,2,2,FIFA World Cup qualification,Istanbul,Turkey,False,4,0,Draw
24278,26094,27765,2005,United States,Mexico,2,0,FIFA World Cup qualification,Columbus,United States,False,2,2,United States
24279,26095,27766,2005,Venezuela,Peru,4,1,FIFA World Cup qualification,Maracaibo,Venezuela,False,5,3,Venezuela
24280,26096,27767,2005,Wales,England,0,1,FIFA World Cup qualification,Cardiff,Wales,False,1,-1,England
24281,26097,27768,2005,Zambia,Senegal,0,1,FIFA World Cup qualification,Chililabombwe,Zambia,False,1,-1,Senegal
24282,26098,27769,2005,Algeria,Nigeria,2,5,FIFA World Cup qualification,Oran,Algeria,False,7,-3,Nigeria
24283,26099,27770,2005,Angola,Gabon,3,0,FIFA World Cup qualification,Luanda,Angola,False,3,3,Angola
24284,26100,27771,2005,Brazil,Chile,5,0,FIFA World Cup qualification,Brasília,Brazil,False,5,5,Brazil
24285,26102,27773,2005,Egypt,Benin,4,1,FIFA World Cup qualification,Cairo,Egypt,False,5,3,Egypt
24286,26103,27774,2005,Ghana,Uganda,2,0,FIFA World Cup qualification,Kumasi,Ghana,False,2,2,Ghana
24287,26104,27775,2005,Guinea,Malawi,3,1,FIFA World Cup qualification,Conakry,Guinea,False,4,2,Guinea
24288,26105,27776,2005,Ivory Coast,Cameroon,2,3,FIFA World Cup qualification,Abidjan,Ivory Coast,False,5,-1,Cameroon
24289,26106,27777,2005,Togo,Liberia,3,0,FIFA World Cup qualification,Lomé,Togo,False,3,3,Togo
24290,26107,27778,2005,Uruguay,Colombia,3,2,FIFA World Cup qualification,Montevideo,Uruguay,False,5,1,Uruguay
24291,26108,27779,2005,Zimbabwe,Rwanda,3,1,FIFA World Cup qualification,Harare,Zimbabwe,False,4,2,Zimbabwe
24292,26109,27780,2005,Solomon Islands,Australia,1,2,FIFA World Cup qualification,Honiara,Solomon Islands,False,3,-1,Australia
24293,26110,27781,2005,Azerbaijan,Austria,0,0,FIFA World Cup qualification,Baku,Azerbaijan,False,0,0,Draw
24294,26111,27782,2005,Belarus,Italy,1,4,FIFA World Cup qualification,Minsk,Belarus,False,5,-3,Italy
24295,26112,27783,2005,Belgium,San Marino,8,0,FIFA World Cup qualification,Antwerp,Belgium,False,8,8,Belgium
24296,26113,27784,2005,Bulgaria,Iceland,3,2,FIFA World Cup qualification,Sofia,Bulgaria,False,5,1,Bulgaria
24297,26114,27785,2005,Costa Rica,Trinidad and Tobago,2,0,FIFA World Cup qualification,San José,Costa Rica,False,2,2,Costa Rica
24298,26115,27786,2005,Cyprus,Switzerland,1,3,FIFA World Cup qualification,Nicosia,Cyprus,False,4,-2,Switzerland
24299,26116,27787,2005,Czech Republic,Armenia,4,1,FIFA World Cup qualification,Olomouc,Czech Republic,False,5,3,Czech Republic
24300,26117,27788,2005,Denmark,Georgia,6,1,FIFA World Cup qualification,Copenhagen,Denmark,False,7,5,Denmark
24301,26118,27789,2005,Faroe Islands,Israel,0,2,FIFA World Cup qualification,Tórshavn,Faroe Islands,False,2,-2,Israel
24302,26120,27791,2005,Germany,South Africa,4,2,Friendly,Bremen,Germany,False,6,2,Germany
24303,26121,27792,2005,Guatemala,United States,0,0,FIFA World Cup qualification,Guatemala,Guatemala,False,0,0,Draw
24304,26122,27793,2005,Hungary,Sweden,0,1,FIFA World Cup qualification,Budapest,Hungary,False,1,-1,Sweden
24305,26123,27794,2005,Republic of Ireland,France,0,1,FIFA World Cup qualification,Dublin,Republic of Ireland,False,1,-1,France
24306,26124,27795,2005,Japan,Honduras,5,4,Friendly,Rifu,Japan,False,9,1,Japan
24307,26125,27796,2005,Kazakhstan,Greece,1,2,FIFA World Cup qualification,Almaty,Kazakhstan,False,3,-1,Greece
24308,26126,27797,2005,Latvia,Slovakia,1,1,FIFA World Cup qualification,Riga,Latvia,False,2,0,Draw
24309,26127,27798,2005,Liechtenstein,Luxembourg,3,0,FIFA World Cup qualification,Vaduz,Liechtenstein,False,3,3,Liechtenstein
24310,26128,27799,2005,Lithuania,Bosnia and Herzegovina,0,1,FIFA World Cup qualification,Vilnius,Lithuania,False,1,-1,Bosnia and Herzegovina
24311,26129,27800,2005,Malta,Croatia,1,1,FIFA World Cup qualification,Attard,Malta,False,2,0,Draw
24312,26130,27801,2005,Mexico,Panama,5,0,FIFA World Cup qualification,Mexico City,Mexico,False,5,5,Mexico
24313,26131,27802,2005,Moldova,Slovenia,1,2,FIFA World Cup qualification,Chişinău,Moldova,False,3,-1,Slovenia
24314,26132,27803,2005,Netherlands,Andorra,4,0,FIFA World Cup qualification,Eindhoven,Netherlands,False,4,4,Netherlands
24315,26133,27804,2005,Northern Ireland,England,1,0,FIFA World Cup qualification,Belfast,Northern Ireland,False,1,1,Northern Ireland
24316,26134,27805,2005,Norway,Scotland,1,2,FIFA World Cup qualification,Oslo,Norway,False,3,-1,Scotland
24317,26135,27806,2005,Poland,Wales,1,0,FIFA World Cup qualification,Warsaw,Poland,False,1,1,Poland
24318,26136,27807,2005,Russia,Portugal,0,0,FIFA World Cup qualification,Moscow,Russia,False,0,0,Draw
24319,26137,27808,2005,Spain,Serbia,1,1,FIFA World Cup qualification,Madrid,Spain,False,2,0,Draw
24320,26138,27809,2005,Ukraine,Turkey,0,1,FIFA World Cup qualification,Kyïv,Ukraine,False,1,-1,Turkey
24321,26139,27810,2005,United Arab Emirates,Benin,0,0,Friendly,Dubai,United Arab Emirates,False,0,0,Draw
24322,26140,27811,2005,Malawi,Zimbabwe,2,0,Friendly,Maputo,Mozambique,True,2,2,Malawi
24323,26141,27812,2005,Mozambique,Zimbabwe,3,2,Friendly,Maputo,Mozambique,False,5,1,Mozambique
24324,26142,27813,2005,Zambia,DR Congo,2,2,Friendly,Chililabombwe,Zambia,False,4,0,Draw
24325,26143,27814,2005,DR Congo,Zambia,0,0,Friendly,Lubumbashi,DR Congo,False,0,0,Draw
24326,26144,27815,2005,Guyana,Dominica,3,0,Friendly,Linden,Guyana,False,3,3,Guyana
24327,26145,27816,2005,Guatemala,Jamaica,1,2,Friendly,Fort Lauderdale,United States,True,3,-1,Jamaica
24328,26146,27817,2005,Liberia,Zambia,0,5,FIFA World Cup qualification,Monrovia,Liberia,False,5,-5,Zambia
24329,26147,27818,2005,Guyana,Dominica,3,0,Friendly,Georgetown,Guyana,False,3,3,Guyana
24330,26148,27819,2005,Poland,Iceland,3,2,Friendly,Warsaw,Poland,False,5,1,Poland
24331,26149,27820,2005,Belgium,Spain,0,2,FIFA World Cup qualification,Brussels,Belgium,False,2,-2,Spain
24332,26150,27821,2005,Bosnia and Herzegovina,San Marino,3,0,FIFA World Cup qualification,Zenica,Bosnia and Herzegovina,False,3,3,Bosnia and Herzegovina
24333,26151,27822,2005,Botswana,Guinea,1,2,FIFA World Cup qualification,Gaborone,Botswana,False,3,-1,Guinea
24334,26152,27823,2005,Bulgaria,Hungary,2,0,FIFA World Cup qualification,Sofia,Bulgaria,False,2,2,Bulgaria
24335,26153,27824,2005,Cameroon,Egypt,1,1,FIFA World Cup qualification,Yaoundé,Cameroon,False,2,0,Draw
24336,26154,27826,2005,Colombia,Chile,1,1,FIFA World Cup qualification,Barranquilla,Colombia,False,2,0,Draw
24337,26155,27827,2005,Congo,Togo,2,3,FIFA World Cup qualification,Brazzaville,Congo,False,5,-1,Togo
24338,26156,27828,2005,Costa Rica,United States,3,0,FIFA World Cup qualification,San José,Costa Rica,False,3,3,Costa Rica
24339,26157,27829,2005,Croatia,Sweden,1,0,FIFA World Cup qualification,Zagreb,Croatia,False,1,1,Croatia
24340,26158,27830,2005,Cyprus,Republic of Ireland,0,1,FIFA World Cup qualification,Nicosia,Cyprus,False,1,-1,Republic of Ireland
24341,26159,27831,2005,Czech Republic,Netherlands,0,2,FIFA World Cup qualification,Prague,Czech Republic,False,2,-2,Netherlands
24342,26160,27832,2005,Denmark,Greece,1,0,FIFA World Cup qualification,Copenhagen,Denmark,False,1,1,Denmark
24343,26161,27833,2005,Ecuador,Uruguay,0,0,FIFA World Cup qualification,Quito,Ecuador,False,0,0,Draw
24344,26162,27834,2005,England,Austria,1,0,FIFA World Cup qualification,Manchester,England,False,1,1,England
24345,26163,27835,2005,Finland,Romania,0,1,FIFA World Cup qualification,Helsinki,Finland,False,1,-1,Romania
24346,26164,27836,2005,Gabon,Algeria,0,0,FIFA World Cup qualification,Port-Gentil,Gabon,False,0,0,Draw
24347,26165,27837,2005,Georgia,Kazakhstan,0,0,FIFA World Cup qualification,Tbilisi,Georgia,False,0,0,Draw
24348,26166,27838,2005,Israel,Faroe Islands,2,1,FIFA World Cup qualification,Ramat-Gan,Israel,False,3,1,Israel
24349,26167,27839,2005,Italy,Slovenia,1,0,FIFA World Cup qualification,Palermo,Italy,False,1,1,Italy
24350,26168,27840,2005,Latvia,Japan,2,2,Friendly,Riga,Latvia,False,4,0,Draw
24351,26169,27841,2005,Lithuania,Serbia,0,2,FIFA World Cup qualification,Vilnius,Lithuania,False,2,-2,Serbia
24352,26170,27842,2005,Malawi,Kenya,3,0,FIFA World Cup qualification,Blantyre,Malawi,False,3,3,Malawi
24353,26171,27843,2005,Mexico,Guatemala,5,2,FIFA World Cup qualification,San Luis Potosí,Mexico,False,7,3,Mexico
24354,26172,27844,2005,Nigeria,Zimbabwe,5,1,FIFA World Cup qualification,Abuja,Nigeria,False,6,4,Nigeria
24355,26173,27845,2005,Northern Ireland,Wales,2,3,FIFA World Cup qualification,Belfast,Northern Ireland,False,5,-1,Wales
24356,26174,27846,2005,Norway,Moldova,1,0,FIFA World Cup qualification,Oslo,Norway,False,1,1,Norway
24357,26175,27847,2005,Panama,Trinidad and Tobago,0,1,FIFA World Cup qualification,Panama City,Panama,False,1,-1,Trinidad and Tobago
24358,26176,27848,2005,Portugal,Liechtenstein,2,1,FIFA World Cup qualification,Aveiro,Portugal,False,3,1,Portugal
24359,26177,27849,2005,Russia,Luxembourg,5,1,FIFA World Cup qualification,Moscow,Russia,False,6,4,Russia
24360,26178,27850,2005,Rwanda,Angola,0,1,FIFA World Cup qualification,Kigali,Rwanda,False,1,-1,Angola
24361,26179,27851,2005,Scotland,Belarus,0,1,FIFA World Cup qualification,Glasgow,Scotland,False,1,-1,Belarus
24362,26180,27852,2005,Senegal,Mali,3,0,FIFA World Cup qualification,Dakar,Senegal,False,3,3,Senegal
24363,26181,27853,2005,Slovakia,Estonia,1,0,FIFA World Cup qualification,Bratislava,Slovakia,False,1,1,Slovakia
24364,26182,27854,2005,South Africa,DR Congo,2,2,FIFA World Cup qualification,Durban,South Africa,False,4,0,Draw
24365,26183,27855,2005,Sudan,Ivory Coast,1,3,FIFA World Cup qualification,Omdurman,Sudan,False,4,-2,Ivory Coast
24366,26184,27856,2005,Switzerland,France,1,1,FIFA World Cup qualification,Berne,Switzerland,False,2,0,Draw
24367,26185,27857,2005,Tunisia,Morocco,2,2,FIFA World Cup qualification,Radès,Tunisia,False,4,0,Draw
24368,26186,27858,2005,Turkey,Germany,2,1,Friendly,Istanbul,Turkey,False,3,1,Turkey
24369,26187,27859,2005,Uganda,Burkina Faso,2,2,FIFA World Cup qualification,Kampala,Uganda,False,4,0,Draw
24370,26188,27860,2005,Ukraine,Albania,2,2,FIFA World Cup qualification,Dnipropetrovs'k,Ukraine,False,4,0,Draw
24371,26189,27861,2005,Uzbekistan,Bahrain,1,1,FIFA World Cup qualification,Tashkent,Uzbekistan,False,2,0,Draw
24372,26190,27862,2005,Venezuela,Paraguay,0,1,FIFA World Cup qualification,Maracaibo,Venezuela,False,1,-1,Paraguay
24373,26191,27863,2005,Argentina,Peru,2,0,FIFA World Cup qualification,Buenos Aires,Argentina,False,2,2,Argentina
24374,26192,27864,2005,Australia,Jamaica,5,0,Friendly,London,England,True,5,5,Australia
24375,26193,27865,2005,Benin,Libya,1,0,FIFA World Cup qualification,Cotonou,Benin,False,1,1,Benin
24376,26194,27866,2005,Bolivia,Brazil,1,1,FIFA World Cup qualification,La Paz,Bolivia,False,2,0,Draw
24377,26195,27867,2005,Cambodia,Singapore,0,2,Friendly,Phnom Penh,Cambodia,False,2,-2,Singapore
24378,26196,27868,2005,Qatar,Iraq,0,0,Friendly,Doha,Qatar,False,0,0,Draw
24379,26197,27869,2005,United Arab Emirates,Oman,2,2,Friendly,Al Ain,United Arab Emirates,False,4,0,Draw
24380,26198,27870,2005,Albania,Turkey,0,1,FIFA World Cup qualification,Tirana,Albania,False,1,-1,Turkey
24381,26199,27871,2005,Andorra,Armenia,0,3,FIFA World Cup qualification,Sant Julià de Lòria,Andorra,False,3,-3,Armenia
24382,26200,27872,2005,Austria,Northern Ireland,2,0,FIFA World Cup qualification,Vienna,Austria,False,2,2,Austria
24383,26201,27873,2005,Bahrain,Uzbekistan,0,0,FIFA World Cup qualification,Riffa,Bahrain,False,0,0,Draw
24384,26202,27874,2005,Belarus,Norway,0,1,FIFA World Cup qualification,Minsk,Belarus,False,1,-1,Norway
24385,26203,27875,2005,Brazil,Venezuela,3,0,FIFA World Cup qualification,Belém,Brazil,False,3,3,Brazil
24386,26204,27876,2005,Chile,Ecuador,0,0,FIFA World Cup qualification,Santiago,Chile,False,0,0,Draw
24387,26205,27877,2005,England,Poland,2,1,FIFA World Cup qualification,Manchester,England,False,3,1,England
24388,26206,27878,2005,Finland,Czech Republic,0,3,FIFA World Cup qualification,Helsinki,Finland,False,3,-3,Czech Republic
24389,26207,27879,2005,France,Cyprus,4,0,FIFA World Cup qualification,Saint-Denis,France,False,4,4,France
24390,26209,27881,2005,Greece,Georgia,1,0,FIFA World Cup qualification,Piraeus,Greece,False,1,1,Greece
24391,26210,27882,2005,Guatemala,Costa Rica,3,1,FIFA World Cup qualification,Guatemala,Guatemala,False,4,2,Guatemala
24392,26211,27883,2005,Hungary,Croatia,0,0,FIFA World Cup qualification,Budapest,Hungary,False,0,0,Draw
24393,26212,27884,2005,Republic of Ireland,Switzerland,0,0,FIFA World Cup qualification,Dublin,Republic of Ireland,False,0,0,Draw
24394,26213,27885,2005,Italy,Moldova,2,1,FIFA World Cup qualification,Lecce,Italy,False,3,1,Italy
24395,26214,27886,2005,Kazakhstan,Denmark,1,2,FIFA World Cup qualification,Almaty,Kazakhstan,False,3,-1,Denmark
24396,26215,27888,2005,Lithuania,Belgium,1,1,FIFA World Cup qualification,Vilnius,Lithuania,False,2,0,Draw
24397,26216,27889,2005,Luxembourg,Estonia,0,2,FIFA World Cup qualification,Luxembourg,Luxembourg,False,2,-2,Estonia
24398,26217,27890,2005,Malta,Bulgaria,1,1,FIFA World Cup qualification,Attard,Malta,False,2,0,Draw
24399,26219,27892,2005,Paraguay,Colombia,0,1,FIFA World Cup qualification,Asunción,Paraguay,False,1,-1,Colombia
24400,26220,27893,2005,Peru,Bolivia,4,1,FIFA World Cup qualification,Tacna,Peru,False,5,3,Peru
24401,26221,27894,2005,Portugal,Latvia,3,0,FIFA World Cup qualification,Porto,Portugal,False,3,3,Portugal
24402,26222,27895,2005,San Marino,Spain,0,6,FIFA World Cup qualification,Serravalle,San Marino,False,6,-6,Spain
24403,26223,27896,2005,Serbia,Bosnia and Herzegovina,1,0,FIFA World Cup qualification,Belgrade,Serbia and Montenegro,True,1,1,Serbia
24404,26224,27897,2005,Slovakia,Russia,0,0,FIFA World Cup qualification,Bratislava,Slovakia,False,0,0,Draw
24405,26225,27898,2005,Slovenia,Scotland,0,3,FIFA World Cup qualification,Celje,Slovenia,False,3,-3,Scotland
24406,26226,27899,2005,Sweden,Iceland,3,1,FIFA World Cup qualification,Solna,Sweden,False,4,2,Sweden
24407,26227,27900,2005,Trinidad and Tobago,Mexico,2,1,FIFA World Cup qualification,Port of Spain,Trinidad and Tobago,False,3,1,Trinidad and Tobago
24408,26228,27901,2005,Ukraine,Japan,1,0,Friendly,Kyïv,Ukraine,False,1,1,Ukraine
24409,26229,27902,2005,Uruguay,Argentina,1,0,FIFA World Cup qualification,Montevideo,Uruguay,False,1,1,Uruguay
24410,26230,27903,2005,United States,Panama,2,0,FIFA World Cup qualification,Foxborough,United States,False,2,2,United States
24411,26231,27904,2005,Wales,Azerbaijan,2,0,FIFA World Cup qualification,Cardiff,Wales,False,2,2,Wales
24412,26232,27906,2005,Madagascar,Mauritius,2,0,Friendly,Antananarivo,Madagascar,False,2,2,Madagascar
24413,26233,27907,2005,Oman,Syria,0,0,Friendly,Muscat,Oman,False,0,0,Draw
24414,26234,27908,2005,Mexico,Uruguay,3,1,Friendly,Guadalajara,Mexico,False,4,2,Mexico
24415,26235,27909,2005,Bahrain,Panama,5,0,Friendly,Riffa,Bahrain,False,5,5,Bahrain
24416,26236,27910,2005,Puerto Rico,Guadeloupe,1,3,Friendly,Bayamón,Puerto Rico,False,4,-2,Guadeloupe
24417,26237,27912,2005,France,Costa Rica,3,2,Friendly,Fort-de-France,Martinique,True,5,1,France
24418,26238,27913,2005,Tajikistan,Afghanistan,4,0,Friendly,Dushanbe,Tajikistan,False,4,4,Tajikistan
24419,26240,27915,2005,DR Congo,Tunisia,2,2,Friendly,Paris,France,True,4,0,Draw
24420,26241,27916,2005,Paraguay,Togo,4,2,Friendly,Teheran,Iran,True,6,2,Paraguay
24421,26242,27917,2005,Belarus,Latvia,3,1,Friendly,Vitsebsk,Belarus,False,4,2,Belarus
24422,26243,27918,2005,Bulgaria,Georgia,6,2,Friendly,Sofia,Bulgaria,False,8,4,Bulgaria
24423,26244,27919,2005,England,Argentina,3,2,Friendly,Geneva,Switzerland,True,5,1,England
24424,26245,27920,2005,Finland,Estonia,2,2,Friendly,Helsinki,Finland,False,4,0,Draw
24425,26246,27921,2005,France,Germany,0,0,Friendly,Saint-Denis,France,False,0,0,Draw
24426,26248,27924,2005,Netherlands,Italy,1,3,Friendly,Amsterdam,Netherlands,False,4,-2,Italy
24427,26249,27925,2005,Norway,Czech Republic,0,1,FIFA World Cup qualification,Oslo,Norway,False,1,-1,Czech Republic
24428,26250,27926,2005,Portugal,Croatia,2,0,Friendly,Coimbra,Portugal,False,2,2,Portugal
24429,26251,27927,2005,Romania,Ivory Coast,1,2,Friendly,Le Mans,France,True,3,-1,Ivory Coast
24430,26252,27928,2005,Scotland,United States,1,1,Friendly,Glasgow,Scotland,False,2,0,Draw
24431,26253,27929,2005,South Africa,Senegal,2,3,Friendly,Port Elizabeth,South Africa,False,5,-1,Senegal
24432,26254,27930,2005,Spain,Slovakia,5,1,FIFA World Cup qualification,Madrid,Spain,False,6,4,Spain
24433,26255,27931,2005,Switzerland,Turkey,2,0,FIFA World Cup qualification,Berne,Switzerland,False,2,2,Switzerland
24434,26256,27932,2005,Trinidad and Tobago,Bahrain,1,1,FIFA World Cup qualification,Port of Spain,Trinidad and Tobago,False,2,0,Draw
24435,26257,27933,2005,United Arab Emirates,Brazil,0,8,Friendly,Abu Dhabi,United Arab Emirates,False,8,-8,Brazil
24436,26258,27934,2005,Uruguay,Australia,1,0,FIFA World Cup qualification,Montevideo,Uruguay,False,1,1,Uruguay
24437,26259,27936,2005,Ecuador,Poland,0,3,Friendly,Barcelona,Spain,True,3,-3,Poland
24438,26260,27937,2005,Iran,Togo,2,0,Friendly,Teheran,Iran,False,2,2,Iran
24439,26261,27938,2005,Saudi Arabia,Ghana,1,3,Friendly,Jeddah,Saudi Arabia,False,4,-2,Ghana
24440,26262,27939,2005,Morocco,Cameroon,0,0,Friendly,Clairfontaine,France,True,0,0,Draw
24441,26263,27940,2005,Northern Ireland,Portugal,1,1,Friendly,Belfast,Northern Ireland,False,2,0,Draw
24442,26264,27941,2005,Australia,Uruguay,1,0,FIFA World Cup qualification,Sydney,Australia,False,1,1,Australia
24443,26265,27942,2005,Bahrain,Trinidad and Tobago,0,1,FIFA World Cup qualification,Riffa,Bahrain,False,1,-1,Trinidad and Tobago
24444,26266,27943,2005,Cyprus,Wales,1,0,Friendly,Limassol,Cyprus,False,1,1,Cyprus
24445,26267,27944,2005,Czech Republic,Norway,1,0,FIFA World Cup qualification,Prague,Czech Republic,False,1,1,Czech Republic
24446,26268,27945,2005,Egypt,Tunisia,1,2,Friendly,Cairo,Egypt,False,3,-1,Tunisia
24447,26269,27946,2005,Georgia,Jordan,3,2,Friendly,Tbilisi,Georgia,False,5,1,Georgia
24448,26270,27947,2005,Greece,Hungary,2,1,Friendly,Piraeus,Greece,False,3,1,Greece
24449,26271,27948,2005,Ivory Coast,Italy,1,1,Friendly,Geneva,Switzerland,True,2,0,Draw
24450,26272,27949,2005,Japan,Angola,1,0,Friendly,Tokyo,Japan,False,1,1,Japan
24451,26273,27951,2005,Libya,DR Congo,2,1,Friendly,Paris,France,True,3,1,Libya
24452,26274,27952,2005,Luxembourg,Canada,0,1,Friendly,Hesperange,Luxembourg,False,1,-1,Canada
24453,26275,27953,2005,Mexico,Bulgaria,0,3,Friendly,Houston,United States,True,3,-3,Bulgaria
24454,26276,27954,2005,Poland,Estonia,3,1,Friendly,Ostrowiec Świętokrzyski,Poland,False,4,2,Poland
24455,26277,27955,2005,Qatar,Argentina,0,3,Friendly,Doha,Qatar,False,3,-3,Argentina
24456,26278,27956,2005,Romania,Nigeria,3,0,Friendly,Bucharest,Romania,False,3,3,Romania
24457,26279,27957,2005,Slovakia,Spain,1,1,FIFA World Cup qualification,Bratislava,Slovakia,False,2,0,Draw
24458,26280,27958,2005,Syria,United Arab Emirates,0,3,Friendly,Damascus,Syria,False,3,-3,United Arab Emirates
24459,26281,27959,2005,Turkey,Switzerland,4,2,FIFA World Cup qualification,Istanbul,Turkey,False,6,2,Turkey
24460,26282,27960,2005,Guinea,Guinea-Bissau,2,2,Amílcar Cabral Cup,Conakry,Guinea,False,4,0,Draw
24461,26283,27961,2005,Guinea-Bissau,Sierra Leone,1,1,Amílcar Cabral Cup,Conakry,Guinea,True,2,0,Draw
24462,26284,27962,2005,Guinea,Sierra Leone,1,0,Amílcar Cabral Cup,Conakry,Guinea,False,1,1,Guinea
24463,26285,27963,2005,Sudan,Ethiopia,1,5,Friendly,Khartoum,Sudan,False,6,-4,Ethiopia
24464,26286,27964,2005,Kuwait,Iraq,0,0,Friendly,Kuwait City,Kuwait,False,0,0,Draw
24465,26288,27966,2005,Djibouti,Somalia,1,2,CECAFA Cup,Kigali,Rwanda,True,3,-1,Somalia
24466,26289,27967,2005,Ethiopia,Uganda,0,0,CECAFA Cup,Kigali,Rwanda,True,0,0,Draw
24467,26290,27968,2005,Burundi,Tanzania,1,2,CECAFA Cup,Kigali,Rwanda,True,3,-1,Tanzania
24468,26292,27970,2005,Somalia,Sudan,1,4,CECAFA Cup,Kigali,Rwanda,True,5,-3,Sudan
24469,26294,27972,2005,Djibouti,Uganda,1,6,CECAFA Cup,Kigali,Rwanda,True,7,-5,Uganda
24470,26295,27973,2005,Rwanda,Eritrea,3,2,CECAFA Cup,Kigali,Rwanda,False,5,1,Rwanda
24471,26296,27974,2005,Ethiopia,Sudan,3,1,CECAFA Cup,Kigali,Rwanda,True,4,2,Ethiopia
24472,26297,27975,2005,Iraq,Palestine,4,0,Friendly,Rayyan,Qatar,True,4,4,Iraq
24473,26298,27976,2005,Somalia,Uganda,0,7,CECAFA Cup,Kigali,Rwanda,True,7,-7,Uganda
24474,26299,27977,2005,Burundi,Eritrea,0,0,CECAFA Cup,Kigali,Rwanda,True,0,0,Draw
24475,26301,27979,2005,United Arab Emirates,Libya,1,1,Friendly,Sharjah,United Arab Emirates,False,2,0,Draw
24476,26302,27980,2005,Djibouti,Ethiopia,0,6,CECAFA Cup,Kigali,Rwanda,True,6,-6,Ethiopia
24477,26303,27981,2005,Oman,Syria,1,3,Friendly,Doha,Qatar,True,4,-2,Syria
24478,26304,27982,2005,Saudi Arabia,Palestine,2,0,Friendly,Rayyan,Qatar,True,2,2,Saudi Arabia
24479,26305,27983,2005,Sudan,Uganda,0,3,CECAFA Cup,Kigali,Rwanda,True,3,-3,Uganda
24480,26306,27984,2005,Bahrain,Syria,2,2,Friendly,Doha,Qatar,True,4,0,Draw
24481,26307,27985,2005,Eritrea,Tanzania,0,1,CECAFA Cup,Kigali,Rwanda,True,1,-1,Tanzania
24482,26308,27986,2005,Rwanda,Burundi,2,0,CECAFA Cup,Kigali,Rwanda,False,2,2,Rwanda
24483,26309,27987,2005,Djibouti,Sudan,0,4,CECAFA Cup,Kigali,Rwanda,True,4,-4,Sudan
24484,26310,27988,2005,Ethiopia,Somalia,3,1,CECAFA Cup,Kigali,Rwanda,True,4,2,Ethiopia
24485,26311,27989,2005,Iraq,Saudi Arabia,5,1,Friendly,Rayyan,Qatar,True,6,4,Iraq
24486,26312,27990,2005,Bahrain,Oman,2,2,Friendly,Doha,Qatar,True,4,0,Draw
24487,26313,27991,2005,Rwanda,Tanzania,3,1,CECAFA Cup,Kigali,Rwanda,False,4,2,Rwanda
24488,26314,27992,2005,Maldives,Afghanistan,9,1,SAFF Cup,Karachi,Pakistan,True,10,8,Maldives
24489,26315,27993,2005,Pakistan,Sri Lanka,1,0,SAFF Cup,Karachi,Pakistan,False,1,1,Pakistan
24490,26316,27994,2005,Bangladesh,Bhutan,3,0,SAFF Cup,Karachi,Pakistan,True,3,3,Bangladesh
24491,26317,27995,2005,India,Nepal,2,1,SAFF Cup,Karachi,Pakistan,True,3,1,India
24492,26318,27996,2005,Iraq,Saudi Arabia,2,0,Friendly,Doha,Qatar,True,2,2,Iraq
24493,26319,27997,2005,Rwanda,Uganda,1,0,CECAFA Cup,Kigali,Rwanda,False,1,1,Rwanda
24494,26320,27999,2005,Maldives,Sri Lanka,2,0,SAFF Cup,Karachi,Pakistan,True,2,2,Maldives
24495,26321,28000,2005,Pakistan,Afghanistan,1,0,SAFF Cup,Karachi,Pakistan,False,1,1,Pakistan
24496,26322,28001,2005,Bangladesh,Nepal,2,0,SAFF Cup,Karachi,Pakistan,True,2,2,Bangladesh
24497,26323,28002,2005,India,Bhutan,3,0,SAFF Cup,Karachi,Pakistan,True,3,3,India
24498,26324,28003,2005,Rwanda,Ethiopia,0,1,CECAFA Cup,Kigali,Rwanda,False,1,-1,Ethiopia
24499,26325,28004,2005,Syria,Iraq,2,2,Friendly,Doha,Qatar,True,4,0,Draw
24500,26326,28006,2005,DR Congo,Zambia,1,1,Friendly,Lubumbashi,DR Congo,False,2,0,Draw
24501,26327,28007,2005,Pakistan,Maldives,0,0,SAFF Cup,Karachi,Pakistan,False,0,0,Draw
24502,26328,28008,2005,Sri Lanka,Afghanistan,1,2,SAFF Cup,Karachi,Pakistan,True,3,-1,Afghanistan
24503,26329,28009,2005,Bangladesh,India,1,1,SAFF Cup,Karachi,Pakistan,True,2,0,Draw
24504,26330,28010,2005,Nepal,Bhutan,3,1,SAFF Cup,Karachi,Pakistan,True,4,2,Nepal
24505,26331,28011,2005,Maldives,India,0,1,SAFF Cup,Karachi,Pakistan,True,1,-1,India
24506,26332,28012,2005,Mexico,Hungary,2,0,Friendly,Phoenix,United States,True,2,2,Mexico
24507,26333,28013,2005,Pakistan,Bangladesh,0,1,SAFF Cup,Karachi,Pakistan,False,1,-1,Bangladesh
24508,26334,28014,2005,Zambia,DR Congo,4,1,Friendly,Chingola,Zambia,False,5,3,Zambia
24509,26335,28015,2005,Mauritius,Réunion,1,1,Friendly,Curepipe,Mauritius,False,2,0,Draw
24510,26336,28016,2005,Bangladesh,India,0,2,SAFF Cup,Karachi,Pakistan,True,2,-2,India
24511,26337,28017,2005,Antigua and Barbuda,Hungary,0,3,Friendly,Miami,United States,True,3,-3,Hungary
24512,26338,28018,2005,Réunion,Mauritius,1,2,Friendly,Saint-Pierre,Réunion,False,3,-1,Mauritius
24513,26339,28019,2005,Bangladesh,Pakistan,0,0,AFC Asian Cup qualification,Dhaka,Bangladesh,False,0,0,Draw
24514,26340,28020,2005,Thailand,Latvia,1,1,King's Cup,Phang Nga,Thailand,False,2,0,Draw
24515,26341,28023,2005,Pakistan,Bangladesh,0,1,AFC Asian Cup qualification,Karachi,Pakistan,False,1,-1,Bangladesh
24516,26342,28024,2005,Ecuador,Senegal,1,2,Friendly,Cairo,Egypt,True,3,-1,Senegal
24517,26343,28025,2005,Egypt,Uganda,2,0,Friendly,Cairo,Egypt,False,2,2,Egypt
24518,26345,28030,2005,Ecuador,Uganda,1,2,Friendly,Cairo,Egypt,True,3,-1,Uganda
24519,26346,28031,2005,Egypt,Senegal,4,2,Friendly,Cairo,Egypt,False,6,2,Egypt
24520,26348,28033,2006,Qatar,Libya,2,0,Friendly,Doha,Qatar,False,2,2,Qatar
24521,26349,28034,2006,Egypt,Zimbabwe,2,0,Friendly,Alexandria,Egypt,False,2,2,Egypt
24522,26350,28035,2006,Guinea,Togo,1,0,Friendly,Viry-Châtillon,France,True,1,1,Guinea
24523,26351,28036,2006,Morocco,DR Congo,3,0,Friendly,Rabat,Morocco,False,3,3,Morocco
24524,26352,28037,2006,Ghana,Togo,0,1,Friendly,Monastir,Tunisia,True,1,-1,Togo
24525,26353,28038,2006,Tunisia,Libya,1,0,Friendly,Tunis,Tunisia,False,1,1,Tunisia
24526,26354,28039,2006,Egypt,South Africa,1,2,Friendly,Cairo,Egypt,False,3,-1,South Africa
24527,26355,28040,2006,Morocco,Zimbabwe,1,0,Friendly,Marrakech,Morocco,False,1,1,Morocco
24528,26356,28041,2006,Senegal,DR Congo,0,0,Friendly,Dakar,Senegal,False,0,0,Draw
24529,26357,28042,2006,Tunisia,Ghana,2,0,Friendly,Tunis,Tunisia,False,2,2,Tunisia
24530,26358,28043,2006,Ivory Coast,Jordan,2,0,Friendly,Abu Dhabi,United Arab Emirates,True,2,2,Ivory Coast
24531,26359,28044,2006,Morocco,Angola,2,2,Friendly,Marrakech,Morocco,False,4,0,Draw
24532,26360,28045,2006,Saudi Arabia,Sweden,1,1,Friendly,Riyadh,Saudi Arabia,False,2,0,Draw
24533,26362,28047,2006,Egypt,Libya,3,0,African Cup of Nations,Cairo,Egypt,False,3,3,Egypt
24534,26363,28048,2006,Cameroon,Angola,3,1,African Cup of Nations,Cairo,Egypt,True,4,2,Cameroon
24535,26365,28050,2006,Morocco,Ivory Coast,0,1,African Cup of Nations,Cairo,Egypt,True,1,-1,Ivory Coast
24536,26366,28051,2006,Saudi Arabia,Finland,1,1,Friendly,Riyadh,Saudi Arabia,False,2,0,Draw
24537,26367,28052,2006,Togo,DR Congo,0,2,African Cup of Nations,Cairo,Egypt,True,2,-2,DR Congo
24538,26368,28053,2006,South Africa,Guinea,0,2,African Cup of Nations,Alexandria,Egypt,True,2,-2,Guinea
24539,26369,28054,2006,Tunisia,Zambia,4,1,African Cup of Nations,Alexandria,Egypt,True,5,3,Tunisia
24540,26370,28055,2006,United States,Canada,0,0,Friendly,San Diego,United States,False,0,0,Draw
24541,26371,28056,2006,Jordan,Sweden,0,0,Friendly,Abu Dhabi,United Arab Emirates,True,0,0,Draw
24542,26372,28057,2006,Nigeria,Ghana,1,0,African Cup of Nations,Port Said,Egypt,True,1,1,Nigeria
24543,26373,28058,2006,Zimbabwe,Senegal,0,2,African Cup of Nations,Port Said,Egypt,True,2,-2,Senegal
24544,26374,28059,2006,Egypt,Morocco,0,0,African Cup of Nations,Cairo,Egypt,False,0,0,Draw
24545,26375,28060,2006,Libya,Ivory Coast,1,2,African Cup of Nations,Cairo,Egypt,True,3,-1,Ivory Coast
24546,26376,28061,2006,Angola,DR Congo,0,0,African Cup of Nations,Cairo,Egypt,True,0,0,Draw
24547,26377,28062,2006,Cameroon,Togo,2,0,African Cup of Nations,Cairo,Egypt,True,2,2,Cameroon
24548,26378,28063,2006,Ecuador,Honduras,1,0,Friendly,Guayaquil,Ecuador,False,1,1,Ecuador
24549,26380,28065,2006,Mexico,Norway,2,1,Friendly,San Francisco,United States,True,3,1,Mexico
24550,26381,28066,2006,Saudi Arabia,Greece,1,1,Friendly,Riyadh,Saudi Arabia,False,2,0,Draw
24551,26382,28067,2006,Tunisia,South Africa,2,0,African Cup of Nations,Alexandria,Egypt,True,2,2,Tunisia
24552,26383,28068,2006,Zambia,Guinea,1,2,African Cup of Nations,Alexandria,Egypt,True,3,-1,Guinea
24553,26384,28069,2006,Ghana,Senegal,1,0,African Cup of Nations,Port Said,Egypt,True,1,1,Ghana
24554,26385,28070,2006,Nigeria,Zimbabwe,2,0,African Cup of Nations,Port Said,Egypt,True,2,2,Nigeria
24555,26386,28072,2006,Saudi Arabia,Lebanon,1,2,Friendly,Riyadh,Saudi Arabia,False,3,-1,Lebanon
24556,26387,28073,2006,Egypt,Ivory Coast,3,1,African Cup of Nations,Cairo,Egypt,False,4,2,Egypt
24557,26388,28074,2006,Libya,Morocco,0,0,African Cup of Nations,Cairo,Egypt,True,0,0,Draw
24558,26389,28075,2006,Angola,Togo,3,2,African Cup of Nations,Cairo,Egypt,True,5,1,Angola
24559,26390,28076,2006,Cameroon,DR Congo,2,0,African Cup of Nations,Cairo,Egypt,True,2,2,Cameroon
24560,26391,28078,2006,United States,Norway,5,0,Friendly,Carson,United States,False,5,5,United States
24561,26392,28079,2006,Bahrain,Syria,1,1,Friendly,Manama,Bahrain,False,2,0,Draw
24562,26393,28080,2006,Tunisia,Guinea,0,3,African Cup of Nations,Alexandria,Egypt,True,3,-3,Guinea
24563,26394,28081,2006,Zambia,South Africa,1,0,African Cup of Nations,Alexandria,Egypt,True,1,1,Zambia
24564,26395,28082,2006,Ghana,Zimbabwe,1,2,African Cup of Nations,Ismailia,Egypt,True,3,-1,Zimbabwe
24565,26396,28083,2006,Nigeria,Senegal,2,1,African Cup of Nations,Port Said,Egypt,True,3,1,Nigeria
24566,26397,28084,2006,Hong Kong,Croatia,0,4,Lunar New Year Cup,So Kon Po,Hong Kong,False,4,-4,Croatia
24567,26398,28085,2006,Thailand,Jordan,0,0,Friendly,Ayutthaya,Thailand,False,0,0,Draw
24568,26399,28086,2006,Egypt,DR Congo,4,1,African Cup of Nations,Cairo,Egypt,False,5,3,Egypt
24569,26400,28087,2006,Guinea,Senegal,2,3,African Cup of Nations,Alexandria,Egypt,True,5,-1,Senegal
24570,26401,28088,2006,Cameroon,Ivory Coast,1,1,African Cup of Nations,Cairo,Egypt,True,2,0,Draw
24571,26402,28089,2006,Nigeria,Tunisia,1,1,African Cup of Nations,Port Said,Egypt,True,2,0,Draw
24572,26403,28090,2006,Oman,Singapore,1,0,Friendly,Doha,Qatar,True,1,1,Oman
24573,26404,28091,2006,Egypt,Senegal,2,1,African Cup of Nations,Cairo,Egypt,False,3,1,Egypt
24574,26405,28092,2006,Kuwait,Jordan,2,1,Friendly,Kuwait City,Kuwait,False,3,1,Kuwait
24575,26406,28093,2006,Nigeria,Ivory Coast,0,1,African Cup of Nations,Alexandria,Egypt,True,1,-1,Ivory Coast
24576,26407,28094,2006,Syria,Palestine,3,0,Friendly,Aleppo,Syria,False,3,3,Syria
24577,26408,28095,2006,Senegal,Nigeria,0,1,African Cup of Nations,Cairo,Egypt,True,1,-1,Nigeria
24578,26409,28096,2006,Egypt,Ivory Coast,0,0,African Cup of Nations,Cairo,Egypt,False,0,0,Draw
24579,26410,28097,2006,United States,Japan,3,2,Friendly,San Francisco,United States,False,5,1,United States
24580,26412,28100,2006,Oman,Iraq,1,0,Friendly,Muscat,Oman,False,1,1,Oman
24581,26413,28101,2006,Jordan,Kazakhstan,2,0,Friendly,Amman,Jordan,False,2,2,Jordan
24582,26414,28102,2006,Qatar,Tajikistan,2,0,Friendly,Doha,Qatar,False,2,2,Qatar
24583,26415,28103,2006,Saudi Arabia,Syria,1,1,Friendly,Jeddah,Saudi Arabia,False,2,0,Draw
24584,26416,28104,2006,Hong Kong,Singapore,1,1,Friendly,Victoria,Hong Kong,False,2,0,Draw
24585,26418,28106,2006,Bahrain,Palestine,0,2,Friendly,Muharraq,Bahrain,False,2,-2,Palestine
24586,26419,28107,2006,Thailand,Iraq,4,3,Friendly,Ayutthaya,Thailand,False,7,1,Thailand
24587,26420,28108,2006,Hong Kong,India,2,2,Friendly,Victoria,Hong Kong,False,4,0,Draw
24588,26421,28109,2006,Japan,Finland,2,0,Friendly,Fukuroi,Japan,False,2,2,Japan
24589,26422,28110,2006,Pakistan,Palestine,0,3,Friendly,Muharraq,Bahrain,True,3,-3,Palestine
24590,26423,28111,2006,New Zealand,Malaysia,1,0,Friendly,Christchurch,New Zealand,False,1,1,New Zealand
24591,26424,28112,2006,United States,Guatemala,4,0,Friendly,Frisco,United States,False,4,4,United States
24592,26425,28113,2006,Bahrain,Australia,1,3,AFC Asian Cup qualification,Riffa,Bahrain,False,4,-2,Australia
24593,26426,28115,2006,Hong Kong,Qatar,0,3,AFC Asian Cup qualification,So Kon Po,Hong Kong,False,3,-3,Qatar
24594,26428,28117,2006,Japan,India,6,0,AFC Asian Cup qualification,Yokohama,Japan,False,6,6,Japan
24595,26429,28118,2006,Jordan,Pakistan,3,0,AFC Asian Cup qualification,Amman,Jordan,False,3,3,Jordan
24596,26430,28119,2006,Lebanon,Kuwait,1,1,AFC Asian Cup qualification,Beirut,Lebanon,False,2,0,Draw
24597,26431,28120,2006,Singapore,Iraq,2,0,AFC Asian Cup qualification,Singapore,Singapore,False,2,2,Singapore
24598,26433,28122,2006,United Arab Emirates,Oman,1,0,AFC Asian Cup qualification,Dubai,United Arab Emirates,False,1,1,United Arab Emirates
24599,26434,28123,2006,Uzbekistan,Bangladesh,5,0,AFC Asian Cup qualification,Tashkent,Uzbekistan,False,5,5,Uzbekistan
24600,26435,28124,2006,Yemen,Saudi Arabia,0,4,AFC Asian Cup qualification,Sana'a,Yemen,False,4,-4,Saudi Arabia
24601,26436,28125,2006,New Zealand,Malaysia,2,1,Friendly,North Shore,New Zealand,False,3,1,New Zealand
24602,26437,28126,2006,Guyana,Antigua and Barbuda,2,1,Friendly,Linden,Guyana,False,3,1,Guyana
24603,26439,28128,2006,Saint Kitts and Nevis,Saint Martin,6,1,Friendly,Basseterre,Saint Kitts and Nevis,False,7,5,Saint Kitts and Nevis
24604,26440,28129,2006,Guyana,Antigua and Barbuda,4,1,Friendly,Georgetown,Guyana,False,5,3,Guyana
24605,26441,28130,2006,Algeria,Burkina Faso,0,0,Friendly,Rouen,France,True,0,0,Draw
24606,26442,28131,2006,Azerbaijan,Ukraine,0,0,Friendly,Baku,Azerbaijan,False,0,0,Draw
24607,26443,28132,2006,Bosnia and Herzegovina,Japan,2,2,Friendly,Dortmund,Germany,True,4,0,Draw
24608,26444,28133,2006,Cyprus,Slovenia,0,1,Cyprus International Tournament,Larnaca,Cyprus,False,1,-1,Slovenia
24609,26445,28134,2006,Finland,Kazakhstan,0,0,Cyprus International Tournament,Larnaca,Cyprus,True,0,0,Draw
24610,26446,28135,2006,Greece,Belarus,1,0,Cyprus International Tournament,Limassol,Cyprus,True,1,1,Greece
24611,26447,28136,2006,Iceland,Trinidad and Tobago,0,2,Friendly,London,England,True,2,-2,Trinidad and Tobago
24612,26448,28137,2006,Romania,Armenia,2,0,Cyprus International Tournament,Nicosia,Cyprus,True,2,2,Romania
24613,26449,28138,2006,Albania,Lithuania,1,2,Friendly,Tirana,Albania,False,3,-1,Lithuania
24614,26450,28139,2006,Argentina,Croatia,2,3,Friendly,Basel,Switzerland,True,5,-1,Croatia
24615,26451,28140,2006,Austria,Canada,0,2,Friendly,Vienna,Austria,False,2,-2,Canada
24616,26452,28141,2006,Bangladesh,Hong Kong,0,1,AFC Asian Cup qualification,Dhaka,Bangladesh,False,1,-1,Hong Kong
24617,26453,28142,2006,Cyprus,Armenia,2,0,Cyprus International Tournament,Limassol,Cyprus,False,2,2,Cyprus
24618,26454,28143,2006,England,Uruguay,2,1,Friendly,Liverpool,England,False,3,1,England
24619,26455,28144,2006,Finland,Belarus,2,2,Cyprus International Tournament,Paphos,Cyprus,True,4,0,Draw
24620,26456,28145,2006,France,Slovakia,1,2,Friendly,Saint-Denis,France,False,3,-1,Slovakia
24621,26457,28146,2006,India,Yemen,0,3,AFC Asian Cup qualification,New Delhi,India,False,3,-3,Yemen
24622,26458,28147,2006,Iran,Costa Rica,3,2,Friendly,Teheran,Iran,False,5,1,Iran
24623,26460,28149,2006,Republic of Ireland,Sweden,3,0,Friendly,Dublin,Republic of Ireland,False,3,3,Republic of Ireland
24624,26461,28150,2006,Israel,Denmark,0,2,Friendly,Ramat-Gan,Israel,False,2,-2,Denmark
24625,26462,28151,2006,Italy,Germany,4,1,Friendly,Florence,Italy,False,5,3,Italy
24626,26463,28152,2006,Kazakhstan,Greece,0,2,Cyprus International Tournament,Nicosia,Cyprus,True,2,-2,Greece
24627,26464,28154,2006,Kuwait,Bahrain,0,0,AFC Asian Cup qualification,Kuwait City,Kuwait,False,0,0,Draw
24628,26465,28155,2006,Luxembourg,Belgium,0,2,Friendly,Luxembourg,Luxembourg,False,2,-2,Belgium
24629,26466,28157,2006,Malta,Georgia,0,2,Malta International Tournament,Attard,Malta,False,2,-2,Georgia
24630,26467,28158,2006,Mexico,Ghana,1,0,Friendly,Frisco,United States,True,1,1,Mexico
24631,26468,28159,2006,Netherlands,Ecuador,1,0,Friendly,Amsterdam,Netherlands,False,1,1,Netherlands
24632,26469,28160,2006,Northern Ireland,Estonia,1,0,Friendly,Belfast,Northern Ireland,False,1,1,Northern Ireland
24633,26470,28161,2006,Oman,Jordan,3,0,AFC Asian Cup qualification,Muscat,Oman,False,3,3,Oman
24634,26471,28162,2006,Pakistan,United Arab Emirates,1,4,AFC Asian Cup qualification,Karachi,Pakistan,False,5,-3,United Arab Emirates
24635,26472,28163,2006,Palestine,Singapore,1,0,AFC Asian Cup qualification,Amman,Jordan,True,1,1,Palestine
24636,26473,28164,2006,Poland,United States,0,1,Friendly,Kaiserslautern,Germany,True,1,-1,United States
24637,26474,28165,2006,Qatar,Uzbekistan,2,1,AFC Asian Cup qualification,Doha,Qatar,False,3,1,Qatar
24638,26475,28166,2006,Russia,Brazil,0,1,Friendly,Moscow,Russia,False,1,-1,Brazil
24639,26476,28167,2006,Saudi Arabia,Portugal,0,3,Friendly,Düsseldorf,Germany,True,3,-3,Portugal
24640,26477,28168,2006,Scotland,Switzerland,1,3,Friendly,Glasgow,Scotland,False,4,-2,Switzerland
24641,26478,28169,2006,Senegal,Norway,2,1,Friendly,Dakar,Senegal,False,3,1,Senegal
24642,26479,28170,2006,Slovenia,Romania,0,2,Cyprus International Tournament,Larnaca,Cyprus,True,2,-2,Romania
24643,26480,28171,2006,Spain,Ivory Coast,3,2,Friendly,Valladolid,Spain,False,5,1,Spain
24644,26481,28172,2006,Tunisia,Serbia,0,1,Friendly,Radès,Tunisia,False,1,-1,Serbia
24645,26482,28173,2006,Turkey,Czech Republic,2,2,Friendly,Izmir,Turkey,False,4,0,Draw
24646,26483,28174,2006,Venezuela,Colombia,1,1,Friendly,Maracaibo,Venezuela,False,2,0,Draw
24647,26484,28175,2006,Wales,Paraguay,0,0,Friendly,Cardiff,Wales,False,0,0,Draw
24648,26485,28176,2006,Equatorial Guinea,Congo,2,1,Friendly,Bata,Equatorial Guinea,False,3,1,Equatorial Guinea
24649,26486,28177,2006,Equatorial Guinea,Chad,1,1,Friendly,Bata,Equatorial Guinea,False,2,0,Draw
24650,26487,28178,2006,Central African Republic,Gabon,2,2,Friendly,Malabo,Equatorial Guinea,True,4,0,Draw
24651,26488,28179,2006,Chad,Congo,0,0,Friendly,Bata,Equatorial Guinea,True,0,0,Draw
24652,26489,28180,2006,Equatorial Guinea,Gabon,0,0,Friendly,Bata,Equatorial Guinea,False,0,0,Draw
24653,26490,28181,2006,Chad,Gabon,2,2,Friendly,Bata,Equatorial Guinea,True,4,0,Draw
24654,26491,28182,2006,Saudi Arabia,Iraq,2,2,Friendly,Jeddah,Saudi Arabia,False,4,0,Draw
24655,26492,28183,2006,Albania,Georgia,0,0,Friendly,Tirana,Albania,False,0,0,Draw
24656,26493,28184,2006,Germany,United States,4,1,Friendly,Dortmund,Germany,False,5,3,Germany
24657,26494,28185,2006,Thailand,Philippines,5,0,Friendly,Chon Buri,Thailand,False,5,5,Thailand
24658,26495,28186,2006,Saudi Arabia,Poland,1,2,Friendly,Riyadh,Saudi Arabia,False,3,-1,Poland
24659,26496,28187,2006,Equatorial Guinea,Benin,2,0,Friendly,Bata,Equatorial Guinea,False,2,2,Equatorial Guinea
24660,26497,28188,2006,Mexico,Paraguay,2,1,Friendly,Chicago,United States,True,3,1,Mexico
24661,26498,28189,2006,Japan,Ecuador,1,0,Friendly,Ōita,Japan,False,1,1,Japan
24662,26499,28190,2006,Bangladesh,Cambodia,2,1,AFC Challenge Cup,Dhaka,Bangladesh,False,3,1,Bangladesh
24663,26500,28191,2006,Palestine,Guam,11,0,AFC Challenge Cup,Dhaka,Bangladesh,True,11,11,Palestine
24664,26502,28193,2006,Kyrgyzstan,Pakistan,0,1,AFC Challenge Cup,Dhaka,Bangladesh,True,1,-1,Pakistan
24665,26503,28194,2006,Nepal,Bhutan,2,0,AFC Challenge Cup,Chittagong,Bangladesh,True,2,2,Nepal
24666,26504,28195,2006,Sri Lanka,Brunei,1,0,AFC Challenge Cup,Chittagong,Bangladesh,True,1,1,Sri Lanka
24667,26505,28196,2006,Tajikistan,Macau,4,0,AFC Challenge Cup,Dhaka,Bangladesh,True,4,4,Tajikistan
24668,26507,28198,2006,Bangladesh,Guam,3,0,AFC Challenge Cup,Dhaka,Bangladesh,False,3,3,Bangladesh
24669,26508,28199,2006,Cambodia,Palestine,0,4,AFC Challenge Cup,Dhaka,Bangladesh,True,4,-4,Palestine
24670,26509,28200,2006,Bhutan,Sri Lanka,0,1,AFC Challenge Cup,Chittagong,Bangladesh,True,1,-1,Sri Lanka
24671,26510,28201,2006,Brunei,Nepal,2,1,AFC Challenge Cup,Chittagong,Bangladesh,True,3,1,Brunei
24672,26511,28202,2006,Pakistan,Tajikistan,0,2,AFC Challenge Cup,Dhaka,Bangladesh,True,2,-2,Tajikistan
24673,26512,28203,2006,Bangladesh,Palestine,1,1,AFC Challenge Cup,Dhaka,Bangladesh,False,2,0,Draw
24674,26513,28204,2006,Philippines,Afghanistan,1,1,AFC Challenge Cup,Chittagong,Bangladesh,True,2,0,Draw
24675,26514,28205,2006,Bhutan,Brunei,0,0,AFC Challenge Cup,Chittagong,Bangladesh,True,0,0,Draw
24676,26515,28206,2006,Cambodia,Guam,3,0,AFC Challenge Cup,Dhaka,Bangladesh,True,3,3,Cambodia
24677,26516,28207,2006,Pakistan,Macau,2,2,AFC Challenge Cup,Dhaka,Bangladesh,True,4,0,Draw
24678,26517,28208,2006,Sri Lanka,Nepal,1,1,AFC Challenge Cup,Chittagong,Bangladesh,True,2,0,Draw
24679,26518,28209,2006,Tajikistan,Kyrgyzstan,0,1,AFC Challenge Cup,Dhaka,Bangladesh,True,1,-1,Kyrgyzstan
24680,26519,28210,2006,Macau,Kyrgyzstan,0,2,AFC Challenge Cup,Dhaka,Bangladesh,True,2,-2,Kyrgyzstan
24681,26521,28212,2006,Palestine,Kyrgyzstan,0,1,AFC Challenge Cup,Dhaka,Bangladesh,True,1,-1,Kyrgyzstan
24682,26522,28213,2006,Bangladesh,Tajikistan,1,6,AFC Challenge Cup,Dhaka,Bangladesh,False,7,-5,Tajikistan
24683,26523,28214,2006,United States,Jamaica,1,1,Friendly,Cary,United States,False,2,0,Draw
24684,26524,28215,2006,Azerbaijan,Turkey,1,1,Friendly,Baku,Azerbaijan,False,2,0,Draw
24685,26525,28216,2006,Sri Lanka,Nepal,1,1,AFC Challenge Cup,Chittagong,Bangladesh,True,2,0,Draw
24686,26526,28217,2006,Tajikistan,Kyrgyzstan,2,0,AFC Challenge Cup,Dhaka,Bangladesh,True,2,2,Tajikistan
24687,26527,28218,2006,Lesotho,Eswatini,5,0,Friendly,Maseru,Lesotho,False,5,5,Lesotho
24688,26528,28219,2006,Lesotho,Eswatini,2,2,Friendly,Maseru,Lesotho,False,4,0,Draw
24689,26529,28220,2006,Sri Lanka,Tajikistan,0,4,AFC Challenge Cup,Dhaka,Bangladesh,True,4,-4,Tajikistan
24690,26530,28221,2006,Kosovo,Monaco,7,1,Friendly,Cap-d'Ail,France,True,8,6,Kosovo
24691,26531,28222,2006,Chile,New Zealand,4,1,Friendly,Rancagua,Chile,False,5,3,Chile
24692,26532,28223,2006,Chile,New Zealand,1,0,Friendly,La Calera,Chile,False,1,1,Chile
24693,26533,28224,2006,Angola,Mauritius,5,1,COSAFA Cup,Maseru,Lesotho,True,6,4,Angola
24694,26534,28225,2006,Lesotho,Mozambique,0,0,COSAFA Cup,Maseru,Lesotho,False,0,0,Draw
24695,26535,28226,2006,Lesotho,Angola,1,3,COSAFA Cup,Maseru,Lesotho,False,4,-2,Angola
24696,26536,28227,2006,Mauritius,Mozambique,0,0,COSAFA Cup,Maseru,Lesotho,True,0,0,Draw
24697,26537,28228,2006,Jersey,Guernsey,3,2,Friendly,St. Helier,Jersey,False,5,1,Jersey
24698,26538,28229,2006,Poland,Lithuania,0,1,Friendly,Bełchatów,Poland,False,1,-1,Lithuania
24699,26539,28230,2006,United Arab Emirates,Syria,2,1,Friendly,Dubai,United Arab Emirates,False,3,1,United Arab Emirates
24700,26540,28231,2006,Mexico,Venezuela,1,0,Friendly,Pasadena,United States,True,1,1,Mexico
24701,26541,28232,2006,Japan,Bulgaria,1,2,Kirin Cup,Osaka,Japan,False,3,-1,Bulgaria
24702,26542,28233,2006,Lesotho,South Africa,0,0,Friendly,Maseru,Lesotho,False,0,0,Draw
24703,26543,28234,2006,Trinidad and Tobago,Peru,1,1,Friendly,Port of Spain,Trinidad and Tobago,False,2,0,Draw
24704,26544,28235,2006,Belgium,Saudi Arabia,2,1,Friendly,Sittard,Netherlands,True,3,1,Belgium
24705,26545,28236,2006,Bulgaria,Scotland,1,5,Kirin Cup,Kobe,Japan,True,6,-4,Scotland
24706,26546,28237,2006,Mexico,DR Congo,2,1,Friendly,Mexico City,Mexico,False,3,1,Mexico
24707,26547,28238,2006,Japan,Scotland,0,0,Kirin Cup,Saitama,Japan,False,0,0,Draw
24708,26548,28239,2006,Botswana,Zambia,0,0,Friendly,Gaborone,Botswana,False,0,0,Draw
24709,26549,28240,2006,Poland,Faroe Islands,4,0,Friendly,Wronki,Poland,False,4,4,Poland
24710,26550,28241,2006,Saudi Arabia,Togo,1,0,Friendly,Sittard,Netherlands,True,1,1,Saudi Arabia
24711,26551,28242,2006,Moldova,Azerbaijan,0,0,Friendly,Chişinău,Moldova,False,0,0,Draw
24712,26552,28243,2006,Botswana,Madagascar,2,0,COSAFA Cup,Gaborone,Botswana,False,2,2,Botswana
24713,26553,28244,2006,Guadeloupe,Saint Lucia,2,1,Friendly,Les Abymes,Guadeloupe,False,3,1,Guadeloupe
24714,26554,28245,2006,Slovakia,Belgium,1,1,Friendly,Trnava,Slovakia,False,2,0,Draw
24715,26555,28246,2006,South Africa,Eswatini,1,0,COSAFA Cup,Gaborone,Botswana,True,1,1,South Africa
24716,26556,28247,2006,Botswana,South Africa,0,0,COSAFA Cup,Gaborone,Botswana,False,0,0,Draw
24717,26557,28248,2006,Madagascar,Eswatini,0,2,COSAFA Cup,Gaborone,Botswana,True,2,-2,Eswatini
24718,26558,28249,2006,Northern Ireland,Uruguay,0,1,Friendly,East Rutherford,United States,True,1,-1,Uruguay
24719,26559,28251,2006,Austria,Croatia,1,4,Friendly,Vienna,Austria,False,5,-3,Croatia
24720,26560,28253,2006,Romania,Uruguay,0,2,Friendly,Los Angeles,United States,True,2,-2,Uruguay
24721,26561,28254,2006,United States,Morocco,0,1,Friendly,Nashville,United States,False,1,-1,Morocco
24722,26562,28255,2006,Belgium,Turkey,3,3,Friendly,Genk,Belgium,False,6,0,Draw
24723,26563,28256,2006,Colombia,Ecuador,1,1,Friendly,East Rutherford,United States,True,2,0,Draw
24724,26564,28257,2006,Hungary,New Zealand,2,0,Friendly,Budapest,Hungary,False,2,2,Hungary
24725,26565,28258,2006,Republic of Ireland,Chile,0,1,Friendly,Dublin,Republic of Ireland,False,1,-1,Chile
24726,26566,28259,2006,Norway,Paraguay,2,2,Friendly,Oslo,Norway,False,4,0,Draw
24727,26567,28261,2006,Australia,Greece,1,0,Friendly,Melbourne,Australia,False,1,1,Australia
24728,26568,28262,2006,Sweden,Finland,0,0,Friendly,Gothenburg,Sweden,False,0,0,Draw
24729,26569,28263,2006,Czech Republic,Saudi Arabia,2,0,Friendly,Innsbruck,Austria,True,2,2,Czech Republic
24730,26570,28265,2006,Romania,Northern Ireland,2,0,Friendly,Chicago,United States,True,2,2,Romania
24731,26571,28266,2006,Turkey,Ghana,1,1,Friendly,Bochum,Germany,True,2,0,Draw
24732,26572,28267,2006,United States,Venezuela,2,0,Friendly,Cleveland,United States,False,2,2,United States
24733,26573,28268,2006,Denmark,Paraguay,1,1,Friendly,Århus,Denmark,False,2,0,Draw
24734,26574,28269,2006,France,Mexico,1,0,Friendly,Saint-Denis,France,False,1,1,France
24735,26575,28270,2006,Georgia,New Zealand,1,3,Friendly,Altenkirchen,Germany,True,4,-2,New Zealand
24736,26576,28271,2006,Germany,Luxembourg,7,0,Friendly,Freiburg,Germany,False,7,7,Germany
24737,26577,28272,2006,Netherlands,Cameroon,1,0,Friendly,Rotterdam,Netherlands,False,1,1,Netherlands
24738,26579,28274,2006,Romania,Colombia,0,0,Friendly,Chicago,United States,True,0,0,Draw
24739,26580,28275,2006,Serbia,Uruguay,1,1,Friendly,Belgrade,Serbia and Montenegro,False,2,0,Draw
24740,26581,28276,2006,Spain,Russia,0,0,Friendly,Albacete,Spain,False,0,0,Draw
24741,26582,28277,2006,Switzerland,Ivory Coast,1,1,Friendly,Basel,Switzerland,False,2,0,Draw
24742,26583,28278,2006,Wales,Trinidad and Tobago,2,1,Friendly,Graz,Austria,True,3,1,Wales
24743,26584,28279,2006,Croatia,Iran,2,2,Friendly,Osijek,Croatia,False,4,0,Draw
24744,26585,28281,2006,Morocco,Mali,0,1,Friendly,Colombes,France,True,1,-1,Mali
24745,26586,28282,2006,Turkey,Estonia,1,1,Friendly,Hamburg,Germany,True,2,0,Draw
24746,26587,28283,2006,Ukraine,Costa Rica,4,0,Friendly,Kyïv,Ukraine,False,4,4,Ukraine
24747,26588,28284,2006,United States,Latvia,1,0,Friendly,East Hartford,United States,False,1,1,United States
24748,26589,28285,2006,Jamaica,Ghana,1,4,Friendly,Leicester,England,True,5,-3,Ghana
24749,26590,28288,2006,Argentina,Angola,2,0,Friendly,Salerno,Italy,True,2,2,Argentina
24750,26591,28289,2006,Chile,Ivory Coast,1,1,Friendly,Vittel,France,True,2,0,Draw
24751,26592,28290,2006,Czech Republic,Costa Rica,1,0,Friendly,Jablonec nad Nisou,Czech Republic,False,1,1,Czech Republic
24752,26593,28291,2006,England,Hungary,3,1,Friendly,Manchester,England,False,4,2,England
24753,26594,28292,2006,Germany,Japan,2,2,Friendly,Leverkusen,Germany,False,4,0,Draw
24754,26595,28293,2006,Libya,Uruguay,1,2,Friendly,Radès,Tunisia,True,3,-1,Uruguay
24755,26596,28294,2006,Poland,Colombia,1,2,Friendly,Chorzów,Poland,False,3,-1,Colombia
24756,26597,28295,2006,Tunisia,Belarus,3,0,Friendly,Radès,Tunisia,False,3,3,Tunisia
24757,26598,28298,2006,Estonia,New Zealand,1,1,Friendly,Tallinn,Estonia,False,2,0,Draw
24758,26599,28299,2006,France,Denmark,2,0,Friendly,Lens,France,False,2,2,France
24759,26600,28300,2006,Georgia,Paraguay,0,1,Friendly,Dornbirn,Austria,True,1,-1,Paraguay
24760,26603,28303,2006,Iran,Bosnia and Herzegovina,5,2,Friendly,Teheran,Iran,False,7,3,Iran
24761,26604,28304,2006,Saudi Arabia,Turkey,0,1,Friendly,Offenbach am Main,Germany,True,1,-1,Turkey
24762,26605,28305,2006,Singapore,Malaysia,0,0,Friendly,Singapore,Singapore,False,0,0,Draw
24763,26606,28306,2006,Slovenia,Trinidad and Tobago,3,1,Friendly,Celje,Slovenia,False,4,2,Slovenia
24764,26607,28307,2006,Switzerland,Italy,1,1,Friendly,Geneva,Switzerland,False,2,0,Draw
24765,26608,28308,2006,Netherlands,Mexico,2,1,Friendly,Eindhoven,Netherlands,False,3,1,Netherlands
24766,26610,28312,2006,Angola,Turkey,2,3,Friendly,Sittard,Netherlands,True,5,-1,Turkey
24767,26611,28313,2006,Germany,Colombia,3,0,Friendly,Mönchengladbach,Germany,False,3,3,Germany
24768,26612,28314,2006,Italy,Ukraine,0,0,Friendly,Lausanne,Switzerland,True,0,0,Draw
24769,26613,28315,2006,Libya,Belarus,1,1,Friendly,Radès,Tunisia,True,2,0,Draw
24770,26614,28316,2006,Liechtenstein,Togo,0,1,Friendly,Vaduz,Liechtenstein,False,1,-1,Togo
24771,26615,28317,2006,Sweden,Chile,1,1,Friendly,Solna,Sweden,False,2,0,Draw
24772,26616,28318,2006,Tunisia,Uruguay,0,0,Friendly,Radès,Tunisia,False,0,0,Draw
24773,26617,28319,2006,Croatia,Poland,0,1,Friendly,Wolfsburg,Germany,True,1,-1,Poland
24774,26618,28320,2006,Czech Republic,Trinidad and Tobago,3,0,Friendly,Prague,Czech Republic,False,3,3,Czech Republic
24775,26619,28321,2006,England,Jamaica,6,0,Friendly,Manchester,England,False,6,6,England
24776,26620,28322,2006,Luxembourg,Portugal,0,3,Friendly,Metz,France,True,3,-3,Portugal
24777,26621,28323,2006,Macau,Hong Kong,0,0,Friendly,Macau,Macau,False,0,0,Draw
24778,26622,28324,2006,Malaysia,Singapore,0,0,Friendly,Seremban,Malaysia,False,0,0,Draw
24779,26623,28327,2006,Spain,Egypt,2,0,Friendly,Elche,Spain,False,2,2,Spain
24780,26625,28329,2006,Algeria,Sudan,1,0,Friendly,Algiers,Algeria,False,1,1,Algeria
24781,26626,28330,2006,Brazil,New Zealand,4,0,Friendly,Geneva,Switzerland,True,4,4,Brazil
24782,26627,28331,2006,Colombia,Morocco,2,0,Friendly,Barcelona,Spain,True,2,2,Colombia
24783,26629,28333,2006,Japan,Malta,1,0,Friendly,Düsseldorf,Germany,True,1,1,Japan
24784,26630,28334,2006,Netherlands,Australia,1,1,Friendly,Rotterdam,Netherlands,False,2,0,Draw
24785,26631,28335,2006,Slovenia,Ivory Coast,0,3,Friendly,Bondoufle,France,True,3,-3,Ivory Coast
24786,26633,28337,2006,Ukraine,Libya,3,0,Friendly,Gossau,Switzerland,True,3,3,Ukraine
24787,26634,28338,2006,Australia,Liechtenstein,3,1,Friendly,Ulm,Germany,True,4,2,Australia
24788,26636,28340,2006,Spain,Croatia,2,1,Friendly,Geneva,Switzerland,True,3,1,Spain
24789,26637,28341,2006,Luxembourg,Ukraine,0,3,Friendly,Luxembourg,Luxembourg,False,3,-3,Ukraine
24790,26638,28342,2006,Germany,Costa Rica,4,2,FIFA World Cup,Munich,Germany,False,6,2,Germany
24791,26639,28343,2006,Poland,Ecuador,0,2,FIFA World Cup,Gelsenkirchen,Germany,True,2,-2,Ecuador
24792,26640,28344,2006,Argentina,Ivory Coast,2,1,FIFA World Cup,Hamburg,Germany,True,3,1,Argentina
24793,26641,28345,2006,England,Paraguay,1,0,FIFA World Cup,Frankfurt am Main,Germany,True,1,1,England
24794,26642,28346,2006,Trinidad and Tobago,Sweden,0,0,FIFA World Cup,Dortmund,Germany,True,0,0,Draw
24795,26643,28347,2006,Angola,Portugal,0,1,FIFA World Cup,Cologne,Germany,True,1,-1,Portugal
24796,26644,28348,2006,Mexico,Iran,3,1,FIFA World Cup,Nuremberg,Germany,True,4,2,Mexico
24797,26645,28349,2006,Serbia,Netherlands,0,1,FIFA World Cup,Leipzig,Germany,True,1,-1,Netherlands
24798,26646,28350,2006,Australia,Japan,3,1,FIFA World Cup,Kaiserslautern,Germany,True,4,2,Australia
24799,26647,28351,2006,Italy,Ghana,2,0,FIFA World Cup,Hanover,Germany,True,2,2,Italy
24800,26648,28352,2006,United States,Czech Republic,0,3,FIFA World Cup,Gelsenkirchen,Germany,True,3,-3,Czech Republic
24801,26649,28353,2006,Brazil,Croatia,1,0,FIFA World Cup,Berlin,Germany,True,1,1,Brazil
24802,26650,28354,2006,France,Switzerland,0,0,FIFA World Cup,Stuttgart,Germany,True,0,0,Draw
24803,26651,28356,2006,Germany,Poland,1,0,FIFA World Cup,Dortmund,Germany,False,1,1,Germany
24804,26652,28357,2006,Spain,Ukraine,4,0,FIFA World Cup,Leipzig,Germany,True,4,4,Spain
24805,26653,28358,2006,Tunisia,Saudi Arabia,2,2,FIFA World Cup,Munich,Germany,True,4,0,Draw
24806,26654,28359,2006,Ecuador,Costa Rica,3,0,FIFA World Cup,Hamburg,Germany,True,3,3,Ecuador
24807,26655,28360,2006,England,Trinidad and Tobago,2,0,FIFA World Cup,Nuremberg,Germany,True,2,2,England
24808,26656,28361,2006,Sweden,Paraguay,1,0,FIFA World Cup,Berlin,Germany,True,1,1,Sweden
24809,26657,28362,2006,Argentina,Serbia,6,0,FIFA World Cup,Gelsenkirchen,Germany,True,6,6,Argentina
24810,26658,28363,2006,Mexico,Angola,0,0,FIFA World Cup,Hanover,Germany,True,0,0,Draw
24811,26659,28364,2006,Netherlands,Ivory Coast,2,1,FIFA World Cup,Stuttgart,Germany,True,3,1,Netherlands
24812,26660,28365,2006,Czech Republic,Ghana,0,2,FIFA World Cup,Cologne,Germany,True,2,-2,Ghana
24813,26661,28366,2006,Italy,United States,1,1,FIFA World Cup,Kaiserslautern,Germany,True,2,0,Draw
24814,26662,28367,2006,Portugal,Iran,2,0,FIFA World Cup,Frankfurt am Main,Germany,True,2,2,Portugal
24815,26663,28368,2006,Brazil,Australia,2,0,FIFA World Cup,Munich,Germany,True,2,2,Brazil
24816,26665,28370,2006,Japan,Croatia,0,0,FIFA World Cup,Nuremberg,Germany,True,0,0,Draw
24817,26666,28371,2006,Saudi Arabia,Ukraine,0,4,FIFA World Cup,Hamburg,Germany,True,4,-4,Ukraine
24818,26667,28372,2006,Spain,Tunisia,3,1,FIFA World Cup,Stuttgart,Germany,True,4,2,Spain
24819,26668,28373,2006,Togo,Switzerland,0,2,FIFA World Cup,Dortmund,Germany,True,2,-2,Switzerland
24820,26669,28374,2006,Costa Rica,Poland,1,2,FIFA World Cup,Hanover,Germany,True,3,-1,Poland
24821,26670,28375,2006,Germany,Ecuador,3,0,FIFA World Cup,Berlin,Germany,False,3,3,Germany
24822,26671,28376,2006,Paraguay,Trinidad and Tobago,2,0,FIFA World Cup,Kaiserslautern,Germany,True,2,2,Paraguay
24823,26672,28377,2006,Sweden,England,2,2,FIFA World Cup,Cologne,Germany,True,4,0,Draw
24824,26673,28378,2006,Iran,Angola,1,1,FIFA World Cup,Leipzig,Germany,True,2,0,Draw
24825,26674,28379,2006,Ivory Coast,Serbia,3,2,FIFA World Cup,Munich,Germany,True,5,1,Ivory Coast
24826,26675,28380,2006,Netherlands,Argentina,0,0,FIFA World Cup,Frankfurt am Main,Germany,True,0,0,Draw
24827,26676,28381,2006,Portugal,Mexico,2,1,FIFA World Cup,Gelsenkirchen,Germany,True,3,1,Portugal
24828,26677,28382,2006,Croatia,Australia,2,2,FIFA World Cup,Stuttgart,Germany,True,4,0,Draw
24829,26678,28383,2006,Czech Republic,Italy,0,2,FIFA World Cup,Hamburg,Germany,True,2,-2,Italy
24830,26679,28384,2006,Ghana,United States,2,1,FIFA World Cup,Nuremberg,Germany,True,3,1,Ghana
24831,26680,28385,2006,Japan,Brazil,1,4,FIFA World Cup,Dortmund,Germany,True,5,-3,Brazil
24832,26681,28386,2006,Saudi Arabia,Spain,0,1,FIFA World Cup,Kaiserslautern,Germany,True,1,-1,Spain
24833,26683,28388,2006,Togo,France,0,2,FIFA World Cup,Cologne,Germany,True,2,-2,France
24834,26684,28389,2006,Ukraine,Tunisia,1,0,FIFA World Cup,Berlin,Germany,True,1,1,Ukraine
24835,26685,28390,2006,Argentina,Mexico,2,1,FIFA World Cup,Leipzig,Germany,True,3,1,Argentina
24836,26686,28391,2006,Germany,Sweden,2,0,FIFA World Cup,Munich,Germany,False,2,2,Germany
24837,26687,28392,2006,Malawi,Zimbabwe,1,1,Friendly,Maputo,Mozambique,True,2,0,Draw
24838,26688,28393,2006,Mozambique,Eswatini,4,0,Friendly,Maputo,Mozambique,False,4,4,Mozambique
24839,26689,28394,2006,England,Ecuador,1,0,FIFA World Cup,Stuttgart,Germany,True,1,1,England
24840,26690,28395,2006,Mozambique,Malawi,1,2,Friendly,Maputo,Mozambique,False,3,-1,Malawi
24841,26691,28396,2006,Portugal,Netherlands,1,0,FIFA World Cup,Nuremberg,Germany,True,1,1,Portugal
24842,26692,28397,2006,Eswatini,Zimbabwe,1,2,Friendly,Maputo,Mozambique,True,3,-1,Zimbabwe
24843,26693,28398,2006,Italy,Australia,1,0,FIFA World Cup,Kaiserslautern,Germany,True,1,1,Italy
24844,26694,28399,2006,Mauritius,Tanzania,1,2,Friendly,Victoria,Seychelles,True,3,-1,Tanzania
24845,26695,28400,2006,Switzerland,Ukraine,0,0,FIFA World Cup,Cologne,Germany,True,0,0,Draw
24846,26696,28401,2006,Brazil,Ghana,3,0,FIFA World Cup,Dortmund,Germany,True,3,3,Brazil
24847,26697,28402,2006,Spain,France,1,3,FIFA World Cup,Hanover,Germany,True,4,-2,France
24848,26698,28403,2006,Seychelles,Mauritius,2,1,Friendly,Victoria,Seychelles,False,3,1,Seychelles
24849,26699,28404,2006,Germany,Argentina,1,1,FIFA World Cup,Berlin,Germany,False,2,0,Draw
24850,26700,28405,2006,Italy,Ukraine,3,0,FIFA World Cup,Hamburg,Germany,True,3,3,Italy
24851,26701,28406,2006,Seychelles,Tanzania,2,1,Friendly,Victoria,Seychelles,False,3,1,Seychelles
24852,26702,28407,2006,Brazil,France,0,1,FIFA World Cup,Frankfurt am Main,Germany,True,1,-1,France
24853,26703,28408,2006,England,Portugal,0,0,FIFA World Cup,Gelsenkirchen,Germany,True,0,0,Draw
24854,26704,28409,2006,Kazakhstan,Tajikistan,4,1,Friendly,Almaty,Kazakhstan,False,5,3,Kazakhstan
24855,26705,28410,2006,Germany,Italy,0,2,FIFA World Cup,Dortmund,Germany,False,2,-2,Italy
24856,26706,28411,2006,Kazakhstan,Kyrgyzstan,1,0,Friendly,Almaty,Kazakhstan,False,1,1,Kazakhstan
24857,26707,28412,2006,Portugal,France,0,1,FIFA World Cup,Munich,Germany,True,1,-1,France
24858,26708,28413,2006,Malawi,Botswana,2,1,Friendly,Lilongwe,Malawi,False,3,1,Malawi
24859,26709,28414,2006,Germany,Portugal,3,1,FIFA World Cup,Stuttgart,Germany,False,4,2,Germany
24860,26710,28415,2006,Malawi,Botswana,0,0,Friendly,Blantyre,Malawi,False,0,0,Draw
24861,26711,28416,2006,Italy,France,1,1,FIFA World Cup,Berlin,Germany,True,2,0,Draw
24862,26712,28417,2006,Syria,Iraq,1,3,Friendly,Damascus,Syria,False,4,-2,Iraq
24863,26713,28418,2006,Zambia,Zimbabwe,0,0,Friendly,Lusaka,Zambia,False,0,0,Draw
24864,26714,28419,2006,Ethiopia,Yemen,1,0,Friendly,Addis Abeba,Ethiopia,False,1,1,Ethiopia
24865,26715,28420,2006,Jordan,Iraq,2,1,Friendly,Amman,Jordan,False,3,1,Jordan
24866,26716,28421,2006,Malawi,Zambia,1,3,COSAFA Cup,Windhoek,Namibia,True,4,-2,Zambia
24867,26717,28422,2006,Namibia,Seychelles,1,1,COSAFA Cup,Windhoek,Namibia,False,2,0,Draw
24868,26718,28423,2006,Namibia,Malawi,3,2,COSAFA Cup,Windhoek,Namibia,False,5,1,Namibia
24869,26719,28424,2006,Seychelles,Zambia,0,2,COSAFA Cup,Windhoek,Namibia,True,2,-2,Zambia
24870,26720,28425,2006,Syria,Iraq,1,2,Friendly,Damascus,Syria,False,3,-1,Iraq
24871,26721,28426,2006,Rwanda,Uganda,1,1,Friendly,Kigali,Rwanda,False,2,0,Draw
24872,26722,28427,2006,Guyana,Saint Lucia,3,2,Friendly,Linden,Guyana,False,5,1,Guyana
24873,26723,28428,2006,Guyana,Saint Lucia,2,0,Friendly,Georgetown,Guyana,False,2,2,Guyana
24874,26724,28429,2006,Jordan,Syria,3,0,Friendly,Amman,Jordan,False,3,3,Jordan
24875,26725,28430,2006,Tanzania,Rwanda,1,0,Friendly,Dar es Salaam,Tanzania,False,1,1,Tanzania
24876,26726,28431,2006,Syria,Libya,2,1,Friendly,Damascus,Syria,False,3,1,Syria
24877,26727,28432,2006,Uganda,Botswana,0,0,Friendly,Kampala,Uganda,False,0,0,Draw
24878,26728,28433,2006,Iran,United Arab Emirates,1,0,Friendly,Teheran,Iran,False,1,1,Iran
24879,26729,28434,2006,Japan,Trinidad and Tobago,2,0,Friendly,Tokyo,Japan,False,2,2,Japan
24880,26730,28435,2006,Jordan,Iraq,0,1,Friendly,Amman,Jordan,False,1,-1,Iraq
24881,26732,28437,2006,Saudi Arabia,Bahrain,1,0,Friendly,Riyadh,Saudi Arabia,False,1,1,Saudi Arabia
24882,26733,28438,2006,Ethiopia,Kenya,1,0,Friendly,Addis Abeba,Ethiopia,False,1,1,Ethiopia
24883,26734,28439,2006,Hong Kong,Singapore,1,2,Friendly,Victoria,Hong Kong,False,3,-1,Singapore
24884,26735,28440,2006,Ethiopia,Kenya,1,0,Friendly,Addis Abeba,Ethiopia,False,1,1,Ethiopia
24885,26736,28441,2006,Algeria,Gabon,0,2,Friendly,Aix-en-Provence,France,True,2,-2,Gabon
24886,26737,28442,2006,Ghana,Togo,2,0,Friendly,Brentford,England,True,2,2,Ghana
24887,26738,28443,2006,Iceland,Spain,0,0,Friendly,Reykjavík,Iceland,False,0,0,Draw
24888,26739,28444,2006,Slovakia,Malta,3,0,Friendly,Bratislava,Slovakia,False,3,3,Slovakia
24889,26740,28445,2006,Slovenia,Israel,1,1,Friendly,Celje,Slovenia,False,2,0,Draw
24890,26741,28446,2006,Ukraine,Azerbaijan,6,0,Friendly,Kyïv,Ukraine,False,6,6,Ukraine
24891,26742,28447,2006,Wales,Bulgaria,0,0,Friendly,Swansea,Wales,False,0,0,Draw
24892,26743,28448,2006,Australia,Kuwait,2,0,AFC Asian Cup qualification,Sydney,Australia,False,2,2,Australia
24893,26744,28449,2006,Austria,Hungary,1,2,Friendly,Graz,Austria,False,3,-1,Hungary
24894,26745,28450,2006,Bangladesh,Qatar,1,4,AFC Asian Cup qualification,Chittagong,Bangladesh,False,5,-3,Qatar
24895,26746,28451,2006,Belarus,Andorra,3,0,Friendly,Minsk,Belarus,False,3,3,Belarus
24896,26747,28452,2006,Belgium,Kazakhstan,0,0,UEFA Euro qualification,Brussels,Belgium,False,0,0,Draw
24897,26748,28453,2006,Bosnia and Herzegovina,France,1,2,Friendly,Sarajevo,Bosnia and Herzegovina,False,3,-1,France
24898,26749,28454,2006,Cameroon,Guinea,1,1,Friendly,Rouen,France,True,2,0,Draw
24899,26750,28455,2006,Chile,Colombia,1,2,Friendly,Santiago,Chile,False,3,-1,Colombia
24900,26751,28457,2006,Czech Republic,Serbia,1,3,Friendly,Uherské Hradiště,Czech Republic,False,4,-2,Serbia
24901,26752,28458,2006,Denmark,Poland,2,0,Friendly,Odense,Denmark,False,2,2,Denmark
24902,26753,28459,2006,Egypt,Uruguay,0,2,Friendly,Alexandria,Egypt,False,2,-2,Uruguay
24903,26754,28460,2006,England,Greece,4,0,Friendly,Manchester,England,False,4,4,England
24904,26756,28462,2006,Faroe Islands,Georgia,0,6,UEFA Euro qualification,Toftir,Faroe Islands,False,6,-6,Georgia
24905,26757,28463,2006,Finland,Northern Ireland,1,2,Friendly,Helsinki,Finland,False,3,-1,Northern Ireland
24906,26758,28464,2006,Germany,Sweden,3,0,Friendly,Gelsenkirchen,Germany,False,3,3,Germany
24907,26759,28465,2006,Guatemala,Haiti,1,1,Friendly,Miami,United States,True,2,0,Draw
24908,26760,28466,2006,India,Saudi Arabia,0,3,AFC Asian Cup qualification,Calcutta,India,False,3,-3,Saudi Arabia
24909,26761,28467,2006,Iran,Syria,1,1,AFC Asian Cup qualification,Teheran,Iran,False,2,0,Draw
24910,26762,28468,2006,Republic of Ireland,Netherlands,0,4,Friendly,Dublin,Republic of Ireland,False,4,-4,Netherlands
24911,26763,28469,2006,Italy,Croatia,0,2,Friendly,Livorno,Italy,False,2,-2,Croatia
24912,26764,28470,2006,Ivory Coast,Senegal,0,1,Friendly,Tours,France,True,1,-1,Senegal
24913,26765,28471,2006,Japan,Yemen,2,0,AFC Asian Cup qualification,Niigata,Japan,False,2,2,Japan
24914,26766,28472,2006,Jordan,United Arab Emirates,1,2,AFC Asian Cup qualification,Amman,Jordan,False,3,-1,United Arab Emirates
24915,26767,28473,2006,Libya,Uganda,3,2,Friendly,Tripoli,Libya,False,5,1,Libya
24916,26768,28474,2006,Liechtenstein,Switzerland,0,3,Friendly,Vaduz,Liechtenstein,False,3,-3,Switzerland
24917,26769,28475,2006,Luxembourg,Turkey,0,1,Friendly,Luxembourg,Luxembourg,False,1,-1,Turkey
24918,26770,28476,2006,Moldova,Lithuania,3,2,Friendly,Chişinău,Moldova,False,5,1,Moldova
24919,26771,28477,2006,Morocco,Burkina Faso,1,0,Friendly,Rabat,Morocco,False,1,1,Morocco
24920,26772,28478,2006,Namibia,South Africa,0,1,Friendly,Windhoek,Namibia,False,1,-1,South Africa
24921,26773,28479,2006,Norway,Brazil,1,1,Friendly,Oslo,Norway,False,2,0,Draw
24922,26774,28480,2006,Pakistan,Oman,1,4,AFC Asian Cup qualification,Islamabad,Pakistan,False,5,-3,Oman
24923,26775,28481,2006,Peru,Panama,0,2,Friendly,Lima,Peru,False,2,-2,Panama
24924,26776,28482,2006,Romania,Cyprus,2,0,Friendly,Constanţa,Romania,False,2,2,Romania
24925,26777,28483,2006,Russia,Latvia,1,0,Friendly,Moscow,Russia,False,1,1,Russia
24926,26778,28484,2006,San Marino,Albania,0,3,Friendly,Serravalle,San Marino,False,3,-3,Albania
24927,26779,28485,2006,Tunisia,Mali,0,1,Friendly,Narbonne,France,True,1,-1,Mali
24928,26780,28486,2006,Uzbekistan,Hong Kong,2,2,AFC Asian Cup qualification,Tashkent,Uzbekistan,False,4,0,Draw
24929,26781,28487,2006,Venezuela,Honduras,0,0,Friendly,Maracay,Venezuela,False,0,0,Draw
24930,26782,28488,2006,Palestine,Iraq,0,3,AFC Asian Cup qualification,Amman,Jordan,True,3,-3,Iraq
24931,26783,28489,2006,Zambia,Botswana,1,0,COSAFA Cup,Lusaka,Zambia,False,1,1,Zambia
24932,26784,28490,2006,Malaysia,Indonesia,1,1,Merdeka Tournament,Shah Alam,Malaysia,False,2,0,Draw
24933,26785,28491,2006,Indonesia,Burma,0,0,Merdeka Tournament,Shah Alam,Malaysia,True,0,0,Draw
24934,26786,28492,2006,Eswatini,Lesotho,3,1,Friendly,Lobamba,Eswatini,False,4,2,Eswatini
24935,26788,28494,2006,Yemen,Libya,0,1,Friendly,Sana'a,Yemen,False,1,-1,Libya
24936,26789,28495,2006,Malaysia,Burma,1,2,Merdeka Tournament,Shah Alam,Malaysia,False,3,-1,Burma
24937,26790,28496,2006,Saudi Arabia,United Arab Emirates,1,0,Friendly,Jeddah,Saudi Arabia,False,1,1,Saudi Arabia
24938,26791,28497,2006,Burma,Indonesia,2,1,Merdeka Tournament,Shah Alam,Malaysia,True,3,1,Burma
24939,26792,28498,2006,Togo,Niger,1,1,Friendly,Lomé,Togo,False,2,0,Draw
24940,26793,28499,2006,Uganda,Burkina Faso,0,0,Friendly,Kampala,Uganda,False,0,0,Draw
24941,26794,28500,2006,Yemen,Libya,1,1,Friendly,Sana'a,Yemen,False,2,0,Draw
24942,26795,28501,2006,Denmark,Portugal,4,2,Friendly,Brøndby,Denmark,False,6,2,Denmark
24943,26796,28502,2006,Oman,Syria,3,0,Friendly,Muscat,Oman,False,3,3,Oman
24944,26797,28503,2006,Austria,Costa Rica,2,2,Friendly,Geneva,Switzerland,True,4,0,Draw
24945,26798,28504,2006,Bahamas,Cayman Islands,3,1,CFU Caribbean Cup qualification,Havana,Cuba,True,4,2,Bahamas
24946,26799,28505,2006,Bahrain,Jordan,0,2,Friendly,Manama,Bahrain,False,2,-2,Jordan
24947,26800,28506,2006,Belarus,Albania,2,2,UEFA Euro qualification,Minsk,Belarus,False,4,0,Draw
24948,26801,28507,2006,Cuba,Turks and Caicos Islands,6,0,CFU Caribbean Cup qualification,Havana,Cuba,False,6,6,Cuba
24949,26802,28508,2006,Czech Republic,Wales,2,1,UEFA Euro qualification,Teplice,Czech Republic,False,3,1,Czech Republic
24950,26803,28509,2006,Egypt,Burundi,4,1,African Cup of Nations qualification,Alexandria,Egypt,False,5,3,Egypt
24951,26804,28510,2006,England,Andorra,5,0,UEFA Euro qualification,Manchester,England,False,5,5,England
24952,26805,28511,2006,Estonia,Israel,0,1,UEFA Euro qualification,Tallinn,Estonia,False,1,-1,Israel
24953,26806,28512,2006,Gabon,Madagascar,4,0,African Cup of Nations qualification,Libreville,Gabon,False,4,4,Gabon
24954,26807,28513,2006,Georgia,France,0,3,UEFA Euro qualification,Tbilisi,Georgia,False,3,-3,France
24955,26808,28514,2006,Germany,Republic of Ireland,1,0,UEFA Euro qualification,Stuttgart,Germany,False,1,1,Germany
24956,26809,28515,2006,Hungary,Norway,1,4,UEFA Euro qualification,Budapest,Hungary,False,5,-3,Norway
24957,26810,28516,2006,Italy,Lithuania,1,1,UEFA Euro qualification,Naples,Italy,False,2,0,Draw
24958,26811,28517,2006,Kenya,Eritrea,1,2,African Cup of Nations qualification,Nairobi,Kenya,False,3,-1,Eritrea
24959,26812,28519,2006,Latvia,Sweden,0,1,UEFA Euro qualification,Riga,Latvia,False,1,-1,Sweden
24960,26813,28520,2006,Luxembourg,Netherlands,0,1,UEFA Euro qualification,Luxembourg,Luxembourg,False,1,-1,Netherlands
24961,26814,28521,2006,Malta,Bosnia and Herzegovina,2,5,UEFA Euro qualification,Attard,Malta,False,7,-3,Bosnia and Herzegovina
24962,26815,28522,2006,Moldova,Greece,0,1,UEFA Euro qualification,Chişinău,Moldova,False,1,-1,Greece
24963,26816,28523,2006,Nigeria,Niger,2,0,African Cup of Nations qualification,Abuja,Nigeria,False,2,2,Nigeria
24964,26817,28524,2006,Northern Ireland,Iceland,0,3,UEFA Euro qualification,Belfast,Northern Ireland,False,3,-3,Iceland
24965,26818,28525,2006,Poland,Finland,1,3,UEFA Euro qualification,Bydgoszcz,Poland,False,4,-2,Finland
24966,26819,28526,2006,Romania,Bulgaria,2,2,UEFA Euro qualification,Constanţa,Romania,False,4,0,Draw
24967,26820,28527,2006,Scotland,Faroe Islands,6,0,UEFA Euro qualification,Glasgow,Scotland,False,6,6,Scotland
24968,26821,28528,2006,Senegal,Mozambique,2,0,African Cup of Nations qualification,Dakar,Senegal,False,2,2,Senegal
24969,26822,28529,2006,Serbia,Azerbaijan,1,0,UEFA Euro qualification,Belgrade,Serbia,False,1,1,Serbia
24970,26823,28530,2006,Slovakia,Cyprus,6,1,UEFA Euro qualification,Bratislava,Slovakia,False,7,5,Slovakia
24971,26824,28531,2006,South Africa,Congo,0,0,African Cup of Nations qualification,Johannesburg,South Africa,False,0,0,Draw
24972,26825,28532,2006,Spain,Liechtenstein,4,0,UEFA Euro qualification,Badajoz,Spain,False,4,4,Spain
24973,26826,28533,2006,Switzerland,Venezuela,1,0,Friendly,Basel,Switzerland,False,1,1,Switzerland
24974,26827,28534,2006,Tanzania,Burkina Faso,2,1,African Cup of Nations qualification,Dar es Salaam,Tanzania,False,3,1,Tanzania
24975,26828,28535,2006,Uganda,Lesotho,3,0,African Cup of Nations qualification,Kampala,Uganda,False,3,3,Uganda
24976,26829,28536,2006,Antigua and Barbuda,Dominica,1,0,Friendly,St. John's,Antigua and Barbuda,False,1,1,Antigua and Barbuda
24977,26830,28537,2006,Argentina,Brazil,0,3,Friendly,London,England,True,3,-3,Brazil
24978,26831,28538,2006,Chad,Zambia,0,2,African Cup of Nations qualification,N'Djamena,Chad,False,2,-2,Zambia
24979,26832,28539,2006,DR Congo,Namibia,3,2,African Cup of Nations qualification,Kinshasa,DR Congo,False,5,1,DR Congo
24980,26833,28540,2006,Equatorial Guinea,Liberia,2,1,African Cup of Nations qualification,Malabo,Equatorial Guinea,False,3,1,Equatorial Guinea
24981,26834,28541,2006,Ethiopia,Libya,1,0,African Cup of Nations qualification,Addis Abeba,Ethiopia,False,1,1,Ethiopia
24982,26836,28543,2006,Guinea,Algeria,0,0,African Cup of Nations qualification,Conakry,Guinea,False,0,0,Draw
24983,26837,28544,2006,Mauritius,Tunisia,0,0,African Cup of Nations qualification,Curepipe,Mauritius,False,0,0,Draw
24984,26838,28545,2006,Rwanda,Cameroon,0,3,African Cup of Nations qualification,Kigali,Rwanda,False,3,-3,Cameroon
24985,26839,28546,2006,Saudi Arabia,Japan,1,0,AFC Asian Cup qualification,Jeddah,Saudi Arabia,False,1,1,Saudi Arabia
24986,26840,28547,2006,Sierra Leone,Mali,0,0,African Cup of Nations qualification,Freetown,Sierra Leone,False,0,0,Draw
24987,26841,28548,2006,Sudan,Seychelles,3,0,African Cup of Nations qualification,Khartoum,Sudan,False,3,3,Sudan
24988,26842,28549,2006,Eswatini,Angola,0,2,African Cup of Nations qualification,Lobamba,Eswatini,False,2,-2,Angola
24989,26843,28550,2006,Togo,Benin,2,1,African Cup of Nations qualification,Lomé,Togo,False,3,1,Togo
24990,26844,28551,2006,Canada,Jamaica,1,0,Friendly,Montréal,Canada,False,1,1,Canada
24991,26845,28552,2006,Cayman Islands,Turks and Caicos Islands,0,2,CFU Caribbean Cup qualification,Havana,Cuba,True,2,-2,Turks and Caicos Islands
24992,26846,28553,2006,Cuba,Bahamas,6,0,CFU Caribbean Cup qualification,Havana,Cuba,False,6,6,Cuba
24993,26847,28554,2006,Wales,Brazil,0,2,Friendly,London,England,True,2,-2,Brazil
24994,26848,28555,2006,Albania,Romania,0,2,UEFA Euro qualification,Tirana,Albania,False,2,-2,Romania
24995,26849,28556,2006,Armenia,Belgium,0,1,UEFA Euro qualification,Yerevan,Armenia,False,1,-1,Belgium
24996,26850,28557,2006,Austria,Venezuela,0,1,Friendly,Basel,Switzerland,True,1,-1,Venezuela
24997,26851,28558,2006,Azerbaijan,Kazakhstan,1,1,UEFA Euro qualification,Baku,Azerbaijan,False,2,0,Draw
24998,26852,28559,2006,Bosnia and Herzegovina,Hungary,1,3,UEFA Euro qualification,Zenica,Bosnia and Herzegovina,False,4,-2,Hungary
24999,26853,28560,2006,Bulgaria,Slovenia,3,0,UEFA Euro qualification,Sofia,Bulgaria,False,3,3,Bulgaria
25000,26854,28561,2006,Cuba,Cayman Islands,7,0,CFU Caribbean Cup qualification,Havana,Cuba,False,7,7,Cuba
25001,26855,28562,2006,Curaçao,Grenada,1,1,CFU Caribbean Cup qualification,Willemstad,Netherlands Antilles,True,2,0,Draw
25002,26856,28563,2006,Ecuador,Peru,1,1,Friendly,East Rutherford,United States,True,2,0,Draw
25003,26857,28564,2006,Finland,Portugal,1,1,UEFA Euro qualification,Helsinki,Finland,False,2,0,Draw
25004,26858,28565,2006,France,Italy,3,1,UEFA Euro qualification,Saint-Denis,France,False,4,2,France
25005,26859,28566,2006,Guatemala,Panama,1,2,Friendly,Guatemala,Guatemala,False,3,-1,Panama
25006,26860,28567,2006,Honduras,El Salvador,2,0,Friendly,Tegucigalpa,Honduras,False,2,2,Honduras
25007,26861,28568,2006,Hong Kong,Uzbekistan,0,0,AFC Asian Cup qualification,So Kon Po,Hong Kong,False,0,0,Draw
25008,26862,28569,2006,Iceland,Denmark,0,2,UEFA Euro qualification,Reykjavík,Iceland,False,2,-2,Denmark
25009,26863,28570,2006,Iraq,Palestine,2,2,AFC Asian Cup qualification,Al Ain,United Arab Emirates,True,4,0,Draw
25010,26864,28571,2006,Israel,Andorra,4,1,UEFA Euro qualification,Nijmegen,Netherlands,True,5,3,Israel
25011,26865,28573,2006,Kuwait,Australia,2,0,AFC Asian Cup qualification,Kuwait City,Kuwait,False,2,2,Kuwait
25012,26866,28574,2006,Lithuania,Scotland,1,2,UEFA Euro qualification,Kaunas,Lithuania,False,3,-1,Scotland
25013,26867,28575,2006,Luxembourg,Latvia,0,0,Friendly,Hesperange,Luxembourg,False,0,0,Draw
25014,26868,28577,2006,Netherlands,Belarus,3,0,UEFA Euro qualification,Eindhoven,Netherlands,False,3,3,Netherlands
25015,26869,28578,2006,Northern Ireland,Spain,3,2,UEFA Euro qualification,Belfast,Northern Ireland,False,5,1,Northern Ireland
25016,26870,28579,2006,Norway,Moldova,2,0,UEFA Euro qualification,Oslo,Norway,False,2,2,Norway
25017,26871,28580,2006,Oman,Pakistan,5,0,AFC Asian Cup qualification,Muscat,Oman,False,5,5,Oman
25018,26872,28581,2006,Poland,Serbia,1,1,UEFA Euro qualification,Warsaw,Poland,False,2,0,Draw
25019,26873,28582,2006,Qatar,Bangladesh,3,0,AFC Asian Cup qualification,Doha,Qatar,False,3,3,Qatar
25020,26874,28583,2006,Russia,Croatia,0,0,UEFA Euro qualification,Moscow,Russia,False,0,0,Draw
25021,26875,28584,2006,San Marino,Germany,0,13,UEFA Euro qualification,Serravalle,San Marino,False,13,-13,Germany
25022,26876,28585,2006,Saudi Arabia,India,7,1,AFC Asian Cup qualification,Jeddah,Saudi Arabia,False,8,6,Saudi Arabia
25023,26878,28587,2006,Slovakia,Czech Republic,0,3,UEFA Euro qualification,Bratislava,Slovakia,False,3,-3,Czech Republic
25024,26879,28588,2006,Suriname,Guyana,0,5,CFU Caribbean Cup qualification,Willemstad,Netherlands Antilles,True,5,-5,Guyana
25025,26880,28589,2006,Sweden,Liechtenstein,3,1,UEFA Euro qualification,Gothenburg,Sweden,False,4,2,Sweden
25026,26881,28590,2006,Switzerland,Costa Rica,2,0,Friendly,Geneva,Switzerland,False,2,2,Switzerland
25027,26882,28591,2006,Turkey,Malta,2,0,UEFA Euro qualification,Frankfurt am Main,Germany,True,2,2,Turkey
25028,26883,28592,2006,Turks and Caicos Islands,Bahamas,2,3,CFU Caribbean Cup qualification,Havana,Cuba,True,5,-1,Bahamas
25029,26884,28593,2006,Ukraine,Georgia,3,2,UEFA Euro qualification,Kyïv,Ukraine,False,5,1,Ukraine
25030,26885,28594,2006,United Arab Emirates,Jordan,0,0,AFC Asian Cup qualification,Sharjah,United Arab Emirates,False,0,0,Draw
25031,26886,28595,2006,Yemen,Japan,0,1,AFC Asian Cup qualification,Sana'a,Yemen,False,1,-1,Japan
25032,26887,28596,2006,Curaçao,Guyana,0,5,CFU Caribbean Cup qualification,Willemstad,Netherlands Antilles,True,5,-5,Guyana
25033,26888,28597,2006,Suriname,Grenada,1,0,CFU Caribbean Cup qualification,Willemstad,Netherlands Antilles,True,1,1,Suriname
25034,26889,28598,2006,Curaçao,Suriname,0,1,CFU Caribbean Cup qualification,Willemstad,Netherlands Antilles,True,1,-1,Suriname
25035,26890,28599,2006,Grenada,Guyana,0,1,CFU Caribbean Cup qualification,Willemstad,Netherlands Antilles,True,1,-1,Guyana
25036,26891,28600,2006,Haiti,Dominican Republic,3,1,Friendly,Saint-Marc,Haiti,False,4,2,Haiti
25037,26892,28601,2006,Dominica,Barbados,0,5,Friendly,Grand Bay,Dominica,False,5,-5,Barbados
25038,26893,28602,2006,Haiti,Dominican Republic,2,1,Friendly,Port-au-Prince,Haiti,False,3,1,Haiti
25039,26894,28603,2006,Zimbabwe,Angola,1,2,COSAFA Cup,Harare,Zimbabwe,False,3,-1,Angola
25040,26895,28604,2006,Antigua and Barbuda,Anguilla,5,3,CFU Caribbean Cup qualification,St. John's,Antigua and Barbuda,False,8,2,Antigua and Barbuda
25041,26896,28605,2006,Barbados,Saint Kitts and Nevis,1,1,CFU Caribbean Cup qualification,St. John's,Antigua and Barbuda,True,2,0,Draw
25042,26897,28606,2006,Dominica,Martinique,0,4,CFU Caribbean Cup qualification,Les Abymes,Guadeloupe,True,4,-4,Martinique
25043,26898,28607,2006,Guadeloupe,Saint Martin,1,0,CFU Caribbean Cup qualification,Les Abymes,Guadeloupe,False,1,1,Guadeloupe
25044,26899,28608,2006,Anguilla,Saint Kitts and Nevis,1,6,CFU Caribbean Cup qualification,St. John's,Antigua and Barbuda,True,7,-5,Saint Kitts and Nevis
25045,26900,28609,2006,Antigua and Barbuda,Barbados,1,3,CFU Caribbean Cup qualification,St. John's,Antigua and Barbuda,False,4,-2,Barbados
25046,26901,28610,2006,Guadeloupe,Dominica,1,0,CFU Caribbean Cup qualification,Les Abymes,Guadeloupe,False,1,1,Guadeloupe
25047,26902,28611,2006,Martinique,Saint Martin,1,0,CFU Caribbean Cup qualification,Les Abymes,Guadeloupe,True,1,1,Martinique
25048,26903,28612,2006,Antigua and Barbuda,Saint Kitts and Nevis,1,0,CFU Caribbean Cup qualification,St. John's,Antigua and Barbuda,False,1,1,Antigua and Barbuda
25049,26904,28613,2006,Barbados,Anguilla,7,1,CFU Caribbean Cup qualification,St. John's,Antigua and Barbuda,True,8,6,Barbados
25050,26905,28614,2006,Dominica,Saint Martin,0,0,CFU Caribbean Cup qualification,Les Abymes,Guadeloupe,True,0,0,Draw
25051,26906,28615,2006,Guadeloupe,Martinique,4,0,CFU Caribbean Cup qualification,Les Abymes,Guadeloupe,False,4,4,Guadeloupe
25052,26907,28616,2006,Jamaica,Saint Lucia,4,0,CFU Caribbean Cup qualification,Kingston,Jamaica,False,4,4,Jamaica
25053,26908,28617,2006,Venezuela,Uruguay,1,0,Friendly,Maracaibo,Venezuela,False,1,1,Venezuela
25054,26909,28618,2006,U.S. Virgin Islands,Bermuda,0,6,CFU Caribbean Cup qualification,Charlotte Amalie,U.S. Virgin Islands,False,6,-6,Bermuda
25055,26910,28619,2006,Bermuda,Dominican Republic,3,1,CFU Caribbean Cup qualification,Charlotte Amalie,U.S. Virgin Islands,True,4,2,Bermuda
25056,26911,28620,2006,Saint Lucia,Haiti,1,7,CFU Caribbean Cup qualification,Kingston,Jamaica,True,8,-6,Haiti
25057,26912,28621,2006,Tanzania,Kenya,0,0,Friendly,Dar es Salaam,Tanzania,False,0,0,Draw
25058,26913,28622,2006,Jamaica,Haiti,2,0,CFU Caribbean Cup qualification,Kingston,Jamaica,False,2,2,Jamaica
25059,26914,28623,2006,Libya,Sudan,1,0,Friendly,Tripoli,Libya,False,1,1,Libya
25060,26915,28624,2006,Saint Vincent and the Grenadines,Saint Lucia,8,0,CFU Caribbean Cup qualification,Kingston,Jamaica,True,8,8,Saint Vincent and the Grenadines
25061,26916,28625,2006,U.S. Virgin Islands,Dominican Republic,1,6,CFU Caribbean Cup qualification,Charlotte Amalie,U.S. Virgin Islands,False,7,-5,Dominican Republic
25062,26917,28626,2006,Botswana,Lesotho,1,0,Friendly,Gaborone,Botswana,False,1,1,Botswana
25063,26918,28627,2006,Ethiopia,Eswatini,2,0,Friendly,Addis Abeba,Ethiopia,False,2,2,Ethiopia
25064,26919,28628,2006,Iran,Iraq,2,0,Friendly,Amman,Jordan,True,2,2,Iran
25065,26920,28629,2006,Japan,Ghana,0,1,Friendly,Yokohama,Japan,False,1,-1,Ghana
25066,26921,28630,2006,Jordan,Iran,0,0,Friendly,Amman,Jordan,False,0,0,Draw
25067,26922,28631,2006,Liechtenstein,Austria,1,2,Friendly,Vaduz,Liechtenstein,False,3,-1,Austria
25068,26923,28632,2006,Algeria,Gambia,1,0,African Cup of Nations qualification,Algiers,Algeria,False,1,1,Algeria
25069,26924,28633,2006,Armenia,Finland,0,0,UEFA Euro qualification,Yerevan,Armenia,False,0,0,Draw
25070,26925,28634,2006,Australia,Paraguay,1,1,Friendly,Brisbane,Australia,False,2,0,Draw
25071,26926,28635,2006,Botswana,Egypt,0,0,African Cup of Nations qualification,Gaborone,Botswana,False,0,0,Draw
25072,26927,28636,2006,Bulgaria,Netherlands,1,1,UEFA Euro qualification,Sofia,Bulgaria,False,2,0,Draw
25073,26928,28637,2006,Burkina Faso,Senegal,1,0,African Cup of Nations qualification,Ouagadougou,Burkina Faso,False,1,1,Burkina Faso
25074,26929,28638,2006,Cameroon,Equatorial Guinea,3,0,African Cup of Nations qualification,Yaoundé,Cameroon,False,3,3,Cameroon
25075,26930,28640,2006,Chile,Peru,3,2,Copa del Pacífico,Viña del Mar,Chile,False,5,1,Chile
25076,26931,28641,2006,Croatia,Andorra,7,0,UEFA Euro qualification,Zagreb,Croatia,False,7,7,Croatia
25077,26932,28642,2006,Cyprus,Republic of Ireland,5,2,UEFA Euro qualification,Nicosia,Cyprus,False,7,3,Cyprus
25078,26933,28643,2006,Czech Republic,San Marino,7,0,UEFA Euro qualification,Liberec,Czech Republic,False,7,7,Czech Republic
25079,26934,28644,2006,Denmark,Northern Ireland,0,0,UEFA Euro qualification,Copenhagen,Denmark,False,0,0,Draw
25080,26936,28646,2006,Eritrea,Eswatini,0,0,African Cup of Nations qualification,Asmara,Eritrea,False,0,0,Draw
25081,26937,28647,2006,Faroe Islands,Lithuania,0,1,UEFA Euro qualification,Tórshavn,Faroe Islands,False,1,-1,Lithuania
25082,26938,28648,2006,Germany,Georgia,2,0,Friendly,Rostock,Germany,False,2,2,Germany
25083,26939,28649,2006,Greece,Norway,1,0,UEFA Euro qualification,Piraeus,Greece,False,1,1,Greece
25084,26940,28650,2006,Guatemala,Honduras,2,3,Friendly,Fort Lauderdale,United States,True,5,-1,Honduras
25085,26941,28651,2006,Hungary,Turkey,0,1,UEFA Euro qualification,Budapest,Hungary,False,1,-1,Turkey
25086,26942,28652,2006,Italy,Ukraine,2,0,UEFA Euro qualification,Rome,Italy,False,2,2,Italy
25087,26943,28653,2006,Kazakhstan,Poland,0,1,UEFA Euro qualification,Almaty,Kazakhstan,False,1,-1,Poland
25088,26944,28654,2006,Latvia,Iceland,4,0,UEFA Euro qualification,Riga,Latvia,False,4,4,Latvia
25089,26945,28655,2006,Malawi,Zimbabwe,1,0,African Cup of Nations qualification,Blantyre,Malawi,False,1,1,Malawi
25090,26946,28656,2006,Moldova,Bosnia and Herzegovina,2,2,UEFA Euro qualification,Chişinău,Moldova,False,4,0,Draw
25091,26947,28657,2006,Namibia,Ethiopia,1,0,African Cup of Nations qualification,Windhoek,Namibia,False,1,1,Namibia
25092,26948,28658,2006,Panama,El Salvador,1,0,Friendly,Panama City,Panama,False,1,1,Panama
25093,26949,28659,2006,Portugal,Azerbaijan,3,0,UEFA Euro qualification,Porto,Portugal,False,3,3,Portugal
25094,26950,28660,2006,Romania,Belarus,3,1,UEFA Euro qualification,Bucharest,Romania,False,4,2,Romania
25095,26951,28661,2006,Russia,Israel,1,1,UEFA Euro qualification,Moscow,Russia,False,2,0,Draw
25096,26952,28662,2006,Scotland,France,1,0,UEFA Euro qualification,Glasgow,Scotland,False,1,1,Scotland
25097,26953,28663,2006,Serbia,Belgium,1,0,UEFA Euro qualification,Belgrade,Serbia,False,1,1,Serbia
25098,26954,28664,2006,Seychelles,Mauritius,2,1,African Cup of Nations qualification,Victoria,Seychelles,False,3,1,Seychelles
25099,26955,28665,2006,Slovenia,Luxembourg,2,0,UEFA Euro qualification,Celje,Slovenia,False,2,2,Slovenia
25100,26956,28666,2006,Sweden,Spain,2,0,UEFA Euro qualification,Solna,Sweden,False,2,2,Sweden
25101,26957,28667,2006,Tunisia,Sudan,1,0,African Cup of Nations qualification,Radès,Tunisia,False,1,1,Tunisia
25102,26958,28668,2006,Wales,Slovakia,1,5,UEFA Euro qualification,Cardiff,Wales,False,6,-4,Slovakia
25103,26959,28669,2006,Angola,Kenya,3,1,African Cup of Nations qualification,Luanda,Angola,False,4,2,Angola
25104,26960,28670,2006,Benin,Sierra Leone,2,0,African Cup of Nations qualification,Cotonou,Benin,False,2,2,Benin
25105,26961,28671,2006,Burundi,Mauritania,3,1,African Cup of Nations qualification,Bujumbura,Burundi,False,4,2,Burundi
25106,26962,28672,2006,Congo,Chad,3,1,African Cup of Nations qualification,Brazzaville,Congo,False,4,2,Congo
25107,26963,28673,2006,Ivory Coast,Gabon,5,0,African Cup of Nations qualification,Abidjan,Ivory Coast,False,5,5,Ivory Coast
25108,26964,28674,2006,Jamaica,Canada,2,1,Friendly,Kingston,Jamaica,False,3,1,Jamaica
25109,26965,28676,2006,Lesotho,Nigeria,0,1,African Cup of Nations qualification,Maseru,Lesotho,False,1,-1,Nigeria
25110,26966,28677,2006,Liberia,Rwanda,3,2,African Cup of Nations qualification,Monrovia,Liberia,False,5,1,Liberia
25111,26967,28678,2006,Libya,DR Congo,1,1,African Cup of Nations qualification,Tripoli,Libya,False,2,0,Draw
25112,26968,28679,2006,Mali,Togo,1,0,African Cup of Nations qualification,Bamako,Mali,False,1,1,Mali
25113,26969,28680,2006,Mozambique,Tanzania,0,0,African Cup of Nations qualification,Maputo,Mozambique,False,0,0,Draw
25114,26970,28681,2006,Niger,Uganda,0,0,African Cup of Nations qualification,Niamey,Niger,False,0,0,Draw
25115,26971,28682,2006,Zambia,South Africa,0,1,African Cup of Nations qualification,Lusaka,Zambia,False,1,-1,South Africa
25116,26972,28684,2006,Brazil,Ecuador,2,1,Friendly,Solna,Sweden,True,3,1,Brazil
25117,26973,28685,2006,Honduras,Guatemala,2,1,Friendly,Atlanta,United States,True,3,1,Honduras
25118,26975,28687,2006,Australia,Bahrain,2,0,AFC Asian Cup qualification,Sydney,Australia,False,2,2,Australia
25119,26976,28688,2006,Austria,Switzerland,2,1,Friendly,Innsbruck,Austria,False,3,1,Austria
25120,26977,28689,2006,Bangladesh,Uzbekistan,0,4,AFC Asian Cup qualification,Dhaka,Bangladesh,False,4,-4,Uzbekistan
25121,26978,28690,2006,Belarus,Slovenia,4,2,UEFA Euro qualification,Minsk,Belarus,False,6,2,Belarus
25122,26979,28691,2006,Belgium,Azerbaijan,3,0,UEFA Euro qualification,Brussels,Belgium,False,3,3,Belgium
25123,26980,28692,2006,Bosnia and Herzegovina,Greece,0,4,UEFA Euro qualification,Zenica,Bosnia and Herzegovina,False,4,-4,Greece
25124,26981,28693,2006,Croatia,England,2,0,UEFA Euro qualification,Zagreb,Croatia,False,2,2,Croatia
25125,26982,28694,2006,France,Faroe Islands,5,0,UEFA Euro qualification,Montbéliard,France,False,5,5,France
25126,26983,28695,2006,Georgia,Italy,1,3,UEFA Euro qualification,Tbilisi,Georgia,False,4,-2,Italy
25127,26984,28696,2006,Iceland,Sweden,1,2,UEFA Euro qualification,Reykjavík,Iceland,False,3,-1,Sweden
25128,26985,28697,2006,India,Japan,0,3,AFC Asian Cup qualification,Bangalore,India,False,3,-3,Japan
25129,26986,28698,2006,Iraq,Singapore,4,2,AFC Asian Cup qualification,Al Ain,United Arab Emirates,True,6,2,Iraq
25130,26987,28699,2006,Republic of Ireland,Czech Republic,1,1,UEFA Euro qualification,Dublin,Republic of Ireland,False,2,0,Draw
25131,26988,28700,2006,Kazakhstan,Finland,0,2,UEFA Euro qualification,Almaty,Kazakhstan,False,2,-2,Finland
25132,26989,28702,2006,Kuwait,Lithuania,1,0,Friendly,Kuwait City,Kuwait,False,1,1,Kuwait
25133,26990,28703,2006,Liechtenstein,Denmark,0,4,UEFA Euro qualification,Vaduz,Liechtenstein,False,4,-4,Denmark
25134,26991,28704,2006,Luxembourg,Bulgaria,0,1,UEFA Euro qualification,Luxembourg,Luxembourg,False,1,-1,Bulgaria
25135,26992,28705,2006,Malta,Hungary,2,1,UEFA Euro qualification,Attard,Malta,False,3,1,Malta
25136,26993,28706,2006,Netherlands,Albania,2,1,UEFA Euro qualification,Amsterdam,Netherlands,False,3,1,Netherlands
25137,26994,28707,2006,Northern Ireland,Latvia,1,0,UEFA Euro qualification,Belfast,Northern Ireland,False,1,1,Northern Ireland
25138,26995,28708,2006,Oman,United Arab Emirates,2,1,AFC Asian Cup qualification,Muscat,Oman,False,3,1,Oman
25139,26996,28709,2006,Pakistan,Jordan,0,3,AFC Asian Cup qualification,Lahore,Pakistan,False,3,-3,Jordan
25140,26998,28711,2006,Peru,Chile,0,1,Copa del Pacífico,Tacna,Peru,False,1,-1,Chile
25141,26999,28712,2006,Poland,Portugal,2,1,UEFA Euro qualification,Chorzów,Poland,False,3,1,Poland
25142,27000,28713,2006,Qatar,Hong Kong,2,0,AFC Asian Cup qualification,Doha,Qatar,False,2,2,Qatar
25143,27001,28714,2006,Russia,Estonia,2,0,UEFA Euro qualification,St. Petersburg,Russia,False,2,2,Russia
25144,27002,28715,2006,Saudi Arabia,Yemen,5,0,AFC Asian Cup qualification,Jeddah,Saudi Arabia,False,5,5,Saudi Arabia
25145,27003,28716,2006,Serbia,Armenia,3,0,UEFA Euro qualification,Belgrade,Serbia,False,3,3,Serbia
25146,27004,28717,2006,Slovakia,Germany,1,4,UEFA Euro qualification,Bratislava,Slovakia,False,5,-3,Germany
25147,27005,28718,2006,Spain,Argentina,2,1,Friendly,Murcia,Spain,False,3,1,Spain
25148,27006,28719,2006,Trinidad and Tobago,Panama,2,1,Friendly,Port of Spain,Trinidad and Tobago,False,3,1,Trinidad and Tobago
25149,27007,28720,2006,Turkey,Moldova,5,0,UEFA Euro qualification,Frankfurt am Main,Germany,True,5,5,Turkey
25150,27008,28721,2006,Ukraine,Scotland,2,0,UEFA Euro qualification,Kyïv,Ukraine,False,2,2,Ukraine
25151,27009,28722,2006,Wales,Cyprus,3,1,UEFA Euro qualification,Cardiff,Wales,False,4,2,Wales
25152,27010,28723,2006,Haiti,Cuba,0,0,Friendly,Port-au-Prince,Haiti,False,0,0,Draw
25153,27011,28724,2006,Uruguay,Venezuela,4,0,Friendly,Montevideo,Uruguay,False,4,4,Uruguay
25154,27012,28725,2006,Haiti,Cuba,0,1,Friendly,Cap-Haïtien,Haiti,False,1,-1,Cuba
25155,27013,28726,2006,Zambia,Angola,2,0,COSAFA Cup,Lusaka,Zambia,False,2,2,Zambia
25156,27014,28727,2006,Saint Vincent and the Grenadines,Martinique,1,1,Friendly,Kingstown,Saint Vincent and the Grenadines,False,2,0,Draw
25157,27015,28728,2006,Antigua and Barbuda,Grenada,1,1,Friendly,Kingstown,Saint Vincent and the Grenadines,True,2,0,Draw
25158,27016,28729,2006,Barbados,Grenada,2,2,Friendly,Black Rock,Barbados,False,4,0,Draw
25159,27017,28730,2006,Haiti,Cuba,1,2,CFU Caribbean Cup qualification,Fort-de-France,Martinique,True,3,-1,Cuba
25160,27018,28731,2006,Martinique,Suriname,1,0,CFU Caribbean Cup qualification,Fort-de-France,Martinique,False,1,1,Martinique
25161,27019,28732,2006,Oman,Bahrain,1,1,Friendly,Muscat,Oman,False,2,0,Draw
25162,27020,28733,2006,Saudi Arabia,Jordan,2,1,Friendly,Riyadh,Saudi Arabia,False,3,1,Saudi Arabia
25163,27022,28735,2006,Cuba,Suriname,3,1,CFU Caribbean Cup qualification,Fort-de-France,Martinique,True,4,2,Cuba
25164,27023,28736,2006,Martinique,Haiti,1,0,CFU Caribbean Cup qualification,Fort-de-France,Martinique,False,1,1,Martinique
25165,27024,28737,2006,Singapore,Indonesia,1,2,Friendly,Singapore,Singapore,False,3,-1,Indonesia
25166,27025,28738,2006,Haiti,Suriname,1,1,CFU Caribbean Cup qualification,Fort-de-France,Martinique,True,2,0,Draw
25167,27026,28739,2006,Martinique,Cuba,0,0,CFU Caribbean Cup qualification,Fort-de-France,Martinique,False,0,0,Draw
25168,27027,28740,2006,Philippines,Laos,1,2,AFF Championship,Bacolod,Philippines,False,3,-1,Laos
25169,27028,28741,2006,Australia,Ghana,1,1,Friendly,London,England,True,2,0,Draw
25170,27029,28742,2006,Cambodia,Laos,2,2,AFF Championship,Bacolod,Philippines,True,4,0,Draw
25171,27030,28743,2006,Mali,Congo,1,0,Friendly,La Courneuve,France,True,1,1,Mali
25172,27031,28744,2006,Philippines,East Timor,7,0,AFF Championship,Bacolod,Philippines,False,7,7,Philippines
25173,27032,28745,2006,Wales,Liechtenstein,4,0,Friendly,Wrexham,Wales,False,4,4,Wales
25174,27033,28746,2006,Algeria,Burkina Faso,1,2,Friendly,Aix-en-Provence,France,True,3,-1,Burkina Faso
25175,27034,28747,2006,Austria,Trinidad and Tobago,4,1,Friendly,Vienna,Austria,False,5,3,Austria
25176,27035,28748,2006,Bahrain,Kuwait,2,1,AFC Asian Cup qualification,Riffa,Bahrain,False,3,1,Bahrain
25177,27036,28749,2006,Belgium,Poland,0,1,UEFA Euro qualification,Brussels,Belgium,False,1,-1,Poland
25178,27037,28750,2006,Bolivia,El Salvador,4,1,Friendly,La Paz,Bolivia,False,5,3,Bolivia
25179,27038,28751,2006,Botswana,Eswatini,1,0,Friendly,Gaborone,Botswana,False,1,1,Botswana
25180,27039,28752,2006,Chile,Paraguay,3,2,Friendly,Viña del Mar,Chile,False,5,1,Chile
25181,27040,28754,2006,Cyprus,Germany,1,1,UEFA Euro qualification,Nicosia,Cyprus,False,2,0,Draw
25182,27041,28755,2006,Czech Republic,Denmark,1,1,Friendly,Prague,Czech Republic,False,2,0,Draw
25183,27042,28756,2006,Egypt,South Africa,1,0,Friendly,Brentford,England,True,1,1,Egypt
25184,27043,28757,2006,Estonia,Belarus,2,1,Friendly,Tallinn,Estonia,False,3,1,Estonia
25185,27044,28758,2006,Finland,Armenia,1,0,UEFA Euro qualification,Helsinki,Finland,False,1,1,Finland
25186,27045,28759,2006,France,Greece,1,0,Friendly,Saint-Denis,France,False,1,1,France
25187,27046,28760,2006,Georgia,Uruguay,2,0,Friendly,Tbilisi,Georgia,False,2,2,Georgia
25188,27047,28761,2006,Hong Kong,Bangladesh,2,0,AFC Asian Cup qualification,Kowloon,Hong Kong,False,2,2,Hong Kong
25189,27048,28762,2006,Hungary,Canada,1,0,Friendly,Székesfehérvár,Hungary,False,1,1,Hungary
25190,27050,28764,2006,Republic of Ireland,San Marino,5,0,UEFA Euro qualification,Dublin,Republic of Ireland,False,5,5,Republic of Ireland
25191,27051,28765,2006,Israel,Croatia,3,4,UEFA Euro qualification,Ramat-Gan,Israel,False,7,-1,Croatia
25192,27052,28766,2006,Italy,Turkey,1,1,Friendly,Bergamo,Italy,False,2,0,Draw
25193,27053,28767,2006,Ivory Coast,Sweden,1,0,Friendly,Le Mans,France,True,1,1,Ivory Coast
25194,27054,28768,2006,Jamaica,Peru,1,1,Friendly,Kingston,Jamaica,False,2,0,Draw
25195,27055,28769,2006,Japan,Saudi Arabia,3,1,AFC Asian Cup qualification,Sapporo,Japan,False,4,2,Japan
25196,27056,28770,2006,Jordan,Oman,3,0,AFC Asian Cup qualification,Amman,Jordan,False,3,3,Jordan
25197,27057,28771,2006,Luxembourg,Togo,0,0,Friendly,Luxembourg,Luxembourg,False,0,0,Draw
25198,27058,28773,2006,Malta,Lithuania,1,4,Friendly,Attard,Malta,False,5,-3,Lithuania
25199,27059,28774,2006,Morocco,Gabon,6,0,Friendly,Rabat,Morocco,False,6,6,Morocco
25200,27060,28775,2006,Netherlands,England,1,1,Friendly,Amsterdam,Netherlands,False,2,0,Draw
25201,27061,28776,2006,Portugal,Kazakhstan,3,0,UEFA Euro qualification,Coimbra,Portugal,False,3,3,Portugal
25202,27062,28777,2006,Serbia,Norway,1,1,Friendly,Belgrade,Serbia,False,2,0,Draw
25203,27063,28778,2006,Slovakia,Bulgaria,3,1,Friendly,Žilina,Slovakia,False,4,2,Slovakia
25204,27064,28779,2006,Spain,Romania,0,1,Friendly,Cádiz,Spain,False,1,-1,Romania
25205,27065,28780,2006,Switzerland,Brazil,1,2,Friendly,Basel,Switzerland,False,3,-1,Brazil
25206,27067,28782,2006,Tunisia,Libya,2,0,Friendly,Tunis,Tunisia,False,2,2,Tunisia
25207,27068,28783,2006,United Arab Emirates,Pakistan,3,2,AFC Asian Cup qualification,Abu Dhabi,United Arab Emirates,False,5,1,United Arab Emirates
25208,27069,28784,2006,Uzbekistan,Qatar,2,0,AFC Asian Cup qualification,Tashkent,Uzbekistan,False,2,2,Uzbekistan
25209,27070,28785,2006,Venezuela,Guatemala,2,1,Friendly,Caracas,Venezuela,False,3,1,Venezuela
25210,27071,28786,2006,Yemen,India,2,1,AFC Asian Cup qualification,Sana'a,Yemen,False,3,1,Yemen
25211,27072,28787,2006,Zimbabwe,Namibia,3,2,Friendly,Harare,Zimbabwe,False,5,1,Zimbabwe
25212,27073,28788,2006,Laos,East Timor,3,2,AFF Championship,Bacolod,Philippines,True,5,1,Laos
25213,27074,28789,2006,Philippines,Cambodia,1,0,AFF Championship,Bacolod,Philippines,False,1,1,Philippines
25214,27075,28790,2006,Tanzania,Angola,1,1,Friendly,Dar es Salaam,Tanzania,False,2,0,Draw
25215,27076,28791,2006,Barbados,Bahamas,2,1,CFU Caribbean Cup qualification,Bridgetown,Barbados,False,3,1,Barbados
25216,27077,28792,2006,Panama,Peru,1,2,Friendly,Panama City,Panama,False,3,-1,Peru
25217,27079,28797,2006,Cambodia,East Timor,4,1,AFF Championship,Bacolod,Philippines,True,5,3,Cambodia
25218,27081,28803,2006,Bahamas,Bermuda,0,4,CFU Caribbean Cup qualification,Bridgetown,Barbados,True,4,-4,Bermuda
25219,27082,28805,2006,Greenland,Kyrgyzstan,0,1,ELF Cup,Kyrenia,Northern Cyprus,True,1,-1,Kyrgyzstan
25220,27084,28809,2006,Barbados,Bermuda,1,1,CFU Caribbean Cup qualification,Bridgetown,Barbados,False,2,0,Draw
25221,27086,28813,2006,Dominican Republic,Guadeloupe,0,3,CFU Caribbean Cup qualification,Georgetown,Guyana,True,3,-3,Guadeloupe
25222,27087,28814,2006,Guyana,Antigua and Barbuda,6,0,CFU Caribbean Cup qualification,Georgetown,Guyana,False,6,6,Guyana
25223,27088,28816,2006,Ethiopia,Tanzania,1,2,CECAFA Cup,Addis Abeba,Ethiopia,False,3,-1,Tanzania
25224,27090,28819,2006,Burundi,Zambia,3,2,CECAFA Cup,Addis Abeba,Ethiopia,True,5,1,Burundi
25225,27091,28820,2006,Djibouti,Malawi,0,3,CECAFA Cup,Addis Abeba,Ethiopia,True,3,-3,Malawi
25226,27092,28821,2006,Dominican Republic,Antigua and Barbuda,2,0,CFU Caribbean Cup qualification,Georgetown,Guyana,True,2,2,Dominican Republic
25227,27093,28822,2006,Guyana,Guadeloupe,3,2,CFU Caribbean Cup qualification,Georgetown,Guyana,False,5,1,Guyana
25228,27094,28823,2006,Somalia,Rwanda,0,3,CECAFA Cup,Addis Abeba,Ethiopia,True,3,-3,Rwanda
25229,27095,28824,2006,Sudan,Uganda,1,2,CECAFA Cup,Addis Abeba,Ethiopia,True,3,-1,Uganda
25230,27096,28825,2006,Antigua and Barbuda,Guadeloupe,1,3,CFU Caribbean Cup qualification,Georgetown,Guyana,True,4,-2,Guadeloupe
25231,27097,28826,2006,Ethiopia,Djibouti,4,0,CECAFA Cup,Addis Abeba,Ethiopia,False,4,4,Ethiopia
25232,27098,28827,2006,Guyana,Dominican Republic,4,0,CFU Caribbean Cup qualification,Georgetown,Guyana,False,4,4,Guyana
25233,27099,28828,2006,Malawi,Tanzania,1,2,CECAFA Cup,Addis Abeba,Ethiopia,True,3,-1,Tanzania
25234,27100,28829,2006,El Salvador,Panama,0,0,Friendly,San Salvador,El Salvador,False,0,0,Draw
25235,27101,28831,2006,Rwanda,Uganda,0,1,CECAFA Cup,Addis Abeba,Ethiopia,True,1,-1,Uganda
25236,27102,28832,2006,Somalia,Sudan,0,3,CECAFA Cup,Addis Abeba,Ethiopia,True,3,-3,Sudan
25237,27103,28833,2006,Ethiopia,Malawi,1,0,CECAFA Cup,Addis Abeba,Ethiopia,False,1,1,Ethiopia
25238,27104,28834,2006,Tanzania,Djibouti,3,0,CECAFA Cup,Addis Abeba,Ethiopia,True,3,3,Tanzania
25239,27106,28836,2006,Sudan,Rwanda,0,0,CECAFA Cup,Addis Abeba,Ethiopia,True,0,0,Draw
25240,27107,28837,2006,Uganda,Somalia,2,0,CECAFA Cup,Addis Abeba,Ethiopia,True,2,2,Uganda
25241,27108,28838,2006,Ethiopia,Zambia,0,1,CECAFA Cup,Addis Abeba,Ethiopia,False,1,-1,Zambia
25242,27109,28839,2006,Tanzania,Rwanda,1,2,CECAFA Cup,Addis Abeba,Ethiopia,True,3,-1,Rwanda
25243,27110,28840,2006,Burundi,Sudan,0,1,CECAFA Cup,Addis Abeba,Ethiopia,True,1,-1,Sudan
25244,27111,28841,2006,Uganda,Malawi,0,0,CECAFA Cup,Addis Abeba,Ethiopia,True,0,0,Draw
25245,27112,28842,2006,United Arab Emirates,Poland,2,5,Friendly,Abu Dhabi,United Arab Emirates,False,7,-3,Poland
25246,27113,28843,2006,Rwanda,Zambia,0,1,CECAFA Cup,Addis Abeba,Ethiopia,True,1,-1,Zambia
25247,27114,28844,2006,Uganda,Sudan,2,2,CECAFA Cup,Addis Abeba,Ethiopia,True,4,0,Draw
25248,27115,28845,2006,Tanzania,DR Congo,2,0,Friendly,Dar es Salaam,Tanzania,False,2,2,Tanzania
25249,27116,28847,2006,Rwanda,Uganda,0,0,CECAFA Cup,Addis Abeba,Ethiopia,True,0,0,Draw
25250,27117,28848,2006,United Arab Emirates,Slovakia,1,2,Friendly,Abu Dhabi,United Arab Emirates,False,3,-1,Slovakia
25251,27118,28849,2006,Zambia,Sudan,0,0,CECAFA Cup,Addis Abeba,Ethiopia,True,0,0,Draw
25252,27119,28850,2006,Yemen,Comoros,2,0,UAFA Cup qualification,Sana'a,Yemen,False,2,2,Yemen
25253,27120,28851,2006,Réunion,Mayotte,3,1,Friendly,Saint-Denis,Réunion,False,4,2,Réunion
25254,27121,28852,2006,Djibouti,Comoros,2,4,UAFA Cup qualification,Sana'a,Yemen,True,6,-2,Comoros
25255,27122,28853,2006,Yemen,Djibouti,4,1,UAFA Cup qualification,Sana'a,Yemen,False,5,3,Yemen
25256,27123,28854,2006,Lebanon,Mauritania,0,0,UAFA Cup qualification,Beirut,Lebanon,False,0,0,Draw
25257,27124,28855,2006,Sudan,Somalia,6,1,UAFA Cup qualification,Beirut,Lebanon,True,7,5,Sudan
25258,27125,28856,2006,Lebanon,Somalia,4,0,UAFA Cup qualification,Beirut,Lebanon,False,4,4,Lebanon
25259,27126,28857,2006,Singapore,Kazakhstan,0,0,King's Cup,Bangkok,Thailand,True,0,0,Draw
25260,27127,28858,2006,Sudan,Mauritania,2,0,UAFA Cup qualification,Beirut,Lebanon,True,2,2,Sudan
25261,27128,28859,2006,Thailand,Vietnam,2,1,King's Cup,Bangkok,Thailand,False,3,1,Thailand
25262,27129,28860,2006,Thailand,Singapore,2,0,King's Cup,Bangkok,Thailand,False,2,2,Thailand
25263,27130,28861,2006,Vietnam,Kazakhstan,2,1,King's Cup,Bangkok,Thailand,True,3,1,Vietnam
25264,27131,28862,2006,Lebanon,Sudan,0,0,UAFA Cup qualification,Beirut,Lebanon,False,0,0,Draw
25265,27132,28863,2006,Somalia,Mauritania,2,8,UAFA Cup qualification,Beirut,Lebanon,True,10,-6,Mauritania
25266,27133,28865,2006,Martinique,Saint Vincent and the Grenadines,2,2,Friendly,Saint-Joseph,Martinique,False,4,0,Draw
25267,27134,28866,2006,Singapore,Vietnam,2,3,King's Cup,Bangkok,Thailand,True,5,-1,Vietnam
25268,27135,28867,2006,Thailand,Kazakhstan,2,2,King's Cup,Bangkok,Thailand,False,4,0,Draw
25269,27136,28869,2006,Martinique,Saint Vincent and the Grenadines,1,1,Friendly,Sainte-Marie,Martinique,False,2,0,Draw
25270,27137,28870,2006,Thailand,Vietnam,3,1,King's Cup,Bangkok,Thailand,False,4,2,Thailand
25271,27138,28871,2007,Martinique,Guadeloupe,3,0,Friendly,Le Lamentin,Martinique,False,3,3,Martinique
25272,27139,28872,2007,Haiti,Bermuda,2,0,CFU Caribbean Cup qualification,Couva,Trinidad and Tobago,True,2,2,Haiti
25273,27140,28873,2007,Singapore,Philippines,4,1,Friendly,Singapore,Singapore,False,5,3,Singapore
25274,27141,28874,2007,Yemen,Eritrea,4,1,Friendly,Sana'a,Yemen,False,5,3,Yemen
25275,27142,28875,2007,Saudi Arabia,Gambia,3,0,Friendly,Dammam,Saudi Arabia,False,3,3,Saudi Arabia
25276,27143,28876,2007,Bermuda,Haiti,0,3,CFU Caribbean Cup qualification,Couva,Trinidad and Tobago,True,3,-3,Haiti
25277,27144,28877,2007,Costa Rica,Nicaragua,2,0,Friendly,San José,Costa Rica,False,2,2,Costa Rica
25278,27145,28878,2007,Saudi Arabia,Syria,2,1,Friendly,Dammam,Saudi Arabia,False,3,1,Saudi Arabia
25279,27146,28879,2007,Haiti,Martinique,1,0,CFU Caribbean Cup,Port of Spain,Trinidad and Tobago,True,1,1,Haiti
25280,27147,28880,2007,Malaysia,Philippines,4,0,AFF Championship,Bangkok,Thailand,True,4,4,Malaysia
25281,27148,28881,2007,Thailand,Burma,1,1,AFF Championship,Bangkok,Thailand,False,2,0,Draw
25282,27149,28882,2007,Trinidad and Tobago,Barbados,1,1,CFU Caribbean Cup,Port of Spain,Trinidad and Tobago,False,2,0,Draw
25283,27150,28883,2007,Indonesia,Laos,3,1,AFF Championship,Singapore,Singapore,True,4,2,Indonesia
25284,27151,28884,2007,Qatar,Oman,1,1,Friendly,Doha,Qatar,False,2,0,Draw
25285,27152,28885,2007,Singapore,Vietnam,0,0,AFF Championship,Singapore,Singapore,False,0,0,Draw
25286,27153,28886,2007,Cuba,Guadeloupe,1,2,CFU Caribbean Cup,San Fernando,Trinidad and Tobago,True,3,-1,Guadeloupe
25287,27154,28887,2007,Malaysia,Burma,0,0,AFF Championship,Bangkok,Thailand,True,0,0,Draw
25288,27155,28888,2007,Panama,Armenia,1,1,Friendly,Monterey Park,United States,True,2,0,Draw
25289,27156,28889,2007,Thailand,Philippines,4,0,AFF Championship,Bangkok,Thailand,False,4,4,Thailand
25290,27157,28890,2007,Venezuela,Sweden,2,0,Friendly,Maracaibo,Venezuela,False,2,2,Venezuela
25291,27158,28891,2007,Haiti,Barbados,2,0,CFU Caribbean Cup,Port of Spain,Trinidad and Tobago,True,2,2,Haiti
25292,27159,28892,2007,Singapore,Laos,11,0,AFF Championship,Singapore,Singapore,False,11,11,Singapore
25293,27160,28893,2007,Trinidad and Tobago,Martinique,5,1,CFU Caribbean Cup,Port of Spain,Trinidad and Tobago,False,6,4,Trinidad and Tobago
25294,27161,28894,2007,Vietnam,Indonesia,1,1,AFF Championship,Singapore,Singapore,True,2,0,Draw
25295,27162,28895,2007,Burma,Philippines,0,0,AFF Championship,Bangkok,Thailand,True,0,0,Draw
25296,27163,28896,2007,Guadeloupe,Guyana,3,4,CFU Caribbean Cup,San Fernando,Trinidad and Tobago,True,7,-1,Guyana
25297,27164,28897,2007,Thailand,Malaysia,1,0,AFF Championship,Bangkok,Thailand,False,1,1,Thailand
25298,27165,28898,2007,Barbados,Martinique,2,3,CFU Caribbean Cup,Port of Spain,Trinidad and Tobago,True,5,-1,Martinique
25299,27166,28899,2007,Kuwait,Yemen,1,1,Gulf Cup,Abu Dhabi,United Arab Emirates,True,2,0,Draw
25300,27167,28900,2007,Singapore,Indonesia,2,2,AFF Championship,Singapore,Singapore,False,4,0,Draw
25301,27168,28901,2007,Trinidad and Tobago,Haiti,3,1,CFU Caribbean Cup,Port of Spain,Trinidad and Tobago,False,4,2,Trinidad and Tobago
25302,27169,28902,2007,United Arab Emirates,Oman,1,2,Gulf Cup,Abu Dhabi,United Arab Emirates,False,3,-1,Oman
25303,27170,28903,2007,Vietnam,Laos,9,0,AFF Championship,Singapore,Singapore,True,9,9,Vietnam
25304,27171,28904,2007,Cuba,Guyana,0,0,CFU Caribbean Cup,San Fernando,Trinidad and Tobago,True,0,0,Draw
25305,27172,28905,2007,Ecuador,Sweden,2,1,Friendly,Cuenca,Ecuador,False,3,1,Ecuador
25306,27173,28906,2007,Qatar,Iraq,0,1,Gulf Cup,Abu Dhabi,United Arab Emirates,True,1,-1,Iraq
25307,27174,28907,2007,Saudi Arabia,Bahrain,2,1,Gulf Cup,Abu Dhabi,United Arab Emirates,True,3,1,Saudi Arabia
25308,27175,28908,2007,Saint Vincent and the Grenadines,Guadeloupe,0,1,CFU Caribbean Cup,San Fernando,Trinidad and Tobago,True,1,-1,Guadeloupe
25309,27176,28909,2007,Guadeloupe,Haiti,1,3,CFU Caribbean Cup,Port of Spain,Trinidad and Tobago,True,4,-2,Haiti
25310,27177,28910,2007,Kuwait,Oman,1,2,Gulf Cup,Abu Dhabi,United Arab Emirates,True,3,-1,Oman
25311,27178,28911,2007,Trinidad and Tobago,Cuba,3,1,CFU Caribbean Cup,Port of Spain,Trinidad and Tobago,False,4,2,Trinidad and Tobago
25312,27179,28912,2007,United Arab Emirates,Yemen,2,1,Gulf Cup,Abu Dhabi,United Arab Emirates,False,3,1,United Arab Emirates
25313,27180,28913,2007,Bahrain,Iraq,1,1,Gulf Cup,Abu Dhabi,United Arab Emirates,True,2,0,Draw
25314,27181,28914,2007,Ecuador,Sweden,1,1,Friendly,Quito,Ecuador,False,2,0,Draw
25315,27182,28915,2007,Saudi Arabia,Qatar,1,1,Gulf Cup,Abu Dhabi,United Arab Emirates,True,2,0,Draw
25316,27183,28916,2007,Cuba,Guadeloupe,2,1,CFU Caribbean Cup,Port of Spain,Trinidad and Tobago,True,3,1,Cuba
25317,27184,28917,2007,Malaysia,Singapore,1,1,AFF Championship,Shah Alam,Malaysia,False,2,0,Draw
25318,27185,28918,2007,Oman,Yemen,2,1,Gulf Cup,Abu Dhabi,United Arab Emirates,True,3,1,Oman
25319,27186,28919,2007,Trinidad and Tobago,Haiti,1,2,CFU Caribbean Cup,Port of Spain,Trinidad and Tobago,False,3,-1,Haiti
25320,27187,28920,2007,United Arab Emirates,Kuwait,3,2,Gulf Cup,Abu Dhabi,United Arab Emirates,False,5,1,United Arab Emirates
25321,27188,28921,2007,Qatar,Bahrain,1,2,Gulf Cup,Abu Dhabi,United Arab Emirates,True,3,-1,Bahrain
25322,27189,28922,2007,Saudi Arabia,Iraq,1,0,Gulf Cup,Abu Dhabi,United Arab Emirates,True,1,1,Saudi Arabia
25323,27190,28923,2007,Vietnam,Thailand,0,2,AFF Championship,Hanoi,Vietnam,False,2,-2,Thailand
25324,27191,28925,2007,Oman,Bahrain,1,0,Gulf Cup,Abu Dhabi,United Arab Emirates,True,1,1,Oman
25325,27192,28926,2007,Singapore,Malaysia,1,1,AFF Championship,Singapore,Singapore,False,2,0,Draw
25326,27193,28927,2007,United Arab Emirates,Saudi Arabia,1,0,Gulf Cup,Abu Dhabi,United Arab Emirates,False,1,1,United Arab Emirates
25327,27194,28928,2007,Thailand,Vietnam,0,0,AFF Championship,Bangkok,Thailand,False,0,0,Draw
25328,27195,28929,2007,United Arab Emirates,Oman,1,0,Gulf Cup,Abu Dhabi,United Arab Emirates,False,1,1,United Arab Emirates
25329,27196,28930,2007,Panama,Trinidad and Tobago,2,1,Friendly,Panama City,Panama,False,3,1,Panama
25330,27197,28931,2007,Singapore,Thailand,2,1,AFF Championship,Singapore,Singapore,False,3,1,Singapore
25331,27198,28932,2007,Poland,Estonia,4,0,Friendly,Jerez de la Frontera,Spain,True,4,4,Poland
25332,27199,28933,2007,Costa Rica,Trinidad and Tobago,4,0,Friendly,Alajuela,Costa Rica,False,4,4,Costa Rica
25333,27200,28934,2007,Thailand,Singapore,1,1,AFF Championship,Bangkok,Thailand,False,2,0,Draw
25334,27201,28935,2007,Australia,Denmark,1,3,Friendly,London,England,True,4,-2,Denmark
25335,27202,28936,2007,Botswana,Namibia,1,0,Friendly,Gaborone,Botswana,False,1,1,Botswana
25336,27203,28937,2007,Cyprus,Hungary,2,1,Cyprus International Tournament,Limassol,Cyprus,False,3,1,Cyprus
25337,27205,28939,2007,Ivory Coast,Guinea,1,0,Friendly,Le Havre,France,True,1,1,Ivory Coast
25338,27206,28940,2007,Latvia,Bulgaria,0,2,Cyprus International Tournament,Larnaca,Cyprus,True,2,-2,Bulgaria
25339,27207,28941,2007,Lithuania,Mali,1,3,Friendly,La Courneuve,France,True,4,-2,Mali
25340,27208,28942,2007,Nigeria,Ghana,1,4,Friendly,Brentford,England,True,5,-3,Ghana
25341,27209,28943,2007,Northern Ireland,Wales,0,0,Friendly,Belfast,Northern Ireland,False,0,0,Draw
25342,27210,28944,2007,Portugal,Brazil,2,0,Friendly,London,England,True,2,2,Portugal
25343,27212,28946,2007,Algeria,Libya,2,1,Friendly,Algiers,Algeria,False,3,1,Algeria
25344,27213,28947,2007,Andorra,Armenia,0,0,Friendly,Sant Julià de Lòria,Andorra,False,0,0,Draw
25345,27214,28948,2007,Belgium,Czech Republic,0,2,Friendly,Brussels,Belgium,False,2,-2,Czech Republic
25346,27215,28950,2007,Colombia,Uruguay,1,3,Friendly,Cúcuta,Colombia,False,4,-2,Uruguay
25347,27216,28951,2007,Croatia,Norway,2,1,Friendly,Rijeka,Croatia,False,3,1,Croatia
25348,27217,28952,2007,Cyprus,Bulgaria,0,3,Cyprus International Tournament,Nicosia,Cyprus,False,3,-3,Bulgaria
25349,27218,28953,2007,Egypt,Sweden,2,0,Friendly,Cairo,Egypt,False,2,2,Egypt
25350,27219,28954,2007,England,Spain,0,1,Friendly,Manchester,England,False,1,-1,Spain
25351,27220,28955,2007,France,Argentina,0,1,Friendly,Saint-Denis,France,False,1,-1,Argentina
25352,27221,28956,2007,Georgia,Turkey,1,0,Friendly,Tbilisi,Georgia,False,1,1,Georgia
25353,27222,28957,2007,Germany,Switzerland,3,1,Friendly,Düsseldorf,Germany,False,4,2,Germany
25354,27223,28958,2007,Iran,Belarus,2,2,Friendly,Teheran,Iran,False,4,0,Draw
25355,27224,28959,2007,Israel,Ukraine,1,1,Friendly,Ramat-Gan,Israel,False,2,0,Draw
25356,27225,28960,2007,Latvia,Hungary,0,2,Cyprus International Tournament,Limassol,Cyprus,True,2,-2,Hungary
25357,27226,28961,2007,Luxembourg,Gambia,2,1,Friendly,Hesperange,Luxembourg,False,3,1,Luxembourg
25358,27227,28962,2007,Malta,Austria,1,1,Friendly,Attard,Malta,False,2,0,Draw
25359,27228,28963,2007,Morocco,Tunisia,1,1,Friendly,Casablanca,Morocco,False,2,0,Draw
25360,27229,28964,2007,Netherlands,Russia,4,1,Friendly,Amsterdam,Netherlands,False,5,3,Netherlands
25361,27230,28965,2007,Poland,Slovakia,2,2,Friendly,Jerez de la Frontera,Spain,True,4,0,Draw
25362,27231,28966,2007,Romania,Moldova,2,0,Friendly,Bucharest,Romania,False,2,2,Romania
25363,27232,28967,2007,San Marino,Republic of Ireland,1,2,UEFA Euro qualification,Serravalle,San Marino,False,3,-1,Republic of Ireland
25364,27233,28968,2007,Senegal,Benin,2,1,Friendly,Rouen,France,True,3,1,Senegal
25365,27234,28969,2007,Slovenia,Estonia,1,0,Friendly,Domžale,Slovenia,False,1,1,Slovenia
25366,27235,28970,2007,Togo,Cameroon,2,2,Friendly,Lomé,Togo,False,4,0,Draw
25367,27236,28971,2007,United States,Mexico,2,0,Friendly,Glendale,United States,False,2,2,United States
25368,27237,28972,2007,Uzbekistan,Azerbaijan,0,0,Friendly,Qarshi,Uzbekistan,False,0,0,Draw
25369,27238,28973,2007,Venezuela,Chile,0,1,Friendly,Maracaibo,Venezuela,False,1,-1,Chile
25370,27239,28974,2007,El Salvador,Belize,2,1,UNCAF Cup,San Salvador,El Salvador,False,3,1,El Salvador
25371,27240,28975,2007,Guatemala,Nicaragua,1,0,UNCAF Cup,San Salvador,El Salvador,True,1,1,Guatemala
25372,27241,28976,2007,Costa Rica,Honduras,3,1,UNCAF Cup,San Salvador,El Salvador,True,4,2,Costa Rica
25373,27242,28977,2007,El Salvador,Nicaragua,2,1,UNCAF Cup,San Salvador,El Salvador,False,3,1,El Salvador
25374,27243,28978,2007,Guatemala,Belize,1,0,UNCAF Cup,San Salvador,El Salvador,True,1,1,Guatemala
25375,27244,28979,2007,Honduras,Panama,1,1,UNCAF Cup,San Salvador,El Salvador,True,2,0,Draw
25376,27245,28980,2007,El Salvador,Guatemala,0,0,UNCAF Cup,San Salvador,El Salvador,False,0,0,Draw
25377,27246,28981,2007,Nicaragua,Belize,4,2,UNCAF Cup,San Salvador,El Salvador,True,6,2,Nicaragua
25378,27247,28982,2007,Lesotho,Eswatini,0,1,Friendly,Maseru,Lesotho,False,1,-1,Eswatini
25379,27248,28983,2007,Panama,Costa Rica,1,0,UNCAF Cup,San Salvador,El Salvador,True,1,1,Panama
25380,27249,28984,2007,Nicaragua,Honduras,1,9,UNCAF Cup,San Salvador,El Salvador,True,10,-8,Honduras
25381,27250,28985,2007,El Salvador,Costa Rica,0,2,UNCAF Cup,San Salvador,El Salvador,False,2,-2,Costa Rica
25382,27251,28986,2007,Panama,Guatemala,2,0,UNCAF Cup,San Salvador,El Salvador,True,2,2,Panama
25383,27252,28987,2007,Costa Rica,Panama,1,1,UNCAF Cup,San Salvador,El Salvador,True,2,0,Draw
25384,27253,28988,2007,El Salvador,Guatemala,0,1,UNCAF Cup,San Salvador,El Salvador,False,1,-1,Guatemala
25385,27254,28989,2007,Benin,Chad,0,1,Friendly,Cotonou,Benin,False,1,-1,Chad
25386,27255,28990,2007,Mexico,Venezuela,3,1,Friendly,San Diego,United States,True,4,2,Mexico
25387,27256,28991,2007,Congo,Equatorial Guinea,2,1,Friendly,N'Djamena,Chad,True,3,1,Congo
25388,27257,28992,2007,Chad,Central African Republic,3,2,Friendly,N'Djamena,Chad,False,5,1,Chad
25389,27258,28993,2007,Azerbaijan,Uzbekistan,1,0,Friendly,Shymkent,Kazakhstan,True,1,1,Azerbaijan
25390,27259,28994,2007,Congo,Gabon,2,2,Friendly,N'Djamena,Chad,True,4,0,Draw
25391,27260,28995,2007,Kazakhstan,Kyrgyzstan,2,0,Friendly,Shymkent,Kazakhstan,False,2,2,Kazakhstan
25392,27261,28996,2007,Equatorial Guinea,Gabon,1,1,Friendly,N'Djamena,Chad,True,2,0,Draw
25393,27262,28997,2007,Kazakhstan,Azerbaijan,1,0,Friendly,Shymkent,Kazakhstan,False,1,1,Kazakhstan
25394,27263,28998,2007,Kyrgyzstan,Uzbekistan,0,6,Friendly,Shymkent,Kazakhstan,True,6,-6,Uzbekistan
25395,27264,28999,2007,Azerbaijan,Kyrgyzstan,1,0,Friendly,Shymkent,Kazakhstan,True,1,1,Azerbaijan
25396,27265,29000,2007,Chad,Gabon,1,2,Friendly,N'Djamena,Chad,False,3,-1,Gabon
25397,27266,29001,2007,Kazakhstan,Uzbekistan,1,1,Friendly,Shymkent,Kazakhstan,False,2,0,Draw
25398,27267,29002,2007,Congo,Central African Republic,4,1,Friendly,N'Djamena,Chad,True,5,3,Congo
25399,27268,29003,2007,Gabon,Congo,0,1,Friendly,N'Djamena,Chad,True,1,-1,Congo
25400,27269,29004,2007,Eswatini,Lesotho,0,1,Friendly,Lobamba,Eswatini,False,1,-1,Lesotho
25401,27270,29005,2007,Libya,Mauritania,0,0,Friendly,Tripoli,Libya,False,0,0,Draw
25402,27271,29006,2007,Mauritius,Ivory Coast,0,3,Friendly,Belle Vue,Mauritius,False,3,-3,Ivory Coast
25403,27272,29007,2007,Jamaica,Switzerland,0,2,Friendly,Fort Lauderdale,United States,True,2,-2,Switzerland
25404,27273,29008,2007,Albania,Slovenia,0,0,UEFA Euro qualification,Shkodër,Albania,False,0,0,Draw
25405,27275,29010,2007,Austria,Ghana,1,1,Friendly,Graz,Austria,False,2,0,Draw
25406,27276,29011,2007,Brazil,Chile,4,0,Friendly,Gothenburg,Sweden,True,4,4,Brazil
25407,27277,29012,2007,Burkina Faso,Mozambique,1,1,African Cup of Nations qualification,Ouagadougou,Burkina Faso,False,2,0,Draw
25408,27278,29013,2007,Cameroon,Liberia,3,1,African Cup of Nations qualification,Yaoundé,Cameroon,False,4,2,Cameroon
25409,27279,29014,2007,Chad,South Africa,0,3,African Cup of Nations qualification,N'Djamena,Chad,False,3,-3,South Africa
25410,27280,29016,2007,Costa Rica,New Zealand,4,0,Friendly,San José,Costa Rica,False,4,4,Costa Rica
25411,27282,29018,2007,Cyprus,Slovakia,1,3,UEFA Euro qualification,Nicosia,Cyprus,False,4,-2,Slovakia
25412,27283,29019,2007,Czech Republic,Germany,1,2,UEFA Euro qualification,Prague,Czech Republic,False,3,-1,Germany
25413,27284,29020,2007,El Salvador,Honduras,0,2,Friendly,Fort Lauderdale,United States,True,2,-2,Honduras
25414,27285,29021,2007,Estonia,Russia,0,2,UEFA Euro qualification,Tallinn,Estonia,False,2,-2,Russia
25415,27286,29022,2007,Faroe Islands,Ukraine,0,2,UEFA Euro qualification,Toftir,Faroe Islands,False,2,-2,Ukraine
25416,27287,29023,2007,Gambia,Guinea,0,2,African Cup of Nations qualification,Bakau,Gambia,False,2,-2,Guinea
25417,27288,29024,2007,Greece,Turkey,1,4,UEFA Euro qualification,Piraeus,Greece,False,5,-3,Turkey
25418,27289,29025,2007,Guadeloupe,Trinidad and Tobago,2,2,Friendly,Le Gosier,Guadeloupe,False,4,0,Draw
25419,27290,29026,2007,Haiti,Panama,3,0,Friendly,Miami,United States,True,3,3,Haiti
25420,27291,29027,2007,Republic of Ireland,Wales,1,0,UEFA Euro qualification,Dublin,Republic of Ireland,False,1,1,Republic of Ireland
25421,27292,29028,2007,Israel,England,0,0,UEFA Euro qualification,Ramat-Gan,Israel,False,0,0,Draw
25422,27293,29029,2007,Japan,Peru,2,0,Friendly,Yokohama,Japan,False,2,2,Japan
25423,27294,29030,2007,Kazakhstan,Serbia,2,1,UEFA Euro qualification,Almaty,Kazakhstan,False,3,1,Kazakhstan
25424,27295,29032,2007,Liechtenstein,Northern Ireland,1,4,UEFA Euro qualification,Vaduz,Liechtenstein,False,5,-3,Northern Ireland
25425,27296,29033,2007,Lithuania,France,0,1,UEFA Euro qualification,Kaunas,Lithuania,False,1,-1,France
25426,27297,29034,2007,Luxembourg,Belarus,1,2,UEFA Euro qualification,Luxembourg,Luxembourg,False,3,-1,Belarus
25427,27298,29035,2007,Moldova,Malta,1,1,UEFA Euro qualification,Chişinău,Moldova,False,2,0,Draw
25428,27299,29036,2007,Montenegro,Hungary,2,1,Friendly,Podgorica,Montenegro,False,3,1,Montenegro
25429,27300,29037,2007,Netherlands,Romania,0,0,UEFA Euro qualification,Rotterdam,Netherlands,False,0,0,Draw
25430,27301,29038,2007,Nigeria,Uganda,1,0,African Cup of Nations qualification,Abeokuta,Nigeria,False,1,1,Nigeria
25431,27302,29039,2007,Norway,Bosnia and Herzegovina,1,2,UEFA Euro qualification,Oslo,Norway,False,3,-1,Bosnia and Herzegovina
25432,27303,29040,2007,Poland,Azerbaijan,5,0,UEFA Euro qualification,Warsaw,Poland,False,5,5,Poland
25433,27304,29041,2007,Portugal,Belgium,4,0,UEFA Euro qualification,Lisbon,Portugal,False,4,4,Portugal
25434,27305,29042,2007,Qatar,Iran,0,1,Friendly,Doha,Qatar,False,1,-1,Iran
25435,27306,29043,2007,Scotland,Georgia,2,1,UEFA Euro qualification,Glasgow,Scotland,False,3,1,Scotland
25436,27307,29044,2007,Senegal,Tanzania,4,0,African Cup of Nations qualification,Dakar,Senegal,False,4,4,Senegal
25437,27308,29045,2007,Seychelles,Tunisia,0,3,African Cup of Nations qualification,Victoria,Seychelles,False,3,-3,Tunisia
25438,27309,29046,2007,Spain,Denmark,2,1,UEFA Euro qualification,Madrid,Spain,False,3,1,Spain
25439,27310,29047,2007,Togo,Sierra Leone,3,1,African Cup of Nations qualification,Woumé,Togo,False,4,2,Togo
25440,27311,29048,2007,Venezuela,Cuba,3,1,Friendly,Mérida,Venezuela,False,4,2,Venezuela
25441,27312,29050,2007,Angola,Eritrea,6,1,African Cup of Nations qualification,Luanda,Angola,False,7,5,Angola
25442,27313,29051,2007,Barbados,Guatemala,0,0,Friendly,Bridgetown,Barbados,False,0,0,Draw
25443,27314,29052,2007,Bermuda,Canada,0,3,Friendly,Hamilton,Bermuda,False,3,-3,Canada
25444,27315,29053,2007,Botswana,Burundi,1,0,African Cup of Nations qualification,Gaborone,Botswana,False,1,1,Botswana
25445,27316,29054,2007,Colombia,Switzerland,3,1,Friendly,Miami,United States,True,4,2,Colombia
25446,27317,29055,2007,Congo,Zambia,0,0,African Cup of Nations qualification,Brazzaville,Congo,False,0,0,Draw
25447,27318,29056,2007,Egypt,Mauritania,3,0,African Cup of Nations qualification,Cairo,Egypt,False,3,3,Egypt
25448,27319,29057,2007,Equatorial Guinea,Rwanda,3,1,African Cup of Nations qualification,Malabo,Equatorial Guinea,False,4,2,Equatorial Guinea
25449,27320,29058,2007,Kenya,Eswatini,2,0,African Cup of Nations qualification,Nairobi,Kenya,False,2,2,Kenya
25450,27321,29059,2007,Lesotho,Niger,3,1,African Cup of Nations qualification,Maseru,Lesotho,False,4,2,Lesotho
25451,27322,29060,2007,Libya,Namibia,2,1,African Cup of Nations qualification,Tripoli,Libya,False,3,1,Libya
25452,27323,29061,2007,Madagascar,Ivory Coast,0,3,African Cup of Nations qualification,Antananarivo,Madagascar,False,3,-3,Ivory Coast
25453,27324,29062,2007,Mali,Benin,1,1,African Cup of Nations qualification,Bamako,Mali,False,2,0,Draw
25454,27325,29063,2007,Mauritius,Sudan,1,2,African Cup of Nations qualification,Curepipe,Mauritius,False,3,-1,Sudan
25455,27326,29064,2007,Mexico,Paraguay,2,1,Friendly,Monterrey,Mexico,False,3,1,Mexico
25456,27327,29065,2007,Northern Mariana Islands,Guam,2,3,EAFF Championship,Oleai,Northern Mariana Islands,False,5,-1,Guam
25457,27328,29066,2007,United States,Ecuador,3,1,Friendly,Tampa,United States,False,4,2,United States
25458,27329,29067,2007,Zimbabwe,Morocco,1,1,African Cup of Nations qualification,Harare,Zimbabwe,False,2,0,Draw
25459,27330,29068,2007,Jamaica,Panama,1,1,Friendly,Kingston,Jamaica,False,2,0,Draw
25460,27331,29069,2007,Brazil,Ghana,1,0,Friendly,Solna,Sweden,True,1,1,Brazil
25461,27332,29071,2007,El Salvador,Honduras,0,2,Friendly,Cary,United States,True,2,-2,Honduras
25462,27333,29072,2007,Andorra,England,0,3,UEFA Euro qualification,Barcelona,Spain,True,3,-3,England
25463,27334,29073,2007,Azerbaijan,Finland,1,0,UEFA Euro qualification,Baku,Azerbaijan,False,1,1,Azerbaijan
25464,27335,29074,2007,Bulgaria,Albania,0,0,UEFA Euro qualification,Sofia,Bulgaria,False,0,0,Draw
25465,27336,29075,2007,Chile,Costa Rica,1,1,Friendly,Talca,Chile,False,2,0,Draw
25466,27337,29076,2007,Colombia,Paraguay,2,0,Friendly,Bogotá,Colombia,False,2,2,Colombia
25467,27338,29077,2007,Czech Republic,Cyprus,1,0,UEFA Euro qualification,Liberec,Czech Republic,False,1,1,Czech Republic
25468,27339,29078,2007,France,Austria,1,0,Friendly,Saint-Denis,France,False,1,1,France
25469,27340,29079,2007,Georgia,Faroe Islands,3,1,UEFA Euro qualification,Tbilisi,Georgia,False,4,2,Georgia
25470,27341,29080,2007,Germany,Denmark,0,1,Friendly,Duisburg,Germany,False,1,-1,Denmark
25471,27342,29081,2007,Hungary,Moldova,2,0,UEFA Euro qualification,Budapest,Hungary,False,2,2,Hungary
25472,27343,29082,2007,Republic of Ireland,Slovakia,1,0,UEFA Euro qualification,Dublin,Republic of Ireland,False,1,1,Republic of Ireland
25473,27344,29083,2007,Israel,Estonia,4,0,UEFA Euro qualification,Ramat-Gan,Israel,False,4,4,Israel
25474,27345,29084,2007,Italy,Scotland,2,0,UEFA Euro qualification,Bari,Italy,False,2,2,Italy
25475,27346,29085,2007,Liechtenstein,Latvia,1,0,UEFA Euro qualification,Vaduz,Liechtenstein,False,1,1,Liechtenstein
25476,27347,29086,2007,Malta,Greece,0,1,UEFA Euro qualification,Attard,Malta,False,1,-1,Greece
25477,27348,29087,2007,Mexico,Ecuador,4,2,Friendly,Oakland,United States,True,6,2,Mexico
25478,27349,29088,2007,Northern Ireland,Sweden,2,1,UEFA Euro qualification,Belfast,Northern Ireland,False,3,1,Northern Ireland
25479,27350,29089,2007,Poland,Armenia,1,0,UEFA Euro qualification,Kielce,Poland,False,1,1,Poland
25480,27351,29090,2007,Romania,Luxembourg,3,0,UEFA Euro qualification,Piatra Neamţ,Romania,False,3,3,Romania
25481,27352,29091,2007,Serbia,Portugal,1,1,UEFA Euro qualification,Belgrade,Serbia,False,2,0,Draw
25482,27353,29092,2007,Slovenia,Netherlands,0,1,UEFA Euro qualification,Celje,Slovenia,False,1,-1,Netherlands
25483,27354,29093,2007,South Africa,Bolivia,0,1,Friendly,Johannesburg,South Africa,False,1,-1,Bolivia
25484,27355,29094,2007,Spain,Iceland,1,0,UEFA Euro qualification,Palma de Mallorca,Spain,False,1,1,Spain
25485,27356,29095,2007,Turkey,Norway,2,2,UEFA Euro qualification,Frankfurt am Main,Germany,True,4,0,Draw
25486,27357,29096,2007,Ukraine,Lithuania,1,0,UEFA Euro qualification,Odesa,Ukraine,False,1,1,Ukraine
25487,27358,29097,2007,United States,Guatemala,0,0,Friendly,Frisco,United States,False,0,0,Draw
25488,27359,29098,2007,Venezuela,New Zealand,5,0,Friendly,Maracaibo,Venezuela,False,5,5,Venezuela
25489,27360,29099,2007,Wales,San Marino,3,0,UEFA Euro qualification,Cardiff,Wales,False,3,3,Wales
25490,27361,29100,2007,Guam,Northern Mariana Islands,9,0,EAFF Championship,Hagätña,Guam,False,9,9,Guam
25491,27362,29101,2007,Angola,Congo,0,0,Friendly,Cabinda,Angola,False,0,0,Draw
25492,27363,29102,2007,El Salvador,Haiti,0,1,Friendly,San Salvador,El Salvador,False,1,-1,Haiti
25493,27364,29103,2007,Argentina,Chile,0,0,Friendly,Mendoza,Argentina,False,0,0,Draw
25494,27365,29104,2007,Honduras,Haiti,1,3,Friendly,La Ceiba,Honduras,False,4,-2,Haiti
25495,27366,29105,2007,Seychelles,Réunion,2,0,Friendly,Victoria,Seychelles,False,2,2,Seychelles
25496,27367,29106,2007,Mauritius,Réunion,1,1,Friendly,Curepipe,Mauritius,False,2,0,Draw
25497,27368,29107,2007,Madagascar,Zimbabwe,0,1,COSAFA Cup,Maputo,Mozambique,True,1,-1,Zimbabwe
25498,27369,29108,2007,Mozambique,Seychelles,2,0,COSAFA Cup,Maputo,Mozambique,False,2,2,Mozambique
25499,27370,29109,2007,DR Congo,Ethiopia,2,0,African Cup of Nations qualification,Kinshasa,DR Congo,False,2,2,DR Congo
25500,27371,29110,2007,Madagascar,Seychelles,5,0,COSAFA Cup,Maputo,Mozambique,True,5,5,Madagascar
25501,27372,29111,2007,Mozambique,Zimbabwe,0,0,COSAFA Cup,Maputo,Mozambique,False,0,0,Draw
25502,27373,29112,2007,Guernsey,Jersey,0,0,Friendly,St. Peter Port,Guernsey,False,0,0,Draw
25503,27374,29113,2007,Chile,Cuba,3,0,Friendly,Osorno,Chile,False,3,3,Chile
25504,27375,29114,2007,Panama,Colombia,0,4,Friendly,Panama City,Panama,False,4,-4,Colombia
25505,27376,29115,2007,Chile,Cuba,2,0,Friendly,Temuco,Chile,False,2,2,Chile
25506,27378,29117,2007,Guadeloupe,Dominica,2,0,Friendly,Morne-à-l'Eau,Guadeloupe,False,2,2,Guadeloupe
25507,27379,29118,2007,Guadeloupe,Dominica,0,0,Friendly,Basse-Terre,Guadeloupe,False,0,0,Draw
25508,27380,29119,2007,Eritrea,Sudan,1,0,Friendly,Asmara,Eritrea,False,1,1,Eritrea
25509,27381,29120,2007,Ecuador,Republic of Ireland,1,1,Friendly,East Rutherford,United States,True,2,0,Draw
25510,27382,29121,2007,Haiti,Chile,0,0,Friendly,Port-au-Prince,Haiti,False,0,0,Draw
25511,27383,29122,2007,Venezuela,Honduras,2,1,Friendly,Mérida,Venezuela,False,3,1,Venezuela
25512,27384,29123,2007,Zimbabwe,Lesotho,1,1,Friendly,Masvingo,Zimbabwe,False,2,0,Draw
25513,27385,29124,2007,Bolivia,Republic of Ireland,1,1,Friendly,Foxborough,United States,True,2,0,Draw
25514,27386,29125,2007,Eritrea,Sudan,1,1,Friendly,Asmara,Eritrea,False,2,0,Draw
25515,27387,29126,2007,Malawi,South Africa,0,0,COSAFA Cup,Lobamba,Eswatini,True,0,0,Draw
25516,27388,29127,2007,Namibia,Zambia,1,2,Friendly,Windhoek,Namibia,False,3,-1,Zambia
25517,27389,29128,2007,Eswatini,Mauritius,0,0,COSAFA Cup,Lobamba,Eswatini,False,0,0,Draw
25518,27390,29129,2007,Uganda,Tanzania,1,1,Friendly,Kampala,Uganda,False,2,0,Draw
25519,27391,29130,2007,Wales,New Zealand,2,2,Friendly,Wrexham,Wales,False,4,0,Draw
25520,27392,29131,2007,Botswana,Libya,0,0,Friendly,Gaborone,Botswana,False,0,0,Draw
25521,27393,29132,2007,Kenya,Nigeria,0,1,Friendly,Nairobi,Kenya,False,1,-1,Nigeria
25522,27394,29133,2007,Mauritius,South Africa,0,2,COSAFA Cup,Lobamba,Eswatini,True,2,-2,South Africa
25523,27395,29134,2007,Rwanda,Burundi,1,0,Friendly,Kigali,Rwanda,False,1,1,Rwanda
25524,27396,29135,2007,Eswatini,Malawi,1,0,COSAFA Cup,Lobamba,Eswatini,False,1,1,Eswatini
25525,27397,29136,2007,Congo,DR Congo,2,1,Friendly,Brazzaville,Congo,False,3,1,Congo
25526,27398,29137,2007,Trinidad and Tobago,Haiti,1,0,Friendly,Port of Spain,Trinidad and Tobago,False,1,1,Trinidad and Tobago
25527,27399,29138,2007,Zimbabwe,Burkina Faso,1,1,Friendly,Masvingo,Zimbabwe,False,2,0,Draw
25528,27400,29139,2007,Austria,Scotland,0,1,Friendly,Vienna,Austria,False,1,-1,Scotland
25529,27401,29140,2007,Saint Vincent and the Grenadines,Haiti,0,3,Friendly,Port of Spain,Trinidad and Tobago,True,3,-3,Haiti
25530,27402,29141,2007,England,Brazil,1,1,Friendly,London,England,False,2,0,Draw
25531,27403,29142,2007,Ethiopia,DR Congo,1,0,African Cup of Nations qualification,Addis Abeba,Ethiopia,False,1,1,Ethiopia
25532,27404,29143,2007,Indonesia,Hong Kong,3,0,Friendly,Jakarta,Indonesia,False,3,3,Indonesia
25533,27405,29144,2007,Japan,Montenegro,2,0,Kirin Cup,Fukuroi,Japan,False,2,2,Japan
25534,27406,29145,2007,Venezuela,Canada,2,2,Friendly,Maracaibo,Venezuela,False,4,0,Draw
25535,27407,29146,2007,Albania,Luxembourg,2,0,UEFA Euro qualification,Tirana,Albania,False,2,2,Albania
25536,27408,29147,2007,Australia,Uruguay,1,2,Friendly,Sydney,Australia,False,3,-1,Uruguay
25537,27409,29148,2007,Austria,Paraguay,0,0,Friendly,Vienna,Austria,False,0,0,Draw
25538,27410,29149,2007,Azerbaijan,Poland,1,3,UEFA Euro qualification,Baku,Azerbaijan,False,4,-2,Poland
25539,27411,29150,2007,Belarus,Bulgaria,0,2,UEFA Euro qualification,Minsk,Belarus,False,2,-2,Bulgaria
25540,27412,29151,2007,Belgium,Portugal,1,2,UEFA Euro qualification,Brussels,Belgium,False,3,-1,Portugal
25541,27413,29152,2007,Bosnia and Herzegovina,Turkey,3,2,UEFA Euro qualification,Sarajevo,Bosnia and Herzegovina,False,5,1,Bosnia and Herzegovina
25542,27414,29154,2007,Costa Rica,Chile,2,0,Friendly,San José,Costa Rica,False,2,2,Costa Rica
25543,27415,29155,2007,Denmark,Sweden,0,3,UEFA Euro qualification,Copenhagen,Denmark,False,3,-3,Sweden
25544,27416,29156,2007,Eritrea,Angola,1,1,African Cup of Nations qualification,Asmara,Eritrea,False,2,0,Draw
25545,27417,29157,2007,Estonia,Croatia,0,1,UEFA Euro qualification,Tallinn,Estonia,False,1,-1,Croatia
25546,27418,29158,2007,Faroe Islands,Italy,1,2,UEFA Euro qualification,Tórshavn,Faroe Islands,False,3,-1,Italy
25547,27419,29159,2007,Finland,Serbia,0,2,UEFA Euro qualification,Helsinki,Finland,False,2,-2,Serbia
25548,27420,29160,2007,France,Ukraine,2,0,UEFA Euro qualification,Saint-Denis,France,False,2,2,France
25549,27421,29161,2007,Germany,San Marino,6,0,UEFA Euro qualification,Nuremberg,Germany,False,6,6,Germany
25550,27422,29162,2007,Greece,Hungary,2,0,UEFA Euro qualification,Heraklion,Greece,False,2,2,Greece
25551,27423,29163,2007,Honduras,Trinidad and Tobago,3,1,Friendly,San Pedro Sula,Honduras,False,4,2,Honduras
25552,27424,29164,2007,Iceland,Liechtenstein,1,1,UEFA Euro qualification,Reykjavík,Iceland,False,2,0,Draw
25553,27425,29165,2007,Kazakhstan,Armenia,1,2,UEFA Euro qualification,Almaty,Kazakhstan,False,3,-1,Armenia
25554,27426,29167,2007,Latvia,Spain,0,2,UEFA Euro qualification,Riga,Latvia,False,2,-2,Spain
25555,27427,29168,2007,Lithuania,Georgia,1,0,UEFA Euro qualification,Kaunas,Lithuania,False,1,1,Lithuania
25556,27428,29170,2007,Mexico,Iran,4,0,Friendly,San Luis Potosí,Mexico,False,4,4,Mexico
25557,27429,29171,2007,Morocco,Zimbabwe,2,0,African Cup of Nations qualification,Casablanca,Morocco,False,2,2,Morocco
25558,27430,29172,2007,Namibia,Libya,1,0,African Cup of Nations qualification,Windhoek,Namibia,False,1,1,Namibia
25559,27431,29173,2007,Norway,Malta,4,0,UEFA Euro qualification,Oslo,Norway,False,4,4,Norway
25560,27432,29174,2007,Russia,Andorra,4,0,UEFA Euro qualification,St. Petersburg,Russia,False,4,4,Russia
25561,27433,29175,2007,Rwanda,Equatorial Guinea,2,0,African Cup of Nations qualification,Kigali,Rwanda,False,2,2,Rwanda
25562,27434,29176,2007,Slovenia,Romania,1,2,UEFA Euro qualification,Celje,Slovenia,False,3,-1,Romania
25563,27435,29177,2007,South Africa,Chad,4,0,African Cup of Nations qualification,Durban,South Africa,False,4,4,South Africa
25564,27436,29178,2007,Sudan,Mauritius,3,0,African Cup of Nations qualification,Omdurman,Sudan,False,3,3,Sudan
25565,27437,29179,2007,Switzerland,Argentina,1,1,Friendly,Basel,Switzerland,False,2,0,Draw
25566,27438,29180,2007,Tanzania,Senegal,1,1,African Cup of Nations qualification,Mwanza,Tanzania,False,2,0,Draw
25567,27439,29181,2007,Tunisia,Seychelles,4,0,African Cup of Nations qualification,Radès,Tunisia,False,4,4,Tunisia
25568,27440,29182,2007,Uganda,Nigeria,2,1,African Cup of Nations qualification,Kampala,Uganda,False,3,1,Uganda
25569,27442,29184,2007,Wales,Czech Republic,0,0,UEFA Euro qualification,Cardiff,Wales,False,0,0,Draw
25570,27443,29185,2007,Zambia,Congo,3,0,African Cup of Nations qualification,Chililabombwe,Zambia,False,3,3,Zambia
25571,27444,29186,2007,Benin,Mali,0,0,African Cup of Nations qualification,Cotonou,Benin,False,0,0,Draw
25572,27445,29187,2007,Burundi,Botswana,1,0,African Cup of Nations qualification,Kigali,Rwanda,True,1,1,Burundi
25573,27446,29188,2007,Colombia,Montenegro,1,0,Kirin Cup,Matsumoto,Japan,True,1,1,Colombia
25574,27447,29189,2007,Ecuador,Peru,1,2,Friendly,Madrid,Spain,True,3,-1,Peru
25575,27448,29190,2007,Guinea,Gambia,2,2,African Cup of Nations qualification,Conakry,Guinea,False,4,0,Draw
25576,27449,29191,2007,Ivory Coast,Madagascar,5,0,African Cup of Nations qualification,Bouaké,Ivory Coast,False,5,5,Ivory Coast
25577,27450,29192,2007,Liberia,Cameroon,1,2,African Cup of Nations qualification,Monrovia,Liberia,False,3,-1,Cameroon
25578,27451,29193,2007,Mauritania,Egypt,1,1,African Cup of Nations qualification,Nouakchott,Mauritania,False,2,0,Draw
25579,27452,29194,2007,Mozambique,Burkina Faso,3,0,African Cup of Nations qualification,Maputo,Mozambique,False,3,3,Mozambique
25580,27453,29195,2007,Niger,Lesotho,2,0,African Cup of Nations qualification,Niamey,Niger,False,2,2,Niger
25581,27454,29196,2007,Sierra Leone,Togo,0,1,African Cup of Nations qualification,Freetown,Sierra Leone,False,1,-1,Togo
25582,27455,29197,2007,Eswatini,Kenya,0,0,African Cup of Nations qualification,Lobamba,Eswatini,False,0,0,Draw
25583,27456,29198,2007,Algeria,Argentina,3,4,Friendly,Barcelona,Spain,True,7,-1,Argentina
25584,27457,29199,2007,Jamaica,Chile,0,1,Friendly,Kingston,Jamaica,False,1,-1,Chile
25585,27458,29200,2007,Japan,Colombia,0,0,Kirin Cup,Saitama,Japan,False,0,0,Draw
25586,27459,29201,2007,Kuwait,Portugal,1,1,Friendly,al-Salmiya,Kuwait,False,2,0,Draw
25587,27460,29202,2007,Mexico,Paraguay,0,1,Friendly,Mexico City,Mexico,False,1,-1,Paraguay
25588,27461,29203,2007,Turkey,Brazil,0,0,Friendly,Dortmund,Germany,True,0,0,Draw
25589,27462,29204,2007,Andorra,Israel,0,2,UEFA Euro qualification,Sant Julià de Lòria,Andorra,False,2,-2,Israel
25590,27463,29205,2007,Armenia,Poland,1,0,UEFA Euro qualification,Yerevan,Armenia,False,1,1,Armenia
25591,27464,29206,2007,Bosnia and Herzegovina,Malta,1,0,UEFA Euro qualification,Sarajevo,Bosnia and Herzegovina,False,1,1,Bosnia and Herzegovina
25592,27465,29207,2007,Bulgaria,Belarus,2,1,UEFA Euro qualification,Sofia,Bulgaria,False,3,1,Bulgaria
25593,27466,29208,2007,Costa Rica,Canada,1,2,Gold Cup,Miami,United States,True,3,-1,Canada
25594,27467,29209,2007,Croatia,Russia,0,0,UEFA Euro qualification,Zagreb,Croatia,False,0,0,Draw
25595,27468,29210,2007,Ecuador,Peru,2,0,Friendly,Barcelona,Spain,True,2,2,Ecuador
25596,27469,29211,2007,Estonia,England,0,3,UEFA Euro qualification,Tallinn,Estonia,False,3,-3,England
25597,27470,29212,2007,Faroe Islands,Scotland,0,2,UEFA Euro qualification,Toftir,Faroe Islands,False,2,-2,Scotland
25598,27471,29213,2007,Finland,Belgium,2,0,UEFA Euro qualification,Helsinki,Finland,False,2,2,Finland
25599,27472,29214,2007,France,Georgia,1,0,UEFA Euro qualification,Auxerre,France,False,1,1,France
25600,27473,29215,2007,Germany,Slovakia,2,1,UEFA Euro qualification,Hamburg,Germany,False,3,1,Germany
25601,27474,29216,2007,Greece,Moldova,2,1,UEFA Euro qualification,Heraklion,Greece,False,3,1,Greece
25602,27475,29217,2007,Guadeloupe,Haiti,1,1,Gold Cup,Miami,United States,True,2,0,Draw
25603,27476,29218,2007,Kazakhstan,Azerbaijan,1,1,UEFA Euro qualification,Almaty,Kazakhstan,False,2,0,Draw
25604,27477,29219,2007,Latvia,Denmark,0,2,UEFA Euro qualification,Riga,Latvia,False,2,-2,Denmark
25605,27478,29220,2007,Liechtenstein,Spain,0,2,UEFA Euro qualification,Vaduz,Liechtenstein,False,2,-2,Spain
25606,27479,29221,2007,Lithuania,Italy,0,2,UEFA Euro qualification,Kaunas,Lithuania,False,2,-2,Italy
25607,27480,29222,2007,Luxembourg,Albania,0,3,UEFA Euro qualification,Luxembourg,Luxembourg,False,3,-3,Albania
25608,27481,29223,2007,Norway,Hungary,4,0,UEFA Euro qualification,Oslo,Norway,False,4,4,Norway
25609,27482,29224,2007,Romania,Slovenia,2,0,UEFA Euro qualification,Timişoara,Romania,False,2,2,Romania
25610,27483,29225,2007,Sweden,Iceland,5,0,UEFA Euro qualification,Solna,Sweden,False,5,5,Sweden
25611,27484,29226,2007,Thailand,Netherlands,1,3,Friendly,Bangkok,Thailand,False,4,-2,Netherlands
25612,27485,29227,2007,El Salvador,Trinidad and Tobago,2,1,Gold Cup,Carson,United States,True,3,1,El Salvador
25613,27486,29228,2007,United States,Guatemala,1,0,Gold Cup,Carson,United States,False,1,1,United States
25614,27487,29229,2007,Jordan,Iraq,1,1,Friendly,Amman,Jordan,False,2,0,Draw
25615,27488,29230,2007,Mexico,Cuba,2,1,Gold Cup,East Rutherford,United States,True,3,1,Mexico
25616,27489,29231,2007,Panama,Honduras,3,2,Gold Cup,East Rutherford,United States,True,5,1,Panama
25617,27490,29232,2007,Burkina Faso,Mali,0,1,Friendly,Ouagadougou,Burkina Faso,False,1,-1,Mali
25618,27491,29233,2007,Canada,Guadeloupe,1,2,Gold Cup,Miami,United States,True,3,-1,Guadeloupe
25619,27492,29234,2007,Guatemala,El Salvador,1,0,Gold Cup,Carson,United States,True,1,1,Guatemala
25620,27493,29235,2007,Haiti,Costa Rica,1,1,Gold Cup,Miami,United States,True,2,0,Draw
25621,27494,29236,2007,Tanzania,Zambia,1,1,Friendly,Morogoro,Tanzania,False,2,0,Draw
25622,27495,29237,2007,United States,Trinidad and Tobago,2,0,Gold Cup,Carson,United States,False,2,2,United States
25623,27496,29238,2007,Honduras,Mexico,2,1,Gold Cup,East Rutherford,United States,True,3,1,Honduras
25624,27497,29239,2007,Hong Kong,Macau,2,1,Friendly,So Kon Po,Hong Kong,False,3,1,Hong Kong
25625,27498,29240,2007,Kenya,Rwanda,2,0,Friendly,Nairobi,Kenya,False,2,2,Kenya
25626,27499,29241,2007,Malawi,Senegal,2,3,Friendly,Blantyre,Malawi,False,5,-1,Senegal
25627,27500,29242,2007,Panama,Cuba,2,2,Gold Cup,East Rutherford,United States,True,4,0,Draw
25628,27501,29243,2007,Costa Rica,Guadeloupe,1,0,Gold Cup,Miami,United States,True,1,1,Costa Rica
25629,27502,29244,2007,Haiti,Canada,0,2,Gold Cup,Miami,United States,True,2,-2,Canada
25630,27503,29245,2007,Jordan,Iraq,0,0,Friendly,Amman,Jordan,False,0,0,Draw
25631,27504,29246,2007,Kuwait,Egypt,1,1,Friendly,Kuwait City,Kuwait,False,2,0,Draw
25632,27505,29247,2007,Réunion,Gabon,0,3,Friendly,Saint-Pierre,Réunion,False,3,-3,Gabon
25633,27506,29248,2007,Trinidad and Tobago,Guatemala,1,1,Gold Cup,Foxborough,United States,True,2,0,Draw
25634,27507,29249,2007,United States,El Salvador,4,0,Gold Cup,Foxborough,United States,False,4,4,United States
25635,27508,29250,2007,Cuba,Honduras,0,5,Gold Cup,Houston,United States,True,5,-5,Honduras
25636,27509,29251,2007,Mexico,Panama,1,0,Gold Cup,Houston,United States,True,1,1,Mexico
25637,27510,29252,2007,Algeria,Guinea,0,2,African Cup of Nations qualification,Algiers,Algeria,False,2,-2,Guinea
25638,27511,29253,2007,Botswana,Mauritania,2,1,African Cup of Nations qualification,Gaborone,Botswana,False,3,1,Botswana
25639,27512,29254,2007,Burkina Faso,Tanzania,0,1,African Cup of Nations qualification,Ouagadougou,Burkina Faso,False,1,-1,Tanzania
25640,27513,29255,2007,Canada,Guatemala,3,0,Gold Cup,Foxborough,United States,True,3,3,Canada
25641,27514,29257,2007,Eritrea,Kenya,1,0,African Cup of Nations qualification,Asmara,Eritrea,False,1,1,Eritrea
25642,27515,29258,2007,Iran,Iraq,0,0,WAFF Championship,Amman,Jordan,True,0,0,Draw
25643,27516,29259,2007,Lebanon,Syria,0,1,WAFF Championship,Amman,Jordan,True,1,-1,Syria
25644,27517,29260,2007,Malawi,Morocco,0,1,African Cup of Nations qualification,Blantyre,Malawi,False,1,-1,Morocco
25645,27518,29261,2007,Namibia,DR Congo,1,1,African Cup of Nations qualification,Windhoek,Namibia,False,2,0,Draw
25646,27519,29262,2007,Seychelles,Sudan,0,2,African Cup of Nations qualification,Victoria,Seychelles,False,2,-2,Sudan
25647,27520,29263,2007,Tunisia,Mauritius,2,0,African Cup of Nations qualification,Radès,Tunisia,False,2,2,Tunisia
25648,27521,29264,2007,United States,Panama,2,1,Gold Cup,Foxborough,United States,False,3,1,United States
25649,27522,29265,2007,Zambia,Chad,1,1,African Cup of Nations qualification,Chililabombwe,Zambia,False,2,0,Draw
25650,27523,29266,2007,Angola,Eswatini,3,0,African Cup of Nations qualification,Luanda,Angola,False,3,3,Angola
25651,27524,29267,2007,Benin,Togo,4,1,African Cup of Nations qualification,Cotonou,Benin,False,5,3,Benin
25652,27525,29268,2007,Cameroon,Rwanda,2,1,African Cup of Nations qualification,Garoua,Cameroon,False,3,1,Cameroon
25653,27526,29269,2007,Congo,South Africa,1,1,African Cup of Nations qualification,Pointe-Noire,Congo,False,2,0,Draw
25654,27528,29271,2007,Honduras,Guadeloupe,1,2,Gold Cup,Houston,United States,True,3,-1,Guadeloupe
25655,27529,29272,2007,Liberia,Equatorial Guinea,0,0,African Cup of Nations qualification,Monrovia,Liberia,False,0,0,Draw
25656,27530,29273,2007,Libya,Ethiopia,3,1,African Cup of Nations qualification,Tripoli,Libya,False,4,2,Libya
25657,27531,29274,2007,Macau,Mongolia,0,0,EAFF Championship,Macau,Macau,False,0,0,Draw
25658,27532,29275,2007,Madagascar,Gabon,0,2,African Cup of Nations qualification,Antananarivo,Madagascar,False,2,-2,Gabon
25659,27533,29276,2007,Mali,Sierra Leone,6,0,African Cup of Nations qualification,Bamako,Mali,False,6,6,Mali
25660,27534,29277,2007,Mexico,Costa Rica,1,0,Gold Cup,Houston,United States,True,1,1,Mexico
25661,27535,29278,2007,Mozambique,Senegal,0,0,African Cup of Nations qualification,Maputo,Mozambique,False,0,0,Draw
25662,27536,29279,2007,Niger,Nigeria,1,3,African Cup of Nations qualification,Niamey,Niger,False,4,-2,Nigeria
25663,27537,29280,2007,Jordan,Syria,0,1,WAFF Championship,Amman,Jordan,False,1,-1,Syria
25664,27538,29281,2007,Malaysia,Cambodia,6,0,Friendly,Shah Alam,Malaysia,False,6,6,Malaysia
25665,27539,29282,2007,Palestine,Iraq,0,1,WAFF Championship,Amman,Jordan,True,1,-1,Iraq
25666,27541,29285,2007,Lesotho,Uganda,0,0,African Cup of Nations qualification,Maseru,Lesotho,False,0,0,Draw
25667,27542,29286,2007,Bolivia,Paraguay,0,0,Friendly,Santa Cruz,Bolivia,False,0,0,Draw
25668,27543,29287,2007,Iran,Palestine,2,0,WAFF Championship,Amman,Jordan,True,2,2,Iran
25669,27544,29288,2007,Jordan,Lebanon,3,0,WAFF Championship,Amman,Jordan,False,3,3,Jordan
25670,27546,29290,2007,Hong Kong,Guam,15,1,EAFF Championship,Macau,Macau,True,16,14,Hong Kong
25671,27547,29291,2007,Indonesia,Jamaica,2,1,Friendly,Jakarta,Indonesia,False,3,1,Indonesia
25672,27549,29293,2007,Malaysia,United Arab Emirates,1,3,Friendly,Petaling Jaya,Malaysia,False,4,-2,United Arab Emirates
25673,27550,29294,2007,Mexico,Guadeloupe,1,0,Gold Cup,Chicago,United States,True,1,1,Mexico
25674,27551,29295,2007,United States,Canada,2,1,Gold Cup,Chicago,United States,False,3,1,United States
25675,27552,29296,2007,Jordan,Iran,0,1,WAFF Championship,Amman,Jordan,False,1,-1,Iran
25676,27553,29297,2007,Syria,Iraq,0,3,WAFF Championship,Amman,Jordan,True,3,-3,Iraq
25677,27554,29298,2007,Colombia,Ecuador,3,1,Friendly,Barranquilla,Colombia,False,4,2,Colombia
25678,27555,29299,2007,Mongolia,Guam,5,2,EAFF Championship,Macau,Macau,True,7,3,Mongolia
25679,27556,29300,2007,Indonesia,Oman,0,1,Friendly,Jakarta,Indonesia,False,1,-1,Oman
25680,27557,29301,2007,Iraq,Iran,1,2,WAFF Championship,Amman,Jordan,True,3,-1,Iran
25681,27558,29303,2007,United Arab Emirates,Saudi Arabia,0,2,Friendly,Singapore,Singapore,True,2,-2,Saudi Arabia
25682,27559,29304,2007,United States,Mexico,2,1,Gold Cup,Chicago,United States,False,3,1,United States
25683,27560,29305,2007,Vietnam,Jamaica,3,0,Friendly,Hanoi,Vietnam,False,3,3,Vietnam
25684,27561,29306,2007,Qatar,Turkmenistan,1,0,Friendly,Doha,Qatar,False,1,1,Qatar
25685,27562,29307,2007,Uruguay,Peru,0,3,Copa América,Mérida,Venezuela,True,3,-3,Peru
25686,27563,29308,2007,Venezuela,Bolivia,2,2,Copa América,San Cristóbal,Venezuela,False,4,0,Draw
25687,27564,29309,2007,Brazil,Mexico,0,2,Copa América,Puerto Ordaz,Venezuela,True,2,-2,Mexico
25688,27565,29310,2007,Ecuador,Chile,2,3,Copa América,Puerto Ordaz,Venezuela,True,5,-1,Chile
25689,27566,29311,2007,Singapore,Saudi Arabia,1,2,Friendly,Singapore,Singapore,False,3,-1,Saudi Arabia
25690,27567,29312,2007,United Arab Emirates,Bahrain,2,2,Friendly,Petaling Jaya,Malaysia,True,4,0,Draw
25691,27568,29313,2007,Argentina,United States,4,1,Copa América,Maracaibo,Venezuela,True,5,3,Argentina
25692,27569,29314,2007,Malaysia,Jamaica,0,2,Friendly,Kuala Lumpur,Malaysia,False,2,-2,Jamaica
25693,27571,29316,2007,Paraguay,Colombia,5,0,Copa América,Barinas,Venezuela,True,5,5,Paraguay
25694,27572,29318,2007,Bolivia,Uruguay,0,1,Copa América,San Cristóbal,Venezuela,True,1,-1,Uruguay
25695,27573,29319,2007,Singapore,Australia,0,3,Friendly,Singapore,Singapore,False,3,-3,Australia
25696,27574,29320,2007,Thailand,Qatar,1,1,Friendly,Bangkok,Thailand,False,2,0,Draw
25697,27575,29321,2007,Venezuela,Peru,2,0,Copa América,San Cristóbal,Venezuela,False,2,2,Venezuela
25698,27576,29322,2007,Vietnam,Bahrain,5,3,Friendly,Hanoi,Vietnam,False,8,2,Vietnam
25699,27578,29326,2007,Brazil,Chile,3,0,Copa América,Maturín,Venezuela,True,3,3,Brazil
25700,27579,29327,2007,Mexico,Ecuador,2,1,Copa América,Maturín,Venezuela,True,3,1,Mexico
25701,27580,29328,2007,Oman,Saudi Arabia,1,1,Friendly,Singapore,Singapore,True,2,0,Draw
25702,27582,29330,2007,Jersey,Gibraltar,1,1,Island Games,Rhodos,Greece,True,2,0,Draw
25703,27583,29331,2007,Åland Islands,Bermuda,0,2,Island Games,Rhodos,Greece,True,2,-2,Bermuda
25704,27584,29334,2007,Argentina,Colombia,4,2,Copa América,Maracaibo,Venezuela,True,6,2,Argentina
25705,27585,29335,2007,Iran,Jamaica,8,1,Friendly,Teheran,Iran,False,9,7,Iran
25706,27586,29336,2007,Iraq,Uzbekistan,0,2,Friendly,Paju,South Korea,True,2,-2,Uzbekistan
25707,27587,29337,2007,Thailand,Qatar,2,0,Friendly,Bangkok,Thailand,False,2,2,Thailand
25708,27588,29338,2007,United States,Paraguay,1,3,Copa América,Barinas,Venezuela,True,4,-2,Paraguay
25709,27590,29343,2007,Peru,Bolivia,2,2,Copa América,Mérida,Venezuela,True,4,0,Draw
25710,27591,29344,2007,Venezuela,Uruguay,0,0,Copa América,Mérida,Venezuela,False,0,0,Draw
25711,27592,29345,2007,Brazil,Ecuador,1,0,Copa América,Puerto la Cruz,Venezuela,True,1,1,Brazil
25712,27593,29346,2007,Mexico,Chile,0,0,Copa América,Puerto la Cruz,Venezuela,True,0,0,Draw
25713,27595,29349,2007,Jersey,Åland Islands,1,0,Island Games,Rhodos,Greece,True,1,1,Jersey
25714,27596,29351,2007,Gibraltar,Bermuda,2,0,Island Games,Rhodos,Greece,True,2,2,Gibraltar
25715,27597,29353,2007,Argentina,Paraguay,1,0,Copa América,Barquisimeto,Venezuela,True,1,1,Argentina
25716,27598,29354,2007,Colombia,United States,1,0,Copa América,Barquisimeto,Venezuela,True,1,1,Colombia
25717,27602,29361,2007,Malawi,Namibia,1,2,Friendly,Blantyre,Malawi,False,3,-1,Namibia
25718,27603,29362,2007,Chile,Brazil,1,6,Copa América,Puerto la Cruz,Venezuela,True,7,-5,Brazil
25719,27604,29363,2007,Thailand,Iraq,1,1,AFC Asian Cup,Bangkok,Thailand,False,2,0,Draw
25720,27605,29364,2007,Venezuela,Uruguay,1,4,Copa América,San Cristóbal,Venezuela,False,5,-3,Uruguay
25721,27606,29365,2007,Argentina,Peru,4,0,Copa América,Barquisimeto,Venezuela,True,4,4,Argentina
25722,27607,29366,2007,Australia,Oman,1,1,AFC Asian Cup,Bangkok,Thailand,True,2,0,Draw
25723,27608,29367,2007,Mexico,Paraguay,6,0,Copa América,Maturín,Venezuela,True,6,6,Mexico
25724,27609,29368,2007,Vietnam,United Arab Emirates,2,0,AFC Asian Cup,Hanoi,Vietnam,False,2,2,Vietnam
25725,27610,29369,2007,Japan,Qatar,1,1,AFC Asian Cup,Hanoi,Vietnam,True,2,0,Draw
25726,27611,29370,2007,Indonesia,Bahrain,2,1,AFC Asian Cup,Jakarta,Indonesia,False,3,1,Indonesia
25727,27613,29372,2007,Uruguay,Brazil,2,2,Copa América,Maracaibo,Venezuela,True,4,0,Draw
25728,27614,29373,2007,Iran,Uzbekistan,2,1,AFC Asian Cup,Kuala Lumpur,Malaysia,True,3,1,Iran
25729,27615,29375,2007,Mexico,Argentina,0,3,Copa América,Puerto Ordaz,Venezuela,True,3,-3,Argentina
25730,27616,29376,2007,Thailand,Oman,2,0,AFC Asian Cup,Bangkok,Thailand,False,2,2,Thailand
25731,27617,29377,2007,Vietnam,Qatar,1,1,AFC Asian Cup,Hanoi,Vietnam,False,2,0,Draw
25732,27618,29378,2007,Iraq,Australia,3,1,AFC Asian Cup,Bangkok,Thailand,True,4,2,Iraq
25733,27619,29379,2007,Solomon Islands,Papua New Guinea,2,1,Friendly,Honiara,Solomon Islands,False,3,1,Solomon Islands
25734,27620,29380,2007,United Arab Emirates,Japan,1,3,AFC Asian Cup,Hanoi,Vietnam,True,4,-2,Japan
25735,27621,29381,2007,Indonesia,Saudi Arabia,1,2,AFC Asian Cup,Jakarta,Indonesia,False,3,-1,Saudi Arabia
25736,27622,29382,2007,Malaysia,Uzbekistan,0,5,AFC Asian Cup,Kuala Lumpur,Malaysia,False,5,-5,Uzbekistan
25737,27623,29383,2007,Mexico,Uruguay,3,1,Copa América,Caracas,Venezuela,True,4,2,Mexico
25738,27625,29385,2007,Brazil,Argentina,3,0,Copa América,Maracaibo,Venezuela,True,3,3,Brazil
25739,27626,29387,2007,Oman,Iraq,0,0,AFC Asian Cup,Bangkok,Thailand,True,0,0,Draw
25740,27627,29388,2007,Qatar,United Arab Emirates,1,2,AFC Asian Cup,Ho Chi Minh City,Vietnam,True,3,-1,United Arab Emirates
25741,27628,29389,2007,Thailand,Australia,0,4,AFC Asian Cup,Bangkok,Thailand,False,4,-4,Australia
25742,27629,29390,2007,Vietnam,Japan,1,4,AFC Asian Cup,Hanoi,Vietnam,False,5,-3,Japan
25743,27630,29391,2007,New Caledonia,Vanuatu,5,3,Friendly,Nouméa,New Caledonia,False,8,2,New Caledonia
25744,27632,29393,2007,Malaysia,Iran,0,2,AFC Asian Cup,Kuala Lumpur,Malaysia,False,2,-2,Iran
25745,27633,29394,2007,Saudi Arabia,Bahrain,4,0,AFC Asian Cup,Palembang,Indonesia,True,4,4,Saudi Arabia
25746,27635,29396,2007,Madagascar,Mayotte,2,2,Friendly,Antananarivo,Madagascar,False,4,0,Draw
25747,27636,29397,2007,New Caledonia,Vanuatu,0,2,Friendly,Nouméa,New Caledonia,False,2,-2,Vanuatu
25748,27637,29398,2007,Iraq,Vietnam,2,0,AFC Asian Cup,Bangkok,Thailand,True,2,2,Iraq
25749,27638,29399,2007,Japan,Australia,1,1,AFC Asian Cup,Hanoi,Vietnam,True,2,0,Draw
25750,27640,29401,2007,Saudi Arabia,Uzbekistan,2,1,AFC Asian Cup,Jakarta,Indonesia,True,3,1,Saudi Arabia
25751,27641,29402,2007,Botswana,Zambia,0,0,Friendly,Orapa,Botswana,False,0,0,Draw
25752,27643,29404,2007,Japan,Saudi Arabia,2,3,AFC Asian Cup,Hanoi,Vietnam,True,5,-1,Saudi Arabia
25753,27644,29405,2007,Angola,Lesotho,2,0,COSAFA Cup,Gaborone,Botswana,True,2,2,Angola
25754,27645,29406,2007,Botswana,Namibia,1,0,COSAFA Cup,Gaborone,Botswana,False,1,1,Botswana
25755,27646,29408,2007,Botswana,Angola,0,0,COSAFA Cup,Gaborone,Botswana,False,0,0,Draw
25756,27647,29409,2007,Iraq,Saudi Arabia,1,0,AFC Asian Cup,Jakarta,Indonesia,True,1,1,Iraq
25757,27648,29410,2007,Lesotho,Namibia,2,3,COSAFA Cup,Gaborone,Botswana,True,5,-1,Namibia
25758,27649,29411,2007,Madagascar,DR Congo,0,0,Friendly,Antananarivo,Madagascar,False,0,0,Draw
25759,27650,29412,2007,India,Cambodia,6,0,Nehru Cup,New Delhi,India,False,6,6,India
25760,27651,29413,2007,Bangladesh,Syria,0,2,Nehru Cup,New Delhi,India,True,2,-2,Syria
25761,27652,29414,2007,Kyrgyzstan,Cambodia,4,3,Nehru Cup,New Delhi,India,True,7,1,Kyrgyzstan
25762,27653,29415,2007,Burma,Lesotho,1,0,Merdeka Tournament,Petaling Jaya,Malaysia,True,1,1,Burma
25763,27654,29416,2007,India,Bangladesh,1,0,Nehru Cup,New Delhi,India,False,1,1,India
25764,27655,29417,2007,Mozambique,Zimbabwe,0,0,Friendly,Beira,Mozambique,False,0,0,Draw
25765,27656,29418,2007,Benin,Gabon,2,2,Friendly,Creil,France,True,4,0,Draw
25766,27657,29419,2007,Ghana,Senegal,1,1,Friendly,London,England,True,2,0,Draw
25767,27658,29420,2007,Syria,Kyrgyzstan,4,1,Nehru Cup,New Delhi,India,True,5,3,Syria
25768,27659,29421,2007,Albania,Malta,3,0,Friendly,Tirana,Albania,False,3,3,Albania
25769,27660,29422,2007,Algeria,Brazil,0,2,Friendly,Montpellier,France,True,2,-2,Brazil
25770,27661,29423,2007,Armenia,Portugal,1,1,UEFA Euro qualification,Yerevan,Armenia,False,2,0,Draw
25771,27662,29424,2007,Austria,Czech Republic,1,1,Friendly,Vienna,Austria,False,2,0,Draw
25772,27663,29425,2007,Bangladesh,Cambodia,1,1,Nehru Cup,New Delhi,India,True,2,0,Draw
25773,27664,29426,2007,Belarus,Israel,2,1,Friendly,Minsk,Belarus,False,3,1,Belarus
25774,27665,29427,2007,Belgium,Serbia,3,2,UEFA Euro qualification,Brussels,Belgium,False,5,1,Belgium
25775,27666,29428,2007,Bosnia and Herzegovina,Croatia,3,5,Friendly,Sarajevo,Bosnia and Herzegovina,False,8,-2,Croatia
25776,27667,29429,2007,Bulgaria,Wales,0,1,Friendly,Burgas,Bulgaria,False,1,-1,Wales
25777,27668,29430,2007,DR Congo,Angola,3,1,Friendly,Kinshasa,DR Congo,False,4,2,DR Congo
25778,27669,29431,2007,Costa Rica,Peru,1,1,Friendly,San José,Costa Rica,False,2,0,Draw
25779,27670,29432,2007,Denmark,Republic of Ireland,0,4,Friendly,Århus,Denmark,False,4,-4,Republic of Ireland
25780,27671,29433,2007,Ecuador,Bolivia,1,0,Friendly,Quito,Ecuador,False,1,1,Ecuador
25781,27672,29434,2007,El Salvador,Honduras,2,0,Friendly,San Salvador,El Salvador,False,2,2,El Salvador
25782,27673,29435,2007,England,Germany,1,2,Friendly,London,England,False,3,-1,Germany
25783,27674,29436,2007,Estonia,Andorra,2,1,UEFA Euro qualification,Tallinn,Estonia,False,3,1,Estonia
25784,27675,29437,2007,Finland,Kazakhstan,2,1,UEFA Euro qualification,Tampere,Finland,False,3,1,Finland
25785,27676,29438,2007,Greece,Spain,2,3,Friendly,Salonica,Greece,False,5,-1,Spain
25786,27677,29439,2007,Hungary,Italy,3,1,Friendly,Budapest,Hungary,False,4,2,Hungary
25787,27678,29440,2007,Iceland,Canada,1,1,Friendly,Reykjavík,Iceland,False,2,0,Draw
25788,27679,29441,2007,Ivory Coast,Egypt,0,0,Friendly,Paris,France,True,0,0,Draw
25789,27680,29442,2007,Japan,Cameroon,2,0,Friendly,Ōita,Japan,False,2,2,Japan
25790,27681,29443,2007,Latvia,Moldova,1,2,Friendly,Riga,Latvia,False,3,-1,Moldova
25791,27682,29444,2007,Lesotho,Laos,3,1,Merdeka Tournament,Petaling Jaya,Malaysia,True,4,2,Lesotho
25792,27683,29445,2007,Lithuania,Turkmenistan,2,1,Friendly,Kaunas,Lithuania,False,3,1,Lithuania
25793,27684,29446,2007,Luxembourg,Georgia,0,0,Friendly,Luxembourg,Luxembourg,False,0,0,Draw
25794,27685,29448,2007,Mali,Burkina Faso,3,2,Friendly,Paris,France,True,5,1,Mali
25795,27686,29449,2007,Mexico,Colombia,0,1,Friendly,Commerce City,United States,True,1,-1,Colombia
25796,27687,29450,2007,Montenegro,Slovenia,1,1,Friendly,Podgorica,Montenegro,False,2,0,Draw
25797,27688,29451,2007,Northern Ireland,Liechtenstein,3,1,UEFA Euro qualification,Belfast,Northern Ireland,False,4,2,Northern Ireland
25798,27689,29452,2007,Norway,Argentina,2,1,Friendly,Oslo,Norway,False,3,1,Norway
25799,27690,29453,2007,Panama,Guatemala,2,1,Friendly,Panama City,Panama,False,3,1,Panama
25800,27691,29454,2007,Paraguay,Venezuela,1,1,Friendly,Asunción,Paraguay,False,2,0,Draw
25801,27692,29455,2007,Romania,Turkey,2,0,Friendly,Bucharest,Romania,False,2,2,Romania
25802,27693,29456,2007,Russia,Poland,2,2,Friendly,Moscow,Russia,False,4,0,Draw
25803,27694,29457,2007,San Marino,Cyprus,0,1,UEFA Euro qualification,Serravalle,San Marino,False,1,-1,Cyprus
25804,27695,29458,2007,Scotland,South Africa,1,0,Friendly,Aberdeen,Scotland,False,1,1,Scotland
25805,27696,29459,2007,Slovakia,France,0,1,Friendly,Trnava,Slovakia,False,1,-1,France
25806,27697,29460,2007,Sudan,Libya,1,0,Friendly,Khartoum,Sudan,False,1,1,Sudan
25807,27698,29461,2007,Sweden,United States,1,0,Friendly,Gothenburg,Sweden,False,1,1,Sweden
25808,27699,29462,2007,Switzerland,Netherlands,2,1,Friendly,Geneva,Switzerland,False,3,1,Switzerland
25809,27700,29463,2007,Tajikistan,Azerbaijan,2,3,Friendly,Dushanbe,Tajikistan,False,5,-1,Azerbaijan
25810,27701,29464,2007,Togo,Zambia,3,1,Friendly,Lomé,Togo,False,4,2,Togo
25811,27702,29465,2007,Tunisia,Guinea,1,1,Friendly,Tunis,Tunisia,False,2,0,Draw
25812,27703,29466,2007,Ukraine,Uzbekistan,2,1,Friendly,Kyïv,Ukraine,False,3,1,Ukraine
25813,27704,29467,2007,India,Syria,2,3,Nehru Cup,New Delhi,India,False,5,-1,Syria
25814,27705,29468,2007,Bangladesh,Kyrgyzstan,0,3,Nehru Cup,New Delhi,India,True,3,-3,Kyrgyzstan
25815,27706,29469,2007,Burma,Laos,1,0,Merdeka Tournament,Shah Alam,Malaysia,True,1,1,Burma
25816,27707,29470,2007,Cambodia,Syria,1,5,Nehru Cup,New Delhi,India,True,6,-4,Syria
25817,27708,29471,2007,Fiji,Tuvalu,16,0,South Pacific Games,Apia,Samoa,True,16,16,Fiji
25818,27709,29472,2007,Samoa,Vanuatu,0,4,South Pacific Games,Apia,Samoa,False,4,-4,Vanuatu
25819,27710,29473,2007,Solomon Islands,American Samoa,12,1,South Pacific Games,Apia,Samoa,True,13,11,Solomon Islands
25820,27711,29475,2007,India,Kyrgyzstan,3,0,Nehru Cup,New Delhi,India,False,3,3,India
25821,27712,29476,2007,Fiji,Cook Islands,4,0,South Pacific Games,Apia,Samoa,True,4,4,Fiji
25822,27713,29477,2007,Samoa,American Samoa,7,0,South Pacific Games,Apia,Samoa,False,7,7,Samoa
25823,27714,29478,2007,Solomon Islands,Tonga,4,0,South Pacific Games,Apia,Samoa,True,4,4,Solomon Islands
25824,27715,29479,2007,Tuvalu,New Caledonia,0,1,South Pacific Games,Apia,Samoa,True,1,-1,New Caledonia
25825,27716,29480,2007,American Samoa,Vanuatu,0,15,South Pacific Games,Apia,Samoa,True,15,-15,Vanuatu
25826,27717,29481,2007,India,Syria,1,0,Nehru Cup,New Delhi,India,False,1,1,India
25827,27718,29482,2007,New Caledonia,Cook Islands,3,0,South Pacific Games,Apia,Samoa,True,3,3,New Caledonia
25828,27719,29483,2007,Samoa,Tonga,2,1,South Pacific Games,Apia,Samoa,False,3,1,Samoa
25829,27721,29485,2007,Cook Islands,Tuvalu,4,1,South Pacific Games,Apia,Samoa,True,5,3,Cook Islands
25830,27722,29487,2007,Tanzania,Uganda,1,0,Friendly,Dar es Salaam,Tanzania,False,1,1,Tanzania
25831,27723,29488,2007,Tonga,American Samoa,4,0,South Pacific Games,Apia,Samoa,True,4,4,Tonga
25832,27724,29489,2007,Vanuatu,Solomon Islands,0,2,South Pacific Games,Apia,Samoa,True,2,-2,Solomon Islands
25833,27726,29491,2007,New Caledonia,Fiji,1,1,South Pacific Games,Apia,Samoa,True,2,0,Draw
25834,27727,29492,2007,Samoa,Solomon Islands,0,3,South Pacific Games,Apia,Samoa,False,3,-3,Solomon Islands
25835,27728,29493,2007,Tonga,Vanuatu,1,4,South Pacific Games,Apia,Samoa,True,5,-3,Vanuatu
25836,27729,29494,2007,Fiji,Vanuatu,3,0,South Pacific Games,Apia,Samoa,True,3,3,Fiji
25837,27730,29495,2007,Solomon Islands,New Caledonia,2,3,South Pacific Games,Apia,Samoa,True,5,-1,New Caledonia
25838,27731,29496,2007,Austria,Japan,0,0,Friendly,Klagenfurt,Austria,False,0,0,Draw
25839,27732,29497,2007,Bahrain,Jordan,1,3,Friendly,Muharraq,Bahrain,False,4,-2,Jordan
25840,27733,29498,2007,New Caledonia,Fiji,1,0,South Pacific Games,Apia,Samoa,True,1,1,New Caledonia
25841,27734,29499,2007,Solomon Islands,Vanuatu,0,2,South Pacific Games,Apia,Samoa,True,2,-2,Vanuatu
25842,27735,29500,2007,Switzerland,Chile,2,1,Friendly,Vienna,Austria,True,3,1,Switzerland
25843,27736,29501,2007,Belarus,Romania,1,3,UEFA Euro qualification,Minsk,Belarus,False,4,-2,Romania
25844,27737,29502,2007,DR Congo,Libya,1,1,African Cup of Nations qualification,Kinshasa,DR Congo,False,2,0,Draw
25845,27738,29503,2007,Croatia,Estonia,2,0,UEFA Euro qualification,Zagreb,Croatia,False,2,2,Croatia
25846,27739,29504,2007,Cyprus,Armenia,3,1,Friendly,Achna,Cyprus,False,4,2,Cyprus
25847,27740,29505,2007,Ecuador,El Salvador,5,1,Friendly,Quito,Ecuador,False,6,4,Ecuador
25848,27741,29506,2007,England,Israel,3,0,UEFA Euro qualification,London,England,False,3,3,England
25849,27742,29507,2007,Ethiopia,Namibia,2,3,African Cup of Nations qualification,Addis Abeba,Ethiopia,False,5,-1,Namibia
25850,27743,29508,2007,Gabon,Ivory Coast,0,0,African Cup of Nations qualification,Libreville,Gabon,False,0,0,Draw
25851,27744,29509,2007,Georgia,Ukraine,1,1,UEFA Euro qualification,Tbilisi,Georgia,False,2,0,Draw
25852,27745,29510,2007,Hungary,Bosnia and Herzegovina,1,0,UEFA Euro qualification,Székesfehérvár,Hungary,False,1,1,Hungary
25853,27746,29511,2007,Iceland,Spain,1,1,UEFA Euro qualification,Reykjavík,Iceland,False,2,0,Draw
25854,27747,29512,2007,Italy,France,0,0,UEFA Euro qualification,Milan,Italy,False,0,0,Draw
25855,27748,29513,2007,Kazakhstan,Tajikistan,1,1,Friendly,Almaty,Kazakhstan,False,2,0,Draw
25856,27749,29514,2007,Kenya,Angola,2,1,African Cup of Nations qualification,Nairobi,Kenya,False,3,1,Kenya
25857,27750,29515,2007,Latvia,Northern Ireland,1,0,UEFA Euro qualification,Riga,Latvia,False,1,1,Latvia
25858,27751,29516,2007,Luxembourg,Slovenia,0,3,UEFA Euro qualification,Luxembourg,Luxembourg,False,3,-3,Slovenia
25859,27752,29517,2007,Malta,Turkey,2,2,UEFA Euro qualification,Attard,Malta,False,4,0,Draw
25860,27753,29518,2007,Moldova,Norway,0,1,UEFA Euro qualification,Chişinău,Moldova,False,1,-1,Norway
25861,27754,29519,2007,Morocco,Ghana,0,2,Friendly,Rouen,France,True,2,-2,Ghana
25862,27755,29520,2007,Netherlands,Bulgaria,2,0,UEFA Euro qualification,Amsterdam,Netherlands,False,2,2,Netherlands
25863,27756,29521,2007,Nigeria,Lesotho,2,0,African Cup of Nations qualification,Warri,Nigeria,False,2,2,Nigeria
25864,27757,29522,2007,Peru,Colombia,2,2,Friendly,Lima,Peru,False,4,0,Draw
25865,27758,29523,2007,Portugal,Poland,2,2,UEFA Euro qualification,Lisbon,Portugal,False,4,0,Draw
25866,27760,29525,2007,Rwanda,Liberia,4,0,African Cup of Nations qualification,Kigali,Rwanda,False,4,4,Rwanda
25867,27761,29526,2007,San Marino,Czech Republic,0,3,UEFA Euro qualification,Serravalle,San Marino,False,3,-3,Czech Republic
25868,27762,29527,2007,Scotland,Lithuania,3,1,UEFA Euro qualification,Glasgow,Scotland,False,4,2,Scotland
25869,27763,29528,2007,Senegal,Burkina Faso,5,1,African Cup of Nations qualification,Dakar,Senegal,False,6,4,Senegal
25870,27764,29529,2007,Serbia,Finland,0,0,UEFA Euro qualification,Belgrade,Serbia,False,0,0,Draw
25871,27765,29530,2007,Slovakia,Republic of Ireland,2,2,UEFA Euro qualification,Bratislava,Slovakia,False,4,0,Draw
25872,27766,29531,2007,Sweden,Denmark,0,0,UEFA Euro qualification,Solna,Sweden,False,0,0,Draw
25873,27767,29532,2007,Tanzania,Mozambique,0,1,African Cup of Nations qualification,Dar es Salaam,Tanzania,False,1,-1,Mozambique
25874,27768,29533,2007,Uganda,Niger,3,1,African Cup of Nations qualification,Kampala,Uganda,False,4,2,Uganda
25875,27769,29534,2007,Venezuela,Paraguay,3,2,Friendly,Puerto Ordaz,Venezuela,False,5,1,Venezuela
25876,27770,29535,2007,Wales,Germany,0,2,UEFA Euro qualification,Cardiff,Wales,False,2,-2,Germany
25877,27771,29536,2007,Burundi,Egypt,0,0,African Cup of Nations qualification,Bujumbura,Burundi,False,0,0,Draw
25878,27772,29537,2007,Chad,Congo,1,1,African Cup of Nations qualification,N'Djamena,Chad,False,2,0,Draw
25879,27773,29538,2007,Costa Rica,Honduras,0,0,Friendly,East Hartford,United States,True,0,0,Draw
25880,27774,29539,2007,Equatorial Guinea,Cameroon,1,0,African Cup of Nations qualification,Malabo,Equatorial Guinea,False,1,1,Equatorial Guinea
25881,27775,29540,2007,Gambia,Algeria,2,1,African Cup of Nations qualification,Bakau,Gambia,False,3,1,Gambia
25882,27777,29542,2007,Mauritius,Seychelles,1,1,African Cup of Nations qualification,Curepipe,Mauritius,False,2,0,Draw
25883,27778,29543,2007,Mexico,Panama,1,0,Friendly,Puebla,Mexico,False,1,1,Mexico
25884,27779,29544,2007,South Africa,Zambia,1,3,African Cup of Nations qualification,Cape Town,South Africa,False,4,-2,Zambia
25885,27780,29545,2007,Sudan,Tunisia,3,2,African Cup of Nations qualification,Khartoum,Sudan,False,5,1,Sudan
25886,27781,29546,2007,Eswatini,Eritrea,0,0,African Cup of Nations qualification,Manzini,Eswatini,False,0,0,Draw
25887,27782,29547,2007,United States,Brazil,2,4,Friendly,Chicago,United States,False,6,-2,Brazil
25888,27783,29548,2007,Zimbabwe,Malawi,3,1,African Cup of Nations qualification,Bulawayo,Zimbabwe,False,4,2,Zimbabwe
25889,27784,29549,2007,Australia,Argentina,0,1,Friendly,Melbourne,Australia,False,1,-1,Argentina
25890,27785,29550,2007,Austria,Chile,0,2,Friendly,Vienna,Austria,False,2,-2,Chile
25891,27786,29551,2007,Saudi Arabia,Ghana,5,0,Friendly,Riyadh,Saudi Arabia,False,5,5,Saudi Arabia
25892,27787,29552,2007,Switzerland,Japan,3,4,Friendly,Klagenfurt,Austria,True,7,-1,Japan
25893,27788,29553,2007,Albania,Netherlands,0,1,UEFA Euro qualification,Tirana,Albania,False,1,-1,Netherlands
25894,27789,29554,2007,Andorra,Croatia,0,6,UEFA Euro qualification,Sant Julià de Lòria,Andorra,False,6,-6,Croatia
25895,27790,29555,2007,Azerbaijan,Georgia,1,1,Friendly,Baku,Azerbaijan,False,2,0,Draw
25896,27791,29556,2007,Bosnia and Herzegovina,Moldova,0,1,UEFA Euro qualification,Sarajevo,Bosnia and Herzegovina,False,1,-1,Moldova
25897,27792,29557,2007,Bulgaria,Luxembourg,3,0,UEFA Euro qualification,Sofia,Bulgaria,False,3,3,Bulgaria
25898,27793,29558,2007,Canada,Costa Rica,1,1,Friendly,Toronto,Canada,False,2,0,Draw
25899,27794,29559,2007,Colombia,Paraguay,1,0,Friendly,Bogotá,Colombia,False,1,1,Colombia
25900,27795,29560,2007,Cyprus,San Marino,3,0,UEFA Euro qualification,Nicosia,Cyprus,False,3,3,Cyprus
25901,27796,29561,2007,Czech Republic,Republic of Ireland,1,0,UEFA Euro qualification,Prague,Czech Republic,False,1,1,Czech Republic
25902,27797,29562,2007,Denmark,Liechtenstein,4,0,UEFA Euro qualification,Århus,Denmark,False,4,4,Denmark
25903,27798,29563,2007,England,Russia,3,0,UEFA Euro qualification,London,England,False,3,3,England
25904,27799,29564,2007,Finland,Poland,0,0,UEFA Euro qualification,Helsinki,Finland,False,0,0,Draw
25905,27800,29565,2007,France,Scotland,0,1,UEFA Euro qualification,Paris,France,False,1,-1,Scotland
25906,27801,29566,2007,Germany,Romania,3,1,Friendly,Cologne,Germany,False,4,2,Germany
25907,27802,29567,2007,Honduras,Ecuador,2,1,Friendly,San Pedro Sula,Honduras,False,3,1,Honduras
25908,27803,29568,2007,Iceland,Northern Ireland,2,1,UEFA Euro qualification,Reykjavík,Iceland,False,3,1,Iceland
25909,27804,29569,2007,Kazakhstan,Belgium,2,2,UEFA Euro qualification,Almaty,Kazakhstan,False,4,0,Draw
25910,27805,29570,2007,Lithuania,Faroe Islands,2,1,UEFA Euro qualification,Kaunas,Lithuania,False,3,1,Lithuania
25911,27806,29572,2007,Malta,Armenia,0,1,Friendly,Attard,Malta,False,1,-1,Armenia
25912,27807,29573,2007,Mexico,Brazil,1,3,Friendly,Foxborough,United States,True,4,-2,Brazil
25913,27808,29574,2007,Montenegro,Sweden,1,2,Friendly,Podgorica,Montenegro,False,3,-1,Sweden
25914,27809,29575,2007,Norway,Greece,2,2,UEFA Euro qualification,Oslo,Norway,False,4,0,Draw
25915,27810,29576,2007,Peru,Bolivia,2,0,Friendly,Lima,Peru,False,2,2,Peru
25916,27811,29577,2007,Portugal,Serbia,1,1,UEFA Euro qualification,Lisbon,Portugal,False,2,0,Draw
25917,27812,29578,2007,Singapore,United Arab Emirates,1,1,Friendly,Singapore,Singapore,False,2,0,Draw
25918,27813,29579,2007,Slovakia,Wales,2,5,UEFA Euro qualification,Trnava,Slovakia,False,7,-3,Wales
25919,27814,29580,2007,Slovenia,Belarus,1,0,UEFA Euro qualification,Celje,Slovenia,False,1,1,Slovenia
25920,27815,29581,2007,South Africa,Uruguay,0,0,Friendly,Johannesburg,South Africa,False,0,0,Draw
25921,27816,29582,2007,Spain,Latvia,2,0,UEFA Euro qualification,Oviedo,Spain,False,2,2,Spain
25922,27817,29583,2007,Turkey,Hungary,3,0,UEFA Euro qualification,Istanbul,Turkey,False,3,3,Turkey
25923,27818,29584,2007,Ukraine,Italy,1,2,UEFA Euro qualification,Kyïv,Ukraine,False,3,-1,Italy
25924,27819,29585,2007,Venezuela,Panama,1,1,Friendly,Puerto la Cruz,Venezuela,False,2,0,Draw
25925,27820,29586,2007,Qatar,Oman,1,1,Friendly,Doha,Qatar,False,2,0,Draw
25926,27821,29587,2007,United Arab Emirates,Lebanon,1,1,Friendly,Dubai,United Arab Emirates,False,2,0,Draw
25927,27822,29588,2007,Mozambique,Zambia,0,3,COSAFA Cup,Atteridgeville,South Africa,True,3,-3,Zambia
25928,27823,29589,2007,South Africa,Botswana,1,0,COSAFA Cup,Atteridgeville,South Africa,False,1,1,South Africa
25929,27824,29590,2007,Oman,Maldives,1,0,Friendly,Muscat,Oman,False,1,1,Oman
25930,27825,29591,2007,Thailand,United Arab Emirates,1,1,Friendly,Bangkok,Thailand,False,2,0,Draw
25931,27826,29592,2007,Bahrain,Singapore,3,1,Friendly,Manama,Bahrain,False,4,2,Bahrain
25932,27827,29593,2007,Bangladesh,Tajikistan,1,1,FIFA World Cup qualification,Dhaka,Bangladesh,False,2,0,Draw
25933,27828,29594,2007,Lebanon,India,4,1,FIFA World Cup qualification,Sidon,Lebanon,False,5,3,Lebanon
25934,27829,29595,2007,Oman,Nepal,2,0,FIFA World Cup qualification,Muscat,Oman,False,2,2,Oman
25935,27830,29596,2007,Palestine,Singapore,0,4,FIFA World Cup qualification,Rayyan,Qatar,True,4,-4,Singapore
25936,27831,29597,2007,Syria,Afghanistan,3,0,FIFA World Cup qualification,Damascus,Syria,False,3,3,Syria
25937,27832,29598,2007,Thailand,Macau,6,1,FIFA World Cup qualification,Bangkok,Thailand,False,7,5,Thailand
25938,27833,29599,2007,Vietnam,United Arab Emirates,0,1,FIFA World Cup qualification,Hanoi,Vietnam,False,1,-1,United Arab Emirates
25939,27834,29600,2007,Yemen,Maldives,3,0,FIFA World Cup qualification,Sana'a,Yemen,False,3,3,Yemen
25940,27835,29601,2007,Cambodia,Turkmenistan,0,1,FIFA World Cup qualification,Phnom Penh,Cambodia,False,1,-1,Turkmenistan
25941,27836,29602,2007,Sierra Leone,Benin,0,2,African Cup of Nations qualification,Freetown,Sierra Leone,False,2,-2,Benin
25942,27837,29603,2007,Togo,Mali,0,2,African Cup of Nations qualification,Lomé,Togo,False,2,-2,Mali
25943,27838,29604,2007,Argentina,Chile,2,0,FIFA World Cup qualification,Buenos Aires,Argentina,False,2,2,Argentina
25944,27839,29605,2007,Armenia,Serbia,0,0,UEFA Euro qualification,Yerevan,Armenia,False,0,0,Draw
25945,27840,29606,2007,Azerbaijan,Portugal,0,2,UEFA Euro qualification,Baku,Azerbaijan,False,2,-2,Portugal
25946,27841,29607,2007,Belarus,Luxembourg,0,1,UEFA Euro qualification,Homel,Belarus,False,1,-1,Luxembourg
25947,27842,29608,2007,Belgium,Finland,0,0,UEFA Euro qualification,Brussels,Belgium,False,0,0,Draw
25948,27843,29609,2007,Croatia,Israel,1,0,UEFA Euro qualification,Zagreb,Croatia,False,1,1,Croatia
25949,27844,29610,2007,Cyprus,Wales,3,1,UEFA Euro qualification,Nicosia,Cyprus,False,4,2,Cyprus
25950,27845,29611,2007,Denmark,Spain,1,3,UEFA Euro qualification,Århus,Denmark,False,4,-2,Spain
25951,27846,29612,2007,Ecuador,Venezuela,0,1,FIFA World Cup qualification,Quito,Ecuador,False,1,-1,Venezuela
25952,27847,29613,2007,Egypt,Botswana,1,0,African Cup of Nations qualification,Cairo,Egypt,False,1,1,Egypt
25953,27848,29614,2007,El Salvador,Costa Rica,2,2,Friendly,San Salvador,El Salvador,False,4,0,Draw
25954,27849,29615,2007,England,Estonia,3,0,UEFA Euro qualification,London,England,False,3,3,England
25955,27850,29616,2007,Faroe Islands,France,0,6,UEFA Euro qualification,Tórshavn,Faroe Islands,False,6,-6,France
25956,27851,29617,2007,Greece,Bosnia and Herzegovina,3,2,UEFA Euro qualification,Athens,Greece,False,5,1,Greece
25957,27852,29618,2007,Hungary,Malta,2,0,UEFA Euro qualification,Budapest,Hungary,False,2,2,Hungary
25958,27853,29619,2007,Iceland,Latvia,2,4,UEFA Euro qualification,Reykjavík,Iceland,False,6,-2,Latvia
25959,27854,29620,2007,Republic of Ireland,Germany,0,0,UEFA Euro qualification,Dublin,Republic of Ireland,False,0,0,Draw
25960,27855,29621,2007,Italy,Georgia,2,0,UEFA Euro qualification,Genoa,Italy,False,2,2,Italy
25961,27856,29622,2007,Liechtenstein,Sweden,0,3,UEFA Euro qualification,Vaduz,Liechtenstein,False,3,-3,Sweden
25962,27857,29623,2007,Mauritania,Burundi,2,1,African Cup of Nations qualification,Nouakchott,Mauritania,False,3,1,Mauritania
25963,27858,29624,2007,Moldova,Turkey,1,1,UEFA Euro qualification,Chişinău,Moldova,False,2,0,Draw
25964,27859,29625,2007,Peru,Paraguay,0,0,FIFA World Cup qualification,Lima,Peru,False,0,0,Draw
25965,27860,29626,2007,Poland,Kazakhstan,3,1,UEFA Euro qualification,Warsaw,Poland,False,4,2,Poland
25966,27861,29627,2007,Romania,Netherlands,1,0,UEFA Euro qualification,Constanţa,Romania,False,1,1,Romania
25967,27862,29628,2007,Scotland,Ukraine,3,1,UEFA Euro qualification,Glasgow,Scotland,False,4,2,Scotland
25968,27863,29629,2007,Slovakia,San Marino,7,0,UEFA Euro qualification,Dubnica nad Váhom,Slovakia,False,7,7,Slovakia
25969,27864,29630,2007,Slovenia,Albania,0,0,UEFA Euro qualification,Celje,Slovenia,False,0,0,Draw
25970,27865,29631,2007,Switzerland,Austria,3,1,Friendly,Zürich,Switzerland,False,4,2,Switzerland
25971,27866,29632,2007,Uruguay,Bolivia,5,0,FIFA World Cup qualification,Montevideo,Uruguay,False,5,5,Uruguay
25972,27868,29634,2007,Colombia,Brazil,0,0,FIFA World Cup qualification,Bogotá,Colombia,False,0,0,Draw
25973,27869,29635,2007,Honduras,Panama,1,0,Friendly,Tegucigalpa,Honduras,False,1,1,Honduras
25974,27870,29636,2007,Madagascar,Comoros,6,2,FIFA World Cup qualification,Antananarivo,Madagascar,False,8,4,Madagascar
25975,27871,29637,2007,Mexico,Nigeria,2,2,Friendly,Ciudad Juárez,Mexico,False,4,0,Draw
25976,27872,29638,2007,Senegal,Guinea,3,1,Friendly,Rouen,France,True,4,2,Senegal
25977,27873,29639,2007,Macau,Thailand,1,7,FIFA World Cup qualification,Macau,Macau,False,8,-6,Thailand
25978,27874,29640,2007,Bahrain,Libya,2,0,Friendly,Muharraq,Bahrain,False,2,2,Bahrain
25979,27875,29641,2007,Croatia,Slovakia,3,0,Friendly,Rijeka,Croatia,False,3,3,Croatia
25980,27876,29642,2007,Qatar,Iraq,3,2,Friendly,Doha,Qatar,False,5,1,Qatar
25981,27877,29643,2007,Venezuela,Argentina,0,2,FIFA World Cup qualification,Maracaibo,Venezuela,False,2,-2,Argentina
25982,27878,29644,2007,Albania,Bulgaria,1,1,UEFA Euro qualification,Tirana,Albania,False,2,0,Draw
25983,27879,29645,2007,Austria,Ivory Coast,3,2,Friendly,Innsbruck,Austria,False,5,1,Austria
25984,27880,29646,2007,Azerbaijan,Serbia,1,6,UEFA Euro qualification,Baku,Azerbaijan,False,7,-5,Serbia
25985,27881,29647,2007,Belgium,Armenia,3,0,UEFA Euro qualification,Brussels,Belgium,False,3,3,Belgium
25986,27882,29648,2007,Bolivia,Colombia,0,0,FIFA World Cup qualification,La Paz,Bolivia,False,0,0,Draw
25987,27883,29649,2007,Bosnia and Herzegovina,Norway,0,2,UEFA Euro qualification,Sarajevo,Bosnia and Herzegovina,False,2,-2,Norway
25988,27884,29650,2007,Brazil,Ecuador,5,0,FIFA World Cup qualification,Rio de Janeiro,Brazil,False,5,5,Brazil
25989,27885,29651,2007,Chile,Peru,2,0,FIFA World Cup qualification,Santiago,Chile,False,2,2,Chile
25990,27886,29652,2007,Costa Rica,Haiti,1,1,Friendly,San José,Costa Rica,False,2,0,Draw
25991,27887,29653,2007,Denmark,Latvia,3,1,UEFA Euro qualification,Copenhagen,Denmark,False,4,2,Denmark
25992,27888,29654,2007,El Salvador,Trinidad and Tobago,0,0,Friendly,San Salvador,El Salvador,False,0,0,Draw
25993,27889,29655,2007,Estonia,Montenegro,0,1,Friendly,Tallinn,Estonia,False,1,-1,Montenegro
25994,27890,29656,2007,Fiji,New Zealand,0,2,FIFA World Cup qualification,Lautoka,Fiji,False,2,-2,New Zealand
25995,27891,29657,2007,Finland,Spain,0,0,Friendly,Helsinki,Finland,False,0,0,Draw
25996,27892,29658,2007,France,Lithuania,2,0,UEFA Euro qualification,Nantes,France,False,2,2,France
25997,27893,29659,2007,Georgia,Scotland,2,0,UEFA Euro qualification,Tbilisi,Georgia,False,2,2,Georgia
25998,27894,29660,2007,Germany,Czech Republic,0,3,UEFA Euro qualification,Munich,Germany,False,3,-3,Czech Republic
25999,27895,29661,2007,Republic of Ireland,Cyprus,1,1,UEFA Euro qualification,Dublin,Republic of Ireland,False,2,0,Draw
26000,27896,29662,2007,Israel,Belarus,2,1,Friendly,Ramat-Gan,Israel,False,3,1,Israel
26001,27897,29663,2007,Italy,South Africa,2,0,Friendly,Siena,Italy,False,2,2,Italy
26002,27898,29664,2007,Japan,Egypt,4,1,Friendly,Osaka,Japan,False,5,3,Japan
26003,27899,29665,2007,Kazakhstan,Portugal,1,2,UEFA Euro qualification,Almaty,Kazakhstan,False,3,-1,Portugal
26004,27900,29666,2007,Liechtenstein,Iceland,3,0,UEFA Euro qualification,Vaduz,Liechtenstein,False,3,3,Liechtenstein
26005,27901,29667,2007,Luxembourg,Romania,0,2,UEFA Euro qualification,Luxembourg,Luxembourg,False,2,-2,Romania
26006,27902,29669,2007,Malta,Moldova,2,3,UEFA Euro qualification,Attard,Malta,False,5,-1,Moldova
26007,27903,29670,2007,Mexico,Guatemala,2,3,Friendly,Los Angeles,United States,True,5,-1,Guatemala
26008,27904,29671,2007,Morocco,Namibia,2,0,Friendly,Tangier,Morocco,False,2,2,Morocco
26009,27905,29672,2007,Netherlands,Slovenia,2,0,UEFA Euro qualification,Eindhoven,Netherlands,False,2,2,Netherlands
26010,27906,29673,2007,Paraguay,Uruguay,1,0,FIFA World Cup qualification,Asunción,Paraguay,False,1,1,Paraguay
26011,27907,29674,2007,Poland,Hungary,0,1,Friendly,Łódź,Poland,False,1,-1,Hungary
26012,27908,29675,2007,Russia,England,2,1,UEFA Euro qualification,Moscow,Russia,False,3,1,Russia
26013,27909,29676,2007,San Marino,Wales,1,2,UEFA Euro qualification,Serravalle,San Marino,False,3,-1,Wales
26014,27910,29677,2007,Sierra Leone,Guinea-Bissau,1,0,FIFA World Cup qualification,Freetown,Sierra Leone,False,1,1,Sierra Leone
26015,27911,29678,2007,Sweden,Northern Ireland,1,1,UEFA Euro qualification,Solna,Sweden,False,2,0,Draw
26016,27912,29679,2007,Switzerland,United States,0,1,Friendly,Basel,Switzerland,False,1,-1,United States
26017,27913,29680,2007,Turkey,Greece,0,1,UEFA Euro qualification,Istanbul,Turkey,False,1,-1,Greece
26018,27914,29681,2007,Ukraine,Faroe Islands,5,0,UEFA Euro qualification,Kyïv,Ukraine,False,5,5,Ukraine
26019,27915,29682,2007,United Arab Emirates,Tunisia,0,1,Friendly,Abu Dhabi,United Arab Emirates,False,1,-1,Tunisia
26020,27916,29683,2007,Kyrgyzstan,Jordan,2,0,FIFA World Cup qualification,Bishkek,Kyrgyzstan,False,2,2,Kyrgyzstan
26021,27917,29684,2007,Bahrain,Malaysia,4,1,FIFA World Cup qualification,Riffa,Bahrain,False,5,3,Bahrain
26022,27918,29686,2007,East Timor,Hong Kong,2,3,FIFA World Cup qualification,Gianyar,Indonesia,True,5,-1,Hong Kong
26023,27920,29688,2007,Sri Lanka,Qatar,0,1,FIFA World Cup qualification,Colombo,Sri Lanka,False,1,-1,Qatar
26024,27921,29689,2007,Pakistan,Iraq,0,7,FIFA World Cup qualification,Lahore,Pakistan,False,7,-7,Iraq
26025,27922,29690,2007,South Africa,Zambia,0,0,COSAFA Cup,Bloemfontein,South Africa,False,0,0,Draw
26026,27923,29691,2007,Afghanistan,Syria,1,2,FIFA World Cup qualification,Dushanbe,Tajikistan,True,3,-1,Syria
26027,27925,29693,2007,Hong Kong,East Timor,8,1,FIFA World Cup qualification,So Kon Po,Hong Kong,False,9,7,Hong Kong
26028,27926,29694,2007,Iraq,Pakistan,0,0,FIFA World Cup qualification,Damascus,Syria,True,0,0,Draw
26029,27927,29695,2007,Jordan,Kyrgyzstan,2,0,FIFA World Cup qualification,Amman,Jordan,False,2,2,Jordan
26030,27928,29697,2007,Malaysia,Bahrain,0,0,FIFA World Cup qualification,Shah Alam,Malaysia,False,0,0,Draw
26031,27929,29698,2007,Maldives,Yemen,2,0,FIFA World Cup qualification,Malé,Maldives,False,2,2,Maldives
26032,27930,29699,2007,Nepal,Oman,0,2,FIFA World Cup qualification,Kathmandu,Nepal,False,2,-2,Oman
26033,27931,29700,2007,Qatar,Sri Lanka,5,0,FIFA World Cup qualification,Doha,Qatar,False,5,5,Qatar
26034,27932,29701,2007,Tajikistan,Bangladesh,5,0,FIFA World Cup qualification,Dushanbe,Tajikistan,False,5,5,Tajikistan
26035,27933,29702,2007,Turkmenistan,Cambodia,4,1,FIFA World Cup qualification,Ashgabat,Turkmenistan,False,5,3,Turkmenistan
26036,27934,29703,2007,United Arab Emirates,Vietnam,5,0,FIFA World Cup qualification,Abu Dhabi,United Arab Emirates,False,5,5,United Arab Emirates
26037,27935,29704,2007,India,Lebanon,2,2,FIFA World Cup qualification,Margao,India,False,4,0,Draw
26038,27937,29706,2007,Saudi Arabia,Namibia,1,0,Friendly,Riyadh,Saudi Arabia,False,1,1,Saudi Arabia
26039,27938,29707,2007,Indonesia,Syria,1,4,FIFA World Cup qualification,Jakarta,Indonesia,False,5,-3,Syria
26040,27939,29708,2007,Saudi Arabia,Estonia,2,0,Friendly,Jeddah,Saudi Arabia,False,2,2,Saudi Arabia
26041,27940,29709,2007,Singapore,Tajikistan,2,0,FIFA World Cup qualification,Singapore,Singapore,False,2,2,Singapore
26042,27941,29710,2007,Yemen,Thailand,1,1,FIFA World Cup qualification,Sana'a,Yemen,False,2,0,Draw
26043,27942,29711,2007,Hong Kong,Turkmenistan,0,0,FIFA World Cup qualification,So Kon Po,Hong Kong,False,0,0,Draw
26044,27944,29713,2007,French Guiana,Guadeloupe,2,3,Friendly,Cayenne,French Guiana,False,5,-1,Guadeloupe
26045,27945,29714,2007,Austria,England,0,1,Friendly,Vienna,Austria,False,1,-1,England
26046,27946,29715,2007,Djibouti,Somalia,1,0,FIFA World Cup qualification,Djibouti,Djibouti,False,1,1,Djibouti
26047,27947,29716,2007,France,Morocco,2,2,Friendly,Saint-Denis,France,False,4,0,Draw
26048,27948,29717,2007,Qatar,Georgia,1,2,Friendly,Doha,Qatar,False,3,-1,Georgia
26049,27949,29718,2007,Albania,Belarus,2,4,UEFA Euro qualification,Tirana,Albania,False,6,-2,Belarus
26050,27950,29719,2007,Andorra,Estonia,0,2,UEFA Euro qualification,Sant Julià de Lòria,Andorra,False,2,-2,Estonia
26051,27951,29720,2007,Angola,Ivory Coast,2,1,Friendly,Melun,France,True,3,1,Angola
26052,27952,29721,2007,Argentina,Bolivia,3,0,FIFA World Cup qualification,Buenos Aires,Argentina,False,3,3,Argentina
26053,27953,29722,2007,Australia,Nigeria,1,0,Friendly,London,England,True,1,1,Australia
26054,27954,29723,2007,Benin,United Arab Emirates,1,0,Friendly,Accra,Ghana,True,1,1,Benin
26055,27955,29724,2007,Bulgaria,Romania,1,0,UEFA Euro qualification,Sofia,Bulgaria,False,1,1,Bulgaria
26056,27956,29725,2007,Colombia,Venezuela,1,0,FIFA World Cup qualification,Bogotá,Colombia,False,1,1,Colombia
26057,27957,29726,2007,Comoros,Madagascar,0,4,FIFA World Cup qualification,Moroni,Comoros,False,4,-4,Madagascar
26058,27958,29727,2007,Czech Republic,Slovakia,3,1,UEFA Euro qualification,Prague,Czech Republic,False,4,2,Czech Republic
26059,27959,29728,2007,Fiji,New Caledonia,3,3,FIFA World Cup qualification,Ba,Fiji,False,6,0,Draw
26060,27960,29729,2007,Finland,Azerbaijan,2,1,UEFA Euro qualification,Helsinki,Finland,False,3,1,Finland
26061,27961,29730,2007,Germany,Cyprus,4,0,UEFA Euro qualification,Hanover,Germany,False,4,4,Germany
26062,27962,29731,2007,Greece,Malta,5,0,UEFA Euro qualification,Athens,Greece,False,5,5,Greece
26063,27963,29732,2007,Guatemala,Honduras,0,1,Friendly,Miami Gardens,United States,True,1,-1,Honduras
26064,27964,29733,2007,Guinea-Bissau,Sierra Leone,0,0,FIFA World Cup qualification,Bissau,Guinea-Bissau,False,0,0,Draw
26065,27965,29734,2007,Israel,Russia,2,1,UEFA Euro qualification,Ramat-Gan,Israel,False,3,1,Israel
26066,27966,29735,2007,Latvia,Liechtenstein,4,1,UEFA Euro qualification,Riga,Latvia,False,5,3,Latvia
26067,27967,29736,2007,Lithuania,Ukraine,2,0,UEFA Euro qualification,Kaunas,Lithuania,False,2,2,Lithuania
26068,27968,29738,2007,Moldova,Hungary,3,0,UEFA Euro qualification,Chişinău,Moldova,False,3,3,Moldova
26069,27969,29739,2007,Netherlands,Luxembourg,1,0,UEFA Euro qualification,Rotterdam,Netherlands,False,1,1,Netherlands
26070,27970,29740,2007,Northern Ireland,Denmark,2,1,UEFA Euro qualification,Belfast,Northern Ireland,False,3,1,Northern Ireland
26071,27971,29741,2007,Norway,Turkey,1,2,UEFA Euro qualification,Oslo,Norway,False,3,-1,Turkey
26072,27972,29742,2007,Paraguay,Ecuador,5,1,FIFA World Cup qualification,Asunción,Paraguay,False,6,4,Paraguay
26073,27973,29743,2007,Poland,Belgium,2,0,UEFA Euro qualification,Chorzów,Poland,False,2,2,Poland
26074,27974,29744,2007,Portugal,Armenia,1,0,UEFA Euro qualification,Leiria,Portugal,False,1,1,Portugal
26075,27975,29745,2007,Scotland,Italy,1,2,UEFA Euro qualification,Glasgow,Scotland,False,3,-1,Italy
26076,27976,29746,2007,Senegal,Mali,3,2,Friendly,Évry/Bondoufle,France,True,5,1,Senegal
26077,27977,29747,2007,South Africa,United States,0,1,Friendly,Johannesburg,South Africa,False,1,-1,United States
26078,27978,29748,2007,Spain,Sweden,3,0,UEFA Euro qualification,Madrid,Spain,False,3,3,Spain
26079,27979,29749,2007,Tunisia,Namibia,2,0,Friendly,Radès,Tunisia,False,2,2,Tunisia
26080,27980,29750,2007,Vanuatu,New Zealand,1,2,FIFA World Cup qualification,Port Vila,Vanuatu,False,3,-1,New Zealand
26081,27981,29751,2007,Wales,Republic of Ireland,2,2,UEFA Euro qualification,Cardiff,Wales,False,4,0,Draw
26082,27982,29752,2007,Ghana,Togo,2,0,Friendly,Accra,Ghana,False,2,2,Ghana
26083,27983,29753,2007,Jamaica,El Salvador,3,0,Friendly,Kingston,Jamaica,False,3,3,Jamaica
26084,27984,29754,2007,Peru,Brazil,1,1,FIFA World Cup qualification,Lima,Peru,False,2,0,Draw
26085,27985,29755,2007,Saint Kitts and Nevis,Antigua and Barbuda,3,0,Friendly,Basseterre,Saint Kitts and Nevis,False,3,3,Saint Kitts and Nevis
26086,27986,29756,2007,Eswatini,Malawi,0,3,Friendly,Manzini,Eswatini,False,3,-3,Malawi
26087,27987,29757,2007,Syria,Indonesia,7,0,FIFA World Cup qualification,Damascus,Syria,False,7,7,Syria
26088,27988,29758,2007,Tajikistan,Singapore,1,1,FIFA World Cup qualification,Dushanbe,Tajikistan,False,2,0,Draw
26089,27989,29759,2007,Thailand,Yemen,1,0,FIFA World Cup qualification,Bangkok,Thailand,False,1,1,Thailand
26090,27990,29760,2007,Turkmenistan,Hong Kong,3,0,FIFA World Cup qualification,Ashgabat,Turkmenistan,False,3,3,Turkmenistan
26091,27991,29761,2007,Uruguay,Chile,2,2,FIFA World Cup qualification,Montevideo,Uruguay,False,4,0,Draw
26092,27992,29762,2007,Algeria,Mali,3,2,Friendly,Rouen,France,True,5,1,Algeria
26093,27993,29763,2007,Angola,Guinea,0,3,Friendly,Melun,France,True,3,-3,Guinea
26094,27994,29764,2007,Colombia,Argentina,2,1,FIFA World Cup qualification,Bogotá,Colombia,False,3,1,Colombia
26095,27995,29765,2007,South Africa,Canada,2,0,Friendly,Durban,South Africa,False,2,2,South Africa
26096,27996,29766,2007,Switzerland,Nigeria,0,1,Friendly,Zürich,Switzerland,False,1,-1,Nigeria
26097,27997,29767,2007,Venezuela,Bolivia,5,3,FIFA World Cup qualification,San Cristóbal,Venezuela,False,8,2,Venezuela
26098,27998,29768,2007,Andorra,Russia,0,1,UEFA Euro qualification,Sant Julià de Lòria,Andorra,False,1,-1,Russia
26099,27999,29769,2007,Armenia,Kazakhstan,0,1,UEFA Euro qualification,Yerevan,Armenia,False,1,-1,Kazakhstan
26100,28000,29770,2007,Austria,Tunisia,0,0,Friendly,Vienna,Austria,False,0,0,Draw
26101,28001,29771,2007,Azerbaijan,Belgium,0,1,UEFA Euro qualification,Baku,Azerbaijan,False,1,-1,Belgium
26102,28002,29772,2007,Belarus,Netherlands,2,1,UEFA Euro qualification,Minsk,Belarus,False,3,1,Belarus
26103,28003,29773,2007,Brazil,Uruguay,2,1,FIFA World Cup qualification,São Paulo,Brazil,False,3,1,Brazil
26104,28004,29774,2007,Chile,Paraguay,0,3,FIFA World Cup qualification,Santiago,Chile,False,3,-3,Paraguay
26105,28005,29775,2007,Cyprus,Czech Republic,0,2,UEFA Euro qualification,Nicosia,Cyprus,False,2,-2,Czech Republic
26106,28006,29776,2007,Denmark,Iceland,3,0,UEFA Euro qualification,Copenhagen,Denmark,False,3,3,Denmark
26107,28007,29777,2007,Ecuador,Peru,5,1,FIFA World Cup qualification,Quito,Ecuador,False,6,4,Ecuador
26108,28008,29778,2007,England,Croatia,2,3,UEFA Euro qualification,London,England,False,5,-1,Croatia
26109,28009,29779,2007,Equatorial Guinea,Niger,1,1,Friendly,Malabo,Equatorial Guinea,False,2,0,Draw
26110,28010,29780,2007,Georgia,Lithuania,0,2,UEFA Euro qualification,Tbilisi,Georgia,False,2,-2,Lithuania
26111,28011,29781,2007,Germany,Wales,0,0,UEFA Euro qualification,Frankfurt am Main,Germany,False,0,0,Draw
26112,28012,29782,2007,Ghana,Benin,4,2,Friendly,Accra,Ghana,False,6,2,Ghana
26113,28013,29783,2007,Hungary,Greece,1,2,UEFA Euro qualification,Budapest,Hungary,False,3,-1,Greece
26114,28015,29785,2007,Italy,Faroe Islands,3,1,UEFA Euro qualification,Modena,Italy,False,4,2,Italy
26115,28016,29786,2007,Jamaica,Guatemala,2,0,Friendly,Kingston,Jamaica,False,2,2,Jamaica
26116,28017,29787,2007,Malta,Norway,1,4,UEFA Euro qualification,Attard,Malta,False,5,-3,Norway
26117,28018,29788,2007,Morocco,Senegal,3,0,Friendly,Évry/Bondoufle,France,True,3,3,Morocco
26118,28019,29789,2007,New Caledonia,Fiji,4,0,FIFA World Cup qualification,Nouméa,New Caledonia,False,4,4,New Caledonia
26119,28020,29790,2007,New Zealand,Vanuatu,4,1,FIFA World Cup qualification,Wellington,New Zealand,False,5,3,New Zealand
26120,28021,29791,2007,Oman,Kenya,2,2,Friendly,Muscat,Oman,False,4,0,Draw
26121,28022,29792,2007,Panama,Costa Rica,1,1,Friendly,Panama City,Panama,False,2,0,Draw
26122,28023,29793,2007,Portugal,Finland,0,0,UEFA Euro qualification,Porto,Portugal,False,0,0,Draw
26123,28024,29794,2007,Qatar,Ivory Coast,1,6,Friendly,Doha,Qatar,False,7,-5,Ivory Coast
26124,28025,29795,2007,Romania,Albania,6,1,UEFA Euro qualification,Bucharest,Romania,False,7,5,Romania
26125,28026,29796,2007,San Marino,Slovakia,0,5,UEFA Euro qualification,Serravalle,San Marino,False,5,-5,Slovakia
26126,28027,29797,2007,Serbia,Poland,2,2,UEFA Euro qualification,Belgrade,Serbia,False,4,0,Draw
26127,28028,29798,2007,Slovenia,Bulgaria,0,2,UEFA Euro qualification,Celje,Slovenia,False,2,-2,Bulgaria
26128,28029,29799,2007,Spain,Northern Ireland,1,0,UEFA Euro qualification,Las Palmas,Spain,False,1,1,Spain
26129,28030,29800,2007,Sweden,Latvia,2,1,UEFA Euro qualification,Solna,Sweden,False,3,1,Sweden
26130,28031,29801,2007,Tanzania,Zambia,1,0,Friendly,Dar es Salaam,Tanzania,False,1,1,Tanzania
26131,28032,29802,2007,Turkey,Bosnia and Herzegovina,1,0,UEFA Euro qualification,Istanbul,Turkey,False,1,1,Turkey
26132,28033,29803,2007,Ukraine,France,2,2,UEFA Euro qualification,Kyïv,Ukraine,False,4,0,Draw
26133,28034,29804,2007,United Arab Emirates,Togo,0,5,Friendly,Accra,Ghana,True,5,-5,Togo
26134,28035,29805,2007,Uzbekistan,Estonia,0,0,Friendly,Tashkent,Uzbekistan,False,0,0,Draw
26135,28036,29806,2007,Oman,Kenya,1,1,Friendly,Muscat,Oman,False,2,0,Draw
26136,28037,29807,2007,Serbia,Kazakhstan,1,0,UEFA Euro qualification,Belgrade,Serbia,False,1,1,Serbia
26137,28038,29808,2007,Sudan,Eritrea,1,0,Friendly,Omdurman,Sudan,False,1,1,Sudan
26138,28039,29809,2007,Antigua and Barbuda,Saint Kitts and Nevis,2,0,Friendly,St. John's,Antigua and Barbuda,False,2,2,Antigua and Barbuda
26139,28040,29810,2007,Guinea-Bissau,Sierra Leone,2,0,Amílcar Cabral Cup,Bissau,Guinea-Bissau,False,2,2,Guinea-Bissau
26140,28041,29812,2007,Sudan,Eritrea,1,0,Friendly,Omdurman,Sudan,False,1,1,Sudan
26141,28043,29814,2007,Tanzania,Kenya,2,1,CECAFA Cup,Dar es Salaam,Tanzania,False,3,1,Tanzania
26142,28044,29815,2007,Rwanda,Eritrea,2,1,CECAFA Cup,Dar es Salaam,Tanzania,True,3,1,Rwanda
26143,28046,29817,2007,Uganda,Djibouti,7,0,CECAFA Cup,Dar es Salaam,Tanzania,True,7,7,Uganda
26144,28047,29818,2007,Somalia,Burundi,0,3,CECAFA Cup,Dar es Salaam,Tanzania,True,3,-3,Burundi
26145,28048,29819,2007,Djibouti,Eritrea,2,3,CECAFA Cup,Dar es Salaam,Tanzania,True,5,-1,Eritrea
26146,28049,29820,2007,Oman,Jordan,0,3,Friendly,Muscat,Oman,False,3,-3,Jordan
26147,28050,29821,2007,Rwanda,Uganda,0,2,CECAFA Cup,Dar es Salaam,Tanzania,True,2,-2,Uganda
26148,28051,29822,2007,Kenya,Burundi,0,1,CECAFA Cup,Dar es Salaam,Tanzania,True,1,-1,Burundi
26149,28052,29823,2007,Tanzania,Somalia,1,0,CECAFA Cup,Dar es Salaam,Tanzania,False,1,1,Tanzania
26150,28053,29824,2007,Djibouti,Rwanda,0,9,CECAFA Cup,Dar es Salaam,Tanzania,True,9,-9,Rwanda
26151,28054,29826,2007,Bermuda,Saint Kitts and Nevis,1,2,Friendly,Hamilton,Bermuda,False,3,-1,Saint Kitts and Nevis
26152,28055,29827,2007,Eritrea,Uganda,3,2,CECAFA Cup,Dar es Salaam,Tanzania,True,5,1,Eritrea
26153,28056,29828,2007,Kenya,Somalia,2,0,CECAFA Cup,Dar es Salaam,Tanzania,True,2,2,Kenya
26154,28057,29829,2007,Ethiopia,Sudan,0,0,CECAFA Cup,Arusha,Tanzania,True,0,0,Draw
26155,28058,29830,2007,Tanzania,Burundi,0,0,CECAFA Cup,Dar es Salaam,Tanzania,False,0,0,Draw
26156,28059,29831,2007,Bermuda,Saint Kitts and Nevis,4,2,Friendly,Hamilton,Bermuda,False,6,2,Bermuda
26157,28060,29832,2007,Oman,Tajikistan,4,2,Friendly,Muscat,Oman,False,6,2,Oman
26158,28061,29833,2007,Burundi,Eritrea,2,1,CECAFA Cup,Dar es Salaam,Tanzania,True,3,1,Burundi
26159,28062,29834,2007,Tanzania,Sudan,1,2,CECAFA Cup,Dar es Salaam,Tanzania,False,3,-1,Sudan
26160,28063,29835,2007,Uganda,Kenya,1,1,CECAFA Cup,Dar es Salaam,Tanzania,True,2,0,Draw
26161,28064,29837,2007,Burundi,Sudan,1,2,CECAFA Cup,Dar es Salaam,Tanzania,True,3,-1,Sudan
26162,28065,29838,2007,Uganda,Rwanda,0,1,CECAFA Cup,Dar es Salaam,Tanzania,True,1,-1,Rwanda
26163,28066,29839,2007,Burundi,Uganda,0,2,CECAFA Cup,Dar es Salaam,Tanzania,True,2,-2,Uganda
26164,28067,29840,2007,Sudan,Rwanda,2,2,CECAFA Cup,Dar es Salaam,Tanzania,True,4,0,Draw
26165,28068,29841,2007,Thailand,Uzbekistan,3,2,King's Cup,Bangkok,Thailand,False,5,1,Thailand
26166,28069,29842,2007,Gambia,Sierra Leone,2,1,Friendly,Bakau,Gambia,False,3,1,Gambia
26167,28071,29849,2008,Kuwait,Lebanon,3,2,Friendly,Salmiya,Kuwait,False,5,1,Kuwait
26168,28072,29850,2008,Egypt,Namibia,3,0,Friendly,Aswan,Egypt,False,3,3,Egypt
26169,28073,29851,2008,Tunisia,Zambia,1,2,Friendly,Radès,Tunisia,False,3,-1,Zambia
26170,28074,29852,2008,Tunisia,Zambia,1,0,Friendly,Radès,Tunisia,False,1,1,Tunisia
26171,28075,29853,2008,Nigeria,Sudan,2,0,Friendly,Estepona,Spain,True,2,2,Nigeria
26172,28076,29854,2008,Egypt,Mali,1,0,Friendly,Abu Dhabi,United Arab Emirates,True,1,1,Egypt
26173,28077,29855,2008,Qatar,Iran,0,0,Friendly,Doha,Qatar,False,0,0,Draw
26174,28079,29857,2008,Guinea,Sudan,6,0,Friendly,Estepona,Spain,True,6,6,Guinea
26175,28080,29858,2008,Kuwait,Ivory Coast,0,2,Friendly,Kuwait City,Kuwait,False,2,-2,Ivory Coast
26176,28081,29859,2008,Morocco,Zambia,2,0,Friendly,Fès,Morocco,False,2,2,Morocco
26177,28082,29860,2008,Senegal,Namibia,3,1,Friendly,Dakar,Senegal,False,4,2,Senegal
26178,28083,29861,2008,Angola,Egypt,3,3,Friendly,Alverca do Ribatejo,Portugal,True,6,0,Draw
26179,28084,29862,2008,Barbados,Antigua and Barbuda,3,2,Friendly,Black Rock,Barbados,False,5,1,Barbados
26180,28085,29863,2008,Costa Rica,Sweden,0,1,Friendly,San José,Costa Rica,False,1,-1,Sweden
26181,28086,29864,2008,South Africa,Mozambique,2,0,Friendly,Durban,South Africa,False,2,2,South Africa
26182,28087,29865,2008,Syria,Qatar,0,0,Friendly,Damascus,Syria,False,0,0,Draw
26183,28088,29866,2008,Bahrain,Kuwait,1,0,Friendly,Manama,Bahrain,False,1,1,Bahrain
26184,28089,29867,2008,Benin,Senegal,1,2,Friendly,Ouagadougou,Burkina Faso,True,3,-1,Senegal
26185,28090,29868,2008,Bermuda,Puerto Rico,0,2,Friendly,Hamilton,Bermuda,False,2,-2,Puerto Rico
26186,28091,29869,2008,Morocco,Angola,2,1,Friendly,Rabat,Morocco,False,3,1,Morocco
26187,28092,29870,2008,South Africa,Botswana,2,1,Friendly,Umlazi,South Africa,False,3,1,South Africa
26188,28093,29871,2008,Bermuda,Puerto Rico,0,1,Friendly,Hamilton,Bermuda,False,1,-1,Puerto Rico
26189,28094,29872,2008,Dominica,Guadeloupe,0,3,Friendly,Roseau,Dominica,False,3,-3,Guadeloupe
26190,28095,29873,2008,United States,Sweden,2,0,Friendly,Carson,United States,False,2,2,United States
26191,28096,29875,2008,Ghana,Guinea,2,1,African Cup of Nations,Accra,Ghana,False,3,1,Ghana
26192,28097,29876,2008,Guyana,Grenada,1,2,Friendly,Georgetown,Guyana,False,3,-1,Grenada
26193,28098,29877,2008,Mali,Benin,1,0,African Cup of Nations,Sekondi,Ghana,True,1,1,Mali
26194,28099,29878,2008,Namibia,Morocco,1,5,African Cup of Nations,Accra,Ghana,True,6,-4,Morocco
26195,28100,29879,2008,Nigeria,Ivory Coast,0,1,African Cup of Nations,Sekondi,Ghana,True,1,-1,Ivory Coast
26196,28101,29880,2008,Belize,El Salvador,0,1,Friendly,San Ignacio,Belize,False,1,-1,El Salvador
26197,28102,29881,2008,Egypt,Cameroon,4,2,African Cup of Nations,Kumasi,Ghana,True,6,2,Egypt
26198,28103,29882,2008,Sudan,Zambia,0,3,African Cup of Nations,Kumasi,Ghana,True,3,-3,Zambia
26199,28104,29883,2008,Bahrain,Syria,1,2,Friendly,Manama,Bahrain,False,3,-1,Syria
26200,28105,29884,2008,South Africa,Angola,1,1,African Cup of Nations,Tamale,Ghana,True,2,0,Draw
26201,28106,29885,2008,Tunisia,Senegal,2,2,African Cup of Nations,Tamale,Ghana,True,4,0,Draw
26202,28107,29886,2008,Ghana,Namibia,1,0,African Cup of Nations,Accra,Ghana,False,1,1,Ghana
26203,28108,29887,2008,Guinea,Morocco,3,2,African Cup of Nations,Accra,Ghana,True,5,1,Guinea
26204,28109,29888,2008,Iraq,Jordan,1,1,Friendly,Dubai,United Arab Emirates,True,2,0,Draw
26205,28110,29889,2008,Kuwait,Singapore,0,2,Friendly,Muscat,Oman,True,2,-2,Singapore
26206,28111,29890,2008,Ivory Coast,Benin,4,1,African Cup of Nations,Sekondi,Ghana,True,5,3,Ivory Coast
26207,28112,29891,2008,Nigeria,Mali,0,0,African Cup of Nations,Sekondi,Ghana,True,0,0,Draw
26208,28113,29892,2008,Bahrain,Yemen,2,1,Friendly,Manama,Bahrain,False,3,1,Bahrain
26209,28114,29893,2008,Cameroon,Zambia,5,1,African Cup of Nations,Kumasi,Ghana,True,6,4,Cameroon
26210,28115,29894,2008,Egypt,Sudan,3,0,African Cup of Nations,Kumasi,Ghana,True,3,3,Egypt
26211,28116,29895,2008,Haiti,El Salvador,0,0,Friendly,Port-au-Prince,Haiti,False,0,0,Draw
26212,28117,29896,2008,Japan,Chile,0,0,Friendly,Tokyo,Japan,False,0,0,Draw
26213,28118,29897,2008,Puerto Rico,Trinidad and Tobago,2,2,Friendly,Bayamón,Puerto Rico,False,4,0,Draw
26214,28119,29899,2008,Oman,Singapore,2,0,Friendly,Muscat,Oman,False,2,2,Oman
26215,28120,29900,2008,Senegal,Angola,1,3,African Cup of Nations,Tamale,Ghana,True,4,-2,Angola
26216,28121,29901,2008,Tunisia,South Africa,3,1,African Cup of Nations,Tamale,Ghana,True,4,2,Tunisia
26217,28122,29902,2008,Ghana,Morocco,2,0,African Cup of Nations,Accra,Ghana,False,2,2,Ghana
26218,28123,29903,2008,Guinea,Namibia,1,1,African Cup of Nations,Sekondi,Ghana,True,2,0,Draw
26219,28124,29904,2008,Jordan,Lebanon,4,1,Friendly,Amman,Jordan,False,5,3,Jordan
26220,28125,29905,2008,Haiti,El Salvador,0,0,Friendly,Saint-Marc,Haiti,False,0,0,Draw
26221,28126,29906,2008,Ivory Coast,Mali,3,0,African Cup of Nations,Accra,Ghana,True,3,3,Ivory Coast
26222,28127,29907,2008,Nigeria,Benin,2,0,African Cup of Nations,Sekondi,Ghana,True,2,2,Nigeria
26223,28128,29908,2008,Trinidad and Tobago,Guyana,2,1,Friendly,Couva,Trinidad and Tobago,False,3,1,Trinidad and Tobago
26224,28129,29909,2008,Cameroon,Sudan,3,0,African Cup of Nations,Tamale,Ghana,True,3,3,Cameroon
26225,28130,29910,2008,Egypt,Zambia,1,1,African Cup of Nations,Kumasi,Ghana,True,2,0,Draw
26226,28131,29911,2008,Iran,Costa Rica,0,0,Friendly,Teheran,Iran,False,0,0,Draw
26227,28132,29912,2008,Japan,Bosnia and Herzegovina,3,0,Friendly,Tokyo,Japan,False,3,3,Japan
26228,28133,29914,2008,Martinique,Canada,0,1,Friendly,Fort-de-France,Martinique,False,1,-1,Canada
26229,28134,29915,2008,Oman,Kuwait,1,1,Friendly,Muscat,Oman,False,2,0,Draw
26230,28135,29916,2008,Saudi Arabia,Luxembourg,2,1,Friendly,Riyadh,Saudi Arabia,False,3,1,Saudi Arabia
26231,28136,29917,2008,Jordan,Singapore,2,1,Friendly,Zarqa,Jordan,False,3,1,Jordan
26232,28137,29918,2008,Senegal,South Africa,1,1,African Cup of Nations,Kumasi,Ghana,True,2,0,Draw
26233,28138,29919,2008,Tunisia,Angola,0,0,African Cup of Nations,Tamale,Ghana,True,0,0,Draw
26234,28139,29920,2008,United Arab Emirates,Iraq,0,1,Friendly,Abu Dhabi,United Arab Emirates,False,1,-1,Iraq
26235,28140,29921,2008,Belarus,Iceland,2,0,Malta International Tournament,Attard,Malta,True,2,2,Belarus
26236,28141,29922,2008,Malta,Armenia,0,1,Malta International Tournament,Attard,Malta,False,1,-1,Armenia
26237,28142,29923,2008,Azerbaijan,Kazakhstan,0,0,Friendly,Antalya,Turkey,True,0,0,Draw
26238,28143,29924,2008,Bermuda,Cayman Islands,1,1,FIFA World Cup qualification,Hamilton,Bermuda,False,2,0,Draw
26239,28144,29925,2008,Ghana,Nigeria,2,1,African Cup of Nations,Accra,Ghana,False,3,1,Ghana
26240,28145,29926,2008,Ivory Coast,Guinea,5,0,African Cup of Nations,Sekondi,Ghana,True,5,5,Ivory Coast
26241,28146,29927,2008,Venezuela,Haiti,1,0,Friendly,Maturín,Venezuela,False,1,1,Venezuela
26242,28147,29928,2008,Armenia,Belarus,2,1,Malta International Tournament,Attard,Malta,True,3,1,Armenia
26243,28148,29929,2008,Egypt,Angola,2,1,African Cup of Nations,Kumasi,Ghana,True,3,1,Egypt
26244,28149,29930,2008,Malta,Iceland,1,0,Malta International Tournament,Attard,Malta,False,1,1,Malta
26245,28150,29931,2008,Tunisia,Cameroon,2,3,African Cup of Nations,Tamale,Ghana,True,5,-1,Cameroon
26246,28151,29932,2008,Armenia,Iceland,0,2,Malta International Tournament,Attard,Malta,True,2,-2,Iceland
26247,28152,29933,2008,Aruba,Antigua and Barbuda,0,3,FIFA World Cup qualification,Oranjestad,Aruba,False,3,-3,Antigua and Barbuda
26248,28153,29934,2008,Australia,Qatar,3,0,FIFA World Cup qualification,Melbourne,Australia,False,3,3,Australia
26249,28154,29935,2008,Austria,Germany,0,3,Friendly,Vienna,Austria,False,3,-3,Germany
26250,28155,29936,2008,Belize,Saint Kitts and Nevis,3,1,FIFA World Cup qualification,Guatemala,Guatemala,True,4,2,Belize
26251,28156,29937,2008,Bolivia,Peru,2,1,Friendly,La Paz,Bolivia,False,3,1,Bolivia
26252,28157,29938,2008,Burundi,Rwanda,0,0,Friendly,Bujumbura,Burundi,False,0,0,Draw
26253,28158,29939,2008,Croatia,Netherlands,0,3,Friendly,Split,Croatia,False,3,-3,Netherlands
26254,28159,29940,2008,Cyprus,Ukraine,1,1,Friendly,Nicosia,Cyprus,False,2,0,Draw
26255,28160,29941,2008,Czech Republic,Poland,0,2,Friendly,Larnaca,Cyprus,True,2,-2,Poland
26256,28161,29942,2008,Dominica,Barbados,1,1,FIFA World Cup qualification,Roseau,Dominica,False,2,0,Draw
26257,28162,29943,2008,El Salvador,Anguilla,12,0,FIFA World Cup qualification,San Salvador,El Salvador,False,12,12,El Salvador
26258,28163,29944,2008,England,Switzerland,2,1,Friendly,London,England,False,3,1,England
26259,28164,29945,2008,Georgia,Latvia,1,3,Friendly,Tbilisi,Georgia,False,4,-2,Latvia
26260,28165,29946,2008,Greece,Finland,2,1,Friendly,Nicosia,Cyprus,True,3,1,Greece
26261,28166,29947,2008,Honduras,Paraguay,2,0,Friendly,San Pedro Sula,Honduras,False,2,2,Honduras
26262,28167,29948,2008,Hungary,Slovakia,1,1,Friendly,Limassol,Cyprus,True,2,0,Draw
26263,28168,29949,2008,Iran,Syria,0,0,FIFA World Cup qualification,Teheran,Iran,False,0,0,Draw
26264,28170,29951,2008,Republic of Ireland,Brazil,0,1,Friendly,Dublin,Republic of Ireland,False,1,-1,Brazil
26265,28171,29952,2008,Israel,Romania,1,0,Friendly,Ramat-Gan,Israel,False,1,1,Israel
26266,28172,29953,2008,Italy,Portugal,3,1,Friendly,Zürich,Switzerland,True,4,2,Italy
26267,28173,29954,2008,Jamaica,Costa Rica,1,1,Friendly,Kingston,Jamaica,False,2,0,Draw
26268,28174,29955,2008,Japan,Thailand,4,1,FIFA World Cup qualification,Saitama,Japan,False,5,3,Japan
26269,28176,29957,2008,Kazakhstan,Moldova,0,1,Friendly,Antalya,Turkey,True,1,-1,Moldova
26270,28177,29959,2008,Lebanon,Uzbekistan,0,1,FIFA World Cup qualification,Beirut,Lebanon,False,1,-1,Uzbekistan
26271,28178,29961,2008,Malta,Belarus,0,1,Malta International Tournament,Attard,Malta,False,1,-1,Belarus
26272,28179,29962,2008,Nicaragua,Curaçao,0,1,FIFA World Cup qualification,Diriamba,Nicaragua,False,1,-1,Curaçao
26273,28180,29963,2008,Northern Ireland,Bulgaria,0,1,Friendly,Belfast,Northern Ireland,False,1,-1,Bulgaria
26274,28181,29964,2008,Oman,Bahrain,0,1,FIFA World Cup qualification,Muscat,Oman,False,1,-1,Bahrain
26275,28182,29965,2008,Saudi Arabia,Singapore,2,0,FIFA World Cup qualification,Riyadh,Saudi Arabia,False,2,2,Saudi Arabia
26276,28183,29966,2008,Slovenia,Denmark,1,2,Friendly,Nova Gorica,Slovenia,False,3,-1,Denmark
26277,28184,29967,2008,Spain,France,1,0,Friendly,Málaga,Spain,False,1,1,Spain
26278,28185,29968,2008,Trinidad and Tobago,Guadeloupe,0,0,Friendly,Port of Spain,Trinidad and Tobago,False,0,0,Draw
26279,28186,29969,2008,Turkey,Sweden,0,0,Friendly,Istanbul,Turkey,False,0,0,Draw
26280,28187,29970,2008,Turks and Caicos Islands,Saint Lucia,2,1,FIFA World Cup qualification,Providenciales,Turks and Caicos Islands,False,3,1,Turks and Caicos Islands
26281,28188,29971,2008,United Arab Emirates,Kuwait,2,0,FIFA World Cup qualification,Abu Dhabi,United Arab Emirates,False,2,2,United Arab Emirates
26282,28189,29972,2008,Uruguay,Colombia,2,2,Friendly,Montevideo,Uruguay,False,4,0,Draw
26283,28190,29973,2008,United States,Mexico,2,2,Friendly,Houston,United States,False,4,0,Draw
26284,28191,29974,2008,Venezuela,Haiti,1,1,Friendly,Puerto la Cruz,Venezuela,False,2,0,Draw
26285,28192,29975,2008,Wales,Norway,3,0,Friendly,Wrexham,Wales,False,3,3,Wales
26286,28193,29976,2008,Ghana,Cameroon,0,1,African Cup of Nations,Accra,Ghana,False,1,-1,Cameroon
26287,28194,29977,2008,Ivory Coast,Egypt,1,4,African Cup of Nations,Kumasi,Ghana,True,5,-3,Egypt
26288,28195,29978,2008,Ghana,Ivory Coast,4,2,African Cup of Nations,Kumasi,Ghana,False,6,2,Ghana
26289,28196,29979,2008,Lesotho,Mozambique,0,1,Friendly,Lobamba,Eswatini,True,1,-1,Mozambique
26290,28197,29980,2008,Eswatini,Botswana,1,4,Friendly,Lobamba,Eswatini,False,5,-3,Botswana
26291,28198,29981,2008,Botswana,Mozambique,1,0,Friendly,Lobamba,Eswatini,True,1,1,Botswana
26292,28199,29982,2008,Cameroon,Egypt,0,1,African Cup of Nations,Accra,Ghana,True,1,-1,Egypt
26293,28200,29983,2008,Eswatini,Lesotho,2,2,Friendly,Lobamba,Eswatini,False,4,0,Draw
26294,28203,29990,2008,Guyana,Cuba,0,0,Friendly,Georgetown,Guyana,False,0,0,Draw
26295,28204,29991,2008,Dominican Republic,Haiti,1,2,Friendly,San Cristóbal,Dominican Republic,False,3,-1,Haiti
26296,28205,29992,2008,Poland,Estonia,2,0,Friendly,Wronki,Poland,False,2,2,Poland
26297,28206,29993,2008,Dominican Republic,Haiti,0,2,Friendly,San Cristóbal,Dominican Republic,False,2,-2,Haiti
26298,28207,29994,2008,Qatar,Bahrain,1,2,Friendly,Doha,Qatar,False,3,-1,Bahrain
26299,28208,29995,2008,Mauritius,Madagascar,1,2,Friendly,Curepipe,Mauritius,False,3,-1,Madagascar
26300,28209,29996,2008,South Africa,Zimbabwe,2,1,Friendly,Germiston,South Africa,False,3,1,South Africa
26301,28210,30000,2008,Iceland,Faroe Islands,3,0,Friendly,Kópavogur,Iceland,False,3,3,Iceland
26302,28211,30001,2008,Qatar,Jordan,2,1,Friendly,Doha,Qatar,False,3,1,Qatar
26303,28212,30002,2008,Oman,United Arab Emirates,1,1,Friendly,Muscat,Oman,False,2,0,Draw
26304,28213,30003,2008,Trinidad and Tobago,El Salvador,1,0,Friendly,Macoya,Trinidad and Tobago,False,1,1,Trinidad and Tobago
26305,28214,30004,2008,Bahrain,Iran,1,0,Friendly,Manama,Bahrain,False,1,1,Bahrain
26306,28215,30005,2008,Kuwait,Iraq,0,0,Friendly,Kuwait City,Kuwait,False,0,0,Draw
26307,28216,30006,2008,Singapore,Australia,0,0,Friendly,Singapore,Singapore,False,0,0,Draw
26308,28217,30007,2008,Uzbekistan,Jordan,4,1,Friendly,Tashkent,Uzbekistan,False,5,3,Uzbekistan
26309,28218,30008,2008,Venezuela,El Salvador,1,0,Friendly,Puerto Ordaz,Venezuela,False,1,1,Venezuela
26310,28219,30009,2008,Gabon,DR Congo,0,0,Friendly,Aubervilliers,France,True,0,0,Draw
26311,28220,30010,2008,Nepal,Pakistan,2,1,Friendly,Pokhara,Nepal,False,3,1,Nepal
26312,28221,30011,2008,Togo,Guinea,0,2,Friendly,Paris,France,True,2,-2,Guinea
26313,28222,30012,2008,Algeria,DR Congo,1,1,Friendly,Nanterre,France,True,2,0,Draw
26314,28223,30013,2008,Andorra,Latvia,0,3,Friendly,Sant Julià de Lòria,Andorra,False,3,-3,Latvia
26315,28224,30014,2008,Anguilla,El Salvador,0,4,FIFA World Cup qualification,Washington,United States,True,4,-4,El Salvador
26316,28225,30015,2008,Antigua and Barbuda,Aruba,1,0,FIFA World Cup qualification,St. John's,Antigua and Barbuda,False,1,1,Antigua and Barbuda
26317,28226,30016,2008,Armenia,Kazakhstan,1,0,Friendly,Pernis,Netherlands,True,1,1,Armenia
26318,28227,30017,2008,Austria,Netherlands,3,4,Friendly,Vienna,Austria,False,7,-1,Netherlands
26319,28229,30019,2008,Bahrain,Japan,1,0,FIFA World Cup qualification,Riffa,Bahrain,False,1,1,Bahrain
26320,28230,30020,2008,Barbados,Dominica,1,0,FIFA World Cup qualification,Bridgetown,Barbados,False,1,1,Barbados
26321,28231,30021,2008,Belarus,Turkey,2,2,Friendly,Minsk,Belarus,False,4,0,Draw
26322,28232,30022,2008,Belgium,Morocco,1,4,Friendly,Brussels,Belgium,False,5,-3,Morocco
26323,28234,30024,2008,Botswana,Zimbabwe,0,1,Friendly,Gaborone,Botswana,False,1,-1,Zimbabwe
26324,28235,30025,2008,Brazil,Sweden,1,0,Friendly,London,England,True,1,1,Brazil
26325,28236,30026,2008,Bulgaria,Finland,2,1,Friendly,Sofia,Bulgaria,False,3,1,Bulgaria
26326,28237,30028,2008,Curaçao,Nicaragua,2,0,FIFA World Cup qualification,Willemstad,Netherlands Antilles,True,2,2,Curaçao
26327,28238,30029,2008,Denmark,Czech Republic,1,1,Friendly,Herning,Denmark,False,2,0,Draw
26328,28239,30030,2008,Ecuador,Haiti,3,1,Friendly,Latacunga,Ecuador,False,4,2,Ecuador
26329,28240,30031,2008,Egypt,Argentina,0,2,Friendly,Cairo,Egypt,False,2,-2,Argentina
26330,28241,30032,2008,Estonia,Canada,2,0,Friendly,Tallinn,Estonia,False,2,2,Estonia
26331,28242,30033,2008,France,England,1,0,Friendly,Saint-Denis,France,False,1,1,France
26332,28243,30034,2008,Ghana,Mexico,1,2,Friendly,London,England,True,3,-1,Mexico
26333,28244,30035,2008,Grenada,U.S. Virgin Islands,10,0,FIFA World Cup qualification,St. George's,Grenada,False,10,10,Grenada
26334,28245,30036,2008,Honduras,Colombia,2,1,Friendly,Fort Lauderdale,United States,True,3,1,Honduras
26335,28246,30037,2008,Hungary,Slovenia,0,1,Friendly,Zalaegerszeg,Hungary,False,1,-1,Slovenia
26336,28247,30038,2008,Israel,Chile,1,0,Friendly,Ramat-Gan,Israel,False,1,1,Israel
26337,28248,30039,2008,Ivory Coast,Tunisia,0,2,Friendly,Évry/Bondoufle,France,True,2,-2,Tunisia
26338,28249,30040,2008,Jamaica,Trinidad and Tobago,2,2,Friendly,Kingston,Jamaica,False,4,0,Draw
26339,28250,30042,2008,Kuwait,Iran,2,2,FIFA World Cup qualification,Kuwait City,Kuwait,False,4,0,Draw
26340,28251,30043,2008,Lithuania,Azerbaijan,1,0,Friendly,Vilnius,Lithuania,False,1,1,Lithuania
26341,28252,30044,2008,Luxembourg,Wales,0,2,Friendly,Luxembourg,Luxembourg,False,2,-2,Wales
26342,28253,30045,2008,Malta,Liechtenstein,7,1,Friendly,Attard,Malta,False,8,6,Malta
26343,28254,30046,2008,Montenegro,Norway,3,1,Friendly,Podgorica,Montenegro,False,4,2,Montenegro
26344,28255,30047,2008,Montserrat,Suriname,1,7,FIFA World Cup qualification,Macoya,Trinidad and Tobago,True,8,-6,Suriname
26345,28256,30048,2008,Namibia,Malawi,1,3,Friendly,Windhoek,Namibia,False,4,-2,Malawi
26346,28257,30049,2008,Northern Ireland,Georgia,4,1,Friendly,Belfast,Northern Ireland,False,5,3,Northern Ireland
26347,28258,30050,2008,Peru,Costa Rica,3,1,Friendly,Iquitos,Peru,False,4,2,Peru
26348,28259,30051,2008,Poland,United States,0,3,Friendly,Cracow,Poland,False,3,-3,United States
26349,28260,30052,2008,Portugal,Greece,1,2,Friendly,Düsseldorf,Germany,True,3,-1,Greece
26350,28261,30053,2008,Puerto Rico,Dominican Republic,1,0,FIFA World Cup qualification,Bayamón,Puerto Rico,False,1,1,Puerto Rico
26351,28262,30054,2008,Qatar,Iraq,2,0,FIFA World Cup qualification,Doha,Qatar,False,2,2,Qatar
26352,28263,30055,2008,Romania,Russia,3,0,Friendly,Bucharest,Romania,False,3,3,Romania
26353,28264,30056,2008,Scotland,Croatia,1,1,Friendly,Glasgow,Scotland,False,2,0,Draw
26354,28265,30057,2008,Singapore,Lebanon,2,0,FIFA World Cup qualification,Singapore,Singapore,False,2,2,Singapore
26355,28266,30058,2008,Slovakia,Iceland,1,2,Friendly,Zlaté Moravce,Slovakia,False,3,-1,Iceland
26356,28267,30059,2008,South Africa,Paraguay,3,0,Friendly,Atteridgeville,South Africa,False,3,3,South Africa
26357,28268,30060,2008,Spain,Italy,1,0,Friendly,Elche,Spain,False,1,1,Spain
26358,28269,30061,2008,Saint Kitts and Nevis,Belize,1,1,FIFA World Cup qualification,Basseterre,Saint Kitts and Nevis,False,2,0,Draw
26359,28270,30062,2008,Saint Lucia,Turks and Caicos Islands,2,0,FIFA World Cup qualification,Vieux Fort,Saint Lucia,False,2,2,Saint Lucia
26360,28271,30063,2008,Sudan,Liberia,0,2,Friendly,Khartoum,Sudan,False,2,-2,Liberia
26361,28272,30064,2008,Switzerland,Germany,0,4,Friendly,Basel,Switzerland,False,4,-4,Germany
26362,28273,30065,2008,Syria,United Arab Emirates,1,1,FIFA World Cup qualification,Damascus,Syria,False,2,0,Draw
26363,28274,30066,2008,Thailand,Oman,0,1,FIFA World Cup qualification,Bangkok,Thailand,False,1,-1,Oman
26364,28275,30067,2008,Turkmenistan,Jordan,0,2,FIFA World Cup qualification,Ashgabat,Turkmenistan,False,2,-2,Jordan
26365,28276,30068,2008,Uganda,Libya,1,1,Friendly,Kampala,Uganda,False,2,0,Draw
26366,28277,30069,2008,Ukraine,Serbia,2,0,Friendly,Kyïv,Ukraine,False,2,2,Ukraine
26367,28278,30070,2008,Uzbekistan,Saudi Arabia,3,0,FIFA World Cup qualification,Tashkent,Uzbekistan,False,3,3,Uzbekistan
26368,28279,30071,2008,Venezuela,Bolivia,0,1,Friendly,Puerto la Cruz,Venezuela,False,1,-1,Bolivia
26369,28280,30072,2008,Nepal,Pakistan,0,2,Friendly,Pokhara,Nepal,False,2,-2,Pakistan
26370,28282,30074,2008,Cayman Islands,Bermuda,1,3,FIFA World Cup qualification,George Town,Cayman Islands,False,4,-2,Bermuda
26371,28283,30075,2008,Sri Lanka,Guam,5,1,AFC Challenge Cup qualification,Taipei,Chinese Taipei,True,6,4,Sri Lanka
26372,28284,30076,2008,Pakistan,Sri Lanka,1,7,AFC Challenge Cup qualification,Taipei,Chinese Taipei,True,8,-6,Sri Lanka
26373,28285,30078,2008,Yemen,Tanzania,2,1,Friendly,Sana'a,Yemen,False,3,1,Yemen
26374,28286,30079,2008,Pakistan,Guam,9,2,AFC Challenge Cup qualification,Taipei,Chinese Taipei,True,11,7,Pakistan
26375,28287,30081,2008,Lebanon,Maldives,4,0,AFC Asian Cup qualification,Beirut,Lebanon,False,4,4,Lebanon
26376,28290,30084,2008,Guatemala,Haiti,1,0,Friendly,Guatemala,Guatemala,False,1,1,Guatemala
26377,28291,30085,2008,Maldives,Lebanon,1,2,AFC Asian Cup qualification,Malé,Maldives,False,3,-1,Lebanon
26378,28292,30086,2008,Oman,Liberia,1,0,Friendly,Muscat,Oman,False,1,1,Oman
26379,28293,30087,2008,Indonesia,Yemen,1,0,Friendly,Bandung,Indonesia,False,1,1,Indonesia
26380,28294,30088,2008,Northern Mariana Islands,Guam,2,3,Friendly,Susupe,Northern Mariana Islands,False,5,-1,Guam
26381,28295,30089,2008,Oman,Kyrgyzstan,2,0,Friendly,Muscat,Oman,False,2,2,Oman
26382,28296,30090,2008,Trinidad and Tobago,Grenada,2,0,Friendly,Macoya,Trinidad and Tobago,False,2,2,Trinidad and Tobago
26383,28297,30091,2008,Colombia,Venezuela,5,2,Friendly,Bucaramanga,Colombia,False,7,3,Colombia
26384,28298,30092,2008,Liberia,Sierra Leone,3,1,Friendly,Paynesville,Liberia,False,4,2,Liberia
26385,28299,30093,2008,Oman,Yemen,0,0,Friendly,Muscat,Oman,False,0,0,Draw
26386,28300,30094,2008,Bangladesh,Afghanistan,0,0,AFC Challenge Cup qualification,Bishkek,Kyrgyzstan,True,0,0,Draw
26387,28301,30095,2008,Jersey,Guernsey,1,1,Friendly,St. Helier,Jersey,False,2,0,Draw
26388,28302,30096,2008,Kyrgyzstan,Afghanistan,0,1,AFC Challenge Cup qualification,Bishkek,Kyrgyzstan,False,1,-1,Afghanistan
26389,28303,30097,2008,Kyrgyzstan,Bangladesh,2,1,AFC Challenge Cup qualification,Bishkek,Kyrgyzstan,False,3,1,Kyrgyzstan
26390,28304,30098,2008,Syria,Oman,2,1,Friendly,Damascus,Syria,False,3,1,Syria
26391,28305,30099,2008,Trinidad and Tobago,Barbados,3,0,Friendly,Macoya,Trinidad and Tobago,False,3,3,Trinidad and Tobago
26392,28306,30100,2008,Philippines,Brunei,1,0,AFC Challenge Cup qualification,Iloilo City,Philippines,False,1,1,Philippines
26393,28307,30101,2008,Tajikistan,Bhutan,3,1,AFC Challenge Cup qualification,Barotac Nuevo,Philippines,True,4,2,Tajikistan
26394,28308,30102,2008,Bhutan,Brunei,1,1,AFC Challenge Cup qualification,Barotac Nuevo,Philippines,True,2,0,Draw
26395,28309,30103,2008,Philippines,Tajikistan,0,0,AFC Challenge Cup qualification,Iloilo City,Philippines,False,0,0,Draw
26396,28310,30104,2008,Philippines,Bhutan,3,0,AFC Challenge Cup qualification,Barotac Nuevo,Philippines,False,3,3,Philippines
26397,28311,30105,2008,Syria,Iraq,2,1,Friendly,Damascus,Syria,False,3,1,Syria
26398,28312,30106,2008,Tajikistan,Brunei,4,0,AFC Challenge Cup qualification,Iloilo City,Philippines,True,4,4,Tajikistan
26399,28313,30107,2008,Antigua and Barbuda,Saint Lucia,6,1,Friendly,St. John's,Antigua and Barbuda,False,7,5,Antigua and Barbuda
26400,28314,30108,2008,Oman,Turkmenistan,2,1,Friendly,Nizwa,Oman,False,3,1,Oman
26401,28315,30109,2008,Greece,Cyprus,2,0,Friendly,Patras,Greece,False,2,2,Greece
26402,28316,30110,2008,Thailand,Nepal,7,0,Friendly,Bangkok,Thailand,False,7,7,Thailand
26403,28317,30111,2008,Turkey,Slovakia,1,0,Friendly,Bielefeld,Germany,True,1,1,Turkey
26404,28318,30113,2008,Curaçao,Suriname,2,1,Friendly,Willemstad,Netherlands Antilles,False,3,1,Curaçao
26405,28319,30114,2008,Mozambique,Lesotho,2,3,Friendly,Maputo,Mozambique,False,5,-1,Lesotho
26406,28320,30115,2008,Ivory Coast,Paraguay,1,1,Kirin Cup,Yokohama,Japan,True,2,0,Draw
26407,28321,30116,2008,Libya,Zambia,2,2,Friendly,Tripoli,Libya,False,4,0,Draw
26408,28322,30117,2008,Yemen,Sudan,1,1,Friendly,Sana'a,Yemen,False,2,0,Draw
26409,28323,30118,2008,Australia,Ghana,1,0,Friendly,Sydney,Australia,False,1,1,Australia
26410,28324,30119,2008,Honduras,Belize,2,0,Friendly,San Pedro Sula,Honduras,False,2,2,Honduras
26411,28325,30120,2008,Qatar,Kuwait,1,1,Friendly,Doha,Qatar,False,2,0,Draw
26412,28326,30121,2008,Russia,Kazakhstan,6,0,Friendly,Moscow,Russia,False,6,6,Russia
26413,28327,30122,2008,Eswatini,Lesotho,1,1,Friendly,Lobamba,Eswatini,False,2,0,Draw
26414,28329,30124,2008,Croatia,Moldova,1,0,Friendly,Rijeka,Croatia,False,1,1,Croatia
26415,28330,30125,2008,Hungary,Greece,3,2,Friendly,Budapest,Hungary,False,5,1,Hungary
26416,28332,30127,2008,Republic of Ireland,Serbia,1,1,Friendly,Dublin,Republic of Ireland,False,2,0,Draw
26417,28333,30128,2008,Japan,Ivory Coast,1,0,Kirin Cup,Toyota,Japan,False,1,1,Japan
26418,28334,30129,2008,Nepal,Macau,3,2,AFC Challenge Cup qualification,Phnom Penh,Cambodia,True,5,1,Nepal
26419,28335,30130,2008,Netherlands,Ukraine,3,0,Friendly,Rotterdam,Netherlands,False,3,3,Netherlands
26420,28336,30131,2008,Saudi Arabia,Syria,1,0,Friendly,Riyadh,Saudi Arabia,False,1,1,Saudi Arabia
26421,28337,30132,2008,Switzerland,Slovakia,2,0,Friendly,Lugano,Switzerland,False,2,2,Switzerland
26422,28338,30135,2008,Iran,Zambia,3,2,Friendly,Teheran,Iran,False,5,1,Iran
26423,28339,30136,2008,Tanzania,Malawi,1,1,Friendly,Dar es Salaam,Tanzania,False,2,0,Draw
26424,28340,30137,2008,Thailand,Iraq,2,1,Friendly,Bangkok,Thailand,False,3,1,Thailand
26425,28341,30138,2008,Turkey,Uruguay,2,3,Friendly,Bochum,Germany,True,5,-1,Uruguay
26426,28342,30139,2008,Cambodia,Nepal,0,1,AFC Challenge Cup qualification,Phnom Penh,Cambodia,False,1,-1,Nepal
26427,28343,30141,2008,Sweden,Slovenia,1,0,Friendly,Gothenburg,Sweden,False,1,1,Sweden
26428,28344,30142,2008,Albania,Poland,0,1,Friendly,Reutlingen,Germany,True,1,-1,Poland
26429,28345,30143,2008,Austria,Nigeria,1,1,Friendly,Graz,Austria,False,2,0,Draw
26430,28346,30144,2008,Czech Republic,Lithuania,2,0,Friendly,Prague,Czech Republic,False,2,2,Czech Republic
26431,28347,30145,2008,Estonia,Georgia,1,1,Friendly,Tallinn,Estonia,False,2,0,Draw
26432,28348,30146,2008,France,Ecuador,2,0,Friendly,Grenoble,France,False,2,2,France
26433,28349,30147,2008,Germany,Belarus,2,2,Friendly,Kaiserslautern,Germany,False,4,0,Draw
26434,28351,30149,2008,Japan,Paraguay,0,0,Kirin Cup,Saitama,Japan,False,0,0,Draw
26435,28352,30150,2008,Libya,Liberia,4,2,Friendly,Tripoli,Libya,False,6,2,Libya
26436,28354,30152,2008,Montenegro,Kazakhstan,3,0,Friendly,Podgorica,Montenegro,False,3,3,Montenegro
26437,28355,30153,2008,Qatar,Lebanon,2,1,Friendly,Doha,Qatar,False,3,1,Qatar
26438,28356,30154,2008,Saudi Arabia,Kuwait,2,1,Friendly,Dammam,Saudi Arabia,False,3,1,Saudi Arabia
26439,28357,30155,2008,Cambodia,Macau,3,1,AFC Challenge Cup qualification,Phnom Penh,Cambodia,False,4,2,Cambodia
26440,28358,30156,2008,England,United States,2,0,Friendly,London,England,False,2,2,England
26441,28359,30157,2008,Iceland,Wales,0,1,Friendly,Reykjavík,Iceland,False,1,-1,Wales
26442,28360,30158,2008,Moldova,Armenia,2,2,Friendly,Tiraspol,Moldova,False,4,0,Draw
26443,28361,30159,2008,Norway,Uruguay,2,2,Friendly,Oslo,Norway,False,4,0,Draw
26444,28362,30160,2008,Russia,Serbia,2,1,Friendly,Burghausen,Germany,True,3,1,Russia
26445,28363,30161,2008,Singapore,Bahrain,0,1,Friendly,Singapore,Singapore,False,1,-1,Bahrain
26446,28364,30162,2008,Finland,Turkey,0,2,Friendly,Duisburg,Germany,True,2,-2,Turkey
26447,28365,30163,2008,Republic of Ireland,Colombia,1,0,Friendly,London,England,True,1,1,Republic of Ireland
26448,28366,30164,2008,Netherlands,Denmark,1,1,Friendly,Eindhoven,Netherlands,False,2,0,Draw
26449,28367,30165,2008,Austria,Malta,5,1,Friendly,Graz,Austria,False,6,4,Austria
26450,28368,30166,2008,Czech Republic,Scotland,3,1,Friendly,Prague,Czech Republic,False,4,2,Czech Republic
26451,28369,30167,2008,Guatemala,El Salvador,0,0,Friendly,Washington,United States,True,0,0,Draw
26452,28370,30168,2008,Italy,Belgium,3,1,Friendly,Florence,Italy,False,4,2,Italy
26453,28371,30169,2008,Latvia,Estonia,1,0,Baltic Cup,Riga,Latvia,False,1,1,Latvia
26454,28372,30170,2008,Switzerland,Liechtenstein,3,0,Friendly,St. Gallen,Switzerland,False,3,3,Switzerland
26455,28373,30171,2008,Venezuela,Honduras,1,1,Friendly,Fort Lauderdale,United States,True,2,0,Draw
26456,28374,30172,2008,Botswana,Madagascar,0,0,FIFA World Cup qualification,Gaborone,Botswana,False,0,0,Draw
26457,28375,30173,2008,Brazil,Canada,3,2,Friendly,Seattle,United States,True,5,1,Brazil
26458,28377,30175,2008,Estonia,Lithuania,0,1,Baltic Cup,Jūrmala,Latvia,True,1,-1,Lithuania
26459,28378,30176,2008,France,Paraguay,0,0,Friendly,Toulouse,France,False,0,0,Draw
26460,28379,30177,2008,Germany,Serbia,2,1,Friendly,Gelsenkirchen,Germany,False,3,1,Germany
26461,28380,30178,2008,Hungary,Croatia,1,1,Friendly,Budapest,Hungary,False,2,0,Draw
26462,28381,30180,2008,Malawi,Djibouti,8,1,FIFA World Cup qualification,Blantyre,Malawi,False,9,7,Malawi
26463,28382,30181,2008,Morocco,Ethiopia,3,0,FIFA World Cup qualification,Casablanca,Morocco,False,3,3,Morocco
26464,28383,30182,2008,Namibia,Kenya,2,1,FIFA World Cup qualification,Windhoek,Namibia,False,3,1,Namibia
26465,28384,30183,2008,Portugal,Georgia,2,0,Friendly,Viseu,Portugal,False,2,2,Portugal
26466,28385,30184,2008,Romania,Montenegro,4,0,Friendly,Bucharest,Romania,False,4,4,Romania
26467,28386,30185,2008,Rwanda,Mauritania,3,0,FIFA World Cup qualification,Kigali,Rwanda,False,3,3,Rwanda
26468,28387,30186,2008,Senegal,Algeria,1,0,FIFA World Cup qualification,Dakar,Senegal,False,1,1,Senegal
26469,28388,30187,2008,Spain,Peru,2,1,Friendly,Huelva,Spain,False,3,1,Spain
26470,28389,30188,2008,Tanzania,Mauritius,1,1,FIFA World Cup qualification,Dar es Salaam,Tanzania,False,2,0,Draw
26471,28390,30189,2008,Togo,Zambia,1,0,FIFA World Cup qualification,Accra,Ghana,True,1,1,Togo
26472,28391,30190,2008,Uganda,Niger,1,0,FIFA World Cup qualification,Kampala,Uganda,False,1,1,Uganda
26473,28392,30191,2008,Angola,Benin,3,0,FIFA World Cup qualification,Luanda,Angola,False,3,3,Angola
26474,28393,30192,2008,Armenia,Greece,0,0,Friendly,Offenbach am Main,Germany,True,0,0,Draw
26475,28394,30193,2008,Australia,Iraq,1,0,FIFA World Cup qualification,Brisbane,Australia,False,1,1,Australia
26476,28395,30194,2008,Bosnia and Herzegovina,Azerbaijan,1,0,Friendly,Zenica,Bosnia and Herzegovina,False,1,1,Bosnia and Herzegovina
26477,28396,30195,2008,Burundi,Seychelles,1,0,FIFA World Cup qualification,Bujumbura,Burundi,False,1,1,Burundi
26478,28397,30196,2008,Egypt,DR Congo,2,1,FIFA World Cup qualification,Cairo,Egypt,False,3,1,Egypt
26479,28398,30197,2008,Equatorial Guinea,Sierra Leone,2,0,FIFA World Cup qualification,Malabo,Equatorial Guinea,False,2,2,Equatorial Guinea
26480,28399,30198,2008,Ghana,Libya,3,0,FIFA World Cup qualification,Kumasi,Ghana,False,3,3,Ghana
26481,28400,30199,2008,Guatemala,Panama,0,1,Friendly,Fort Lauderdale,United States,True,1,-1,Panama
26482,28401,30200,2008,Guinea,Zimbabwe,0,0,FIFA World Cup qualification,Conakry,Guinea,False,0,0,Draw
26483,28402,30201,2008,Ivory Coast,Mozambique,1,0,FIFA World Cup qualification,Abidjan,Ivory Coast,False,1,1,Ivory Coast
26484,28403,30202,2008,Latvia,Lithuania,2,1,Baltic Cup,Riga,Latvia,False,3,1,Latvia
26485,28404,30203,2008,Liberia,Gambia,1,1,FIFA World Cup qualification,Paynesville,Liberia,False,2,0,Draw
26486,28405,30204,2008,Mali,Congo,4,2,FIFA World Cup qualification,Bamako,Mali,False,6,2,Mali
26487,28406,30205,2008,Netherlands,Wales,2,0,Friendly,Rotterdam,Netherlands,False,2,2,Netherlands
26488,28407,30206,2008,Nigeria,South Africa,2,0,FIFA World Cup qualification,Abuja,Nigeria,False,2,2,Nigeria
26489,28408,30207,2008,Poland,Denmark,1,1,Friendly,Chorzów,Poland,False,2,0,Draw
26490,28409,30208,2008,Sweden,Ukraine,0,1,Friendly,Solna,Sweden,False,1,-1,Ukraine
26491,28410,30209,2008,Trinidad and Tobago,England,0,3,Friendly,Port of Spain,Trinidad and Tobago,False,3,-3,England
26492,28411,30210,2008,Tunisia,Burkina Faso,1,2,FIFA World Cup qualification,Radès,Tunisia,False,3,-1,Burkina Faso
26493,28412,30211,2008,Finland,Belarus,1,1,Friendly,Turku,Finland,False,2,0,Draw
26494,28413,30212,2008,Iran,United Arab Emirates,0,0,FIFA World Cup qualification,Teheran,Iran,False,0,0,Draw
26495,28414,30213,2008,Japan,Oman,3,0,FIFA World Cup qualification,Yokohama,Japan,False,3,3,Japan
26496,28416,30215,2008,Saudi Arabia,Lebanon,4,1,FIFA World Cup qualification,Riyadh,Saudi Arabia,False,5,3,Saudi Arabia
26497,28417,30216,2008,Singapore,Uzbekistan,3,7,FIFA World Cup qualification,Singapore,Singapore,False,10,-4,Uzbekistan
26498,28418,30217,2008,Syria,Kuwait,1,0,FIFA World Cup qualification,Damascus,Syria,False,1,1,Syria
26499,28419,30218,2008,Thailand,Bahrain,2,3,FIFA World Cup qualification,Bangkok,Thailand,False,5,-1,Bahrain
26500,28421,30220,2008,France,Colombia,1,0,Friendly,Saint-Denis,France,False,1,1,France
26501,28422,30221,2008,India,Nepal,4,0,SAFF Cup,Malé,Maldives,True,4,4,India
26502,28423,30222,2008,Maldives,Pakistan,3,0,SAFF Cup,Malé,Maldives,False,3,3,Maldives
26503,28424,30223,2008,Andorra,Azerbaijan,1,2,Friendly,Sant Julià de Lòria,Andorra,False,3,-1,Azerbaijan
26504,28425,30224,2008,Bangladesh,Bhutan,1,1,SAFF Cup,Colombo,Sri Lanka,True,2,0,Draw
26505,28426,30225,2008,Chile,Guatemala,2,0,Friendly,Rancagua,Chile,False,2,2,Chile
26506,28427,30226,2008,Estonia,Faroe Islands,4,3,Friendly,Tallinn,Estonia,False,7,1,Estonia
26507,28428,30227,2008,Honduras,Puerto Rico,4,0,FIFA World Cup qualification,San Pedro Sula,Honduras,False,4,4,Honduras
26508,28429,30228,2008,Lithuania,Russia,1,4,Friendly,Burghausen,Germany,True,5,-3,Russia
26509,28430,30229,2008,Mexico,Argentina,1,4,Friendly,San Diego,United States,True,5,-3,Argentina
26510,28431,30230,2008,Panama,Canada,2,2,Friendly,Fort Lauderdale,United States,True,4,0,Draw
26511,28432,30231,2008,Spain,United States,1,0,Friendly,Santander,Spain,False,1,1,Spain
26512,28433,30232,2008,Sri Lanka,Afghanistan,2,2,SAFF Cup,Colombo,Sri Lanka,False,4,0,Draw
26513,28434,30233,2008,India,Pakistan,2,1,SAFF Cup,Malé,Maldives,True,3,1,India
26514,28435,30234,2008,Maldives,Nepal,4,1,SAFF Cup,Malé,Maldives,False,5,3,Maldives
26515,28436,30235,2008,Algeria,Liberia,3,0,FIFA World Cup qualification,Blida,Algeria,False,3,3,Algeria
26516,28437,30236,2008,Bangladesh,Afghanistan,2,2,SAFF Cup,Colombo,Sri Lanka,True,4,0,Draw
26517,28438,30237,2008,Bermuda,Barbados,2,1,Friendly,Hamilton,Bermuda,False,3,1,Bermuda
26518,28439,30238,2008,Brazil,Venezuela,0,2,Friendly,Foxborough,United States,True,2,-2,Venezuela
26519,28440,30239,2008,Indonesia,Malaysia,1,1,Friendly,Jakarta,Indonesia,False,2,0,Draw
26520,28441,30240,2008,Sri Lanka,Bhutan,2,0,SAFF Cup,Colombo,Sri Lanka,False,2,2,Sri Lanka
26521,28442,30241,2008,Bahrain,Thailand,1,1,FIFA World Cup qualification,Riffa,Bahrain,False,2,0,Draw
26522,28443,30242,2008,Burkina Faso,Burundi,2,0,FIFA World Cup qualification,Ouagadougou,Burkina Faso,False,2,2,Burkina Faso
26523,28444,30244,2008,Chad,Mali,1,2,FIFA World Cup qualification,N'Djamena,Chad,False,3,-1,Mali
26524,28445,30245,2008,Chile,Panama,0,0,Friendly,Valparaíso,Chile,False,0,0,Draw
26525,28446,30247,2008,Cuba,Saint Vincent and the Grenadines,1,0,Friendly,Havana,Cuba,False,1,1,Cuba
26526,28447,30248,2008,Honduras,Haiti,3,1,Friendly,La Ceiba,Honduras,False,4,2,Honduras
26527,28448,30249,2008,Iraq,Australia,1,0,FIFA World Cup qualification,Dubai,United Arab Emirates,True,1,1,Iraq
26528,28450,30251,2008,Kenya,Guinea,2,0,FIFA World Cup qualification,Nairobi,Kenya,False,2,2,Kenya
26529,28451,30253,2008,Libya,Gabon,1,0,FIFA World Cup qualification,Tripoli,Libya,False,1,1,Libya
26530,28452,30254,2008,Maldives,India,0,1,SAFF Cup,Malé,Maldives,False,1,-1,India
26531,28453,30255,2008,Mauritania,Morocco,1,4,FIFA World Cup qualification,Nouakchott,Mauritania,False,5,-3,Morocco
26532,28454,30256,2008,Oman,Japan,1,1,FIFA World Cup qualification,Muscat,Oman,False,2,0,Draw
26533,28455,30257,2008,Pakistan,Nepal,1,4,SAFF Cup,Malé,Maldives,True,5,-3,Nepal
26534,28456,30258,2008,Portugal,Turkey,2,0,UEFA Euro,Geneva,Switzerland,True,2,2,Portugal
26535,28457,30259,2008,Saudi Arabia,Lebanon,2,1,FIFA World Cup qualification,Riyadh,Saudi Arabia,False,3,1,Saudi Arabia
26536,28458,30260,2008,Seychelles,Tunisia,0,2,FIFA World Cup qualification,Victoria,Seychelles,False,2,-2,Tunisia
26537,28459,30261,2008,Sierra Leone,Nigeria,0,1,FIFA World Cup qualification,Freetown,Sierra Leone,False,1,-1,Nigeria
26538,28460,30262,2008,Switzerland,Czech Republic,0,1,UEFA Euro,Basel,Switzerland,False,1,-1,Czech Republic
26539,28461,30263,2008,Trinidad and Tobago,Jamaica,1,1,Friendly,Macoya,Trinidad and Tobago,False,2,0,Draw
26540,28462,30264,2008,United Arab Emirates,Iran,0,1,FIFA World Cup qualification,Al Ain,United Arab Emirates,False,1,-1,Iran
26541,28463,30265,2008,Uzbekistan,Singapore,3,0,FIFA World Cup qualification,Tashkent,Uzbekistan,False,3,3,Uzbekistan
26542,28464,30266,2008,Afghanistan,Bhutan,1,3,SAFF Cup,Colombo,Sri Lanka,True,4,-2,Bhutan
26543,28465,30267,2008,Antigua and Barbuda,Saint Kitts and Nevis,2,0,Friendly,St. John's,Antigua and Barbuda,False,2,2,Antigua and Barbuda
26544,28466,30268,2008,Austria,Croatia,0,1,UEFA Euro,Vienna,Austria,False,1,-1,Croatia
26545,28467,30269,2008,Benin,Uganda,4,1,FIFA World Cup qualification,Cotonou,Benin,False,5,3,Benin
26546,28468,30270,2008,Congo,Sudan,1,0,FIFA World Cup qualification,Brazzaville,Congo,False,1,1,Congo
26547,28469,30271,2008,DR Congo,Malawi,1,0,FIFA World Cup qualification,Kinshasa,DR Congo,False,1,1,DR Congo
26548,28470,30272,2008,Ethiopia,Rwanda,1,2,FIFA World Cup qualification,Addis Abeba,Ethiopia,False,3,-1,Rwanda
26549,28471,30273,2008,Gambia,Senegal,0,0,FIFA World Cup qualification,Bakau,Gambia,False,0,0,Draw
26550,28472,30274,2008,Germany,Poland,2,0,UEFA Euro,Klagenfurt,Austria,True,2,2,Germany
26551,28473,30275,2008,Kuwait,Syria,4,2,FIFA World Cup qualification,Kuwait City,Kuwait,False,6,2,Kuwait
26552,28474,30276,2008,Lesotho,Ghana,2,3,FIFA World Cup qualification,Bloemfontein,South Africa,True,5,-1,Ghana
26553,28475,30277,2008,Madagascar,Ivory Coast,0,0,FIFA World Cup qualification,Antananarivo,Madagascar,False,0,0,Draw
26554,28476,30278,2008,Mauritius,Cameroon,0,3,FIFA World Cup qualification,Curepipe,Mauritius,False,3,-3,Cameroon
26555,28477,30279,2008,Mexico,Peru,4,0,Friendly,Chicago,United States,True,4,4,Mexico
26556,28478,30280,2008,Mozambique,Botswana,1,2,FIFA World Cup qualification,Maputo,Mozambique,False,3,-1,Botswana
26557,28479,30281,2008,Niger,Angola,1,2,FIFA World Cup qualification,Niamey,Niger,False,3,-1,Angola
26558,28480,30282,2008,Sri Lanka,Bangladesh,1,0,SAFF Cup,Colombo,Sri Lanka,False,1,1,Sri Lanka
26559,28481,30283,2008,Eswatini,Togo,2,1,FIFA World Cup qualification,Lobamba,Eswatini,False,3,1,Eswatini
26560,28482,30284,2008,United States,Argentina,0,0,Friendly,East Rutherford,United States,False,0,0,Draw
26561,28483,30285,2008,Zimbabwe,Namibia,2,0,FIFA World Cup qualification,Harare,Zimbabwe,False,2,2,Zimbabwe
26562,28484,30286,2008,Bermuda,Barbados,3,0,Friendly,Hamilton,Bermuda,False,3,3,Bermuda
26563,28485,30287,2008,Curaçao,Venezuela,0,1,Friendly,Willemstad,Netherlands Antilles,False,1,-1,Venezuela
26564,28486,30288,2008,Netherlands,Italy,3,0,UEFA Euro,Berne,Switzerland,True,3,3,Netherlands
26565,28487,30289,2008,Romania,France,0,0,UEFA Euro,Zürich,Switzerland,True,0,0,Draw
26566,28488,30290,2008,Greece,Sweden,0,2,UEFA Euro,Salzburg,Austria,True,2,-2,Sweden
26567,28489,30291,2008,Grenada,Jamaica,2,1,Friendly,St. George's,Grenada,False,3,1,Grenada
26568,28490,30292,2008,Spain,Russia,4,1,UEFA Euro,Innsbruck,Austria,True,5,3,Spain
26569,28491,30293,2008,Czech Republic,Portugal,1,3,UEFA Euro,Geneva,Switzerland,True,4,-2,Portugal
26570,28492,30294,2008,India,Bhutan,2,1,SAFF Cup,Malé,Maldives,True,3,1,India
26571,28493,30295,2008,Indonesia,Vietnam,1,0,Friendly,Surabaya,Indonesia,False,1,1,Indonesia
26572,28494,30296,2008,Sri Lanka,Maldives,0,1,SAFF Cup,Colombo,Sri Lanka,False,1,-1,Maldives
26573,28495,30297,2008,Switzerland,Turkey,1,2,UEFA Euro,Basel,Switzerland,False,3,-1,Turkey
26574,28496,30298,2008,Austria,Poland,1,1,UEFA Euro,Vienna,Austria,False,2,0,Draw
26575,28497,30299,2008,Croatia,Germany,2,1,UEFA Euro,Klagenfurt,Austria,True,3,1,Croatia
26576,28498,30300,2008,Djibouti,DR Congo,0,6,FIFA World Cup qualification,Djibouti,Djibouti,False,6,-6,DR Congo
26577,28499,30301,2008,Italy,Romania,1,1,UEFA Euro,Zürich,Switzerland,True,2,0,Draw
26578,28500,30302,2008,Mauritania,Ethiopia,0,1,FIFA World Cup qualification,Nouakchott,Mauritania,False,1,-1,Ethiopia
26579,28501,30303,2008,Netherlands,France,4,1,UEFA Euro,Berne,Switzerland,True,5,3,Netherlands
26580,28502,30304,2008,Bahrain,Oman,1,1,FIFA World Cup qualification,Riffa,Bahrain,False,2,0,Draw
26581,28503,30305,2008,Botswana,Ivory Coast,1,1,FIFA World Cup qualification,Gaborone,Botswana,False,2,0,Draw
26582,28504,30306,2008,Chad,Congo,2,1,FIFA World Cup qualification,N'Djamena,Chad,False,3,1,Chad
26583,28505,30308,2008,Gabon,Ghana,2,0,FIFA World Cup qualification,Libreville,Gabon,False,2,2,Gabon
26584,28506,30309,2008,Gambia,Algeria,1,0,FIFA World Cup qualification,Bakau,Gambia,False,1,1,Gambia
26585,28507,30310,2008,Greece,Russia,0,1,UEFA Euro,Salzburg,Austria,True,1,-1,Russia
26586,28508,30311,2008,Grenada,Costa Rica,2,2,FIFA World Cup qualification,St. George's,Grenada,False,4,0,Draw
26587,28509,30312,2008,Guatemala,Saint Lucia,6,0,FIFA World Cup qualification,Guatemala,Guatemala,False,6,6,Guatemala
26588,28510,30313,2008,India,Maldives,0,1,SAFF Cup,Colombo,Sri Lanka,True,1,-1,Maldives
26589,28511,30314,2008,Kenya,Zimbabwe,2,0,FIFA World Cup qualification,Nairobi,Kenya,False,2,2,Kenya
26590,28512,30316,2008,Kuwait,United Arab Emirates,2,3,FIFA World Cup qualification,Kuwait City,Kuwait,False,5,-1,United Arab Emirates
26591,28513,30317,2008,Malawi,Egypt,1,0,FIFA World Cup qualification,Blantyre,Malawi,False,1,1,Malawi
26592,28514,30318,2008,Namibia,Guinea,1,2,FIFA World Cup qualification,Windhoek,Namibia,False,3,-1,Guinea
26593,28515,30319,2008,Niger,Benin,0,2,FIFA World Cup qualification,Niamey,Niger,False,2,-2,Benin
26594,28516,30320,2008,Peru,Colombia,1,1,FIFA World Cup qualification,Lima,Peru,False,2,0,Draw
26595,28517,30321,2008,Puerto Rico,Honduras,2,2,FIFA World Cup qualification,Bayamón,Puerto Rico,False,4,0,Draw
26596,28518,30322,2008,Qatar,Australia,1,3,FIFA World Cup qualification,Doha,Qatar,False,4,-2,Australia
26597,28519,30323,2008,Rwanda,Morocco,3,1,FIFA World Cup qualification,Kigali,Rwanda,False,4,2,Rwanda
26598,28520,30324,2008,Seychelles,Burkina Faso,2,3,FIFA World Cup qualification,Victoria,Seychelles,False,5,-1,Burkina Faso
26599,28521,30325,2008,Sierra Leone,South Africa,1,0,FIFA World Cup qualification,Freetown,Sierra Leone,False,1,1,Sierra Leone
26600,28522,30326,2008,Singapore,Saudi Arabia,0,3,FIFA World Cup qualification,Singapore,Singapore,False,3,-3,Saudi Arabia
26601,28523,30327,2008,Sudan,Mali,3,2,FIFA World Cup qualification,Khartoum,Sudan,False,5,1,Sudan
26602,28524,30328,2008,Suriname,Guyana,1,0,FIFA World Cup qualification,Paramaribo,Suriname,False,1,1,Suriname
26603,28525,30329,2008,Sweden,Spain,1,2,UEFA Euro,Innsbruck,Austria,True,3,-1,Spain
26604,28526,30330,2008,Syria,Iran,0,2,FIFA World Cup qualification,Damascus,Syria,False,2,-2,Iran
26605,28527,30331,2008,Tanzania,Cameroon,0,0,FIFA World Cup qualification,Dar es Salaam,Tanzania,False,0,0,Draw
26606,28528,30332,2008,Thailand,Japan,0,3,FIFA World Cup qualification,Bangkok,Thailand,False,3,-3,Japan
26607,28530,30334,2008,Uganda,Angola,3,1,FIFA World Cup qualification,Kampala,Uganda,False,4,2,Uganda
26608,28531,30335,2008,Uruguay,Venezuela,1,1,FIFA World Cup qualification,Montevideo,Uruguay,False,2,0,Draw
26609,28532,30336,2008,Uzbekistan,Lebanon,3,0,FIFA World Cup qualification,Tashkent,Uzbekistan,False,3,3,Uzbekistan
26610,28533,30337,2008,Vanuatu,New Caledonia,1,1,FIFA World Cup qualification,Port Vila,Vanuatu,False,2,0,Draw
26611,28534,30338,2008,Argentina,Ecuador,1,1,FIFA World Cup qualification,Buenos Aires,Argentina,False,2,0,Draw
26612,28535,30339,2008,Belize,Mexico,0,2,FIFA World Cup qualification,Houston,United States,True,2,-2,Mexico
26613,28536,30340,2008,Bolivia,Chile,0,2,FIFA World Cup qualification,La Paz,Bolivia,False,2,-2,Chile
26614,28537,30341,2008,Burundi,Tunisia,0,1,FIFA World Cup qualification,Bujumbura,Burundi,False,1,-1,Tunisia
26615,28538,30342,2008,Equatorial Guinea,Nigeria,0,1,FIFA World Cup qualification,Malabo,Equatorial Guinea,False,1,-1,Nigeria
26616,28539,30343,2008,Haiti,Curaçao,0,0,FIFA World Cup qualification,Port-au-Prince,Haiti,False,0,0,Draw
26617,28540,30344,2008,Jamaica,Bahamas,7,0,FIFA World Cup qualification,Kingston,Jamaica,False,7,7,Jamaica
26618,28541,30345,2008,Lesotho,Libya,0,1,FIFA World Cup qualification,Bloemfontein,South Africa,True,1,-1,Libya
26619,28542,30346,2008,Liberia,Senegal,2,2,FIFA World Cup qualification,Paynesville,Liberia,False,4,0,Draw
26620,28543,30347,2008,Macau,Hong Kong,0,1,Friendly,Macau,Macau,False,1,-1,Hong Kong
26621,28544,30348,2008,Madagascar,Mozambique,1,1,FIFA World Cup qualification,Antananarivo,Madagascar,False,2,0,Draw
26622,28546,30350,2008,Panama,El Salvador,1,0,FIFA World Cup qualification,Panama City,Panama,False,1,1,Panama
26623,28547,30351,2008,Paraguay,Brazil,2,0,FIFA World Cup qualification,Asunción,Paraguay,False,2,2,Paraguay
26624,28548,30352,2008,Eswatini,Zambia,0,0,FIFA World Cup qualification,Lobamba,Eswatini,False,0,0,Draw
26625,28549,30353,2008,Switzerland,Portugal,2,0,UEFA Euro,Basel,Switzerland,False,2,2,Switzerland
26626,28550,30354,2008,Trinidad and Tobago,Bermuda,1,2,FIFA World Cup qualification,Macoya,Trinidad and Tobago,False,3,-1,Bermuda
26627,28551,30355,2008,Turkey,Czech Republic,3,2,UEFA Euro,Geneva,Switzerland,True,5,1,Turkey
26628,28552,30356,2008,United States,Barbados,8,0,FIFA World Cup qualification,Carson,United States,False,8,8,United States
26629,28553,30357,2008,Austria,Germany,0,1,UEFA Euro,Vienna,Austria,False,1,-1,Germany
26630,28554,30358,2008,Poland,Croatia,0,1,UEFA Euro,Klagenfurt,Austria,True,1,-1,Croatia
26631,28555,30359,2008,Antigua and Barbuda,Cuba,3,4,FIFA World Cup qualification,St. John's,Antigua and Barbuda,False,7,-1,Cuba
26632,28556,30360,2008,France,Italy,0,2,UEFA Euro,Zürich,Switzerland,True,2,-2,Italy
26633,28557,30361,2008,Netherlands,Romania,2,0,UEFA Euro,Berne,Switzerland,True,2,2,Netherlands
26634,28558,30362,2008,Uruguay,Peru,6,0,FIFA World Cup qualification,Montevideo,Uruguay,False,6,6,Uruguay
26635,28559,30363,2008,Bolivia,Paraguay,4,2,FIFA World Cup qualification,La Paz,Bolivia,False,6,2,Bolivia
26636,28560,30364,2008,Ecuador,Colombia,0,0,FIFA World Cup qualification,Quito,Ecuador,False,0,0,Draw
26637,28561,30365,2008,Greece,Spain,1,2,UEFA Euro,Salzburg,Austria,True,3,-1,Spain
26638,28562,30366,2008,Jamaica,Bahamas,6,0,FIFA World Cup qualification,Falmouth,Jamaica,False,6,6,Jamaica
26639,28563,30367,2008,Russia,Sweden,2,0,UEFA Euro,Innsbruck,Austria,True,2,2,Russia
26640,28564,30368,2008,Portugal,Germany,2,3,UEFA Euro,Basel,Switzerland,True,5,-1,Germany
26641,28565,30369,2008,Venezuela,Chile,2,3,FIFA World Cup qualification,Puerto la Cruz,Venezuela,False,5,-1,Chile
26642,28566,30370,2008,Algeria,Gambia,1,0,FIFA World Cup qualification,Blida,Algeria,False,1,1,Algeria
26643,28567,30371,2008,Canada,Saint Vincent and the Grenadines,4,1,FIFA World Cup qualification,Montréal,Canada,False,5,3,Canada
26644,28568,30372,2008,Croatia,Turkey,1,1,UEFA Euro,Vienna,Austria,True,2,0,Draw
26645,28569,30373,2008,Libya,Lesotho,4,0,FIFA World Cup qualification,Tripoli,Libya,False,4,4,Libya
26646,28570,30374,2008,Burkina Faso,Seychelles,4,1,FIFA World Cup qualification,Ouagadougou,Burkina Faso,False,5,3,Burkina Faso
26647,28571,30375,2008,Cameroon,Tanzania,2,1,FIFA World Cup qualification,Yaoundé,Cameroon,False,3,1,Cameroon
26648,28572,30376,2008,Costa Rica,Grenada,3,0,FIFA World Cup qualification,San José,Costa Rica,False,3,3,Costa Rica
26649,28573,30377,2008,Mexico,Belize,7,0,FIFA World Cup qualification,Monterrey,Mexico,False,7,7,Mexico
26650,28574,30378,2008,Morocco,Rwanda,2,0,FIFA World Cup qualification,Casablanca,Morocco,False,2,2,Morocco
26651,28575,30379,2008,Netherlands,Russia,1,3,UEFA Euro,Basel,Switzerland,True,4,-2,Russia
26652,28576,30380,2008,New Caledonia,Vanuatu,3,0,FIFA World Cup qualification,Nouméa,New Caledonia,False,3,3,New Caledonia
26653,28577,30381,2008,Nigeria,Equatorial Guinea,2,0,FIFA World Cup qualification,Abuja,Nigeria,False,2,2,Nigeria
26654,28578,30382,2008,Senegal,Liberia,3,1,FIFA World Cup qualification,Dakar,Senegal,False,4,2,Senegal
26655,28579,30383,2008,South Africa,Sierra Leone,0,0,FIFA World Cup qualification,Atteridgeville,South Africa,False,0,0,Draw
26656,28580,30384,2008,Saint Lucia,Guatemala,1,3,FIFA World Cup qualification,Los Angeles,United States,True,4,-2,Guatemala
26657,28581,30385,2008,Tunisia,Burundi,2,1,FIFA World Cup qualification,Radès,Tunisia,False,3,1,Tunisia
26658,28582,30386,2008,Zambia,Eswatini,1,0,FIFA World Cup qualification,Chililabombwe,Zambia,False,1,1,Zambia
26659,28584,30388,2008,Barbados,United States,0,1,FIFA World Cup qualification,Bridgetown,Barbados,False,1,-1,United States
26660,28585,30389,2008,Benin,Niger,2,0,FIFA World Cup qualification,Cotonou,Benin,False,2,2,Benin
26661,28586,30390,2008,Bermuda,Trinidad and Tobago,0,2,FIFA World Cup qualification,Hamilton,Bermuda,False,2,-2,Trinidad and Tobago
26662,28587,30392,2008,Congo,Chad,2,0,FIFA World Cup qualification,Brazzaville,Congo,False,2,2,Congo
26663,28588,30393,2008,DR Congo,Djibouti,5,1,FIFA World Cup qualification,Kinshasa,DR Congo,False,6,4,DR Congo
26664,28589,30394,2008,Cuba,Antigua and Barbuda,4,0,FIFA World Cup qualification,Havana,Cuba,False,4,4,Cuba
26665,28590,30395,2008,Curaçao,Haiti,0,1,FIFA World Cup qualification,Willemstad,Netherlands Antilles,True,1,-1,Haiti
26666,28591,30396,2008,Egypt,Malawi,2,0,FIFA World Cup qualification,Cairo,Egypt,False,2,2,Egypt
26667,28592,30397,2008,El Salvador,Panama,3,1,FIFA World Cup qualification,San Salvador,El Salvador,False,4,2,El Salvador
26668,28593,30398,2008,Ethiopia,Mauritania,6,1,FIFA World Cup qualification,Addis Abeba,Ethiopia,False,7,5,Ethiopia
26669,28594,30399,2008,Ghana,Gabon,2,0,FIFA World Cup qualification,Accra,Ghana,False,2,2,Ghana
26670,28595,30400,2008,Guinea,Namibia,4,0,FIFA World Cup qualification,Conakry,Guinea,False,4,4,Guinea
26671,28596,30401,2008,Guyana,Suriname,1,2,FIFA World Cup qualification,Providence,Guyana,False,3,-1,Suriname
26672,28597,30402,2008,Iran,Kuwait,2,0,FIFA World Cup qualification,Teheran,Iran,False,2,2,Iran
26673,28598,30403,2008,Iraq,Qatar,0,1,FIFA World Cup qualification,Dubai,United Arab Emirates,True,1,-1,Qatar
26674,28599,30404,2008,Ivory Coast,Botswana,4,0,FIFA World Cup qualification,Abidjan,Ivory Coast,False,4,4,Ivory Coast
26675,28600,30405,2008,Japan,Bahrain,1,0,FIFA World Cup qualification,Saitama,Japan,False,1,1,Japan
26676,28601,30406,2008,Jordan,Turkmenistan,2,0,FIFA World Cup qualification,Amman,Jordan,False,2,2,Jordan
26677,28602,30408,2008,Lebanon,Singapore,1,2,FIFA World Cup qualification,Beirut,Lebanon,False,3,-1,Singapore
26678,28603,30409,2008,Mali,Sudan,3,0,FIFA World Cup qualification,Bamako,Mali,False,3,3,Mali
26679,28604,30410,2008,Mozambique,Madagascar,3,0,FIFA World Cup qualification,Maputo,Mozambique,False,3,3,Mozambique
26680,28605,30411,2008,Oman,Thailand,2,1,FIFA World Cup qualification,Muscat,Oman,False,3,1,Oman
26681,28606,30412,2008,Saudi Arabia,Uzbekistan,4,0,FIFA World Cup qualification,Riyadh,Saudi Arabia,False,4,4,Saudi Arabia
26682,28607,30413,2008,Spain,Italy,0,0,UEFA Euro,Vienna,Austria,True,0,0,Draw
26683,28608,30414,2008,United Arab Emirates,Syria,1,3,FIFA World Cup qualification,Al Ain,United Arab Emirates,False,4,-2,Syria
26684,28609,30415,2008,Zimbabwe,Kenya,0,0,FIFA World Cup qualification,Harare,Zimbabwe,False,0,0,Draw
26685,28610,30416,2008,Angola,Uganda,0,0,FIFA World Cup qualification,Luanda,Angola,False,0,0,Draw
26686,28611,30417,2008,Germany,Turkey,3,2,UEFA Euro,Basel,Switzerland,True,5,1,Germany
26687,28612,30418,2008,Russia,Spain,0,3,UEFA Euro,Vienna,Austria,True,3,-3,Spain
26688,28613,30419,2008,Gabon,Lesotho,2,0,FIFA World Cup qualification,Libreville,Gabon,False,2,2,Gabon
26689,28614,30420,2008,Germany,Spain,0,1,UEFA Euro,Vienna,Austria,True,1,-1,Spain
26690,28615,30421,2008,Solomon Islands,Vanuatu,1,2,Friendly,Honiara,Solomon Islands,False,3,-1,Vanuatu
26691,28616,30423,2008,Trinidad and Tobago,Guyana,2,0,Friendly,Macoya,Trinidad and Tobago,False,2,2,Trinidad and Tobago
26692,28617,30435,2008,Trinidad and Tobago,Curaçao,2,0,Friendly,Macoya,Trinidad and Tobago,False,2,2,Trinidad and Tobago
26693,28618,30436,2008,Madagascar,Eswatini,1,1,COSAFA Cup,Witbank,South Africa,True,2,0,Draw
26694,28619,30437,2008,Mauritius,Seychelles,0,7,COSAFA Cup,Witbank,South Africa,True,7,-7,Seychelles
26695,28620,30438,2008,Comoros,Namibia,0,3,COSAFA Cup,Secunda,South Africa,True,3,-3,Namibia
26696,28621,30439,2008,El Salvador,Guatemala,0,0,Friendly,Los Angeles,United States,True,0,0,Draw
26697,28622,30440,2008,Lesotho,Malawi,0,1,COSAFA Cup,Secunda,South Africa,True,1,-1,Malawi
26698,28623,30441,2008,Madagascar,Seychelles,1,1,COSAFA Cup,Witbank,South Africa,True,2,0,Draw
26699,28624,30442,2008,Mauritius,Eswatini,1,1,COSAFA Cup,Witbank,South Africa,True,2,0,Draw
26700,28625,30443,2008,Comoros,Malawi,0,1,COSAFA Cup,Secunda,South Africa,True,1,-1,Malawi
26701,28626,30444,2008,India,Malaysia,1,1,Friendly,Hyderabad,India,False,2,0,Draw
26702,28627,30445,2008,Lesotho,Namibia,1,1,COSAFA Cup,Secunda,South Africa,True,2,0,Draw
26703,28628,30446,2008,Madagascar,Mauritius,2,1,COSAFA Cup,Witbank,South Africa,True,3,1,Madagascar
26704,28629,30447,2008,Seychelles,Eswatini,0,1,COSAFA Cup,Witbank,South Africa,True,1,-1,Eswatini
26705,28630,30448,2008,Comoros,Lesotho,0,1,COSAFA Cup,Secunda,South Africa,True,1,-1,Lesotho
26706,28631,30449,2008,Malawi,Namibia,0,1,COSAFA Cup,Secunda,South Africa,True,1,-1,Namibia
26707,28632,30450,2008,El Salvador,Jamaica,0,0,Friendly,Frisco,United States,True,0,0,Draw
26708,28633,30451,2008,Botswana,Mozambique,0,2,COSAFA Cup,Secunda,South Africa,True,2,-2,Mozambique
26709,28634,30452,2008,Curaçao,Aruba,0,0,CFU Caribbean Cup qualification,Willemstad,Netherlands Antilles,True,0,0,Draw
26710,28635,30453,2008,Zambia,Zimbabwe,0,0,COSAFA Cup,Secunda,South Africa,True,0,0,Draw
26711,28636,30454,2008,Grenada,Aruba,3,1,CFU Caribbean Cup qualification,Willemstad,Netherlands Antilles,True,4,2,Grenada
26712,28637,30455,2008,India,Afghanistan,1,0,AFC Challenge Cup,Hyderabad,India,False,1,1,India
26713,28638,30456,2008,Madagascar,Mozambique,1,2,COSAFA Cup,Bushbuckridge,South Africa,True,3,-1,Mozambique
26714,28639,30457,2008,Trinidad and Tobago,Haiti,2,0,Friendly,Macoya,Trinidad and Tobago,False,2,2,Trinidad and Tobago
26715,28640,30458,2008,Turkmenistan,Tajikistan,0,0,AFC Challenge Cup,Hyderabad,India,True,0,0,Draw
26716,28641,30459,2008,Burma,Nepal,3,0,AFC Challenge Cup,Hyderabad,India,True,3,3,Burma
26717,28642,30460,2008,Curaçao,Grenada,2,0,CFU Caribbean Cup qualification,Willemstad,Netherlands Antilles,True,2,2,Curaçao
26718,28643,30462,2008,Afghanistan,Turkmenistan,0,5,AFC Challenge Cup,Hyderabad,India,True,5,-5,Turkmenistan
26719,28644,30463,2008,India,Tajikistan,1,1,AFC Challenge Cup,Hyderabad,India,False,2,0,Draw
26720,28646,30465,2008,Sri Lanka,Burma,1,3,AFC Challenge Cup,Hyderabad,India,True,4,-2,Burma
26721,28647,30466,2008,Afghanistan,Tajikistan,0,4,AFC Challenge Cup,Hyderabad,India,True,4,-4,Tajikistan
26722,28648,30467,2008,India,Turkmenistan,2,1,AFC Challenge Cup,Hyderabad,India,False,3,1,India
26723,28649,30468,2008,Madagascar,Zambia,0,2,COSAFA Cup,Bushbuckridge,South Africa,True,2,-2,Zambia
26724,28650,30470,2008,Nepal,Sri Lanka,3,0,AFC Challenge Cup,Hyderabad,India,True,3,3,Nepal
26725,28651,30471,2008,Guatemala,Bolivia,3,0,Friendly,Washington,United States,True,3,3,Guatemala
26726,28652,30472,2008,India,Burma,1,0,AFC Challenge Cup,Hyderabad,India,False,1,1,India
26727,28653,30473,2008,Iran,Palestine,3,0,WAFF Championship,Teheran,Iran,False,3,3,Iran
26728,28654,30475,2008,Syria,Jordan,0,0,WAFF Championship,Teheran,Iran,True,0,0,Draw
26729,28655,30476,2008,Guyana,Dominica,3,0,CFU Caribbean Cup qualification,Providence,Guyana,False,3,3,Guyana
26730,28656,30477,2008,Dominica,Suriname,1,3,CFU Caribbean Cup qualification,Blairmont,Guyana,True,4,-2,Suriname
26731,28657,30478,2008,Oman,Syria,1,2,WAFF Championship,Teheran,Iran,True,3,-1,Syria
26732,28658,30479,2008,Palestine,Qatar,0,1,WAFF Championship,Teheran,Iran,True,1,-1,Qatar
26733,28659,30480,2008,Guyana,Suriname,1,1,CFU Caribbean Cup qualification,Providence,Guyana,False,2,0,Draw
26734,28660,30481,2008,Haiti,Trinidad and Tobago,1,0,Friendly,Port-au-Prince,Haiti,False,1,1,Haiti
26735,28661,30482,2008,Iran,Qatar,6,1,WAFF Championship,Teheran,Iran,False,7,5,Iran
26736,28663,30484,2008,India,Tajikistan,4,1,AFC Challenge Cup,New Delhi,India,False,5,3,India
26737,28664,30485,2008,Iran,Syria,2,0,WAFF Championship,Teheran,Iran,False,2,2,Iran
26738,28665,30486,2008,Jordan,Qatar,3,0,WAFF Championship,Teheran,Iran,True,3,3,Jordan
26739,28666,30487,2008,El Salvador,Trinidad and Tobago,1,3,Friendly,Washington,United States,True,4,-2,Trinidad and Tobago
26740,28667,30488,2008,Iran,Jordan,2,1,WAFF Championship,Teheran,Iran,False,3,1,Iran
26741,28668,30489,2008,Australia,South Africa,2,2,Friendly,London,England,True,4,0,Draw
26742,28669,30490,2008,Gabon,Mali,1,0,Friendly,Mantes-la-Ville,France,True,1,1,Gabon
26743,28670,30491,2008,Albania,Liechtenstein,2,0,Friendly,Tirana,Albania,False,2,2,Albania
26744,28671,30492,2008,Algeria,United Arab Emirates,1,0,Friendly,Le Touquet-Paris-Plage,France,True,1,1,Algeria
26745,28672,30493,2008,Bahrain,Burkina Faso,3,1,Friendly,Manama,Bahrain,False,4,2,Bahrain
26746,28673,30494,2008,Belarus,Argentina,0,0,Friendly,Minsk,Belarus,False,0,0,Draw
26747,28674,30495,2008,Bolivia,Panama,1,0,Friendly,Santa Cruz,Bolivia,False,1,1,Bolivia
26748,28675,30496,2008,Bosnia and Herzegovina,Bulgaria,1,2,Friendly,Zenica,Bosnia and Herzegovina,False,3,-1,Bulgaria
26749,28676,30497,2008,Canada,Jamaica,1,1,FIFA World Cup qualification,Toronto,Canada,False,2,0,Draw
26750,28677,30498,2008,Colombia,Ecuador,0,1,Friendly,East Rutherford,United States,True,1,-1,Ecuador
26751,28678,30499,2008,DR Congo,Togo,2,1,Friendly,Dreux,France,True,3,1,DR Congo
26752,28679,30500,2008,Costa Rica,El Salvador,1,0,FIFA World Cup qualification,San José,Costa Rica,False,1,1,Costa Rica
26753,28680,30501,2008,Cuba,Trinidad and Tobago,1,3,FIFA World Cup qualification,Havana,Cuba,False,4,-2,Trinidad and Tobago
26754,28681,30502,2008,Denmark,Spain,0,3,Friendly,Copenhagen,Denmark,False,3,-3,Spain
26755,28682,30503,2008,England,Czech Republic,2,2,Friendly,London,England,False,4,0,Draw
26756,28683,30504,2008,Estonia,Malta,2,1,Friendly,Tallinn,Estonia,False,3,1,Estonia
26757,28684,30505,2008,Finland,Israel,2,0,Friendly,Tampere,Finland,False,2,2,Finland
26758,28685,30506,2008,Germany,Belgium,2,0,Friendly,Nuremberg,Germany,False,2,2,Germany
26759,28686,30507,2008,Guatemala,United States,0,1,FIFA World Cup qualification,Guatemala,Guatemala,False,1,-1,United States
26760,28687,30508,2008,Guinea,Ivory Coast,1,2,Friendly,Chantilly,France,True,3,-1,Ivory Coast
26761,28688,30509,2008,Haiti,Suriname,2,2,FIFA World Cup qualification,Port-au-Prince,Haiti,False,4,0,Draw
26762,28689,30510,2008,Hungary,Montenegro,3,3,Friendly,Budapest,Hungary,False,6,0,Draw
26763,28690,30511,2008,Iceland,Azerbaijan,1,1,Friendly,Reykjavík,Iceland,False,2,0,Draw
26764,28691,30512,2008,Italy,Austria,2,2,Friendly,Nice,France,True,4,0,Draw
26765,28692,30513,2008,Japan,Uruguay,1,3,Friendly,Sapporo,Japan,False,4,-2,Uruguay
26766,28693,30514,2008,Kazakhstan,Andorra,3,0,FIFA World Cup qualification,Almaty,Kazakhstan,False,3,3,Kazakhstan
26767,28694,30515,2008,Libya,Senegal,0,0,Friendly,Tripoli,Libya,False,0,0,Draw
26768,28695,30516,2008,Lithuania,Moldova,3,0,Friendly,Marijampolė,Lithuania,False,3,3,Lithuania
26769,28697,30518,2008,Mexico,Honduras,2,1,FIFA World Cup qualification,Mexico City,Mexico,False,3,1,Mexico
26770,28698,30519,2008,Morocco,Benin,3,1,Friendly,Rabat,Morocco,False,4,2,Morocco
26771,28699,30520,2008,Mozambique,Eswatini,3,0,Friendly,Maputo,Mozambique,False,3,3,Mozambique
26772,28700,30521,2008,Norway,Republic of Ireland,1,1,Friendly,Oslo,Norway,False,2,0,Draw
26773,28701,30522,2008,Oman,Uzbekistan,2,0,Friendly,Muscat,Oman,False,2,2,Oman
26774,28702,30523,2008,Portugal,Faroe Islands,5,0,Friendly,Aveiro,Portugal,False,5,5,Portugal
26775,28703,30524,2008,Qatar,Tajikistan,5,0,Friendly,Doha,Qatar,False,5,5,Qatar
26776,28704,30525,2008,Romania,Latvia,1,0,Friendly,Urziceni,Romania,False,1,1,Romania
26777,28705,30526,2008,Russia,Netherlands,1,1,Friendly,Moscow,Russia,False,2,0,Draw
26778,28706,30527,2008,Saudi Arabia,Paraguay,1,1,Friendly,Nyon,Switzerland,True,2,0,Draw
26779,28707,30528,2008,Scotland,Northern Ireland,0,0,Friendly,Glasgow,Scotland,False,0,0,Draw
26780,28708,30529,2008,Slovakia,Greece,0,2,Friendly,Bratislava,Slovakia,False,2,-2,Greece
26781,28709,30530,2008,Slovenia,Croatia,2,3,Friendly,Maribor,Slovenia,False,5,-1,Croatia
26782,28710,30531,2008,Sudan,Egypt,4,0,Friendly,Omdurman,Sudan,False,4,4,Sudan
26783,28711,30532,2008,Sweden,France,2,3,Friendly,Gothenburg,Sweden,False,5,-1,France
26784,28712,30533,2008,Switzerland,Cyprus,4,1,Friendly,Geneva,Switzerland,False,5,3,Switzerland
26785,28713,30534,2008,Tanzania,Ghana,1,1,Friendly,Arusha,Tanzania,False,2,0,Draw
26786,28714,30535,2008,Tunisia,Angola,1,1,Friendly,Monastir,Tunisia,False,2,0,Draw
26787,28715,30536,2008,Turkey,Chile,1,0,Friendly,İzmit,Turkey,False,1,1,Turkey
26788,28716,30537,2008,Ukraine,Poland,1,0,Friendly,L'viv,Ukraine,False,1,1,Ukraine
26789,28717,30538,2008,Venezuela,Syria,4,1,Friendly,Puerto la Cruz,Venezuela,False,5,3,Venezuela
26790,28718,30539,2008,Wales,Georgia,1,2,Friendly,Swansea,Wales,False,3,-1,Georgia
26791,28719,30540,2008,Zimbabwe,Botswana,1,0,Friendly,Harare,Zimbabwe,False,1,1,Zimbabwe
26792,28720,30541,2008,Indonesia,Cambodia,7,0,Friendly,Jakarta,Indonesia,False,7,7,Indonesia
26793,28721,30542,2008,Cambodia,Burma,1,7,Friendly,Jakarta,Indonesia,True,8,-6,Burma
26794,28722,30543,2008,Libya,Chad,3,0,Friendly,Tripoli,Libya,False,3,3,Libya
26795,28724,30545,2008,Indonesia,Burma,4,0,Friendly,Jakarta,Indonesia,False,4,4,Indonesia
26796,28725,30546,2008,Bermuda,Antigua and Barbuda,0,4,CFU Caribbean Cup qualification,George Town,Cayman Islands,True,4,-4,Antigua and Barbuda
26797,28726,30547,2008,Cayman Islands,Saint Martin,3,0,CFU Caribbean Cup qualification,George Town,Cayman Islands,False,3,3,Cayman Islands
26798,28727,30548,2008,Iran,Azerbaijan,1,0,Friendly,Teheran,Iran,False,1,1,Iran
26799,28728,30549,2008,Libya,Niger,6,2,Friendly,Tripoli,Libya,False,8,4,Libya
26800,28729,30550,2008,United Arab Emirates,Bahrain,2,3,Friendly,Abu Dhabi,United Arab Emirates,False,5,-1,Bahrain
26801,28731,30552,2008,Cayman Islands,Antigua and Barbuda,1,1,CFU Caribbean Cup qualification,George Town,Cayman Islands,False,2,0,Draw
26802,28732,30553,2008,Saudi Arabia,Qatar,2,1,Friendly,Dammam,Saudi Arabia,False,3,1,Saudi Arabia
26803,28733,30554,2008,Saint Martin,Bermuda,0,7,CFU Caribbean Cup qualification,George Town,Cayman Islands,True,7,-7,Bermuda
26804,28734,30555,2008,Suriname,French Guiana,2,1,Friendly,Paramaribo,Suriname,False,3,1,Suriname
26805,28735,30556,2008,Antigua and Barbuda,Saint Martin,3,2,CFU Caribbean Cup qualification,George Town,Cayman Islands,True,5,1,Antigua and Barbuda
26806,28736,30557,2008,Cayman Islands,Bermuda,0,0,CFU Caribbean Cup qualification,George Town,Cayman Islands,False,0,0,Draw
26807,28737,30558,2008,Trinidad and Tobago,Guyana,3,0,Friendly,Port of Spain,Trinidad and Tobago,False,3,3,Trinidad and Tobago
26808,28738,30559,2008,Algeria,Senegal,3,2,FIFA World Cup qualification,Blida,Algeria,False,5,1,Algeria
26809,28739,30560,2008,Djibouti,Malawi,0,3,FIFA World Cup qualification,Djibouti,Djibouti,False,3,-3,Malawi
26810,28740,30562,2008,Libya,Ghana,1,0,FIFA World Cup qualification,Tripoli,Libya,False,1,1,Libya
26811,28741,30563,2008,Albania,Sweden,0,0,FIFA World Cup qualification,Tirana,Albania,False,0,0,Draw
26812,28742,30564,2008,Andorra,England,0,2,FIFA World Cup qualification,Barcelona,Spain,True,2,-2,England
26813,28743,30565,2008,Argentina,Paraguay,1,1,FIFA World Cup qualification,Buenos Aires,Argentina,False,2,0,Draw
26814,28744,30566,2008,Armenia,Turkey,0,2,FIFA World Cup qualification,Yerevan,Armenia,False,2,-2,Turkey
26815,28745,30567,2008,Austria,France,3,1,FIFA World Cup qualification,Vienna,Austria,False,4,2,Austria
26816,28746,30568,2008,Bahrain,Japan,2,3,FIFA World Cup qualification,Riffa,Bahrain,False,5,-1,Japan
26817,28747,30569,2008,Belgium,Estonia,3,2,FIFA World Cup qualification,Liège,Belgium,False,5,1,Belgium
26818,28748,30570,2008,Burkina Faso,Tunisia,0,0,FIFA World Cup qualification,Ouagadougou,Burkina Faso,False,0,0,Draw
26819,28749,30572,2008,Colombia,Uruguay,0,1,FIFA World Cup qualification,Bogotá,Colombia,False,1,-1,Uruguay
26820,28750,30573,2008,Croatia,Kazakhstan,3,0,FIFA World Cup qualification,Zagreb,Croatia,False,3,3,Croatia
26821,28751,30574,2008,Cuba,United States,0,1,FIFA World Cup qualification,Havana,Cuba,False,1,-1,United States
26822,28752,30575,2008,Cyprus,Italy,1,2,FIFA World Cup qualification,Larnaca,Cyprus,False,3,-1,Italy
26823,28753,30576,2008,Ecuador,Bolivia,3,1,FIFA World Cup qualification,Quito,Ecuador,False,4,2,Ecuador
26824,28754,30577,2008,Fiji,Vanuatu,2,0,FIFA World Cup qualification,Ba,Fiji,False,2,2,Fiji
26825,28755,30578,2008,Gambia,Liberia,3,0,FIFA World Cup qualification,Bakau,Gambia,False,3,3,Gambia
26826,28756,30579,2008,Georgia,Republic of Ireland,1,2,FIFA World Cup qualification,Mainz,Germany,True,3,-1,Republic of Ireland
26827,28757,30580,2008,Hungary,Denmark,0,0,FIFA World Cup qualification,Budapest,Hungary,False,0,0,Draw
26828,28758,30581,2008,Israel,Switzerland,2,2,FIFA World Cup qualification,Ramat-Gan,Israel,False,4,0,Draw
26829,28759,30582,2008,Kenya,Namibia,1,0,FIFA World Cup qualification,Nairobi,Kenya,False,1,1,Kenya
26830,28760,30583,2008,Liechtenstein,Germany,0,6,FIFA World Cup qualification,Vaduz,Liechtenstein,False,6,-6,Germany
26831,28761,30584,2008,Luxembourg,Greece,0,3,FIFA World Cup qualification,Luxembourg,Luxembourg,False,3,-3,Greece
26832,28762,30586,2008,Malta,Portugal,0,4,FIFA World Cup qualification,Attard,Malta,False,4,-4,Portugal
26833,28763,30587,2008,Martinique,French Guiana,2,1,Friendly,Fort-de-France,Martinique,False,3,1,Martinique
26834,28764,30588,2008,Mauritania,Rwanda,0,1,FIFA World Cup qualification,Nouakchott,Mauritania,False,1,-1,Rwanda
26835,28765,30589,2008,Mauritius,Tanzania,1,4,FIFA World Cup qualification,Curepipe,Mauritius,False,5,-3,Tanzania
26836,28766,30590,2008,Moldova,Latvia,1,2,FIFA World Cup qualification,Tiraspol,Moldova,False,3,-1,Latvia
26837,28767,30591,2008,Montenegro,Bulgaria,2,2,FIFA World Cup qualification,Podgorica,Montenegro,False,4,0,Draw
26838,28768,30592,2008,Netherlands,Australia,1,2,Friendly,Eindhoven,Netherlands,False,3,-1,Australia
26839,28769,30593,2008,New Caledonia,New Zealand,1,3,FIFA World Cup qualification,Nouméa,New Caledonia,False,4,-2,New Zealand
26840,28770,30594,2008,Norway,Iceland,2,2,FIFA World Cup qualification,Oslo,Norway,False,4,0,Draw
26841,28771,30595,2008,Oman,Morocco,0,0,Friendly,Muscat,Oman,False,0,0,Draw
26842,28772,30596,2008,Peru,Venezuela,1,0,FIFA World Cup qualification,Lima,Peru,False,1,1,Peru
26843,28773,30597,2008,Poland,Slovenia,1,1,FIFA World Cup qualification,Wrocław,Poland,False,2,0,Draw
26844,28774,30598,2008,Qatar,Uzbekistan,3,0,FIFA World Cup qualification,Doha,Qatar,False,3,3,Qatar
26845,28775,30599,2008,Romania,Lithuania,0,3,FIFA World Cup qualification,Cluj,Romania,False,3,-3,Lithuania
26846,28776,30600,2008,Saudi Arabia,Iran,1,1,FIFA World Cup qualification,Riyadh,Saudi Arabia,False,2,0,Draw
26847,28777,30601,2008,Serbia,Faroe Islands,2,0,FIFA World Cup qualification,Belgrade,Serbia,False,2,2,Serbia
26848,28778,30602,2008,Seychelles,Burundi,1,2,FIFA World Cup qualification,Victoria,Seychelles,False,3,-1,Burundi
26849,28779,30603,2008,Sierra Leone,Equatorial Guinea,2,1,FIFA World Cup qualification,Freetown,Sierra Leone,False,3,1,Sierra Leone
26850,28780,30604,2008,Slovakia,Northern Ireland,2,1,FIFA World Cup qualification,Bratislava,Slovakia,False,3,1,Slovakia
26851,28781,30605,2008,South Africa,Nigeria,0,1,FIFA World Cup qualification,Port Elizabeth,South Africa,False,1,-1,Nigeria
26852,28782,30606,2008,Spain,Bosnia and Herzegovina,1,0,FIFA World Cup qualification,Murcia,Spain,False,1,1,Spain
26853,28783,30607,2008,Sudan,Chad,1,2,FIFA World Cup qualification,Cairo,Egypt,True,3,-1,Chad
26854,28784,30608,2008,Trinidad and Tobago,Guatemala,1,1,FIFA World Cup qualification,Port of Spain,Trinidad and Tobago,False,2,0,Draw
26855,28785,30609,2008,Ukraine,Belarus,1,0,FIFA World Cup qualification,L'viv,Ukraine,False,1,1,Ukraine
26856,28787,30611,2008,Wales,Azerbaijan,1,0,FIFA World Cup qualification,Cardiff,Wales,False,1,1,Wales
26857,28788,30612,2008,Benin,Angola,3,2,FIFA World Cup qualification,Cotonou,Benin,False,5,1,Benin
26858,28789,30613,2008,Chile,Brazil,0,3,FIFA World Cup qualification,Santiago,Chile,False,3,-3,Brazil
26859,28790,30614,2008,Congo,Mali,1,0,FIFA World Cup qualification,Brazzaville,Congo,False,1,1,Congo
26860,28791,30615,2008,DR Congo,Egypt,0,1,FIFA World Cup qualification,Kinshasa,DR Congo,False,1,-1,Egypt
26861,28792,30616,2008,Lesotho,Gabon,0,3,FIFA World Cup qualification,Bloemfontein,South Africa,True,3,-3,Gabon
26862,28793,30617,2008,Madagascar,Botswana,1,0,FIFA World Cup qualification,Antananarivo,Madagascar,False,1,1,Madagascar
26863,28794,30618,2008,Mozambique,Ivory Coast,1,1,FIFA World Cup qualification,Maputo,Mozambique,False,2,0,Draw
26864,28795,30619,2008,Niger,Uganda,3,1,FIFA World Cup qualification,Niamey,Niger,False,4,2,Niger
26865,28796,30620,2008,Zimbabwe,Guinea,0,0,FIFA World Cup qualification,Harare,Zimbabwe,False,0,0,Draw
26866,28797,30621,2008,Paraguay,Venezuela,2,0,FIFA World Cup qualification,Asunción,Paraguay,False,2,2,Paraguay
26867,28798,30622,2008,South Africa,Guinea,0,1,Friendly,Atteridgeville,South Africa,False,1,-1,Guinea
26868,28799,30623,2008,Albania,Malta,3,0,FIFA World Cup qualification,Tirana,Albania,False,3,3,Albania
26869,28800,30624,2008,Andorra,Belarus,1,3,FIFA World Cup qualification,Sant Julià de Lòria,Andorra,False,4,-2,Belarus
26870,28801,30625,2008,Azerbaijan,Liechtenstein,0,0,FIFA World Cup qualification,Baku,Azerbaijan,False,0,0,Draw
26871,28802,30626,2008,Bosnia and Herzegovina,Estonia,7,0,FIFA World Cup qualification,Zenica,Bosnia and Herzegovina,False,7,7,Bosnia and Herzegovina
26872,28803,30627,2008,Brazil,Bolivia,0,0,FIFA World Cup qualification,Rio de Janeiro,Brazil,False,0,0,Draw
26873,28804,30628,2008,Chad,Sudan,1,3,FIFA World Cup qualification,Cairo,Egypt,True,4,-2,Sudan
26874,28805,30629,2008,Chile,Colombia,4,0,FIFA World Cup qualification,Santiago,Chile,False,4,4,Chile
26875,28806,30630,2008,Croatia,England,1,4,FIFA World Cup qualification,Zagreb,Croatia,False,5,-3,England
26876,28807,30631,2008,Faroe Islands,Romania,0,1,FIFA World Cup qualification,Tórshavn,Faroe Islands,False,1,-1,Romania
26877,28808,30632,2008,Finland,Germany,3,3,FIFA World Cup qualification,Helsinki,Finland,False,6,0,Draw
26878,28809,30633,2008,France,Serbia,2,1,FIFA World Cup qualification,Saint-Denis,France,False,3,1,France
26879,28810,30634,2008,Guatemala,Cuba,4,1,FIFA World Cup qualification,Guatemala,Guatemala,False,5,3,Guatemala
26880,28811,30635,2008,Haiti,Costa Rica,1,3,FIFA World Cup qualification,Port-au-Prince,Haiti,False,4,-2,Costa Rica
26881,28812,30636,2008,Honduras,Jamaica,2,0,FIFA World Cup qualification,San Pedro Sula,Honduras,False,2,2,Honduras
26882,28813,30637,2008,Iceland,Scotland,1,2,FIFA World Cup qualification,Reykjavík,Iceland,False,3,-1,Scotland
26883,28814,30638,2008,Italy,Georgia,2,0,FIFA World Cup qualification,Udine,Italy,False,2,2,Italy
26884,28815,30639,2008,Kazakhstan,Ukraine,1,3,FIFA World Cup qualification,Almaty,Kazakhstan,False,4,-2,Ukraine
26885,28816,30641,2008,Latvia,Greece,0,2,FIFA World Cup qualification,Riga,Latvia,False,2,-2,Greece
26886,28817,30642,2008,Lithuania,Austria,2,0,FIFA World Cup qualification,Marijampolė,Lithuania,False,2,2,Lithuania
26887,28818,30644,2008,Mexico,Canada,2,1,FIFA World Cup qualification,Tuxtla Gutiérrez,Mexico,False,3,1,Mexico
26888,28819,30645,2008,Moldova,Israel,1,2,FIFA World Cup qualification,Chişinău,Moldova,False,3,-1,Israel
26889,28820,30646,2008,Montenegro,Republic of Ireland,0,0,FIFA World Cup qualification,Podgorica,Montenegro,False,0,0,Draw
26890,28821,30647,2008,New Zealand,New Caledonia,3,0,FIFA World Cup qualification,North Shore,New Zealand,False,3,3,New Zealand
26891,28822,30648,2008,Northern Ireland,Czech Republic,0,0,FIFA World Cup qualification,Belfast,Northern Ireland,False,0,0,Draw
26892,28823,30649,2008,Oman,Zimbabwe,3,2,Friendly,Muscat,Oman,False,5,1,Oman
26893,28824,30650,2008,Peru,Argentina,1,1,FIFA World Cup qualification,Lima,Peru,False,2,0,Draw
26894,28825,30651,2008,Portugal,Denmark,2,3,FIFA World Cup qualification,Lisbon,Portugal,False,5,-1,Denmark
26895,28826,30652,2008,Qatar,Bahrain,1,1,FIFA World Cup qualification,Doha,Qatar,False,2,0,Draw
26896,28827,30653,2008,Russia,Wales,2,1,FIFA World Cup qualification,Moscow,Russia,False,3,1,Russia
26897,28828,30654,2008,San Marino,Poland,0,2,FIFA World Cup qualification,Serravalle,San Marino,False,2,-2,Poland
26898,28829,30655,2008,Slovenia,Slovakia,2,1,FIFA World Cup qualification,Maribor,Slovenia,False,3,1,Slovenia
26899,28830,30656,2008,Spain,Armenia,4,0,FIFA World Cup qualification,Albacete,Spain,False,4,4,Spain
26900,28831,30657,2008,Suriname,El Salvador,0,2,FIFA World Cup qualification,Paramaribo,Suriname,False,2,-2,El Salvador
26901,28832,30658,2008,Sweden,Hungary,2,1,FIFA World Cup qualification,Solna,Sweden,False,3,1,Sweden
26902,28833,30659,2008,Switzerland,Luxembourg,1,2,FIFA World Cup qualification,Zürich,Switzerland,False,3,-1,Luxembourg
26903,28834,30660,2008,Turkey,Belgium,1,1,FIFA World Cup qualification,Istanbul,Turkey,False,2,0,Draw
26904,28835,30661,2008,United Arab Emirates,Saudi Arabia,1,2,FIFA World Cup qualification,Abu Dhabi,United Arab Emirates,False,3,-1,Saudi Arabia
26905,28836,30662,2008,Uruguay,Ecuador,0,0,FIFA World Cup qualification,Montevideo,Uruguay,False,0,0,Draw
26906,28837,30663,2008,United States,Trinidad and Tobago,3,0,FIFA World Cup qualification,Bridgeview,United States,False,3,3,United States
26907,28838,30664,2008,Uzbekistan,Australia,0,1,FIFA World Cup qualification,Tashkent,Uzbekistan,False,1,-1,Australia
26908,28839,30665,2008,Vanuatu,Fiji,2,1,FIFA World Cup qualification,Port Vila,Vanuatu,False,3,1,Vanuatu
26909,28840,30666,2008,Zambia,Togo,1,0,FIFA World Cup qualification,Chililabombwe,Zambia,False,1,1,Zambia
26910,28841,30667,2008,Martinique,Anguilla,3,1,CFU Caribbean Cup qualification,Fort-de-France,Martinique,False,4,2,Martinique
26911,28842,30668,2008,Antigua and Barbuda,Guyana,3,0,Friendly,St. John's,Antigua and Barbuda,False,3,3,Antigua and Barbuda
26912,28843,30669,2008,Guadeloupe,Martinique,0,1,African Nations Championship,La Courneuve,France,True,1,-1,Martinique
26913,28844,30670,2008,Mexico,Chile,0,1,Friendly,Los Angeles,United States,True,1,-1,Chile
26914,28846,30673,2008,Mayotte,Réunion,1,6,African Nations Championship,Franconville,France,True,7,-5,Réunion
26915,28847,30675,2008,New Caledonia,Guadeloupe,0,4,African Nations Championship,Melun,France,True,4,-4,Guadeloupe
26916,28848,30677,2008,French Guiana,Mayotte,4,2,African Nations Championship,Bonneuil-sur-Marne,France,True,6,2,French Guiana
26917,28849,30678,2008,Saint Kitts and Nevis,Barbados,1,3,CFU Caribbean Cup qualification,Basseterre,Saint Kitts and Nevis,False,4,-2,Barbados
26918,28850,30679,2008,New Caledonia,Martinique,1,1,African Nations Championship,Poissy,France,True,2,0,Draw
26919,28851,30680,2008,South Africa,Malawi,3,0,Friendly,Johannesburg,South Africa,False,3,3,South Africa
26920,28852,30682,2008,French Guiana,Réunion,0,2,African Nations Championship,Viry-Châtillon,France,True,2,-2,Réunion
26921,28853,30683,2008,Vietnam,Burma,2,3,Friendly,Ho Chi Minh City,Vietnam,False,5,-1,Burma
26922,28854,30684,2008,Burma,Turkmenistan,1,2,Friendly,Ho Chi Minh City,Vietnam,True,3,-1,Turkmenistan
26923,28855,30685,2008,Guadeloupe,French Guiana,4,0,African Nations Championship,La Courneuve,France,True,4,4,Guadeloupe
26924,28856,30686,2008,New Caledonia,Mayotte,3,2,African Nations Championship,La Courneuve,France,True,5,1,New Caledonia
26925,28857,30687,2008,Martinique,Réunion,0,1,African Nations Championship,Créteil,France,True,1,-1,Réunion
26926,28858,30688,2008,Trinidad and Tobago,Dominican Republic,9,0,Friendly,Port of Spain,Trinidad and Tobago,False,9,9,Trinidad and Tobago
26927,28859,30689,2008,Japan,United Arab Emirates,1,1,Friendly,Niigata,Japan,False,2,0,Draw
26928,28860,30690,2008,Malaysia,Pakistan,4,1,Friendly,Kuala Lumpur,Malaysia,False,5,3,Malaysia
26929,28861,30691,2008,Argentina,Uruguay,2,1,FIFA World Cup qualification,Buenos Aires,Argentina,False,3,1,Argentina
26930,28862,30692,2008,Belgium,Armenia,2,0,FIFA World Cup qualification,Brussels,Belgium,False,2,2,Belgium
26931,28863,30693,2008,Bolivia,Peru,3,0,FIFA World Cup qualification,La Paz,Bolivia,False,3,3,Bolivia
26932,28864,30694,2008,Botswana,Mozambique,0,1,FIFA World Cup qualification,Gaborone,Botswana,False,1,-1,Mozambique
26933,28865,30695,2008,Bulgaria,Italy,0,0,FIFA World Cup qualification,Sofia,Bulgaria,False,0,0,Draw
26934,28866,30696,2008,Cameroon,Mauritius,5,0,FIFA World Cup qualification,Yaoundé,Cameroon,False,5,5,Cameroon
26935,28867,30697,2008,Colombia,Paraguay,0,1,FIFA World Cup qualification,Bogotá,Colombia,False,1,-1,Paraguay
26936,28868,30698,2008,Denmark,Malta,3,0,FIFA World Cup qualification,Copenhagen,Denmark,False,3,3,Denmark
26937,28869,30699,2008,England,Kazakhstan,5,1,FIFA World Cup qualification,London,England,False,6,4,England
26938,28870,30700,2008,Equatorial Guinea,South Africa,0,1,FIFA World Cup qualification,Malabo,Equatorial Guinea,False,1,-1,South Africa
26939,28871,30701,2008,Estonia,Spain,0,3,FIFA World Cup qualification,Tallinn,Estonia,False,3,-3,Spain
26940,28872,30702,2008,Faroe Islands,Austria,1,1,FIFA World Cup qualification,Tórshavn,Faroe Islands,False,2,0,Draw
26941,28873,30703,2008,Finland,Azerbaijan,1,0,FIFA World Cup qualification,Helsinki,Finland,False,1,1,Finland
26942,28874,30704,2008,Gabon,Libya,1,0,FIFA World Cup qualification,Libreville,Gabon,False,1,1,Gabon
26943,28875,30705,2008,Georgia,Cyprus,1,1,FIFA World Cup qualification,Tbilisi,Georgia,False,2,0,Draw
26944,28876,30706,2008,Germany,Russia,2,1,FIFA World Cup qualification,Dortmund,Germany,False,3,1,Germany
26945,28877,30707,2008,Ghana,Lesotho,3,0,FIFA World Cup qualification,Sekondi,Ghana,False,3,3,Ghana
26946,28878,30708,2008,Greece,Moldova,3,0,FIFA World Cup qualification,Athens,Greece,False,3,3,Greece
26947,28879,30709,2008,Guadeloupe,Cayman Islands,7,1,CFU Caribbean Cup qualification,Les Abymes,Guadeloupe,False,8,6,Guadeloupe
26948,28880,30710,2008,Guatemala,Trinidad and Tobago,0,0,FIFA World Cup qualification,Guatemala,Guatemala,False,0,0,Draw
26949,28881,30711,2008,Haiti,El Salvador,0,0,FIFA World Cup qualification,Port-au-Prince,Haiti,False,0,0,Draw
26950,28882,30712,2008,Honduras,Canada,3,1,FIFA World Cup qualification,San Pedro Sula,Honduras,False,4,2,Honduras
26951,28883,30713,2008,Hungary,Albania,2,0,FIFA World Cup qualification,Budapest,Hungary,False,2,2,Hungary
26952,28884,30714,2008,Ivory Coast,Madagascar,3,0,FIFA World Cup qualification,Abidjan,Ivory Coast,False,3,3,Ivory Coast
26953,28885,30715,2008,Jamaica,Mexico,1,0,FIFA World Cup qualification,Kingston,Jamaica,False,1,1,Jamaica
26954,28886,30717,2008,Liberia,Algeria,0,0,FIFA World Cup qualification,Paynesville,Liberia,False,0,0,Draw
26955,28887,30718,2008,Luxembourg,Israel,1,3,FIFA World Cup qualification,Luxembourg,Luxembourg,False,4,-2,Israel
26956,28888,30719,2008,Malawi,DR Congo,2,1,FIFA World Cup qualification,Blantyre,Malawi,False,3,1,Malawi
26957,28889,30720,2008,Mali,Chad,2,1,FIFA World Cup qualification,Bamako,Mali,False,3,1,Mali
26958,28890,30721,2008,Martinique,Grenada,2,2,CFU Caribbean Cup qualification,Les Abymes,Guadeloupe,True,4,0,Draw
26959,28891,30722,2008,Morocco,Mauritania,4,1,FIFA World Cup qualification,Rabat,Morocco,False,5,3,Morocco
26960,28892,30723,2008,Namibia,Zimbabwe,4,2,FIFA World Cup qualification,Windhoek,Namibia,False,6,2,Namibia
26961,28893,30724,2008,Netherlands,Iceland,2,0,FIFA World Cup qualification,Rotterdam,Netherlands,False,2,2,Netherlands
26962,28894,30725,2008,Nigeria,Sierra Leone,4,1,FIFA World Cup qualification,Abuja,Nigeria,False,5,3,Nigeria
26963,28895,30726,2008,Poland,Czech Republic,2,1,FIFA World Cup qualification,Chorzów,Poland,False,3,1,Poland
26964,28896,30727,2008,Romania,France,2,2,FIFA World Cup qualification,Constanţa,Romania,False,4,0,Draw
26965,28897,30728,2008,San Marino,Slovakia,1,3,FIFA World Cup qualification,Serravalle,San Marino,False,4,-2,Slovakia
26966,28898,30729,2008,Scotland,Norway,0,0,FIFA World Cup qualification,Glasgow,Scotland,False,0,0,Draw
26967,28899,30730,2008,Senegal,Gambia,1,1,FIFA World Cup qualification,Dakar,Senegal,False,2,0,Draw
26968,28900,30731,2008,Serbia,Lithuania,3,0,FIFA World Cup qualification,Belgrade,Serbia,False,3,3,Serbia
26969,28901,30732,2008,Slovenia,Northern Ireland,2,0,FIFA World Cup qualification,Maribor,Slovenia,False,2,2,Slovenia
26970,28902,30733,2008,Sudan,Congo,2,0,FIFA World Cup qualification,Omdurman,Sudan,False,2,2,Sudan
26971,28903,30734,2008,Suriname,Costa Rica,1,4,FIFA World Cup qualification,Paramaribo,Suriname,False,5,-3,Costa Rica
26972,28904,30735,2008,Sweden,Portugal,0,0,FIFA World Cup qualification,Solna,Sweden,False,0,0,Draw
26973,28905,30736,2008,Switzerland,Latvia,2,1,FIFA World Cup qualification,St. Gallen,Switzerland,False,3,1,Switzerland
26974,28907,30738,2008,Togo,Eswatini,6,0,FIFA World Cup qualification,Accra,Ghana,True,6,6,Togo
26975,28908,30739,2008,Tunisia,Seychelles,5,0,FIFA World Cup qualification,Radès,Tunisia,False,5,5,Tunisia
26976,28909,30740,2008,Turkey,Bosnia and Herzegovina,2,1,FIFA World Cup qualification,Istanbul,Turkey,False,3,1,Turkey
26977,28910,30741,2008,Ukraine,Croatia,0,0,FIFA World Cup qualification,Charkiv,Ukraine,False,0,0,Draw
26978,28911,30742,2008,United States,Cuba,6,1,FIFA World Cup qualification,Washington,United States,False,7,5,United States
26979,28912,30743,2008,Wales,Liechtenstein,2,0,FIFA World Cup qualification,Cardiff,Wales,False,2,2,Wales
26980,28913,30744,2008,Angola,Niger,3,1,FIFA World Cup qualification,Luanda,Angola,False,4,2,Angola
26981,28914,30745,2008,Burundi,Burkina Faso,1,3,FIFA World Cup qualification,Bujumbura,Burundi,False,4,-2,Burkina Faso
26982,28915,30746,2008,Ecuador,Chile,1,0,FIFA World Cup qualification,Quito,Ecuador,False,1,1,Ecuador
26983,28916,30747,2008,Egypt,Djibouti,4,0,FIFA World Cup qualification,Cairo,Egypt,False,4,4,Egypt
26984,28917,30748,2008,Guinea,Kenya,3,2,FIFA World Cup qualification,Conakry,Guinea,False,5,1,Guinea
26985,28918,30749,2008,Uganda,Benin,2,1,FIFA World Cup qualification,Kampala,Uganda,False,3,1,Uganda
26986,28919,30750,2008,Venezuela,Brazil,0,4,FIFA World Cup qualification,San Cristóbal,Venezuela,False,4,-4,Brazil
26987,28920,30751,2008,Cayman Islands,Martinique,0,1,CFU Caribbean Cup qualification,Les Abymes,Guadeloupe,True,1,-1,Martinique
26988,28921,30752,2008,Guadeloupe,Grenada,2,1,CFU Caribbean Cup qualification,Les Abymes,Guadeloupe,False,3,1,Guadeloupe
26989,28922,30753,2008,Bolivia,Uruguay,2,2,FIFA World Cup qualification,La Paz,Bolivia,False,4,0,Draw
26990,28923,30754,2008,France,Tunisia,3,1,Friendly,Saint-Denis,France,False,4,2,France
26991,28924,30755,2008,Vietnam,Singapore,0,0,Friendly,Hanoi,Vietnam,False,0,0,Draw
26992,28925,30756,2008,Australia,Qatar,4,0,FIFA World Cup qualification,Brisbane,Australia,False,4,4,Australia
26993,28926,30757,2008,Austria,Serbia,1,3,FIFA World Cup qualification,Vienna,Austria,False,4,-2,Serbia
26994,28927,30758,2008,Bahrain,Azerbaijan,1,2,Friendly,Arad,Bahrain,False,3,-1,Azerbaijan
26995,28928,30759,2008,Belarus,England,1,3,FIFA World Cup qualification,Minsk,Belarus,False,4,-2,England
26996,28929,30760,2008,Belgium,Spain,1,2,FIFA World Cup qualification,Brussels,Belgium,False,3,-1,Spain
26997,28930,30761,2008,Bosnia and Herzegovina,Armenia,4,1,FIFA World Cup qualification,Zenica,Bosnia and Herzegovina,False,5,3,Bosnia and Herzegovina
26998,28931,30762,2008,Brazil,Colombia,0,0,FIFA World Cup qualification,Rio de Janeiro,Brazil,False,0,0,Draw
26999,28932,30763,2008,Canada,Mexico,2,2,FIFA World Cup qualification,Edmonton,Canada,False,4,0,Draw
27000,28933,30764,2008,Chile,Argentina,1,0,FIFA World Cup qualification,Santiago,Chile,False,1,1,Chile
27001,28934,30765,2008,Costa Rica,Haiti,2,0,FIFA World Cup qualification,San José,Costa Rica,False,2,2,Costa Rica
27002,28935,30766,2008,Croatia,Andorra,4,0,FIFA World Cup qualification,Zagreb,Croatia,False,4,4,Croatia
27003,28936,30767,2008,Cuba,Guatemala,2,1,FIFA World Cup qualification,Havana,Cuba,False,3,1,Cuba
27004,28937,30768,2008,Czech Republic,Slovenia,1,0,FIFA World Cup qualification,Teplice,Czech Republic,False,1,1,Czech Republic
27005,28938,30769,2008,El Salvador,Suriname,3,0,FIFA World Cup qualification,San Salvador,El Salvador,False,3,3,El Salvador
27006,28939,30770,2008,Estonia,Turkey,0,0,FIFA World Cup qualification,Tallinn,Estonia,False,0,0,Draw
27007,28940,30771,2008,Georgia,Bulgaria,0,0,FIFA World Cup qualification,Tbilisi,Georgia,False,0,0,Draw
27008,28941,30772,2008,Germany,Wales,1,0,FIFA World Cup qualification,Mönchengladbach,Germany,False,1,1,Germany
27009,28942,30773,2008,Greece,Switzerland,1,2,FIFA World Cup qualification,Athens,Greece,False,3,-1,Switzerland
27010,28943,30774,2008,Grenada,Cayman Islands,4,2,CFU Caribbean Cup qualification,Les Abymes,Guadeloupe,True,6,2,Grenada
27011,28944,30775,2008,Guadeloupe,Martinique,3,1,CFU Caribbean Cup qualification,Les Abymes,Guadeloupe,False,4,2,Guadeloupe
27012,28947,30778,2008,Republic of Ireland,Cyprus,1,0,FIFA World Cup qualification,Dublin,Republic of Ireland,False,1,1,Republic of Ireland
27013,28948,30779,2008,Italy,Montenegro,2,1,FIFA World Cup qualification,Lecce,Italy,False,3,1,Italy
27014,28949,30780,2008,Jamaica,Honduras,1,0,FIFA World Cup qualification,Kingston,Jamaica,False,1,1,Jamaica
27015,28950,30781,2008,Japan,Uzbekistan,1,1,FIFA World Cup qualification,Saitama,Japan,False,2,0,Draw
27016,28951,30783,2008,Latvia,Israel,1,1,FIFA World Cup qualification,Riga,Latvia,False,2,0,Draw
27017,28952,30784,2008,Lithuania,Faroe Islands,1,0,FIFA World Cup qualification,Kaunas,Lithuania,False,1,1,Lithuania
27018,28953,30785,2008,Luxembourg,Moldova,0,0,FIFA World Cup qualification,Luxembourg,Luxembourg,False,0,0,Draw
27019,28954,30786,2008,Malaysia,Nepal,4,0,Merdeka Tournament,Petaling Jaya,Malaysia,False,4,4,Malaysia
27020,28955,30787,2008,Malta,Hungary,0,1,FIFA World Cup qualification,Attard,Malta,False,1,-1,Hungary
27021,28956,30788,2008,Northern Ireland,San Marino,4,0,FIFA World Cup qualification,Belfast,Northern Ireland,False,4,4,Northern Ireland
27022,28957,30789,2008,Norway,Netherlands,0,1,FIFA World Cup qualification,Oslo,Norway,False,1,-1,Netherlands
27023,28958,30790,2008,Paraguay,Peru,1,0,FIFA World Cup qualification,Asunción,Paraguay,False,1,1,Paraguay
27024,28959,30791,2008,Portugal,Albania,0,0,FIFA World Cup qualification,Braga,Portugal,False,0,0,Draw
27025,28960,30792,2008,Russia,Finland,3,0,FIFA World Cup qualification,Moscow,Russia,False,3,3,Russia
27026,28961,30793,2008,Slovakia,Poland,2,1,FIFA World Cup qualification,Bratislava,Slovakia,False,3,1,Slovakia
27027,28962,30794,2008,South Africa,Ghana,2,1,Friendly,Bloemfontein,South Africa,False,3,1,South Africa
27028,28963,30795,2008,Trinidad and Tobago,United States,2,1,FIFA World Cup qualification,Port of Spain,Trinidad and Tobago,False,3,1,Trinidad and Tobago
27029,28964,30796,2008,Venezuela,Ecuador,3,1,FIFA World Cup qualification,Puerto la Cruz,Venezuela,False,4,2,Venezuela
27030,28965,30797,2008,Cambodia,Laos,3,2,AFF Championship,Phnom Penh,Cambodia,False,5,1,Cambodia
27031,28966,30798,2008,Nepal,Afghanistan,2,2,Merdeka Tournament,Petaling Jaya,Malaysia,True,4,0,Draw
27032,28967,30799,2008,Philippines,East Timor,1,0,AFF Championship,Phnom Penh,Cambodia,True,1,1,Philippines
27033,28968,30800,2008,Bangladesh,Burma,0,1,Merdeka Tournament,Shah Alam,Malaysia,True,1,-1,Burma
27034,28969,30801,2008,Brunei,Philippines,1,1,AFF Championship,Phnom Penh,Cambodia,True,2,0,Draw
27035,28970,30802,2008,Cambodia,East Timor,2,2,AFF Championship,Phnom Penh,Cambodia,False,4,0,Draw
27036,28971,30803,2008,Malaysia,Afghanistan,6,0,Merdeka Tournament,Kuala Lumpur,Malaysia,False,6,6,Malaysia
27037,28972,30804,2008,East Timor,Brunei,1,4,AFF Championship,Phnom Penh,Cambodia,True,5,-3,Brunei
27038,28973,30805,2008,Philippines,Laos,1,2,AFF Championship,Phnom Penh,Cambodia,True,3,-1,Laos
27039,28974,30806,2008,Bolivia,El Salvador,0,2,Friendly,Washington,United States,True,2,-2,El Salvador
27040,28975,30807,2008,Barbados,Suriname,3,2,CFU Caribbean Cup qualification,Havana,Cuba,True,5,1,Barbados
27041,28976,30808,2008,Cambodia,Philippines,2,3,AFF Championship,Phnom Penh,Cambodia,False,5,-1,Philippines
27042,28977,30809,2008,Cuba,Curaçao,7,1,CFU Caribbean Cup qualification,Havana,Cuba,False,8,6,Cuba
27043,28978,30810,2008,Laos,Brunei,3,2,AFF Championship,Phnom Penh,Cambodia,True,5,1,Laos
27044,28979,30811,2008,Malaysia,Burma,4,0,Merdeka Tournament,Kuala Lumpur,Malaysia,False,4,4,Malaysia
27045,28980,30812,2008,Cambodia,Brunei,2,1,AFF Championship,Phnom Penh,Cambodia,False,3,1,Cambodia
27046,28981,30813,2008,Cuba,Barbados,1,1,CFU Caribbean Cup qualification,Havana,Cuba,False,2,0,Draw
27047,28982,30814,2008,Laos,East Timor,2,1,AFF Championship,Phnom Penh,Cambodia,True,3,1,Laos
27048,28983,30815,2008,Suriname,Curaçao,2,1,CFU Caribbean Cup qualification,Havana,Cuba,True,3,1,Suriname
27049,28984,30816,2008,Palestine,Jordan,1,1,Friendly,Ar Ram,Palestine,False,2,0,Draw
27050,28985,30817,2008,Cuba,Suriname,6,0,CFU Caribbean Cup qualification,Havana,Cuba,False,6,6,Cuba
27051,28986,30818,2008,Curaçao,Barbados,1,2,CFU Caribbean Cup qualification,Havana,Cuba,True,3,-1,Barbados
27052,28989,30821,2008,Guyana,Saint Kitts and Nevis,1,1,CFU Caribbean Cup qualification,Macoya,Trinidad and Tobago,True,2,0,Draw
27053,28990,30822,2008,Trinidad and Tobago,Antigua and Barbuda,3,2,CFU Caribbean Cup qualification,Macoya,Trinidad and Tobago,False,5,1,Trinidad and Tobago
27054,28991,30823,2008,Antigua and Barbuda,Guyana,2,1,CFU Caribbean Cup qualification,Macoya,Trinidad and Tobago,True,3,1,Antigua and Barbuda
27055,28992,30824,2008,Trinidad and Tobago,Saint Kitts and Nevis,3,1,CFU Caribbean Cup qualification,Macoya,Trinidad and Tobago,False,4,2,Trinidad and Tobago
27056,28993,30825,2008,Jersey,Gibraltar,2,1,Friendly,St. Helier,Jersey,False,3,1,Jersey
27057,28994,30826,2008,Saudi Arabia,Thailand,1,0,Friendly,Riyadh,Saudi Arabia,False,1,1,Saudi Arabia
27058,28995,30827,2008,Cayman Islands,Jamaica,0,2,Friendly,George Town,Cayman Islands,False,2,-2,Jamaica
27059,28996,30828,2008,Qatar,Iran,0,1,Friendly,Doha,Qatar,False,1,-1,Iran
27060,28997,30829,2008,Saint Kitts and Nevis,Antigua and Barbuda,3,4,CFU Caribbean Cup qualification,Macoya,Trinidad and Tobago,True,7,-1,Antigua and Barbuda
27061,28998,30830,2008,Trinidad and Tobago,Guyana,1,1,CFU Caribbean Cup qualification,Macoya,Trinidad and Tobago,False,2,0,Draw
27062,28999,30831,2008,Burma,Bangladesh,0,0,Friendly,Rangoon,Burma,False,0,0,Draw
27063,29000,30832,2008,Estonia,Latvia,1,1,Friendly,Tallinn,Estonia,False,2,0,Draw
27064,29001,30833,2008,Mexico,Ecuador,2,1,Friendly,Phoenix,United States,True,3,1,Mexico
27065,29002,30834,2008,Saudi Arabia,Bahrain,4,0,Friendly,Riyadh,Saudi Arabia,False,4,4,Saudi Arabia
27066,29003,30835,2008,Bangladesh,Indonesia,0,2,Friendly,Rangoon,Burma,True,2,-2,Indonesia
27067,29004,30836,2008,Japan,Syria,3,1,Friendly,Kobe,Japan,False,4,2,Japan
27068,29005,30837,2008,Burma,Indonesia,2,1,Friendly,Rangoon,Burma,False,3,1,Burma
27069,29006,30838,2008,Vietnam,Thailand,2,2,VFF Cup,Hanoi,Vietnam,False,4,0,Draw
27070,29007,30839,2008,Algeria,Mali,1,1,Friendly,Rouen,France,True,2,0,Draw
27071,29008,30840,2008,Burma,Malaysia,4,1,Friendly,Rangoon,Burma,False,5,3,Burma
27072,29009,30841,2008,Estonia,Moldova,1,0,Friendly,Tallinn,Estonia,False,1,1,Estonia
27073,29010,30842,2008,Gabon,Guinea,3,3,Friendly,Compiègne,France,True,6,0,Draw
27074,29011,30843,2008,Austria,Turkey,2,4,Friendly,Vienna,Austria,False,6,-2,Turkey
27075,29012,30844,2008,Azerbaijan,Albania,1,1,Friendly,Baku,Azerbaijan,False,2,0,Draw
27076,29013,30845,2008,Bahrain,Australia,0,1,FIFA World Cup qualification,Riffa,Bahrain,False,1,-1,Australia
27077,29014,30846,2008,Brazil,Portugal,6,2,Friendly,Gama,Brazil,False,8,4,Brazil
27078,29015,30847,2008,Colombia,Nigeria,1,0,Friendly,Palmira,Colombia,False,1,1,Colombia
27079,29016,30848,2008,Cyprus,Belarus,2,1,Friendly,Nicosia,Cyprus,False,3,1,Cyprus
27080,29017,30849,2008,Denmark,Wales,0,1,Friendly,Brøndby,Denmark,False,1,-1,Wales
27081,29018,30850,2008,Egypt,Benin,5,1,Friendly,Cairo,Egypt,False,6,4,Egypt
27082,29019,30851,2008,El Salvador,Costa Rica,1,3,FIFA World Cup qualification,San Salvador,El Salvador,False,4,-2,Costa Rica
27083,29020,30852,2008,Fiji,New Zealand,2,0,FIFA World Cup qualification,Lautoka,Fiji,False,2,2,Fiji
27084,29021,30853,2008,France,Uruguay,0,0,Friendly,Saint-Denis,France,False,0,0,Draw
27085,29022,30854,2008,Germany,England,1,2,Friendly,Berlin,Germany,False,3,-1,England
27086,29023,30855,2008,Ghana,Tunisia,0,0,Friendly,Accra,Ghana,False,0,0,Draw
27087,29024,30856,2008,Greece,Italy,1,1,Friendly,Piraeus,Greece,False,2,0,Draw
27088,29025,30857,2008,Honduras,Mexico,1,0,FIFA World Cup qualification,San Pedro Sula,Honduras,False,1,1,Honduras
27089,29026,30858,2008,Republic of Ireland,Poland,2,3,Friendly,Dublin,Republic of Ireland,False,5,-1,Poland
27090,29027,30859,2008,Israel,Ivory Coast,2,2,Friendly,Ramat-Gan,Israel,False,4,0,Draw
27091,29028,30860,2008,Jamaica,Canada,3,0,FIFA World Cup qualification,Kingston,Jamaica,False,3,3,Jamaica
27092,29029,30861,2008,Luxembourg,Belgium,1,1,Friendly,Luxembourg,Luxembourg,False,2,0,Draw
27093,29030,30862,2008,Macau,Hong Kong,1,9,Friendly,Macau,Macau,False,10,-8,Hong Kong
27094,29031,30863,2008,Malta,Iceland,0,1,Friendly,Paola,Malta,False,1,-1,Iceland
27095,29032,30864,2008,Moldova,Lithuania,1,1,Friendly,Tallinn,Estonia,True,2,0,Draw
27096,29034,30866,2008,Morocco,Zambia,3,0,Friendly,Rabat,Morocco,False,3,3,Morocco
27097,29035,30867,2008,Netherlands,Sweden,3,1,Friendly,Amsterdam,Netherlands,False,4,2,Netherlands
27098,29036,30868,2008,Northern Ireland,Hungary,0,2,Friendly,Belfast,Northern Ireland,False,2,-2,Hungary
27099,29037,30869,2008,Oman,Paraguay,0,1,Friendly,Muscat,Oman,False,1,-1,Paraguay
27100,29038,30870,2008,Qatar,Japan,0,3,FIFA World Cup qualification,Doha,Qatar,False,3,-3,Japan
27101,29039,30871,2008,Romania,Georgia,2,1,Friendly,Bucharest,Romania,False,3,1,Romania
27102,29040,30872,2008,San Marino,Czech Republic,0,3,FIFA World Cup qualification,Serravalle,San Marino,False,3,-3,Czech Republic
27103,29042,30874,2008,Scotland,Argentina,0,1,Friendly,Glasgow,Scotland,False,1,-1,Argentina
27104,29043,30875,2008,Serbia,Bulgaria,6,1,Friendly,Belgrade,Serbia,False,7,5,Serbia
27105,29044,30876,2008,Slovakia,Liechtenstein,4,0,Friendly,Žilina,Slovakia,False,4,4,Slovakia
27106,29045,30877,2008,Slovenia,Bosnia and Herzegovina,3,4,Friendly,Maribor,Slovenia,False,7,-1,Bosnia and Herzegovina
27107,29046,30878,2008,South Africa,Cameroon,3,2,Friendly,Rustenburg,South Africa,False,5,1,South Africa
27108,29047,30879,2008,Spain,Chile,3,0,Friendly,Vila-real,Spain,False,3,3,Spain
27109,29048,30880,2008,Suriname,Haiti,1,1,FIFA World Cup qualification,Paramaribo,Suriname,False,2,0,Draw
27110,29049,30881,2008,Switzerland,Finland,1,0,Friendly,St. Gallen,Switzerland,False,1,1,Switzerland
27111,29050,30882,2008,Tanzania,Mozambique,1,0,Friendly,Dar es Salaam,Tanzania,False,1,1,Tanzania
27112,29051,30883,2008,Togo,Rwanda,1,0,Friendly,Lomé,Togo,False,1,1,Togo
27113,29052,30884,2008,Trinidad and Tobago,Cuba,3,0,FIFA World Cup qualification,Port of Spain,Trinidad and Tobago,False,3,3,Trinidad and Tobago
27114,29053,30885,2008,Ukraine,Norway,1,0,Friendly,Dnipropetrovs'k,Ukraine,False,1,1,Ukraine
27115,29054,30886,2008,United Arab Emirates,Iran,1,1,FIFA World Cup qualification,Dubai,United Arab Emirates,False,2,0,Draw
27116,29055,30887,2008,United States,Guatemala,2,0,FIFA World Cup qualification,Commerce City,United States,False,2,2,United States
27117,29056,30888,2008,Venezuela,Angola,0,0,Friendly,Barinas,Venezuela,False,0,0,Draw
27118,29057,30889,2008,Burma,Indonesia,2,1,Friendly,Rangoon,Burma,False,3,1,Burma
27119,29058,30890,2008,Estonia,Lithuania,1,1,Friendly,Kuressaare,Estonia,False,2,0,Draw
27120,29059,30891,2008,Malaysia,Singapore,2,2,Friendly,Petaling Jaya,Malaysia,False,4,0,Draw
27121,29060,30892,2008,Jamaica,Barbados,2,1,CFU Caribbean Cup,Kingston,Jamaica,False,3,1,Jamaica
27122,29061,30893,2008,Trinidad and Tobago,Grenada,1,2,CFU Caribbean Cup,Kingston,Jamaica,True,3,-1,Grenada
27123,29062,30894,2008,Guadeloupe,Cuba,1,2,CFU Caribbean Cup,Montego Bay,Jamaica,True,3,-1,Cuba
27124,29063,30895,2008,Haiti,Antigua and Barbuda,1,1,CFU Caribbean Cup,Montego Bay,Jamaica,True,2,0,Draw
27125,29064,30896,2008,Barbados,Trinidad and Tobago,1,2,CFU Caribbean Cup,Montego Bay,Jamaica,True,3,-1,Trinidad and Tobago
27126,29065,30897,2008,Indonesia,Burma,3,0,AFF Championship,Jakarta,Indonesia,False,3,3,Indonesia
27127,29066,30898,2008,Jamaica,Grenada,4,0,CFU Caribbean Cup,Montego Bay,Jamaica,False,4,4,Jamaica
27128,29067,30899,2008,Singapore,Cambodia,5,0,AFF Championship,Jakarta,Indonesia,True,5,5,Singapore
27129,29068,30900,2008,Cuba,Antigua and Barbuda,3,0,CFU Caribbean Cup,Falmouth,Jamaica,True,3,3,Cuba
27130,29069,30901,2008,Haiti,Guadeloupe,2,3,CFU Caribbean Cup,Falmouth,Jamaica,True,5,-1,Guadeloupe
27131,29070,30902,2008,Malaysia,Laos,3,0,AFF Championship,Phuket,Thailand,True,3,3,Malaysia
27132,29071,30903,2008,Thailand,Vietnam,2,0,AFF Championship,Phuket,Thailand,False,2,2,Thailand
27133,29072,30904,2008,Grenada,Barbados,4,2,CFU Caribbean Cup,Falmouth,Jamaica,True,6,2,Grenada
27134,29073,30905,2008,Indonesia,Cambodia,4,0,AFF Championship,Jakarta,Indonesia,False,4,4,Indonesia
27135,29074,30906,2008,Jamaica,Trinidad and Tobago,1,1,CFU Caribbean Cup,Falmouth,Jamaica,False,2,0,Draw
27136,29075,30907,2008,Singapore,Burma,3,1,AFF Championship,Jakarta,Indonesia,True,4,2,Singapore
27137,29076,30908,2008,Antigua and Barbuda,Guadeloupe,2,2,CFU Caribbean Cup,Montego Bay,Jamaica,True,4,0,Draw
27138,29077,30909,2008,Cuba,Haiti,0,1,CFU Caribbean Cup,Montego Bay,Jamaica,True,1,-1,Haiti
27139,29078,30910,2008,Malaysia,Vietnam,2,3,AFF Championship,Phuket,Thailand,True,5,-1,Vietnam
27140,29079,30911,2008,Thailand,Laos,6,0,AFF Championship,Phuket,Thailand,False,6,6,Thailand
27141,29080,30912,2008,Burma,Cambodia,3,2,AFF Championship,Bandung,Indonesia,True,5,1,Burma
27142,29081,30913,2008,Indonesia,Singapore,0,2,AFF Championship,Jakarta,Indonesia,False,2,-2,Singapore
27143,29082,30914,2008,Thailand,Malaysia,3,0,AFF Championship,Phuket,Thailand,False,3,3,Thailand
27144,29083,30915,2008,Vietnam,Laos,4,0,AFF Championship,Phuket,Thailand,True,4,4,Vietnam
27145,29084,30916,2008,Cuba,Grenada,2,2,CFU Caribbean Cup,Kingston,Jamaica,True,4,0,Draw
27146,29085,30917,2008,Jamaica,Guadeloupe,2,0,CFU Caribbean Cup,Kingston,Jamaica,False,2,2,Jamaica
27147,29086,30918,2008,Cuba,Guadeloupe,0,0,CFU Caribbean Cup,Kingston,Jamaica,True,0,0,Draw
27148,29087,30919,2008,Jamaica,Grenada,2,0,CFU Caribbean Cup,Kingston,Jamaica,False,2,2,Jamaica
27149,29088,30920,2008,Serbia,Poland,0,1,Friendly,Antalya,Turkey,True,1,-1,Poland
27150,29089,30921,2008,Indonesia,Thailand,0,1,AFF Championship,Jakarta,Indonesia,False,1,-1,Thailand
27151,29090,30922,2008,Iran,Ecuador,0,1,Friendly,Muscat,Oman,True,1,-1,Ecuador
27152,29092,30924,2008,Vietnam,Singapore,0,0,AFF Championship,Hanoi,Vietnam,False,0,0,Draw
27153,29094,30926,2008,Oman,Ecuador,2,0,Friendly,Muscat,Oman,False,2,2,Oman
27154,29096,30928,2008,Bahrain,Saudi Arabia,1,0,Friendly,Manama,Bahrain,False,1,1,Bahrain
27155,29097,30929,2008,Djibouti,Somalia,2,3,Friendly,Djibouti,Djibouti,False,5,-1,Somalia
27156,29098,30930,2008,Thailand,Vietnam,1,2,AFF Championship,Bangkok,Thailand,False,3,-1,Vietnam
27157,29099,30931,2008,Saudi Arabia,Syria,1,1,Friendly,Dammam,Saudi Arabia,False,2,0,Draw
27158,29100,30932,2008,United Arab Emirates,Iraq,2,2,Friendly,Al Ain,United Arab Emirates,False,4,0,Draw
27159,29101,30934,2008,Vietnam,Thailand,1,1,AFF Championship,Hanoi,Vietnam,False,2,0,Draw
27160,29102,30936,2008,Bahrain,Syria,2,2,Friendly,Manama,Bahrain,False,4,0,Draw
27161,29103,30937,2008,United Arab Emirates,Kuwait,0,0,Friendly,Dubai,United Arab Emirates,False,0,0,Draw
27162,29104,30938,2008,Sudan,Kenya,0,0,CECAFA Cup,Jinja,Uganda,True,0,0,Draw
27163,29105,30939,2008,Zambia,Djibouti,3,0,CECAFA Cup,Jinja,Uganda,True,3,3,Zambia
27164,29106,30940,2009,Uganda,Rwanda,4,0,CECAFA Cup,Kampala,Uganda,False,4,4,Uganda
27165,29107,30942,2009,Djibouti,Burundi,0,4,CECAFA Cup,Jinja,Uganda,True,4,-4,Burundi
27166,29108,30943,2009,Kenya,Zambia,0,0,CECAFA Cup,Jinja,Uganda,True,0,0,Draw
27167,29109,30944,2009,Somalia,Tanzania,1,0,CECAFA Cup,Kampala,Uganda,True,1,1,Somalia
27168,29111,30946,2009,Bahrain,Iraq,3,1,Gulf Cup,Muscat,Oman,True,4,2,Bahrain
27169,29112,30947,2009,Djibouti,Sudan,1,1,CECAFA Cup,Jinja,Uganda,True,2,0,Draw
27170,29113,30948,2009,Oman,Kuwait,0,0,Gulf Cup,Muscat,Oman,False,0,0,Draw
27171,29114,30949,2009,Zambia,Burundi,1,1,CECAFA Cup,Jinja,Uganda,True,2,0,Draw
27172,29115,30950,2009,Rwanda,Somalia,3,0,CECAFA Cup,Kampala,Uganda,True,3,3,Rwanda
27173,29116,30951,2009,Saudi Arabia,Qatar,0,0,Gulf Cup,Muscat,Oman,True,0,0,Draw
27174,29118,30953,2009,United Arab Emirates,Yemen,3,1,Gulf Cup,Muscat,Oman,True,4,2,United Arab Emirates
27175,29119,30954,2009,Burundi,Sudan,1,0,CECAFA Cup,Jinja,Uganda,True,1,1,Burundi
27176,29120,30955,2009,Kenya,Djibouti,5,1,CECAFA Cup,Jinja,Uganda,True,6,4,Kenya
27177,29121,30956,2009,Bahrain,Kuwait,0,1,Gulf Cup,Muscat,Oman,True,1,-1,Kuwait
27178,29122,30957,2009,Oman,Iraq,4,0,Gulf Cup,Muscat,Oman,False,4,4,Oman
27179,29123,30958,2009,Rwanda,Tanzania,0,2,CECAFA Cup,Kampala,Uganda,True,2,-2,Tanzania
27180,29124,30959,2009,Uganda,Somalia,4,0,CECAFA Cup,Kampala,Uganda,False,4,4,Uganda
27181,29125,30960,2009,Burundi,Kenya,0,1,CECAFA Cup,Kampala,Uganda,True,1,-1,Kenya
27182,29126,30961,2009,Qatar,United Arab Emirates,0,0,Gulf Cup,Muscat,Oman,True,0,0,Draw
27183,29127,30962,2009,Saudi Arabia,Yemen,6,0,Gulf Cup,Muscat,Oman,True,6,6,Saudi Arabia
27184,29128,30963,2009,Sudan,Zambia,2,0,CECAFA Cup,Kampala,Uganda,True,2,2,Sudan
27185,29130,30965,2009,Uganda,Tanzania,2,1,CECAFA Cup,Kampala,Uganda,False,3,1,Uganda
27186,29131,30967,2009,Iraq,Kuwait,1,1,Gulf Cup,Muscat,Oman,True,2,0,Draw
27187,29132,30968,2009,Oman,Bahrain,2,0,Gulf Cup,Muscat,Oman,False,2,2,Oman
27188,29133,30969,2009,Kenya,Tanzania,2,1,CECAFA Cup,Kampala,Uganda,True,3,1,Kenya
27189,29134,30970,2009,Qatar,Yemen,2,1,Gulf Cup,Muscat,Oman,True,3,1,Qatar
27190,29135,30971,2009,Uganda,Burundi,5,0,CECAFA Cup,Kampala,Uganda,False,5,5,Uganda
27191,29136,30972,2009,United Arab Emirates,Saudi Arabia,0,3,Gulf Cup,Muscat,Oman,True,3,-3,Saudi Arabia
27192,29137,30973,2009,Tanzania,Burundi,3,2,CECAFA Cup,Kampala,Uganda,True,5,1,Tanzania
27193,29138,30974,2009,Uganda,Kenya,1,0,CECAFA Cup,Kampala,Uganda,False,1,1,Uganda
27194,29139,30975,2009,Hong Kong,India,2,1,Friendly,Victoria,Hong Kong,False,3,1,Hong Kong
27195,29140,30976,2009,Iran,Singapore,6,0,AFC Asian Cup qualification,Teheran,Iran,False,6,6,Iran
27196,29141,30977,2009,Jordan,Thailand,0,0,AFC Asian Cup qualification,Amman,Jordan,False,0,0,Draw
27197,29142,30978,2009,Kuwait,Saudi Arabia,0,1,Gulf Cup,Muscat,Oman,True,1,-1,Saudi Arabia
27198,29143,30979,2009,Oman,Qatar,1,0,Gulf Cup,Muscat,Oman,False,1,1,Oman
27199,29145,30981,2009,Vietnam,Lebanon,3,1,AFC Asian Cup qualification,Hanoi,Vietnam,False,4,2,Vietnam
27200,29146,30982,2009,Guatemala,Haiti,1,0,Friendly,Fort Pierce,United States,True,1,1,Guatemala
27201,29147,30983,2009,Oman,Saudi Arabia,0,0,Gulf Cup,Muscat,Oman,False,0,0,Draw
27202,29148,30984,2009,Honduras,Chile,2,0,Friendly,Fort Lauderdale,United States,True,2,2,Honduras
27203,29149,30985,2009,Syria,Turkmenistan,5,1,Friendly,Kuwait City,Kuwait,True,6,4,Syria
27204,29150,30986,2009,Oman,Indonesia,0,0,AFC Asian Cup qualification,Muscat,Oman,False,0,0,Draw
27205,29151,30987,2009,Japan,Yemen,2,1,AFC Asian Cup qualification,Kumamoto,Japan,False,3,1,Japan
27206,29152,30988,2009,Kuwait,Turkmenistan,2,0,Friendly,Kuwait City,Kuwait,False,2,2,Kuwait
27207,29153,30990,2009,Hong Kong,Bahrain,1,3,AFC Asian Cup qualification,So Kon Po,Hong Kong,False,4,-2,Bahrain
27208,29154,30991,2009,Malaysia,United Arab Emirates,0,5,AFC Asian Cup qualification,Kuala Lumpur,Malaysia,False,5,-5,United Arab Emirates
27209,29155,30992,2009,Thailand,Lebanon,2,1,King's Cup,Phuket,Thailand,False,3,1,Thailand
27210,29156,30993,2009,El Salvador,Nicaragua,1,1,UNCAF Cup,Tegucigalpa,Honduras,True,2,0,Draw
27211,29157,30994,2009,Honduras,Belize,2,1,UNCAF Cup,Tegucigalpa,Honduras,False,3,1,Honduras
27212,29158,30995,2009,Costa Rica,Panama,3,0,UNCAF Cup,Tegucigalpa,Honduras,True,3,3,Costa Rica
27213,29159,30996,2009,Egypt,Kenya,1,0,Friendly,Cairo,Egypt,False,1,1,Egypt
27214,29160,30998,2009,Kuwait,Syria,2,3,Friendly,Kuwait City,Kuwait,False,5,-1,Syria
27215,29161,30999,2009,Belize,El Salvador,1,4,UNCAF Cup,Tegucigalpa,Honduras,True,5,-3,El Salvador
27216,29162,31000,2009,Honduras,Nicaragua,4,1,UNCAF Cup,Tegucigalpa,Honduras,False,5,3,Honduras
27217,29163,31001,2009,United States,Sweden,3,2,Friendly,Carson,United States,False,5,1,United States
27218,29164,31002,2009,Guatemala,Costa Rica,1,3,UNCAF Cup,Tegucigalpa,Honduras,True,4,-2,Costa Rica
27219,29165,31003,2009,Honduras,El Salvador,2,0,UNCAF Cup,Tegucigalpa,Honduras,False,2,2,Honduras
27220,29166,31004,2009,Nicaragua,Belize,1,1,UNCAF Cup,Tegucigalpa,Honduras,True,2,0,Draw
27221,29167,31005,2009,Panama,Guatemala,1,0,UNCAF Cup,Tegucigalpa,Honduras,True,1,1,Panama
27222,29168,31006,2009,South Africa,Zambia,1,0,Friendly,Atteridgeville,South Africa,False,1,1,South Africa
27223,29169,31007,2009,Bahrain,Japan,1,0,AFC Asian Cup qualification,Riffa,Bahrain,False,1,1,Bahrain
27224,29170,31008,2009,Indonesia,Australia,0,0,AFC Asian Cup qualification,Jakarta,Indonesia,False,0,0,Draw
27225,29171,31009,2009,Kuwait,Oman,0,1,AFC Asian Cup qualification,Kuwait City,Kuwait,False,1,-1,Oman
27226,29172,31010,2009,Lebanon,Syria,0,2,AFC Asian Cup qualification,Sidon,Lebanon,False,2,-2,Syria
27227,29173,31011,2009,Mexico,Sweden,0,1,Friendly,Oakland,United States,True,1,-1,Sweden
27228,29174,31012,2009,Singapore,Jordan,2,1,AFC Asian Cup qualification,Singapore,Singapore,False,3,1,Singapore
27229,29175,31013,2009,Thailand,Iran,0,0,AFC Asian Cup qualification,Bangkok,Thailand,False,0,0,Draw
27230,29176,31014,2009,United Arab Emirates,Uzbekistan,0,1,AFC Asian Cup qualification,Sharjah,United Arab Emirates,False,1,-1,Uzbekistan
27231,29177,31015,2009,Yemen,Hong Kong,1,0,AFC Asian Cup qualification,Sana'a,Yemen,False,1,1,Yemen
27232,29178,31016,2009,Nicaragua,Guatemala,2,0,UNCAF Cup,Tegucigalpa,Honduras,True,2,2,Nicaragua
27233,29179,31017,2009,Costa Rica,El Salvador,3,0,UNCAF Cup,Tegucigalpa,Honduras,True,3,3,Costa Rica
27234,29180,31018,2009,Honduras,Panama,0,1,UNCAF Cup,Tegucigalpa,Honduras,False,1,-1,Panama
27235,29181,31019,2009,Azerbaijan,Uzbekistan,1,1,Friendly,Dubai,United Arab Emirates,True,2,0,Draw
27236,29182,31020,2009,Costa Rica,Panama,0,0,UNCAF Cup,Tegucigalpa,Honduras,True,0,0,Draw
27237,29183,31021,2009,Honduras,El Salvador,1,0,UNCAF Cup,Tegucigalpa,Honduras,False,1,1,Honduras
27238,29186,31024,2009,Japan,Finland,5,1,Friendly,Tokyo,Japan,False,6,4,Japan
27239,29187,31025,2009,Saudi Arabia,Thailand,2,1,Friendly,Sendai,Japan,True,3,1,Saudi Arabia
27240,29188,31026,2009,El Salvador,Peru,1,0,Friendly,Los Angeles,United States,True,1,1,El Salvador
27241,29189,31027,2009,Lithuania,Poland,1,1,Friendly,Faro,Portugal,True,2,0,Draw
27242,29190,31028,2009,Barbados,Grenada,5,0,Friendly,Bridgetown,Barbados,False,5,5,Barbados
27243,29191,31029,2009,Brazil,Italy,2,0,Friendly,London,England,True,2,2,Brazil
27244,29192,31030,2009,Cyprus,Serbia,0,2,Cyprus International Tournament,Nicosia,Cyprus,False,2,-2,Serbia
27245,29193,31031,2009,Slovakia,Ukraine,2,3,Cyprus International Tournament,Limassol,Cyprus,True,5,-1,Ukraine
27246,29194,31032,2009,Algeria,Benin,2,1,Friendly,Algiers,Algeria,False,3,1,Algeria
27247,29195,31033,2009,Andorra,Lithuania,1,3,Friendly,Albufeira,Portugal,True,4,-2,Lithuania
27248,29196,31034,2009,Angola,Mali,0,4,Friendly,Bois-Guillaume,France,True,4,-4,Mali
27249,29197,31035,2009,Austria,Sweden,0,2,Friendly,Graz,Austria,False,2,-2,Sweden
27250,29198,31036,2009,Belgium,Slovenia,2,0,Friendly,Genk,Belgium,False,2,2,Belgium
27251,29199,31037,2009,Burkina Faso,Togo,1,1,Friendly,Le Petit-Quevilly,France,True,2,0,Draw
27252,29200,31038,2009,Cameroon,Guinea,3,1,Friendly,Évry/Bondoufle,France,True,4,2,Cameroon
27253,29201,31039,2009,Colombia,Haiti,2,0,Friendly,Pereira,Colombia,False,2,2,Colombia
27254,29202,31040,2009,Costa Rica,Honduras,2,0,FIFA World Cup qualification,San José,Costa Rica,False,2,2,Costa Rica
27255,29203,31041,2009,Cyprus,Slovakia,3,2,Cyprus International Tournament,Nicosia,Cyprus,False,5,1,Cyprus
27256,29204,31042,2009,Egypt,Ghana,2,2,Friendly,Cairo,Egypt,False,4,0,Draw
27257,29205,31043,2009,El Salvador,Trinidad and Tobago,2,2,FIFA World Cup qualification,San Salvador,El Salvador,False,4,0,Draw
27258,29206,31044,2009,Estonia,Kazakhstan,0,2,Friendly,Antalya,Turkey,True,2,-2,Kazakhstan
27259,29207,31045,2009,France,Argentina,0,2,Friendly,Marseille,France,False,2,-2,Argentina
27260,29208,31046,2009,Germany,Norway,0,1,Friendly,Düsseldorf,Germany,False,1,-1,Norway
27261,29209,31047,2009,Greece,Denmark,1,1,Friendly,Piraeus,Greece,False,2,0,Draw
27262,29211,31049,2009,Republic of Ireland,Georgia,2,1,FIFA World Cup qualification,Dublin,Republic of Ireland,False,3,1,Republic of Ireland
27263,29212,31050,2009,Israel,Hungary,1,0,Friendly,Ramat-Gan,Israel,False,1,1,Israel
27264,29213,31051,2009,Japan,Australia,0,0,FIFA World Cup qualification,Yokohama,Japan,False,0,0,Draw
27265,29214,31053,2009,Kuwait,Azerbaijan,1,1,Friendly,Kuwait City,Kuwait,False,2,0,Draw
27266,29215,31054,2009,Latvia,Armenia,0,0,Friendly,Limassol,Cyprus,True,0,0,Draw
27267,29216,31055,2009,Libya,Uruguay,2,3,Friendly,Tripoli,Libya,False,5,-1,Uruguay
27268,29217,31056,2009,Liechtenstein,Iceland,0,2,Friendly,Cartagena,Spain,True,2,-2,Iceland
27269,29218,31058,2009,Malta,Albania,0,0,FIFA World Cup qualification,Attard,Malta,False,0,0,Draw
27270,29219,31059,2009,Morocco,Czech Republic,0,0,Friendly,Casablanca,Morocco,False,0,0,Draw
27271,29220,31060,2009,Mozambique,Malawi,2,0,Friendly,Maputo,Mozambique,False,2,2,Mozambique
27272,29221,31061,2009,Nigeria,Jamaica,0,0,Friendly,London,England,True,0,0,Draw
27273,29222,31062,2009,Peru,Paraguay,0,1,Friendly,Lima,Peru,False,1,-1,Paraguay
27274,29223,31063,2009,Portugal,Finland,1,0,Friendly,Faro,Portugal,False,1,1,Portugal
27275,29224,31064,2009,Romania,Croatia,1,2,Friendly,Bucharest,Romania,False,3,-1,Croatia
27276,29225,31065,2009,San Marino,Northern Ireland,0,3,FIFA World Cup qualification,Serravalle,San Marino,False,3,-3,Northern Ireland
27277,29226,31066,2009,Serbia,Ukraine,0,1,Cyprus International Tournament,Nicosia,Cyprus,True,1,-1,Ukraine
27278,29227,31067,2009,South Africa,Chile,0,2,Friendly,Polokwane,South Africa,False,2,-2,Chile
27279,29228,31068,2009,Spain,England,2,0,Friendly,Seville,Spain,False,2,2,Spain
27280,29229,31069,2009,Switzerland,Bulgaria,1,1,Friendly,Geneva,Switzerland,False,2,0,Draw
27281,29230,31070,2009,Tanzania,Zimbabwe,0,0,Friendly,Dar es Salaam,Tanzania,False,0,0,Draw
27282,29231,31071,2009,Tunisia,Netherlands,1,1,Friendly,Radès,Tunisia,False,2,0,Draw
27283,29232,31072,2009,Turkey,Ivory Coast,1,1,Friendly,Izmir,Turkey,False,2,0,Draw
27284,29233,31073,2009,United States,Mexico,2,0,FIFA World Cup qualification,Columbus,United States,False,2,2,United States
27285,29234,31074,2009,Uzbekistan,Bahrain,0,1,FIFA World Cup qualification,Tashkent,Uzbekistan,False,1,-1,Bahrain
27286,29235,31075,2009,Venezuela,Guatemala,2,1,Friendly,Maturín,Venezuela,False,3,1,Venezuela
27287,29236,31076,2009,Wales,Poland,0,1,Friendly,Vila Real de Santo António,Portugal,True,1,-1,Poland
27288,29237,31077,2009,Australia,Kuwait,0,1,AFC Asian Cup qualification,Canberra,Australia,False,1,-1,Kuwait
27289,29238,31078,2009,Sudan,Uganda,0,2,Friendly,Khartoum,Sudan,False,2,-2,Uganda
27290,29239,31079,2009,Guam,Mongolia,1,0,EAFF Championship,Yona,Guam,False,1,1,Guam
27291,29240,31080,2009,Macau,Northern Mariana Islands,6,1,EAFF Championship,Yona,Guam,True,7,5,Macau
27292,29241,31081,2009,Mexico,Bolivia,5,1,Friendly,Commerce City,United States,True,6,4,Mexico
27293,29242,31082,2009,Nepal,Pakistan,1,0,Friendly,Kathmandu,Nepal,False,1,1,Nepal
27294,29243,31083,2009,Guam,Northern Mariana Islands,2,1,EAFF Championship,Yona,Guam,False,3,1,Guam
27295,29244,31084,2009,Macau,Mongolia,1,2,EAFF Championship,Yona,Guam,True,3,-1,Mongolia
27296,29245,31085,2009,Iran,Kenya,1,0,Friendly,Teheran,Iran,False,1,1,Iran
27297,29246,31086,2009,Nepal,Sri Lanka,4,2,Friendly,Kathmandu,Nepal,False,6,2,Nepal
27298,29247,31087,2009,Guam,Macau,2,2,EAFF Championship,Yona,Guam,False,4,0,Draw
27299,29248,31088,2009,Northern Mariana Islands,Mongolia,1,4,EAFF Championship,Yona,Guam,True,5,-3,Mongolia
27300,29249,31089,2009,Qatar,Kuwait,1,0,Friendly,Doha,Qatar,False,1,1,Qatar
27301,29250,31090,2009,Trinidad and Tobago,Panama,1,0,Friendly,San Fernando,Trinidad and Tobago,False,1,1,Trinidad and Tobago
27302,29251,31091,2009,Namibia,Botswana,0,0,Friendly,Keetmanshoop,Namibia,False,0,0,Draw
27303,29252,31092,2009,Syria,Qatar,1,2,Friendly,Aleppo,Syria,False,3,-1,Qatar
27304,29253,31093,2009,Uganda,Malawi,2,1,Friendly,Kampala,Uganda,False,3,1,Uganda
27305,29254,31094,2009,Iceland,Faroe Islands,1,2,Friendly,Kópavogur,Iceland,False,3,-1,Faroe Islands
27306,29255,31095,2009,Saudi Arabia,Iraq,0,0,Friendly,Riyadh,Saudi Arabia,False,0,0,Draw
27307,29256,31096,2009,Bahrain,Zimbabwe,5,2,Friendly,Riffa,Bahrain,False,7,3,Bahrain
27308,29257,31097,2009,Kuwait,Iran,0,1,Friendly,Kuwait City,Kuwait,False,1,-1,Iran
27309,29259,31099,2009,Nepal,Palestine,0,0,AFC Challenge Cup qualification,Kathmandu,Nepal,False,0,0,Draw
27310,29260,31100,2009,Albania,Hungary,0,1,FIFA World Cup qualification,Tirana,Albania,False,1,-1,Hungary
27311,29261,31101,2009,Argentina,Venezuela,4,0,FIFA World Cup qualification,Buenos Aires,Argentina,False,4,4,Argentina
27312,29262,31102,2009,Armenia,Estonia,2,2,FIFA World Cup qualification,Yerevan,Armenia,False,4,0,Draw
27313,29263,31103,2009,Belgium,Bosnia and Herzegovina,2,4,FIFA World Cup qualification,Genk,Belgium,False,6,-2,Bosnia and Herzegovina
27314,29264,31104,2009,Burkina Faso,Guinea,4,2,FIFA World Cup qualification,Ouagadougou,Burkina Faso,False,6,2,Burkina Faso
27315,29265,31106,2009,Colombia,Bolivia,2,0,FIFA World Cup qualification,Bogotá,Colombia,False,2,2,Colombia
27316,29266,31107,2009,Cyprus,Georgia,2,1,FIFA World Cup qualification,Larnaca,Cyprus,False,3,1,Cyprus
27317,29267,31108,2009,El Salvador,United States,2,2,FIFA World Cup qualification,San Salvador,El Salvador,False,4,0,Draw
27318,29268,31109,2009,England,Slovakia,4,0,Friendly,London,England,False,4,4,England
27319,29269,31110,2009,Germany,Liechtenstein,4,0,FIFA World Cup qualification,Leipzig,Germany,False,4,4,Germany
27320,29270,31111,2009,Iran,Saudi Arabia,1,2,FIFA World Cup qualification,Teheran,Iran,False,3,-1,Saudi Arabia
27321,29271,31112,2009,Republic of Ireland,Bulgaria,1,1,FIFA World Cup qualification,Dublin,Republic of Ireland,False,2,0,Draw
27322,29272,31113,2009,Israel,Greece,1,1,FIFA World Cup qualification,Ramat-Gan,Israel,False,2,0,Draw
27323,29273,31114,2009,Japan,Bahrain,1,0,FIFA World Cup qualification,Saitama,Japan,False,1,1,Japan
27324,29274,31115,2009,Kenya,Tunisia,1,2,FIFA World Cup qualification,Nairobi,Kenya,False,3,-1,Tunisia
27325,29275,31118,2009,Lithuania,France,0,1,FIFA World Cup qualification,Kaunas,Lithuania,False,1,-1,France
27326,29276,31119,2009,Luxembourg,Latvia,0,4,FIFA World Cup qualification,Luxembourg,Luxembourg,False,4,-4,Latvia
27327,29277,31120,2009,Malta,Denmark,0,3,FIFA World Cup qualification,Attard,Malta,False,3,-3,Denmark
27328,29278,31121,2009,Mexico,Costa Rica,2,0,FIFA World Cup qualification,Mexico City,Mexico,False,2,2,Mexico
27329,29279,31122,2009,Moldova,Switzerland,0,2,FIFA World Cup qualification,Chişinău,Moldova,False,2,-2,Switzerland
27330,29280,31123,2009,Montenegro,Italy,0,2,FIFA World Cup qualification,Podgorica,Montenegro,False,2,-2,Italy
27331,29281,31124,2009,Morocco,Gabon,1,2,FIFA World Cup qualification,Casablanca,Morocco,False,3,-1,Gabon
27332,29282,31125,2009,Nepal,Kyrgyzstan,1,1,AFC Challenge Cup qualification,Kathmandu,Nepal,False,2,0,Draw
27333,29283,31126,2009,Netherlands,Scotland,3,0,FIFA World Cup qualification,Amsterdam,Netherlands,False,3,3,Netherlands
27334,29284,31127,2009,Northern Ireland,Poland,3,2,FIFA World Cup qualification,Belfast,Northern Ireland,False,5,1,Northern Ireland
27335,29285,31128,2009,Oman,Senegal,2,0,Friendly,Muscat,Oman,False,2,2,Oman
27336,29286,31129,2009,Portugal,Sweden,0,0,FIFA World Cup qualification,Porto,Portugal,False,0,0,Draw
27337,29287,31130,2009,Romania,Serbia,2,3,FIFA World Cup qualification,Constanţa,Romania,False,5,-1,Serbia
27338,29288,31131,2009,Russia,Azerbaijan,2,0,FIFA World Cup qualification,Moscow,Russia,False,2,2,Russia
27339,29289,31132,2009,Rwanda,Algeria,0,0,FIFA World Cup qualification,Kigali,Rwanda,False,0,0,Draw
27340,29290,31133,2009,Slovenia,Czech Republic,0,0,FIFA World Cup qualification,Maribor,Slovenia,False,0,0,Draw
27341,29291,31134,2009,South Africa,Norway,2,1,Friendly,Rustenburg,South Africa,False,3,1,South Africa
27342,29292,31135,2009,Spain,Turkey,1,0,FIFA World Cup qualification,Madrid,Spain,False,1,1,Spain
27343,29293,31136,2009,Sri Lanka,Maldives,1,1,Friendly,Colombo,Sri Lanka,False,2,0,Draw
27344,29294,31137,2009,Sudan,Mali,1,1,FIFA World Cup qualification,Omdurman,Sudan,False,2,0,Draw
27345,29295,31138,2009,Thailand,New Zealand,3,1,Friendly,Bangkok,Thailand,False,4,2,Thailand
27346,29296,31139,2009,Togo,Cameroon,1,0,FIFA World Cup qualification,Accra,Ghana,True,1,1,Togo
27347,29297,31140,2009,Trinidad and Tobago,Honduras,1,1,FIFA World Cup qualification,Port of Spain,Trinidad and Tobago,False,2,0,Draw
27348,29298,31141,2009,Uruguay,Paraguay,2,0,FIFA World Cup qualification,Montevideo,Uruguay,False,2,2,Uruguay
27349,29299,31142,2009,Uzbekistan,Qatar,4,0,FIFA World Cup qualification,Tashkent,Uzbekistan,False,4,4,Uzbekistan
27350,29300,31143,2009,Wales,Finland,0,2,FIFA World Cup qualification,Cardiff,Wales,False,2,-2,Finland
27351,29301,31144,2009,Ivory Coast,Malawi,5,0,FIFA World Cup qualification,Abidjan,Ivory Coast,False,5,5,Ivory Coast
27352,29302,31145,2009,Kyrgyzstan,Palestine,1,1,AFC Challenge Cup qualification,Kathmandu,Nepal,True,2,0,Draw
27353,29303,31146,2009,Angola,Morocco,0,2,Friendly,Lisbon,Portugal,True,2,-2,Morocco
27354,29304,31147,2009,Panama,Haiti,4,0,Friendly,La Chorrera,Panama,False,4,4,Panama
27355,29305,31148,2009,Portugal,South Africa,2,0,Friendly,Lausanne,Switzerland,True,2,2,Portugal
27356,29306,31149,2009,Venezuela,Colombia,2,0,FIFA World Cup qualification,Puerto Ordaz,Venezuela,False,2,2,Venezuela
27357,29307,31150,2009,Andorra,Croatia,0,2,FIFA World Cup qualification,Sant Julià de Lòria,Andorra,False,2,-2,Croatia
27358,29308,31151,2009,Australia,Uzbekistan,2,0,FIFA World Cup qualification,Sydney,Australia,False,2,2,Australia
27359,29309,31152,2009,Austria,Romania,2,1,FIFA World Cup qualification,Klagenfurt,Austria,False,3,1,Austria
27360,29310,31153,2009,Bahrain,Qatar,1,0,FIFA World Cup qualification,Riffa,Bahrain,False,1,1,Bahrain
27361,29311,31154,2009,Bosnia and Herzegovina,Belgium,2,1,FIFA World Cup qualification,Zenica,Bosnia and Herzegovina,False,3,1,Bosnia and Herzegovina
27362,29312,31155,2009,Bulgaria,Cyprus,2,0,FIFA World Cup qualification,Sofia,Bulgaria,False,2,2,Bulgaria
27363,29313,31156,2009,Costa Rica,El Salvador,1,0,FIFA World Cup qualification,San José,Costa Rica,False,1,1,Costa Rica
27364,29314,31157,2009,Czech Republic,Slovakia,1,2,FIFA World Cup qualification,Prague,Czech Republic,False,3,-1,Slovakia
27365,29315,31158,2009,Denmark,Albania,3,0,FIFA World Cup qualification,Copenhagen,Denmark,False,3,3,Denmark
27366,29316,31159,2009,England,Ukraine,2,1,FIFA World Cup qualification,London,England,False,3,1,England
27367,29317,31160,2009,Estonia,Armenia,1,0,FIFA World Cup qualification,Tallinn,Estonia,False,1,1,Estonia
27368,29318,31161,2009,France,Lithuania,1,0,FIFA World Cup qualification,Saint-Denis,France,False,1,1,France
27369,29319,31162,2009,Georgia,Montenegro,0,0,FIFA World Cup qualification,Tbilisi,Georgia,False,0,0,Draw
27370,29320,31163,2009,Greece,Israel,2,1,FIFA World Cup qualification,Heraklion,Greece,False,3,1,Greece
27371,29321,31164,2009,Honduras,Mexico,3,1,FIFA World Cup qualification,San Pedro Sula,Honduras,False,4,2,Honduras
27372,29322,31165,2009,Hungary,Malta,3,0,FIFA World Cup qualification,Budapest,Hungary,False,3,3,Hungary
27373,29323,31166,2009,Iran,Senegal,1,1,Friendly,Teheran,Iran,False,2,0,Draw
27374,29324,31167,2009,Italy,Republic of Ireland,1,1,FIFA World Cup qualification,Bari,Italy,False,2,0,Draw
27375,29325,31168,2009,Kazakhstan,Belarus,1,5,FIFA World Cup qualification,Almaty,Kazakhstan,False,6,-4,Belarus
27376,29326,31170,2009,Latvia,Luxembourg,2,0,FIFA World Cup qualification,Riga,Latvia,False,2,2,Latvia
27377,29327,31171,2009,Lebanon,Namibia,1,1,Friendly,Beirut,Lebanon,False,2,0,Draw
27378,29328,31172,2009,Lesotho,Botswana,0,0,Friendly,Maseru,Lesotho,False,0,0,Draw
27379,29329,31173,2009,Liechtenstein,Russia,0,1,FIFA World Cup qualification,Vaduz,Liechtenstein,False,1,-1,Russia
27380,29331,31175,2009,Northern Ireland,Slovenia,1,0,FIFA World Cup qualification,Belfast,Northern Ireland,False,1,1,Northern Ireland
27381,29332,31176,2009,Norway,Finland,3,2,Friendly,Oslo,Norway,False,5,1,Norway
27382,29333,31177,2009,Poland,San Marino,10,0,FIFA World Cup qualification,Kielce,Poland,False,10,10,Poland
27383,29334,31178,2009,Saudi Arabia,United Arab Emirates,3,2,FIFA World Cup qualification,Riyadh,Saudi Arabia,False,5,1,Saudi Arabia
27384,29335,31179,2009,Scotland,Iceland,2,1,FIFA World Cup qualification,Glasgow,Scotland,False,3,1,Scotland
27385,29336,31180,2009,Serbia,Sweden,2,0,Friendly,Belgrade,Serbia,False,2,2,Serbia
27386,29337,31181,2009,Switzerland,Moldova,2,0,FIFA World Cup qualification,Geneva,Switzerland,False,2,2,Switzerland
27387,29338,31182,2009,Turkey,Spain,1,2,FIFA World Cup qualification,Istanbul,Turkey,False,3,-1,Spain
27388,29339,31183,2009,United States,Trinidad and Tobago,3,0,FIFA World Cup qualification,Nashville,United States,False,3,3,United States
27389,29340,31184,2009,Wales,Germany,0,2,FIFA World Cup qualification,Cardiff,Wales,False,2,-2,Germany
27390,29341,31185,2009,Angola,Namibia,0,0,Friendly,Dundo,Angola,False,0,0,Draw
27391,29343,31187,2009,Sri Lanka,Brunei,5,1,AFC Challenge Cup qualification,Colombo,Sri Lanka,False,6,4,Sri Lanka
27392,29344,31188,2009,Brunei,Pakistan,0,6,AFC Challenge Cup qualification,Colombo,Sri Lanka,True,6,-6,Pakistan
27393,29345,31189,2009,Macau,Mongolia,2,0,AFC Challenge Cup qualification,Macau,Macau,False,2,2,Macau
27394,29346,31190,2009,Sri Lanka,Pakistan,2,2,AFC Challenge Cup qualification,Colombo,Sri Lanka,False,4,0,Draw
27395,29347,31191,2009,Maldives,Turkmenistan,1,3,AFC Challenge Cup qualification,Malé,Maldives,False,4,-2,Turkmenistan
27396,29348,31192,2009,Mongolia,Macau,3,1,AFC Challenge Cup qualification,Ulaanbaatar,Mongolia,False,4,2,Mongolia
27397,29349,31193,2009,Philippines,Bhutan,1,0,AFC Challenge Cup qualification,Malé,Maldives,True,1,1,Philippines
27398,29350,31194,2009,Bhutan,Turkmenistan,0,7,AFC Challenge Cup qualification,Malé,Maldives,True,7,-7,Turkmenistan
27399,29351,31195,2009,Maldives,Philippines,3,2,AFC Challenge Cup qualification,Malé,Maldives,False,5,1,Maldives
27400,29352,31196,2009,Maldives,Bhutan,5,0,AFC Challenge Cup qualification,Malé,Maldives,False,5,5,Maldives
27401,29353,31197,2009,Turkmenistan,Philippines,5,0,AFC Challenge Cup qualification,Malé,Maldives,True,5,5,Turkmenistan
27402,29354,31198,2009,French Guiana,Suriname,0,0,Friendly,Cayenne,French Guiana,False,0,0,Draw
27403,29355,31199,2009,Bangladesh,Cambodia,1,0,AFC Challenge Cup qualification,Dhaka,Bangladesh,False,1,1,Bangladesh
27404,29356,31200,2009,Burma,Macau,4,0,AFC Challenge Cup qualification,Dhaka,Bangladesh,True,4,4,Burma
27405,29357,31201,2009,Bangladesh,Burma,1,2,AFC Challenge Cup qualification,Dhaka,Bangladesh,False,3,-1,Burma
27406,29358,31202,2009,Macau,Cambodia,1,2,AFC Challenge Cup qualification,Dhaka,Bangladesh,True,3,-1,Cambodia
27407,29359,31203,2009,Bangladesh,Macau,3,0,AFC Challenge Cup qualification,Dhaka,Bangladesh,False,3,3,Bangladesh
27408,29360,31204,2009,Burma,Cambodia,1,0,AFC Challenge Cup qualification,Dhaka,Bangladesh,True,1,1,Burma
27409,29361,31205,2009,Guernsey,Jersey,0,1,Friendly,St. Sampson,Guernsey,False,1,-1,Jersey
27410,29362,31206,2009,Tanzania,DR Congo,0,2,Friendly,Dar es Salaam,Tanzania,False,2,-2,DR Congo
27411,29363,31207,2009,Jordan,Zimbabwe,2,0,Friendly,Amman,Jordan,False,2,2,Jordan
27412,29364,31208,2009,Venezuela,Costa Rica,1,1,Friendly,San Cristóbal,Venezuela,False,2,0,Draw
27413,29365,31209,2009,Argentina,Panama,3,1,Friendly,Santa Fe,Argentina,False,4,2,Argentina
27414,29366,31210,2009,Jamaica,Haiti,2,2,Friendly,Fort Lauderdale,United States,True,4,0,Draw
27415,29367,31211,2009,Qatar,Saudi Arabia,2,1,Friendly,Doha,Qatar,False,3,1,Qatar
27416,29368,31212,2009,El Salvador,Ecuador,3,1,Friendly,Los Angeles,United States,True,4,2,El Salvador
27417,29369,31213,2009,Japan,Chile,4,0,Kirin Cup,Osaka,Japan,False,4,4,Japan
27418,29370,31214,2009,Jordan,Congo,1,1,Friendly,Amman,Jordan,False,2,0,Draw
27419,29371,31215,2009,Tunisia,Sudan,4,0,Friendly,Radès,Tunisia,False,4,4,Tunisia
27420,29372,31216,2009,Belgium,Chile,1,1,Kirin Cup,Chiba,Japan,True,2,0,Draw
27421,29373,31218,2009,Republic of Ireland,Nigeria,1,1,Friendly,London,England,True,2,0,Draw
27422,29374,31219,2009,Wales,Estonia,1,0,Friendly,Llanelli,Wales,False,1,1,Wales
27423,29375,31220,2009,Cyprus,Canada,0,1,Friendly,Larnaca,Cyprus,False,1,-1,Canada
27424,29376,31221,2009,El Salvador,Jamaica,0,0,Friendly,Washington,United States,True,0,0,Draw
27425,29377,31222,2009,Oman,Egypt,0,1,Friendly,Muscat,Oman,False,1,-1,Egypt
27426,29378,31223,2009,Bahrain,Congo,3,1,Friendly,Riffa,Bahrain,False,4,2,Bahrain
27427,29379,31224,2009,Ghana,Uganda,2,1,Friendly,Tamale,Ghana,False,3,1,Ghana
27428,29380,31225,2009,Japan,Belgium,4,0,Kirin Cup,Tokyo,Japan,False,4,4,Japan
27429,29381,31226,2009,Kuwait,Vietnam,0,1,Friendly,Kuwait City,Kuwait,False,1,-1,Vietnam
27430,29382,31227,2009,Malawi,Rwanda,2,0,Friendly,Blantyre,Malawi,False,2,2,Malawi
27431,29383,31228,2009,Qatar,Iraq,1,0,Friendly,Doha,Qatar,False,1,1,Qatar
27432,29384,31230,2009,Uzbekistan,Bosnia and Herzegovina,0,0,Friendly,Tashkent,Uzbekistan,False,0,0,Draw
27433,29385,31231,2009,France,Nigeria,0,1,Friendly,Saint-Étienne,France,False,1,-1,Nigeria
27434,29386,31232,2009,Turkey,Azerbaijan,2,0,Friendly,Kayseri,Turkey,False,2,2,Turkey
27435,29387,31233,2009,United Arab Emirates,Germany,2,7,Friendly,Dubai,United Arab Emirates,False,9,-5,Germany
27436,29388,31234,2009,Antigua and Barbuda,Guyana,2,1,Friendly,Paramaribo,Suriname,True,3,1,Antigua and Barbuda
27437,29389,31235,2009,Bahrain,Jordan,4,0,Friendly,Riffa,Bahrain,False,4,4,Bahrain
27438,29390,31236,2009,Costa Rica,United States,3,1,FIFA World Cup qualification,San José,Costa Rica,False,4,2,Costa Rica
27439,29391,31237,2009,Tanzania,New Zealand,2,1,Friendly,Dar es Salaam,Tanzania,False,3,1,Tanzania
27440,29392,31239,2009,Antigua and Barbuda,French Guiana,1,2,Friendly,Paramaribo,Suriname,True,3,-1,French Guiana
27441,29393,31240,2009,Czech Republic,Malta,1,0,Friendly,Jablonec nad Nisou nad Nisou,Czech Republic,False,1,1,Czech Republic
27442,29394,31241,2009,France,Turkey,1,0,Friendly,Lyon,France,False,1,1,France
27443,29395,31242,2009,Albania,Portugal,1,2,FIFA World Cup qualification,Tirana,Albania,False,3,-1,Portugal
27444,29396,31243,2009,Argentina,Colombia,1,0,FIFA World Cup qualification,Buenos Aires,Argentina,False,1,1,Argentina
27445,29397,31244,2009,Azerbaijan,Wales,0,1,FIFA World Cup qualification,Baku,Azerbaijan,False,1,-1,Wales
27446,29398,31245,2009,Belarus,Andorra,5,1,FIFA World Cup qualification,Hrodna,Belarus,False,6,4,Belarus
27447,29399,31246,2009,Bolivia,Venezuela,0,1,FIFA World Cup qualification,La Paz,Bolivia,False,1,-1,Venezuela
27448,29400,31247,2009,Botswana,New Zealand,0,0,Friendly,Gaborone,Botswana,False,0,0,Draw
27449,29401,31248,2009,Bulgaria,Republic of Ireland,1,1,FIFA World Cup qualification,Sofia,Bulgaria,False,2,0,Draw
27450,29402,31249,2009,Croatia,Ukraine,2,2,FIFA World Cup qualification,Zagreb,Croatia,False,4,0,Draw
27451,29403,31250,2009,Cyprus,Montenegro,2,2,FIFA World Cup qualification,Larnaca,Cyprus,False,4,0,Draw
27452,29404,31251,2009,El Salvador,Mexico,2,1,FIFA World Cup qualification,San Salvador,El Salvador,False,3,1,El Salvador
27453,29405,31252,2009,Estonia,Equatorial Guinea,3,0,Friendly,Tallinn,Estonia,False,3,3,Estonia
27454,29406,31253,2009,Finland,Liechtenstein,2,1,FIFA World Cup qualification,Helsinki,Finland,False,3,1,Finland
27455,29407,31254,2009,Gabon,Togo,3,0,FIFA World Cup qualification,Libreville,Gabon,False,3,3,Gabon
27456,29408,31255,2009,Georgia,Moldova,1,2,Friendly,Tbilisi,Georgia,False,3,-1,Moldova
27457,29409,31256,2009,Iceland,Netherlands,1,2,FIFA World Cup qualification,Reykjavík,Iceland,False,3,-1,Netherlands
27458,29410,31257,2009,Italy,Northern Ireland,3,0,Friendly,Pisa,Italy,False,3,3,Italy
27459,29411,31258,2009,Kazakhstan,England,0,4,FIFA World Cup qualification,Almaty,Kazakhstan,False,4,-4,England
27460,29412,31260,2009,Lithuania,Romania,0,1,FIFA World Cup qualification,Marijampolė,Lithuania,False,1,-1,Romania
27461,29413,31262,2009,Malawi,Burkina Faso,0,1,FIFA World Cup qualification,Blantyre,Malawi,False,1,-1,Burkina Faso
27462,29414,31263,2009,Namibia,DR Congo,4,0,Friendly,Windhoek,Namibia,False,4,4,Namibia
27463,29415,31264,2009,Paraguay,Chile,0,2,FIFA World Cup qualification,Asunción,Paraguay,False,2,-2,Chile
27464,29416,31265,2009,Qatar,Australia,0,0,FIFA World Cup qualification,Doha,Qatar,False,0,0,Draw
27465,29417,31266,2009,Serbia,Austria,1,0,FIFA World Cup qualification,Belgrade,Serbia,False,1,1,Serbia
27466,29418,31267,2009,Slovakia,San Marino,7,0,FIFA World Cup qualification,Bratislava,Slovakia,False,7,7,Slovakia
27467,29419,31268,2009,South Africa,Poland,1,0,Friendly,Johannesburg,South Africa,False,1,1,South Africa
27468,29420,31269,2009,Sweden,Denmark,0,1,FIFA World Cup qualification,Solna,Sweden,False,1,-1,Denmark
27469,29421,31270,2009,Trinidad and Tobago,Costa Rica,2,3,FIFA World Cup qualification,Scarborough,Trinidad and Tobago,False,5,-1,Costa Rica
27470,29422,31271,2009,Tunisia,Mozambique,2,0,FIFA World Cup qualification,Radès,Tunisia,False,2,2,Tunisia
27471,29424,31273,2009,Uruguay,Brazil,0,4,FIFA World Cup qualification,Montevideo,Uruguay,False,4,-4,Brazil
27472,29425,31274,2009,United States,Honduras,2,1,FIFA World Cup qualification,Chicago,United States,False,3,1,United States
27473,29426,31275,2009,Uzbekistan,Japan,0,1,FIFA World Cup qualification,Tashkent,Uzbekistan,False,1,-1,Japan
27474,29427,31276,2009,Zambia,Rwanda,1,0,FIFA World Cup qualification,Chililabombwe,Zambia,False,1,1,Zambia
27475,29428,31278,2009,Guinea,Ivory Coast,1,2,FIFA World Cup qualification,Conakry,Guinea,False,3,-1,Ivory Coast
27476,29429,31279,2009,Guyana,French Guiana,2,3,Friendly,Paramaribo,Suriname,True,5,-1,French Guiana
27477,29430,31280,2009,Jamaica,Panama,3,2,Friendly,Kingston,Jamaica,False,5,1,Jamaica
27478,29431,31281,2009,Azerbaijan,Spain,0,6,Friendly,Baku,Azerbaijan,False,6,-6,Spain
27479,29432,31282,2009,Bosnia and Herzegovina,Oman,2,1,Friendly,Cannes,France,True,3,1,Bosnia and Herzegovina
27480,29433,31283,2009,Iraq,Poland,1,1,Friendly,Cape Town,South Africa,True,2,0,Draw
27481,29434,31284,2009,Albania,Georgia,1,1,Friendly,Tirana,Albania,False,2,0,Draw
27482,29435,31285,2009,Australia,Bahrain,2,0,FIFA World Cup qualification,Sydney,Australia,False,2,2,Australia
27483,29436,31286,2009,Belarus,Moldova,2,2,Friendly,Barysaw,Belarus,False,4,0,Draw
27484,29437,31287,2009,Brazil,Paraguay,2,1,FIFA World Cup qualification,Recife,Brazil,False,3,1,Brazil
27485,29438,31288,2009,Chile,Bolivia,4,0,FIFA World Cup qualification,Santiago,Chile,False,4,4,Chile
27486,29439,31289,2009,Colombia,Peru,1,0,FIFA World Cup qualification,Medellín,Colombia,False,1,1,Colombia
27487,29440,31290,2009,Ecuador,Argentina,2,0,FIFA World Cup qualification,Quito,Ecuador,False,2,2,Ecuador
27488,29441,31291,2009,England,Andorra,6,0,FIFA World Cup qualification,London,England,False,6,6,England
27489,29442,31292,2009,Estonia,Portugal,0,0,Friendly,Tallinn,Estonia,False,0,0,Draw
27490,29443,31293,2009,Faroe Islands,Serbia,0,2,FIFA World Cup qualification,Tórshavn,Faroe Islands,False,2,-2,Serbia
27491,29444,31294,2009,Finland,Russia,0,3,FIFA World Cup qualification,Helsinki,Finland,False,3,-3,Russia
27492,29445,31295,2009,Honduras,El Salvador,1,0,FIFA World Cup qualification,San Pedro Sula,Honduras,False,1,1,Honduras
27493,29446,31296,2009,Iran,United Arab Emirates,1,0,FIFA World Cup qualification,Teheran,Iran,False,1,1,Iran
27494,29447,31297,2009,Italy,New Zealand,4,3,Friendly,Atteridgeville,South Africa,True,7,1,Italy
27495,29448,31298,2009,Japan,Qatar,1,1,FIFA World Cup qualification,Yokohama,Japan,False,2,0,Draw
27496,29449,31301,2009,Mexico,Trinidad and Tobago,2,1,FIFA World Cup qualification,Mexico City,Mexico,False,3,1,Mexico
27497,29450,31302,2009,Netherlands,Norway,2,0,FIFA World Cup qualification,Rotterdam,Netherlands,False,2,2,Netherlands
27498,29451,31303,2009,Sweden,Malta,4,0,FIFA World Cup qualification,Gothenburg,Sweden,False,4,4,Sweden
27499,29452,31304,2009,Ukraine,Kazakhstan,2,1,FIFA World Cup qualification,Kyïv,Ukraine,False,3,1,Ukraine
27500,29453,31305,2009,Venezuela,Uruguay,2,2,FIFA World Cup qualification,Puerto Ordaz,Venezuela,False,4,0,Draw
27501,29454,31306,2009,Tonga,Cook Islands,1,1,Friendly,Ha'ateiho,Tonga,False,2,0,Draw
27502,29455,31307,2009,Ivory Coast,Cameroon,2,1,Friendly,Abidjan,Ivory Coast,False,3,1,Ivory Coast
27503,29456,31308,2009,Tonga,Cook Islands,1,2,Friendly,Ha'ateiho,Tonga,False,3,-1,Cook Islands
27504,29457,31309,2009,Madagascar,Mayotte,2,0,Friendly,Mahajanga,Madagascar,False,2,2,Madagascar
27505,29458,31310,2009,New Zealand,Spain,0,5,Confederations Cup,Rustenburg,South Africa,True,5,-5,Spain
27506,29459,31311,2009,South Africa,Iraq,0,0,Confederations Cup,Johannesburg,South Africa,False,0,0,Draw
27507,29460,31312,2009,Brazil,Egypt,4,3,Confederations Cup,Bloemfontein,South Africa,True,7,1,Brazil
27508,29461,31313,2009,United States,Italy,1,3,Confederations Cup,Pretoria,South Africa,True,4,-2,Italy
27509,29462,31314,2009,Australia,Japan,2,1,FIFA World Cup qualification,Melbourne,Australia,False,3,1,Australia
27510,29463,31315,2009,Bahrain,Uzbekistan,1,0,FIFA World Cup qualification,Riffa,Bahrain,False,1,1,Bahrain
27511,29465,31318,2009,South Africa,New Zealand,2,0,Confederations Cup,Rustenburg,South Africa,False,2,2,South Africa
27512,29466,31319,2009,Spain,Iraq,1,0,Confederations Cup,Bloemfontein,South Africa,True,1,1,Spain
27513,29467,31320,2009,Egypt,Italy,1,0,Confederations Cup,Johannesburg,South Africa,True,1,1,Egypt
27514,29468,31321,2009,United States,Brazil,0,3,Confederations Cup,Pretoria,South Africa,True,3,-3,Brazil
27515,29469,31322,2009,Haiti,Panama,1,1,Friendly,Port-au-Prince,Haiti,False,2,0,Draw
27516,29470,31323,2009,Eswatini,Lesotho,1,1,Friendly,Manzini,Eswatini,False,2,0,Draw
27517,29471,31324,2009,Burkina Faso,Ivory Coast,2,3,FIFA World Cup qualification,Ouagadougou,Burkina Faso,False,5,-1,Ivory Coast
27518,29472,31325,2009,Iraq,New Zealand,0,0,Confederations Cup,Johannesburg,South Africa,True,0,0,Draw
27519,29473,31326,2009,Kenya,Mozambique,2,1,FIFA World Cup qualification,Nairobi,Kenya,False,3,1,Kenya
27520,29474,31327,2009,Morocco,Togo,0,0,FIFA World Cup qualification,Rabat,Morocco,False,0,0,Draw
27521,29475,31328,2009,South Africa,Spain,0,2,Confederations Cup,Bloemfontein,South Africa,False,2,-2,Spain
27522,29476,31329,2009,Sudan,Ghana,0,2,FIFA World Cup qualification,Omdurman,Sudan,False,2,-2,Ghana
27523,29477,31330,2009,Tunisia,Nigeria,0,0,FIFA World Cup qualification,Radès,Tunisia,False,0,0,Draw
27524,29478,31331,2009,Zambia,Algeria,0,2,FIFA World Cup qualification,Chililabombwe,Zambia,False,2,-2,Algeria
27525,29479,31332,2009,Egypt,United States,0,3,Confederations Cup,Rustenburg,South Africa,True,3,-3,United States
27526,29480,31333,2009,Italy,Brazil,0,3,Confederations Cup,Pretoria,South Africa,True,3,-3,Brazil
27527,29481,31334,2009,Eswatini,Lesotho,1,1,Friendly,Lobamba,Eswatini,False,2,0,Draw
27528,29482,31337,2009,Haiti,Martinique,0,0,Friendly,Saint-Marc,Haiti,False,0,0,Draw
27529,29483,31340,2009,Mexico,Venezuela,4,0,Friendly,Atlanta,United States,True,4,4,Mexico
27530,29484,31341,2009,Spain,United States,0,2,Confederations Cup,Bloemfontein,South Africa,True,2,-2,United States
27531,29485,31344,2009,South Africa,Brazil,0,1,Confederations Cup,Johannesburg,South Africa,False,1,-1,Brazil
27532,29486,31349,2009,Costa Rica,Venezuela,1,0,Friendly,San José,Costa Rica,False,1,1,Costa Rica
27533,29487,31350,2009,Haiti,Syria,1,2,Friendly,Montréal,Canada,True,3,-1,Syria
27534,29488,31352,2009,Cayman Islands,Jamaica,1,4,Friendly,George Town,Cayman Islands,False,5,-3,Jamaica
27535,29489,31353,2009,Grenada,Antigua and Barbuda,2,2,Friendly,St. George's,Grenada,False,4,0,Draw
27536,29490,31354,2009,Mexico,Guatemala,0,0,Friendly,San Diego,United States,True,0,0,Draw
27537,29491,31355,2009,Panama,Honduras,0,2,Friendly,Cary,United States,True,2,-2,Honduras
27538,29492,31356,2009,South Africa,Spain,2,3,Confederations Cup,Rustenburg,South Africa,False,5,-1,Spain
27539,29493,31357,2009,United States,Brazil,2,3,Confederations Cup,Johannesburg,South Africa,True,5,-1,Brazil
27540,29494,31358,2009,Åland Islands,Greenland,4,2,Island Games,Mariehamn,Sweden,False,6,2,Åland Islands
27541,29495,31360,2009,Gibraltar,Guernsey,0,0,Island Games,Eckerö,Sweden,True,0,0,Draw
27542,29496,31365,2009,Falkland Islands,Isle of Man,1,2,Island Games,Eckerö,Sweden,True,3,-1,Isle of Man
27543,29500,31374,2009,Guatemala,Canada,0,3,Friendly,Oxnard,United States,True,3,-3,Canada
27544,29508,31386,2009,Åland Islands,Isle of Man,2,1,Island Games,Jomala,Sweden,False,3,1,Åland Islands
27545,29509,31387,2009,Guernsey,Jersey,0,2,Island Games,Sund,Sweden,True,2,-2,Jersey
27546,29510,31388,2009,Canada,Jamaica,1,0,Gold Cup,Carson,United States,True,1,1,Canada
27547,29511,31389,2009,Costa Rica,El Salvador,1,2,Gold Cup,Carson,United States,True,3,-1,El Salvador
27548,29513,31393,2009,Isle of Man,Guernsey,0,5,Island Games,Eckerö,Sweden,True,5,-5,Guernsey
27549,29514,31394,2009,Åland Islands,Jersey,1,2,Island Games,Mariehamn,Sweden,False,3,-1,Jersey
27550,29515,31395,2009,Honduras,Haiti,1,0,Gold Cup,Seattle,United States,True,1,1,Honduras
27551,29516,31396,2009,United States,Grenada,4,0,Gold Cup,Seattle,United States,False,4,4,United States
27552,29517,31397,2009,Botswana,Iran,1,1,Friendly,Gaborone,Botswana,False,2,0,Draw
27553,29518,31398,2009,Egypt,Rwanda,3,0,FIFA World Cup qualification,Cairo,Egypt,False,3,3,Egypt
27554,29519,31399,2009,Nicaragua,Mexico,0,2,Gold Cup,Oakland,United States,True,2,-2,Mexico
27555,29520,31400,2009,Panama,Guadeloupe,1,2,Gold Cup,Oakland,United States,True,3,-1,Guadeloupe
27556,29521,31401,2009,Malawi,Eswatini,3,1,Friendly,Blantyre,Malawi,False,4,2,Malawi
27557,29522,31402,2009,El Salvador,Canada,0,1,Gold Cup,Columbus,United States,True,1,-1,Canada
27558,29523,31403,2009,Jamaica,Costa Rica,0,1,Gold Cup,Columbus,United States,True,1,-1,Costa Rica
27559,29524,31404,2009,Haiti,Grenada,2,0,Gold Cup,Washington,United States,True,2,2,Haiti
27560,29525,31405,2009,United States,Honduras,2,0,Gold Cup,Washington,United States,False,2,2,United States
27561,29526,31406,2009,Guadeloupe,Nicaragua,2,0,Gold Cup,Houston,United States,True,2,2,Guadeloupe
27562,29527,31407,2009,Mexico,Panama,1,1,Gold Cup,Houston,United States,True,2,0,Draw
27563,29528,31408,2009,Costa Rica,Canada,2,2,Gold Cup,Miami,United States,True,4,0,Draw
27564,29529,31409,2009,El Salvador,Jamaica,0,1,Gold Cup,Miami,United States,True,1,-1,Jamaica
27565,29530,31410,2009,Iraq,Palestine,3,0,Friendly,Arbil,Iraq,False,3,3,Iraq
27566,29531,31411,2009,Honduras,Grenada,4,0,Gold Cup,Foxborough,United States,True,4,4,Honduras
27567,29532,31412,2009,United States,Haiti,2,2,Gold Cup,Foxborough,United States,False,4,0,Draw
27568,29533,31413,2009,Mayotte,Madagascar,2,2,Friendly,Mamoudzou,Mayotte,False,4,0,Draw
27569,29534,31414,2009,Mexico,Guadeloupe,2,0,Gold Cup,Glendale,United States,True,2,2,Mexico
27570,29535,31415,2009,Panama,Nicaragua,4,0,Gold Cup,Glendale,United States,True,4,4,Panama
27571,29536,31416,2009,Saint Kitts and Nevis,Trinidad and Tobago,2,3,Friendly,Basseterre,Saint Kitts and Nevis,False,5,-1,Trinidad and Tobago
27572,29537,31417,2009,Iraq,Palestine,4,0,Friendly,Baghdad,Iraq,False,4,4,Iraq
27573,29538,31418,2009,Canada,Honduras,0,1,Gold Cup,Philadelphia,United States,True,1,-1,Honduras
27574,29539,31420,2009,United States,Panama,2,1,Gold Cup,Philadelphia,United States,False,3,1,United States
27575,29540,31421,2009,Guadeloupe,Costa Rica,1,5,Gold Cup,Arlington,United States,True,6,-4,Costa Rica
27576,29541,31422,2009,Mexico,Haiti,4,0,Gold Cup,Arlington,United States,True,4,4,Mexico
27577,29542,31423,2009,Costa Rica,Mexico,1,1,Gold Cup,Chicago,United States,True,2,0,Draw
27578,29543,31424,2009,United States,Honduras,2,0,Gold Cup,Chicago,United States,False,2,2,United States
27579,29544,31426,2009,United States,Mexico,0,5,Gold Cup,East Rutherford,United States,False,5,-5,Mexico
27580,29545,31427,2009,Colombia,El Salvador,2,1,Friendly,Houston,United States,True,3,1,Colombia
27581,29546,31428,2009,Benin,Gabon,1,1,Friendly,Dieppe,France,True,2,0,Draw
27582,29547,31429,2009,Albania,Cyprus,6,1,Friendly,Tirana,Albania,False,7,5,Albania
27583,29548,31430,2009,Algeria,Uruguay,1,0,Friendly,Algiers,Algeria,False,1,1,Algeria
27584,29549,31431,2009,Armenia,Moldova,1,4,Friendly,Yerevan,Armenia,False,5,-3,Moldova
27585,29550,31432,2009,Austria,Cameroon,0,2,Friendly,Klagenfurt,Austria,False,2,-2,Cameroon
27586,29551,31433,2009,Azerbaijan,Germany,0,2,FIFA World Cup qualification,Baku,Azerbaijan,False,2,-2,Germany
27587,29552,31434,2009,Belarus,Croatia,1,3,FIFA World Cup qualification,Minsk,Belarus,False,4,-2,Croatia
27588,29553,31435,2009,Bosnia and Herzegovina,Iran,2,3,Friendly,Sarajevo,Bosnia and Herzegovina,False,5,-1,Iran
27589,29554,31436,2009,Bulgaria,Latvia,1,0,Friendly,Sofia,Bulgaria,False,1,1,Bulgaria
27590,29555,31437,2009,Colombia,Venezuela,1,2,Friendly,East Rutherford,United States,True,3,-1,Venezuela
27591,29556,31438,2009,DR Congo,Senegal,1,2,Friendly,Blois,France,True,3,-1,Senegal
27592,29557,31439,2009,Czech Republic,Belgium,3,1,Friendly,Teplice,Czech Republic,False,4,2,Czech Republic
27593,29558,31440,2009,Denmark,Chile,1,2,Friendly,Brøndby,Denmark,False,3,-1,Chile
27594,29559,31441,2009,Ecuador,Jamaica,0,0,Friendly,East Rutherford,United States,True,0,0,Draw
27595,29560,31442,2009,Egypt,Guinea,3,3,Friendly,Cairo,Egypt,False,6,0,Draw
27596,29561,31443,2009,Estonia,Brazil,0,1,Friendly,Tallinn,Estonia,False,1,-1,Brazil
27597,29562,31444,2009,Faroe Islands,France,0,1,FIFA World Cup qualification,Tórshavn,Faroe Islands,False,1,-1,France
27598,29563,31445,2009,Ghana,Zambia,4,1,Friendly,London,England,True,5,3,Ghana
27599,29564,31446,2009,Honduras,Costa Rica,4,0,FIFA World Cup qualification,San Pedro Sula,Honduras,False,4,4,Honduras
27600,29565,31447,2009,Hungary,Romania,0,1,Friendly,Budapest,Hungary,False,1,-1,Romania
27601,29566,31448,2009,Iceland,Slovakia,1,1,Friendly,Reykjavík,Iceland,False,2,0,Draw
27602,29567,31449,2009,Republic of Ireland,Australia,0,3,Friendly,Limerick,Republic of Ireland,False,3,-3,Australia
27603,29568,31451,2009,Liechtenstein,Portugal,0,3,Friendly,Vaduz,Liechtenstein,False,3,-3,Portugal
27604,29569,31452,2009,Luxembourg,Lithuania,0,1,Friendly,Luxembourg,Luxembourg,False,1,-1,Lithuania
27605,29570,31454,2009,Malaysia,Kenya,0,0,Friendly,Kuala Lumpur,Malaysia,False,0,0,Draw
27606,29571,31455,2009,Mali,Burkina Faso,3,0,Friendly,Le Petit-Quevilly,France,True,3,3,Mali
27607,29572,31456,2009,Malta,Georgia,2,0,Friendly,Attard,Malta,False,2,2,Malta
27608,29573,31457,2009,Mexico,United States,2,1,FIFA World Cup qualification,Mexico City,Mexico,False,3,1,Mexico
27609,29574,31458,2009,Montenegro,Wales,2,1,Friendly,Podgorica,Montenegro,False,3,1,Montenegro
27610,29575,31459,2009,Morocco,Congo,1,1,Friendly,Rabat,Morocco,False,2,0,Draw
27611,29576,31460,2009,Mozambique,Eswatini,1,0,Friendly,Maputo,Mozambique,False,1,1,Mozambique
27612,29577,31461,2009,Netherlands,England,2,2,Friendly,Amsterdam,Netherlands,False,4,0,Draw
27613,29578,31462,2009,Northern Ireland,Israel,1,1,Friendly,Belfast,Northern Ireland,False,2,0,Draw
27614,29579,31463,2009,Norway,Scotland,4,0,FIFA World Cup qualification,Oslo,Norway,False,4,4,Norway
27615,29580,31464,2009,Oman,Saudi Arabia,2,1,Friendly,Salalah,Oman,False,3,1,Oman
27616,29581,31465,2009,Poland,Greece,2,0,Friendly,Bydgoszcz,Poland,False,2,2,Poland
27617,29582,31466,2009,Russia,Argentina,2,3,Friendly,Moscow,Russia,False,5,-1,Argentina
27618,29583,31467,2009,Rwanda,Tanzania,1,2,Friendly,Kigali,Rwanda,False,3,-1,Tanzania
27619,29585,31469,2009,Slovenia,San Marino,5,0,FIFA World Cup qualification,Maribor,Slovenia,False,5,5,Slovenia
27620,29586,31470,2009,South Africa,Serbia,1,3,Friendly,Atteridgeville,South Africa,False,4,-2,Serbia
27621,29587,31471,2009,Sweden,Finland,1,0,Friendly,Solna,Sweden,False,1,1,Sweden
27622,29588,31472,2009,Switzerland,Italy,0,0,Friendly,Basel,Switzerland,False,0,0,Draw
27623,29589,31473,2009,Togo,Angola,0,2,Friendly,Lisbon,Portugal,True,2,-2,Angola
27624,29590,31474,2009,Trinidad and Tobago,El Salvador,1,0,FIFA World Cup qualification,Port of Spain,Trinidad and Tobago,False,1,1,Trinidad and Tobago
27625,29591,31475,2009,Tunisia,Ivory Coast,0,0,Friendly,Sousse,Tunisia,False,0,0,Draw
27626,29592,31476,2009,Ukraine,Turkey,0,3,Friendly,Kyïv,Ukraine,False,3,-3,Turkey
27627,29593,31477,2009,Zimbabwe,Lesotho,1,1,Friendly,Bulawayo,Zimbabwe,False,2,0,Draw
27628,29595,31479,2009,Saint Kitts and Nevis,Jamaica,0,1,Friendly,Basseterre,Saint Kitts and Nevis,False,1,-1,Jamaica
27629,29596,31480,2009,India,Lebanon,0,1,Nehru Cup,New Delhi,India,False,1,-1,Lebanon
27630,29597,31481,2009,Syria,Kyrgyzstan,2,0,Nehru Cup,New Delhi,India,True,2,2,Syria
27631,29598,31482,2009,Sri Lanka,Lebanon,4,3,Nehru Cup,New Delhi,India,True,7,1,Sri Lanka
27632,29599,31483,2009,India,Kyrgyzstan,2,1,Nehru Cup,New Delhi,India,False,3,1,India
27633,29600,31485,2009,Syria,Sri Lanka,4,0,Nehru Cup,New Delhi,India,True,4,4,Syria
27634,29602,31487,2009,Kyrgyzstan,Lebanon,1,1,Nehru Cup,New Delhi,India,True,2,0,Draw
27635,29603,31488,2009,Bahrain,Kenya,2,1,Friendly,Riffa,Bahrain,False,3,1,Bahrain
27636,29604,31489,2009,India,Sri Lanka,3,1,Nehru Cup,New Delhi,India,False,4,2,India
27637,29605,31490,2009,Hong Kong,Guam,12,0,EAFF Championship,Kaohsiung,Chinese Taipei,True,12,12,Hong Kong
27638,29606,31491,2009,Syria,Lebanon,1,0,Nehru Cup,New Delhi,India,True,1,1,Syria
27639,29607,31492,2009,Sri Lanka,Kyrgyzstan,1,4,Nehru Cup,New Delhi,India,True,5,-3,Kyrgyzstan
27640,29608,31493,2009,India,Syria,0,1,Nehru Cup,New Delhi,India,False,1,-1,Syria
27641,29609,31494,2009,Saudi Arabia,Malaysia,2,1,Friendly,Riyadh,Saudi Arabia,False,3,1,Saudi Arabia
27642,29610,31495,2009,Bahrain,Iran,4,2,Friendly,Riffa,Bahrain,False,6,2,Bahrain
27643,29611,31496,2009,India,Syria,1,1,Nehru Cup,New Delhi,India,False,2,0,Draw
27644,29613,31498,2009,Angola,Senegal,1,1,Friendly,Lisbon,Portugal,True,2,0,Draw
27645,29614,31499,2009,Argentina,Brazil,1,3,FIFA World Cup qualification,Rosario,Argentina,False,4,-2,Brazil
27646,29615,31500,2009,Armenia,Bosnia and Herzegovina,0,2,FIFA World Cup qualification,Yerevan,Armenia,False,2,-2,Bosnia and Herzegovina
27647,29616,31501,2009,Austria,Faroe Islands,3,1,FIFA World Cup qualification,Graz,Austria,False,4,2,Austria
27648,29617,31502,2009,Azerbaijan,Finland,1,2,FIFA World Cup qualification,Lənkəran,Azerbaijan,False,3,-1,Finland
27649,29618,31503,2009,Bahrain,Saudi Arabia,0,0,FIFA World Cup qualification,Riffa,Bahrain,False,0,0,Draw
27650,29619,31504,2009,Bulgaria,Montenegro,4,1,FIFA World Cup qualification,Sofia,Bulgaria,False,5,3,Bulgaria
27651,29620,31505,2009,Chile,Venezuela,2,2,FIFA World Cup qualification,Santiago,Chile,False,4,0,Draw
27652,29621,31506,2009,Colombia,Ecuador,2,0,FIFA World Cup qualification,Medellín,Colombia,False,2,2,Colombia
27653,29622,31507,2009,Costa Rica,Mexico,0,3,FIFA World Cup qualification,San José,Costa Rica,False,3,-3,Mexico
27654,29623,31508,2009,Croatia,Belarus,1,0,FIFA World Cup qualification,Zagreb,Croatia,False,1,1,Croatia
27655,29624,31509,2009,Cyprus,Republic of Ireland,1,2,FIFA World Cup qualification,Nicosia,Cyprus,False,3,-1,Republic of Ireland
27656,29625,31510,2009,Denmark,Portugal,1,1,FIFA World Cup qualification,Copenhagen,Denmark,False,2,0,Draw
27657,29626,31511,2009,England,Slovenia,2,1,Friendly,London,England,False,3,1,England
27658,29627,31512,2009,France,Romania,1,1,FIFA World Cup qualification,Saint-Denis,France,False,2,0,Draw
27659,29628,31513,2009,Gabon,Cameroon,0,2,FIFA World Cup qualification,Libreville,Gabon,False,2,-2,Cameroon
27660,29629,31514,2009,Georgia,Italy,0,2,FIFA World Cup qualification,Tbilisi,Georgia,False,2,-2,Italy
27661,29630,31515,2009,Germany,South Africa,2,0,Friendly,Leverkusen,Germany,False,2,2,Germany
27662,29631,31516,2009,Honduras,Trinidad and Tobago,4,1,FIFA World Cup qualification,San Pedro Sula,Honduras,False,5,3,Honduras
27663,29632,31517,2009,Hungary,Sweden,1,2,FIFA World Cup qualification,Budapest,Hungary,False,3,-1,Sweden
27664,29633,31518,2009,Iceland,Norway,1,1,FIFA World Cup qualification,Reykjavík,Iceland,False,2,0,Draw
27665,29634,31519,2009,Israel,Latvia,0,1,FIFA World Cup qualification,Ramat-Gan,Israel,False,1,-1,Latvia
27666,29635,31520,2009,Ivory Coast,Burkina Faso,5,0,FIFA World Cup qualification,Abidjan,Ivory Coast,False,5,5,Ivory Coast
27667,29636,31521,2009,Jordan,Malaysia,0,0,Friendly,Amman,Jordan,False,0,0,Draw
27668,29637,31523,2009,Malawi,Guinea,2,1,FIFA World Cup qualification,Blantyre,Malawi,False,3,1,Malawi
27669,29638,31524,2009,Moldova,Luxembourg,0,0,FIFA World Cup qualification,Chişinău,Moldova,False,0,0,Draw
27670,29639,31525,2009,Namibia,Eswatini,1,1,Friendly,Windhoek,Namibia,False,2,0,Draw
27671,29640,31526,2009,Netherlands,Japan,3,0,Friendly,Enschede,Netherlands,False,3,3,Netherlands
27672,29641,31527,2009,Paraguay,Bolivia,1,0,FIFA World Cup qualification,Asunción,Paraguay,False,1,1,Paraguay
27673,29642,31528,2009,Peru,Uruguay,1,0,FIFA World Cup qualification,Lima,Peru,False,1,1,Peru
27674,29643,31529,2009,Poland,Northern Ireland,1,1,FIFA World Cup qualification,Chorzów,Poland,False,2,0,Draw
27675,29644,31530,2009,Russia,Liechtenstein,3,0,FIFA World Cup qualification,St. Petersburg,Russia,False,3,3,Russia
27676,29645,31531,2009,Rwanda,Egypt,0,1,FIFA World Cup qualification,Kigali,Rwanda,False,1,-1,Egypt
27677,29647,31533,2009,Slovakia,Czech Republic,2,2,FIFA World Cup qualification,Bratislava,Slovakia,False,4,0,Draw
27678,29648,31534,2009,Spain,Belgium,5,0,FIFA World Cup qualification,La Coruña,Spain,False,5,5,Spain
27679,29649,31535,2009,Saint Vincent and the Grenadines,Saint Kitts and Nevis,0,3,Friendly,Kingstown,Saint Vincent and the Grenadines,False,3,-3,Saint Kitts and Nevis
27680,29650,31536,2009,Switzerland,Greece,2,0,FIFA World Cup qualification,Basel,Switzerland,False,2,2,Switzerland
27681,29651,31537,2009,Turkey,Estonia,4,2,FIFA World Cup qualification,Kayseri,Turkey,False,6,2,Turkey
27682,29652,31538,2009,Ukraine,Andorra,5,0,FIFA World Cup qualification,Kyïv,Ukraine,False,5,5,Ukraine
27683,29653,31539,2009,United States,El Salvador,2,1,FIFA World Cup qualification,Sandy City,United States,False,3,1,United States
27684,29654,31540,2009,Uzbekistan,Iran,0,0,Friendly,Tashkent,Uzbekistan,False,0,0,Draw
27685,29655,31541,2009,Algeria,Zambia,1,0,FIFA World Cup qualification,Blida,Algeria,False,1,1,Algeria
27686,29656,31542,2009,Benin,Mali,1,1,FIFA World Cup qualification,Cotonou,Benin,False,2,0,Draw
27687,29657,31543,2009,Ghana,Sudan,2,0,FIFA World Cup qualification,Accra,Ghana,False,2,2,Ghana
27688,29658,31544,2009,Mozambique,Kenya,1,0,FIFA World Cup qualification,Maputo,Mozambique,False,1,1,Mozambique
27689,29659,31545,2009,Nigeria,Tunisia,2,2,FIFA World Cup qualification,Abuja,Nigeria,False,4,0,Draw
27690,29660,31546,2009,Togo,Morocco,1,1,FIFA World Cup qualification,Lomé,Togo,False,2,0,Draw
27691,29661,31547,2009,Republic of Ireland,South Africa,1,0,Friendly,Limerick,Republic of Ireland,False,1,1,Republic of Ireland
27692,29662,31548,2009,Albania,Denmark,1,1,FIFA World Cup qualification,Tirana,Albania,False,2,0,Draw
27693,29663,31549,2009,Andorra,Kazakhstan,1,3,FIFA World Cup qualification,Sant Julià de Lòria,Andorra,False,4,-2,Kazakhstan
27694,29665,31551,2009,Armenia,Belgium,2,1,FIFA World Cup qualification,Yerevan,Armenia,False,3,1,Armenia
27695,29666,31552,2009,Belarus,Ukraine,0,0,FIFA World Cup qualification,Minsk,Belarus,False,0,0,Draw
27696,29667,31553,2009,Bolivia,Ecuador,1,3,FIFA World Cup qualification,La Paz,Bolivia,False,4,-2,Ecuador
27697,29668,31554,2009,Bosnia and Herzegovina,Turkey,1,1,FIFA World Cup qualification,Zenica,Bosnia and Herzegovina,False,2,0,Draw
27698,29669,31555,2009,Cameroon,Gabon,2,1,FIFA World Cup qualification,Yaoundé,Cameroon,False,3,1,Cameroon
27699,29670,31556,2009,Czech Republic,San Marino,7,0,FIFA World Cup qualification,Uherské Hradiště,Czech Republic,False,7,7,Czech Republic
27700,29671,31557,2009,El Salvador,Costa Rica,1,0,FIFA World Cup qualification,San Salvador,El Salvador,False,1,1,El Salvador
27701,29672,31558,2009,England,Croatia,5,1,FIFA World Cup qualification,London,England,False,6,4,England
27702,29673,31559,2009,Faroe Islands,Lithuania,2,1,FIFA World Cup qualification,Toftir,Faroe Islands,False,3,1,Faroe Islands
27703,29674,31560,2009,Germany,Azerbaijan,4,0,FIFA World Cup qualification,Hanover,Germany,False,4,4,Germany
27704,29675,31561,2009,Hungary,Portugal,0,1,FIFA World Cup qualification,Budapest,Hungary,False,1,-1,Portugal
27705,29676,31562,2009,Iceland,Georgia,3,1,Friendly,Reykjavík,Iceland,False,4,2,Iceland
27706,29677,31563,2009,Israel,Luxembourg,7,0,FIFA World Cup qualification,Ramat-Gan,Israel,False,7,7,Israel
27707,29678,31564,2009,Italy,Bulgaria,2,0,FIFA World Cup qualification,Turin,Italy,False,2,2,Italy
27708,29679,31565,2009,Japan,Ghana,4,3,Friendly,Utrecht,Netherlands,True,7,1,Japan
27709,29680,31566,2009,Jordan,New Zealand,1,3,Friendly,Amman,Jordan,False,4,-2,New Zealand
27710,29681,31567,2009,Latvia,Switzerland,2,2,FIFA World Cup qualification,Riga,Latvia,False,4,0,Draw
27711,29682,31568,2009,Liechtenstein,Finland,1,1,FIFA World Cup qualification,Vaduz,Liechtenstein,False,2,0,Draw
27712,29683,31569,2009,Malta,Sweden,0,1,FIFA World Cup qualification,Attard,Malta,False,1,-1,Sweden
27713,29684,31570,2009,Mexico,Honduras,1,0,FIFA World Cup qualification,Mexico City,Mexico,False,1,1,Mexico
27714,29685,31571,2009,Moldova,Greece,1,1,FIFA World Cup qualification,Chişinău,Moldova,False,2,0,Draw
27715,29686,31572,2009,Montenegro,Cyprus,1,1,FIFA World Cup qualification,Podgorica,Montenegro,False,2,0,Draw
27716,29687,31573,2009,Northern Ireland,Slovakia,0,2,FIFA World Cup qualification,Belfast,Northern Ireland,False,2,-2,Slovakia
27717,29689,31575,2009,Qatar,Oman,1,1,Friendly,Doha,Qatar,False,2,0,Draw
27718,29690,31576,2009,Romania,Austria,1,1,FIFA World Cup qualification,Bucharest,Romania,False,2,0,Draw
27719,29691,31577,2009,Saudi Arabia,Bahrain,2,2,FIFA World Cup qualification,Riyadh,Saudi Arabia,False,4,0,Draw
27720,29692,31578,2009,Scotland,Netherlands,0,1,FIFA World Cup qualification,Glasgow,Scotland,False,1,-1,Netherlands
27721,29693,31579,2009,Serbia,France,1,1,FIFA World Cup qualification,Belgrade,Serbia,False,2,0,Draw
27722,29694,31580,2009,Slovenia,Poland,3,0,FIFA World Cup qualification,Maribor,Slovenia,False,3,3,Slovenia
27723,29695,31581,2009,Spain,Estonia,3,0,FIFA World Cup qualification,Mérida,Spain,False,3,3,Spain
27724,29696,31582,2009,Trinidad and Tobago,United States,0,1,FIFA World Cup qualification,Port of Spain,Trinidad and Tobago,False,1,-1,United States
27725,29697,31583,2009,Wales,Russia,1,3,FIFA World Cup qualification,Cardiff,Wales,False,4,-2,Russia
27726,29698,31584,2009,Malaysia,Lesotho,5,0,Friendly,Kuala Lumpur,Malaysia,False,5,5,Malaysia
27727,29699,31585,2009,South Africa,Madagascar,1,0,Friendly,Kimberley,South Africa,False,1,1,South Africa
27728,29700,31586,2009,Saint Kitts and Nevis,Saint Vincent and the Grenadines,1,1,Friendly,Basseterre,Saint Kitts and Nevis,False,2,0,Draw
27729,29701,31587,2009,Argentina,Ghana,2,0,Friendly,Córdoba,Argentina,False,2,2,Argentina
27730,29702,31589,2009,Mexico,Colombia,1,2,Friendly,Dallas,United States,True,3,-1,Colombia
27731,29703,31590,2009,Egypt,Mauritius,4,0,Friendly,Cairo,Egypt,False,4,4,Egypt
27732,29704,31591,2009,Kuwait,Libya,1,1,Friendly,Cairo,Egypt,True,2,0,Draw
27733,29705,31592,2009,Croatia,Qatar,3,2,Friendly,Rijeka,Croatia,False,5,1,Croatia
27734,29706,31593,2009,Japan,Hong Kong,6,0,AFC Asian Cup qualification,Shizuoka,Japan,False,6,6,Japan
27735,29707,31594,2009,Argentina,Peru,2,1,FIFA World Cup qualification,Buenos Aires,Argentina,False,3,1,Argentina
27736,29708,31595,2009,Armenia,Spain,1,2,FIFA World Cup qualification,Yerevan,Armenia,False,3,-1,Spain
27737,29709,31596,2009,Australia,Netherlands,0,0,Friendly,Sydney,Australia,False,0,0,Draw
27738,29710,31597,2009,Austria,Lithuania,2,1,FIFA World Cup qualification,Innsbruck,Austria,False,3,1,Austria
27739,29711,31598,2009,Bahrain,New Zealand,0,0,FIFA World Cup qualification,Riffa,Bahrain,False,0,0,Draw
27740,29712,31599,2009,Belarus,Kazakhstan,4,0,FIFA World Cup qualification,Brest,Belarus,False,4,4,Belarus
27741,29713,31600,2009,Belgium,Turkey,2,0,FIFA World Cup qualification,Brussels,Belgium,False,2,2,Belgium
27742,29714,31601,2009,Cameroon,Togo,3,0,FIFA World Cup qualification,Yaoundé,Cameroon,False,3,3,Cameroon
27743,29715,31602,2009,Colombia,Chile,2,4,FIFA World Cup qualification,Medellín,Colombia,False,6,-2,Chile
27744,29716,31603,2009,Costa Rica,Trinidad and Tobago,4,0,FIFA World Cup qualification,San José,Costa Rica,False,4,4,Costa Rica
27745,29717,31604,2009,Cyprus,Bulgaria,4,1,FIFA World Cup qualification,Larnaca,Cyprus,False,5,3,Cyprus
27746,29718,31605,2009,Czech Republic,Poland,2,0,FIFA World Cup qualification,Prague,Czech Republic,False,2,2,Czech Republic
27747,29719,31606,2009,Denmark,Sweden,1,0,FIFA World Cup qualification,Copenhagen,Denmark,False,1,1,Denmark
27748,29720,31607,2009,Ecuador,Uruguay,1,2,FIFA World Cup qualification,Quito,Ecuador,False,3,-1,Uruguay
27749,29721,31608,2009,Estonia,Bosnia and Herzegovina,0,2,FIFA World Cup qualification,Tallinn,Estonia,False,2,-2,Bosnia and Herzegovina
27750,29722,31609,2009,Finland,Wales,2,1,FIFA World Cup qualification,Helsinki,Finland,False,3,1,Finland
27751,29723,31610,2009,France,Faroe Islands,5,0,FIFA World Cup qualification,Guingamp,France,False,5,5,France
27752,29724,31611,2009,Gabon,Morocco,3,1,FIFA World Cup qualification,Libreville,Gabon,False,4,2,Gabon
27753,29725,31612,2009,Greece,Latvia,5,2,FIFA World Cup qualification,Athens,Greece,False,7,3,Greece
27754,29726,31613,2009,Honduras,United States,2,3,FIFA World Cup qualification,San Pedro Sula,Honduras,False,5,-1,United States
27755,29727,31614,2009,Republic of Ireland,Italy,2,2,FIFA World Cup qualification,Dublin,Republic of Ireland,False,4,0,Draw
27756,29728,31615,2009,Israel,Moldova,3,1,FIFA World Cup qualification,Ramat-Gan,Israel,False,4,2,Israel
27757,29729,31616,2009,Japan,Scotland,2,0,Friendly,Yokohama,Japan,False,2,2,Japan
27758,29730,31617,2009,Kuwait,Jordan,2,1,Friendly,Cairo,Egypt,True,3,1,Kuwait
27759,29731,31618,2009,Liechtenstein,Azerbaijan,0,2,FIFA World Cup qualification,Vaduz,Liechtenstein,False,2,-2,Azerbaijan
27760,29732,31619,2009,Luxembourg,Switzerland,0,3,FIFA World Cup qualification,Luxembourg,Luxembourg,False,3,-3,Switzerland
27761,29733,31620,2009,Malawi,Ivory Coast,1,1,FIFA World Cup qualification,Blantyre,Malawi,False,2,0,Draw
27762,29734,31621,2009,Malta,Angola,1,2,Friendly,Vila Real de Santo António,Portugal,True,3,-1,Angola
27763,29735,31622,2009,Mexico,El Salvador,4,1,FIFA World Cup qualification,Mexico City,Mexico,False,5,3,Mexico
27764,29736,31623,2009,Montenegro,Georgia,2,1,FIFA World Cup qualification,Podgorica,Montenegro,False,3,1,Montenegro
27765,29737,31624,2009,Norway,South Africa,1,0,Friendly,Oslo,Norway,False,1,1,Norway
27766,29738,31625,2009,Portugal,Hungary,3,0,FIFA World Cup qualification,Lisbon,Portugal,False,3,3,Portugal
27767,29739,31626,2009,Russia,Germany,0,1,FIFA World Cup qualification,Moscow,Russia,False,1,-1,Germany
27768,29740,31627,2009,Serbia,Romania,5,0,FIFA World Cup qualification,Belgrade,Serbia,False,5,5,Serbia
27769,29741,31628,2009,Slovakia,Slovenia,0,2,FIFA World Cup qualification,Bratislava,Slovakia,False,2,-2,Slovenia
27770,29742,31629,2009,Ukraine,England,1,0,FIFA World Cup qualification,Dnipropetrovs'k,Ukraine,False,1,1,Ukraine
27771,29743,31630,2009,United Arab Emirates,Palestine,1,1,Friendly,Dubai,United Arab Emirates,False,2,0,Draw
27772,29744,31631,2009,Venezuela,Paraguay,1,2,FIFA World Cup qualification,Puerto Ordaz,Venezuela,False,3,-1,Paraguay
27773,29745,31632,2009,Zambia,Egypt,0,1,FIFA World Cup qualification,Chililabombwe,Zambia,False,1,-1,Egypt
27774,29746,31633,2009,Algeria,Rwanda,3,1,FIFA World Cup qualification,Blida,Algeria,False,4,2,Algeria
27775,29747,31634,2009,Benin,Ghana,1,0,FIFA World Cup qualification,Cotonou,Benin,False,1,1,Benin
27776,29748,31635,2009,Guinea,Burkina Faso,1,2,FIFA World Cup qualification,Accra,Ghana,True,3,-1,Burkina Faso
27777,29749,31637,2009,Mali,Sudan,1,0,FIFA World Cup qualification,Bamako,Mali,False,1,1,Mali
27778,29750,31638,2009,Nigeria,Mozambique,1,0,FIFA World Cup qualification,Abuja,Nigeria,False,1,1,Nigeria
27779,29752,31640,2009,Iceland,South Africa,1,0,Friendly,Reykjavík,Iceland,False,1,1,Iceland
27780,29753,31641,2009,Andorra,Ukraine,0,6,FIFA World Cup qualification,Sant Julià de Lòria,Andorra,False,6,-6,Ukraine
27781,29754,31642,2009,Angola,Cameroon,0,0,Friendly,Olhão,Portugal,True,0,0,Draw
27782,29755,31643,2009,Australia,Oman,1,0,AFC Asian Cup qualification,Melbourne,Australia,False,1,1,Australia
27783,29756,31644,2009,Azerbaijan,Russia,1,1,FIFA World Cup qualification,Baku,Azerbaijan,False,2,0,Draw
27784,29757,31645,2009,Bosnia and Herzegovina,Spain,2,5,FIFA World Cup qualification,Zenica,Bosnia and Herzegovina,False,7,-3,Spain
27785,29758,31646,2009,Brazil,Venezuela,0,0,FIFA World Cup qualification,Campo Grande,Brazil,False,0,0,Draw
27786,29759,31647,2009,Bulgaria,Georgia,6,2,FIFA World Cup qualification,Sofia,Bulgaria,False,8,4,Bulgaria
27787,29760,31648,2009,Chile,Ecuador,1,0,FIFA World Cup qualification,Santiago,Chile,False,1,1,Chile
27788,29761,31649,2009,Czech Republic,Northern Ireland,0,0,FIFA World Cup qualification,Prague,Czech Republic,False,0,0,Draw
27789,29762,31650,2009,Denmark,Hungary,0,1,FIFA World Cup qualification,Copenhagen,Denmark,False,1,-1,Hungary
27790,29763,31651,2009,El Salvador,Honduras,0,1,FIFA World Cup qualification,San Salvador,El Salvador,False,1,-1,Honduras
27791,29764,31652,2009,England,Belarus,3,0,FIFA World Cup qualification,London,England,False,3,3,England
27792,29765,31653,2009,Estonia,Belgium,2,0,FIFA World Cup qualification,Tallinn,Estonia,False,2,2,Estonia
27793,29766,31654,2009,France,Austria,3,1,FIFA World Cup qualification,Saint-Denis,France,False,4,2,France
27794,29767,31655,2009,Germany,Finland,1,1,FIFA World Cup qualification,Hamburg,Germany,False,2,0,Draw
27795,29768,31656,2009,Greece,Luxembourg,2,1,FIFA World Cup qualification,Athens,Greece,False,3,1,Greece
27796,29769,31657,2009,Republic of Ireland,Montenegro,0,0,FIFA World Cup qualification,Dublin,Republic of Ireland,False,0,0,Draw
27797,29770,31658,2009,Italy,Cyprus,3,2,FIFA World Cup qualification,Parma,Italy,False,5,1,Italy
27798,29771,31659,2009,Japan,Togo,5,0,Friendly,Miyagi,Japan,False,5,5,Japan
27799,29772,31660,2009,Kazakhstan,Croatia,1,2,FIFA World Cup qualification,Astana,Kazakhstan,False,3,-1,Croatia
27800,29773,31662,2009,Latvia,Moldova,3,2,FIFA World Cup qualification,Riga,Latvia,False,5,1,Latvia
27801,29774,31663,2009,Liechtenstein,Wales,0,2,FIFA World Cup qualification,Vaduz,Liechtenstein,False,2,-2,Wales
27802,29775,31664,2009,Lithuania,Serbia,2,1,FIFA World Cup qualification,Marijampolė,Lithuania,False,3,1,Lithuania
27803,29776,31665,2009,Paraguay,Colombia,0,2,FIFA World Cup qualification,Asunción,Paraguay,False,2,-2,Colombia
27804,29777,31666,2009,Peru,Bolivia,1,0,FIFA World Cup qualification,Lima,Peru,False,1,1,Peru
27805,29778,31667,2009,Poland,Slovakia,0,1,FIFA World Cup qualification,Chorzów,Poland,False,1,-1,Slovakia
27806,29779,31668,2009,Portugal,Malta,4,0,FIFA World Cup qualification,Guimarães,Portugal,False,4,4,Portugal
27807,29780,31669,2009,Qatar,DR Congo,2,2,Friendly,Saint-Gratien,France,True,4,0,Draw
27808,29781,31670,2009,Romania,Faroe Islands,3,1,FIFA World Cup qualification,Piatra Neamţ,Romania,False,4,2,Romania
27809,29782,31671,2009,San Marino,Slovenia,0,3,FIFA World Cup qualification,Serravalle,San Marino,False,3,-3,Slovenia
27810,29783,31672,2009,Sweden,Albania,4,1,FIFA World Cup qualification,Solna,Sweden,False,5,3,Sweden
27811,29784,31673,2009,Switzerland,Israel,0,0,FIFA World Cup qualification,Basel,Switzerland,False,0,0,Draw
27812,29785,31674,2009,Trinidad and Tobago,Mexico,2,2,FIFA World Cup qualification,Port of Spain,Trinidad and Tobago,False,4,0,Draw
27813,29786,31675,2009,Tunisia,Saudi Arabia,0,1,Friendly,Radès,Tunisia,False,1,-1,Saudi Arabia
27814,29787,31676,2009,Turkey,Armenia,2,0,FIFA World Cup qualification,Bursa,Turkey,False,2,2,Turkey
27815,29788,31677,2009,United Arab Emirates,Jordan,3,1,Friendly,Dubai,United Arab Emirates,False,4,2,United Arab Emirates
27816,29789,31678,2009,Uruguay,Argentina,0,1,FIFA World Cup qualification,Montevideo,Uruguay,False,1,-1,Argentina
27817,29790,31679,2009,United States,Costa Rica,2,2,FIFA World Cup qualification,Washington,United States,False,4,0,Draw
27818,29791,31680,2009,Zimbabwe,Mauritius,3,0,COSAFA Cup,Harare,Zimbabwe,False,3,3,Zimbabwe
27819,29792,31681,2009,Comoros,Botswana,0,0,COSAFA Cup,Bulawayo,Zimbabwe,True,0,0,Draw
27820,29793,31682,2009,Eswatini,Seychelles,2,1,COSAFA Cup,Bulawayo,Zimbabwe,True,3,1,Eswatini
27821,29794,31683,2009,Zimbabwe,Lesotho,2,2,COSAFA Cup,Harare,Zimbabwe,False,4,0,Draw
27822,29795,31684,2009,Botswana,Eswatini,1,0,COSAFA Cup,Bulawayo,Zimbabwe,True,1,1,Botswana
27823,29796,31685,2009,Seychelles,Comoros,1,2,COSAFA Cup,Bulawayo,Zimbabwe,True,3,-1,Comoros
27824,29797,31686,2009,Vietnam,Turkmenistan,1,0,Friendly,Ho Chi Minh City,Vietnam,False,1,1,Vietnam
27825,29798,31687,2009,Mauritius,Lesotho,0,1,COSAFA Cup,Harare,Zimbabwe,True,1,-1,Lesotho
27826,29799,31688,2009,Seychelles,Botswana,0,2,COSAFA Cup,Bulawayo,Zimbabwe,True,2,-2,Botswana
27827,29800,31689,2009,Singapore,Turkmenistan,4,2,Friendly,Ho Chi Minh City,Vietnam,True,6,2,Singapore
27828,29801,31690,2009,Eswatini,Comoros,3,0,COSAFA Cup,Bulawayo,Zimbabwe,True,3,3,Eswatini
27829,29802,31691,2009,Vietnam,Singapore,2,2,Friendly,Ho Chi Minh City,Vietnam,False,4,0,Draw
27830,29803,31692,2009,Malawi,Mozambique,0,1,COSAFA Cup,Harare,Zimbabwe,True,1,-1,Mozambique
27831,29804,31693,2009,Namibia,Zambia,0,1,COSAFA Cup,Harare,Zimbabwe,True,1,-1,Zambia
27832,29805,31694,2009,Kuwait,Syria,1,0,Friendly,Al-Jahra,Kuwait,False,1,1,Kuwait
27833,29806,31695,2009,Zimbabwe,Botswana,1,0,COSAFA Cup,Bulawayo,Zimbabwe,False,1,1,Zimbabwe
27834,29807,31696,2009,Curaçao,French Guiana,1,4,Friendly,Paramaribo,Suriname,True,5,-3,French Guiana
27835,29808,31697,2009,Mozambique,Zambia,0,2,COSAFA Cup,Bulawayo,Zimbabwe,True,2,-2,Zambia
27836,29809,31698,2009,Guyana,Curaçao,1,0,Friendly,Paramaribo,Suriname,True,1,1,Guyana
27837,29810,31699,2009,Suriname,French Guiana,4,0,Friendly,Paramaribo,Suriname,False,4,4,Suriname
27838,29811,31700,2009,French Guiana,Guyana,0,1,Friendly,Paramaribo,Suriname,True,1,-1,Guyana
27839,29812,31701,2009,Suriname,Curaçao,1,1,Friendly,Paramaribo,Suriname,False,2,0,Draw
27840,29813,31702,2009,Zimbabwe,Zambia,3,1,COSAFA Cup,Harare,Zimbabwe,False,4,2,Zimbabwe
27841,29814,31703,2009,Kenya,Kuwait,0,5,Friendly,Cairo,Egypt,True,5,-5,Kuwait
27842,29815,31704,2009,Chile,Paraguay,2,1,Friendly,Talcahuano,Chile,False,3,1,Chile
27843,29816,31705,2009,Singapore,Indonesia,3,1,Friendly,Singapore,Singapore,False,4,2,Singapore
27844,29817,31706,2009,Egypt,Tanzania,5,1,Friendly,Aswan,Egypt,False,6,4,Egypt
27845,29818,31707,2009,Bahrain,Togo,5,1,Friendly,Riffa,Bahrain,False,6,4,Bahrain
27846,29820,31709,2009,Thailand,Syria,1,1,Friendly,Nonthaburi,Thailand,False,2,0,Draw
27847,29821,31710,2009,Yemen,Tanzania,1,1,Friendly,Sana'a,Yemen,False,2,0,Draw
27848,29822,31711,2009,Iran,Iceland,1,0,Friendly,Teheran,Iran,False,1,1,Iran
27849,29823,31712,2009,Yemen,Tanzania,2,1,Friendly,Sana'a,Yemen,False,3,1,Yemen
27850,29824,31713,2009,Paraguay,Qatar,0,2,Friendly,Rouen,France,True,2,-2,Qatar
27851,29825,31714,2009,Angola,Congo,1,1,Friendly,Luanda,Angola,False,2,0,Draw
27852,29826,31715,2009,Belgium,Hungary,3,0,Friendly,Ghent,Belgium,False,3,3,Belgium
27853,29827,31716,2009,Brazil,England,1,0,Friendly,Doha,Qatar,True,1,1,Brazil
27854,29828,31717,2009,Burkina Faso,Malawi,1,0,FIFA World Cup qualification,Ouagadougou,Burkina Faso,False,1,1,Burkina Faso
27855,29829,31718,2009,Costa Rica,Uruguay,0,1,FIFA World Cup qualification,San José,Costa Rica,False,1,-1,Uruguay
27856,29830,31719,2009,Croatia,Liechtenstein,5,0,Friendly,Vinkovci,Croatia,False,5,5,Croatia
27857,29832,31721,2009,Egypt,Algeria,2,0,FIFA World Cup qualification,Cairo,Egypt,False,2,2,Egypt
27858,29833,31722,2009,Estonia,Albania,0,0,Friendly,Tallinn,Estonia,False,0,0,Draw
27859,29834,31723,2009,Greece,Ukraine,0,0,FIFA World Cup qualification,Athens,Greece,False,0,0,Draw
27860,29835,31724,2009,Honduras,Latvia,2,1,Friendly,Tegucigalpa,Honduras,False,3,1,Honduras
27861,29836,31725,2009,Iran,Jordan,1,0,AFC Asian Cup qualification,Teheran,Iran,False,1,1,Iran
27862,29837,31726,2009,Republic of Ireland,France,0,1,FIFA World Cup qualification,Dublin,Republic of Ireland,False,1,-1,France
27863,29838,31727,2009,Italy,Netherlands,0,0,Friendly,Pescara,Italy,False,0,0,Draw
27864,29839,31728,2009,Ivory Coast,Guinea,3,0,FIFA World Cup qualification,Abidjan,Ivory Coast,False,3,3,Ivory Coast
27865,29840,31729,2009,Kenya,Nigeria,2,3,FIFA World Cup qualification,Nairobi,Kenya,False,5,-1,Nigeria
27866,29841,31730,2009,Kuwait,Indonesia,2,1,AFC Asian Cup qualification,Kuwait City,Kuwait,False,3,1,Kuwait
27867,29843,31732,2009,Luxembourg,Iceland,1,1,Friendly,Luxembourg,Luxembourg,False,2,0,Draw
27868,29844,31734,2009,Morocco,Cameroon,0,2,FIFA World Cup qualification,Fès,Morocco,False,2,-2,Cameroon
27869,29845,31735,2009,Mozambique,Tunisia,1,0,FIFA World Cup qualification,Maputo,Mozambique,False,1,1,Mozambique
27870,29846,31736,2009,New Zealand,Bahrain,1,0,FIFA World Cup qualification,Wellington,New Zealand,False,1,1,New Zealand
27871,29847,31737,2009,Northern Ireland,Serbia,0,1,Friendly,Belfast,Northern Ireland,False,1,-1,Serbia
27872,29848,31738,2009,Oman,Australia,1,2,AFC Asian Cup qualification,Muscat,Oman,False,3,-1,Australia
27873,29849,31739,2009,Poland,Romania,0,1,Friendly,Warsaw,Poland,False,1,-1,Romania
27874,29850,31740,2009,Portugal,Bosnia and Herzegovina,1,0,FIFA World Cup qualification,Lisbon,Portugal,False,1,1,Portugal
27875,29851,31741,2009,Russia,Slovenia,2,1,FIFA World Cup qualification,Moscow,Russia,False,3,1,Russia
27876,29852,31742,2009,Rwanda,Zambia,0,0,FIFA World Cup qualification,Kigali,Rwanda,False,0,0,Draw
27877,29853,31743,2009,Saudi Arabia,Belarus,1,1,Friendly,Dammam,Saudi Arabia,False,2,0,Draw
27878,29854,31744,2009,Singapore,Thailand,1,3,AFC Asian Cup qualification,Singapore,Singapore,False,4,-2,Thailand
27879,29855,31745,2009,Slovakia,United States,1,0,Friendly,Bratislava,Slovakia,False,1,1,Slovakia
27880,29856,31746,2009,South Africa,Japan,0,0,Friendly,Port Elizabeth,South Africa,False,0,0,Draw
27881,29857,31747,2009,Spain,Argentina,2,1,Friendly,Madrid,Spain,False,3,1,Spain
27882,29858,31748,2009,Sudan,Benin,1,2,FIFA World Cup qualification,Omdurman,Sudan,False,3,-1,Benin
27883,29859,31749,2009,Switzerland,Norway,0,1,Friendly,Geneva,Switzerland,False,1,-1,Norway
27884,29860,31750,2009,Togo,Gabon,1,0,FIFA World Cup qualification,Lomé,Togo,False,1,1,Togo
27885,29861,31751,2009,Uzbekistan,Malaysia,3,1,AFC Asian Cup qualification,Tashkent,Uzbekistan,False,4,2,Uzbekistan
27886,29862,31752,2009,Vietnam,Syria,0,1,AFC Asian Cup qualification,Hanoi,Vietnam,False,1,-1,Syria
27887,29863,31753,2009,Wales,Scotland,3,0,Friendly,Cardiff,Wales,False,3,3,Wales
27888,29864,31754,2009,Ghana,Mali,2,2,FIFA World Cup qualification,Kumasi,Ghana,False,4,0,Draw
27889,29865,31755,2009,Iraq,Azerbaijan,1,0,Friendly,al-Ain,United Arab Emirates,True,1,1,Iraq
27890,29866,31756,2009,United Arab Emirates,Czech Republic,0,0,Friendly,al-Ain,United Arab Emirates,False,0,0,Draw
27891,29867,31757,2009,Belgium,Qatar,2,0,Friendly,Sedan,France,True,2,2,Belgium
27892,29868,31758,2009,Oman,Brazil,0,2,Friendly,Muscat,Oman,False,2,-2,Brazil
27893,29869,31759,2009,Slovakia,Chile,1,2,Friendly,Žilina,Slovakia,False,3,-1,Chile
27894,29870,31760,2009,South Africa,Jamaica,0,0,Friendly,Bloemfontein,South Africa,False,0,0,Draw
27895,29871,31761,2009,Algeria,Egypt,1,0,FIFA World Cup qualification,Omdurman,Sudan,True,1,1,Algeria
27896,29872,31762,2009,Angola,Ghana,0,0,Friendly,Luanda,Angola,False,0,0,Draw
27897,29873,31763,2009,Austria,Spain,1,5,Friendly,Vienna,Austria,False,6,-4,Spain
27898,29874,31764,2009,Azerbaijan,Czech Republic,2,0,Friendly,al-Ain,United Arab Emirates,True,2,2,Azerbaijan
27899,29875,31765,2009,Bahrain,Yemen,4,0,AFC Asian Cup qualification,Riffa,Bahrain,False,4,4,Bahrain
27900,29876,31766,2009,Bosnia and Herzegovina,Portugal,0,1,FIFA World Cup qualification,Zenica,Bosnia and Herzegovina,False,1,-1,Portugal
27901,29877,31767,2009,Denmark,United States,3,1,Friendly,Århus,Denmark,False,4,2,Denmark
27902,29878,31768,2009,France,Republic of Ireland,1,1,FIFA World Cup qualification,Saint-Denis,France,False,2,0,Draw
27903,29879,31769,2009,Germany,Ivory Coast,2,2,Friendly,Gelsenkirchen,Germany,False,4,0,Draw
27904,29880,31770,2009,Honduras,Peru,1,2,Friendly,Miami Gardens,United States,True,3,-1,Peru
27905,29881,31771,2009,Hong Kong,Japan,0,4,AFC Asian Cup qualification,So Kon Po,Hong Kong,False,4,-4,Japan
27906,29882,31772,2009,Indonesia,Kuwait,1,1,AFC Asian Cup qualification,Jakarta,Indonesia,False,2,0,Draw
27907,29884,31774,2009,Italy,Sweden,1,0,Friendly,Cesena,Italy,False,1,1,Italy
27908,29885,31776,2009,Malaysia,Uzbekistan,1,3,AFC Asian Cup qualification,Kuala Lumpur,Malaysia,False,4,-2,Uzbekistan
27909,29886,31777,2009,Malta,Bulgaria,1,4,Friendly,Paola,Malta,False,5,-3,Bulgaria
27910,29887,31778,2009,Montenegro,Belarus,1,0,Friendly,Podgorica,Montenegro,False,1,1,Montenegro
27911,29888,31779,2009,Netherlands,Paraguay,0,0,Friendly,Heerenveen,Netherlands,False,0,0,Draw
27912,29889,31780,2009,Poland,Canada,1,0,Friendly,Bydgoszcz,Poland,False,1,1,Poland
27913,29890,31781,2009,Slovenia,Russia,1,0,FIFA World Cup qualification,Maribor,Slovenia,False,1,1,Slovenia
27914,29891,31782,2009,Syria,Vietnam,0,0,AFC Asian Cup qualification,Aleppo,Syria,False,0,0,Draw
27915,29892,31783,2009,Thailand,Singapore,0,1,AFC Asian Cup qualification,Bangkok,Thailand,False,1,-1,Singapore
27916,29893,31784,2009,Ukraine,Greece,0,1,FIFA World Cup qualification,Donets'k,Ukraine,False,1,-1,Greece
27917,29894,31785,2009,United Arab Emirates,Iraq,0,1,Friendly,al-Ain,United Arab Emirates,False,1,-1,Iraq
27918,29895,31786,2009,Uruguay,Costa Rica,1,1,FIFA World Cup qualification,Montevideo,Uruguay,False,2,0,Draw
27919,29897,31789,2009,Jordan,Iran,1,0,AFC Asian Cup qualification,Amman,Jordan,False,1,1,Jordan
27920,29898,31790,2009,Kenya,Zambia,0,2,CECAFA Cup,Nairobi,Kenya,False,2,-2,Zambia
27921,29900,31792,2009,Rwanda,Somalia,1,0,CECAFA Cup,Nairobi,Kenya,True,1,1,Rwanda
27922,29901,31793,2009,Uganda,Tanzania,2,0,CECAFA Cup,Mumias,Kenya,True,2,2,Uganda
27923,29902,31794,2009,Ethiopia,Djibouti,5,0,CECAFA Cup,Nairobi,Kenya,True,5,5,Ethiopia
27924,29903,31796,2009,Burundi,Uganda,0,2,CECAFA Cup,Mumias,Kenya,True,2,-2,Uganda
27925,29904,31797,2009,Ethiopia,Zambia,0,1,CECAFA Cup,Nairobi,Kenya,True,1,-1,Zambia
27926,29905,31798,2009,Kenya,Djibouti,2,0,CECAFA Cup,Nairobi,Kenya,False,2,2,Kenya
27927,29906,31799,2009,Rwanda,Eritrea,2,1,CECAFA Cup,Nairobi,Kenya,True,3,1,Rwanda
27928,29907,31800,2009,Bangladesh,Bhutan,4,1,SAFF Cup,Dhaka,Bangladesh,False,5,3,Bangladesh
27929,29908,31801,2009,Djibouti,Zambia,0,6,CECAFA Cup,Nairobi,Kenya,True,6,-6,Zambia
27930,29909,31802,2009,Sri Lanka,Pakistan,1,0,SAFF Cup,Dhaka,Bangladesh,True,1,1,Sri Lanka
27931,29910,31803,2009,Tanzania,Burundi,1,0,CECAFA Cup,Mumias,Kenya,True,1,1,Tanzania
27932,29912,31805,2009,Kenya,Ethiopia,2,0,CECAFA Cup,Nairobi,Kenya,False,2,2,Kenya
27933,29913,31806,2009,Maldives,Nepal,1,1,SAFF Cup,Dhaka,Bangladesh,True,2,0,Draw
27934,29914,31807,2009,Somalia,Eritrea,1,3,CECAFA Cup,Nairobi,Kenya,True,4,-2,Eritrea
27935,29916,31809,2009,Bangladesh,Pakistan,0,0,SAFF Cup,Dhaka,Bangladesh,False,0,0,Draw
27936,29917,31810,2009,Sri Lanka,Bhutan,6,0,SAFF Cup,Dhaka,Bangladesh,True,6,6,Sri Lanka
27937,29918,31811,2009,Kenya,Uganda,0,1,CECAFA Cup,Nairobi,Kenya,False,1,-1,Uganda
27938,29919,31812,2009,Maldives,Afghanistan,3,1,SAFF Cup,Dhaka,Bangladesh,True,4,2,Maldives
27939,29921,31814,2009,Bangladesh,Sri Lanka,2,1,SAFF Cup,Dhaka,Bangladesh,False,3,1,Bangladesh
27940,29922,31815,2009,Pakistan,Bhutan,7,0,SAFF Cup,Dhaka,Bangladesh,True,7,7,Pakistan
27941,29923,31816,2009,Tanzania,Eritrea,4,0,CECAFA Cup,Nairobi,Kenya,True,4,4,Tanzania
27942,29924,31817,2009,Afghanistan,Nepal,0,3,SAFF Cup,Dhaka,Bangladesh,True,3,-3,Nepal
27943,29925,31819,2009,Tanzania,Rwanda,1,2,CECAFA Cup,Nairobi,Kenya,True,3,-1,Rwanda
27944,29926,31820,2009,Maldives,Sri Lanka,5,1,SAFF Cup,Dhaka,Bangladesh,True,6,4,Maldives
27945,29927,31821,2009,Uganda,Rwanda,2,0,CECAFA Cup,Nairobi,Kenya,True,2,2,Uganda
27946,29928,31823,2009,Kuwait,United Arab Emirates,0,0,Friendly,Kuwait City,Kuwait,False,0,0,Draw
27947,29929,31824,2009,Mozambique,Malawi,0,1,Friendly,Tete,Mozambique,False,1,-1,Malawi
27948,29930,31827,2009,Qatar,Iran,3,2,Friendly,Doha,Qatar,False,5,1,Qatar
27949,29931,31828,2009,Egypt,Malawi,1,1,Friendly,Cairo,Egypt,False,2,0,Draw
27950,29932,31829,2009,Thailand,Zimbabwe,3,0,Friendly,Bangkok,Thailand,False,3,3,Thailand
27951,29933,31830,2009,Angola,Estonia,0,1,Friendly,Vila Real de Santo António,Portugal,True,1,-1,Estonia
27952,29934,31832,2009,Malaysia,Syria,4,1,Friendly,Kuala Lumpur,Malaysia,False,5,3,Malaysia
27953,29935,31833,2009,Mali,Iran,2,1,Friendly,Doha,Qatar,True,3,1,Mali
27954,29937,31835,2009,Yemen,Tajikistan,2,1,Friendly,Sana'a,Yemen,False,3,1,Yemen
27955,29938,31836,2009,Singapore,Oman,1,4,Friendly,Singapore,Singapore,False,5,-3,Oman
27956,29940,31838,2010,Qatar,Mali,0,0,Friendly,Doha,Qatar,False,0,0,Draw
27957,29941,31839,2010,Syria,Zimbabwe,6,0,Friendly,Kuala Lumpur,Malaysia,True,6,6,Syria
27958,29942,31840,2010,Yemen,Tajikistan,0,1,Friendly,Sana'a,Yemen,False,1,-1,Tajikistan
27959,29943,31841,2010,Angola,Gambia,1,1,Friendly,Vila Real de Santo António,Portugal,True,2,0,Draw
27960,29944,31842,2010,Egypt,Mali,1,0,Friendly,Dubai,United Arab Emirates,True,1,1,Egypt
27961,29945,31843,2010,Tanzania,Ivory Coast,0,1,Friendly,Dar es Salaam,Tanzania,False,1,-1,Ivory Coast
27962,29946,31844,2010,Ghana,Malawi,0,0,Friendly,Manzini,Eswatini,True,0,0,Draw
27963,29947,31845,2010,Bahrain,Hong Kong,4,0,AFC Asian Cup qualification,Riffa,Bahrain,False,4,4,Bahrain
27964,29948,31846,2010,Benin,Libya,1,0,Friendly,Cotonou,Benin,False,1,1,Benin
27965,29949,31848,2010,Gabon,Mozambique,2,0,Friendly,Bloemfontein,South Africa,True,2,2,Gabon
27966,29950,31849,2010,Indonesia,Oman,1,2,AFC Asian Cup qualification,Jakarta,Indonesia,False,3,-1,Oman
27967,29951,31850,2010,Kuwait,Australia,2,2,AFC Asian Cup qualification,Kuwait City,Kuwait,False,4,0,Draw
27968,29952,31851,2010,Lebanon,Vietnam,1,1,AFC Asian Cup qualification,Sidon,Lebanon,False,2,0,Draw
27969,29953,31852,2010,Singapore,Iran,1,3,AFC Asian Cup qualification,Singapore,Singapore,False,4,-2,Iran
27970,29954,31853,2010,Thailand,Jordan,0,0,AFC Asian Cup qualification,Bangkok,Thailand,False,0,0,Draw
27971,29955,31854,2010,United Arab Emirates,Malaysia,1,0,AFC Asian Cup qualification,Dubai,United Arab Emirates,False,1,1,United Arab Emirates
27972,29956,31855,2010,Yemen,Japan,2,3,AFC Asian Cup qualification,Sana'a,Yemen,False,5,-1,Japan
27973,29957,31856,2010,Rwanda,Ivory Coast,0,2,Friendly,Dar es Salaam,Tanzania,True,2,-2,Ivory Coast
27974,29958,31857,2010,Kenya,Cameroon,1,3,Friendly,Nairobi,Kenya,False,4,-2,Cameroon
27975,29959,31858,2010,Tunisia,Gambia,1,2,Friendly,Radès,Tunisia,False,3,-1,Gambia
27976,29961,31860,2010,Angola,Mali,4,4,African Cup of Nations,Luanda,Angola,False,8,0,Draw
27977,29962,31861,2010,Ivory Coast,Burkina Faso,0,0,African Cup of Nations,Cabinda,Angola,True,0,0,Draw
27978,29963,31862,2010,Malawi,Algeria,3,0,African Cup of Nations,Luanda,Angola,True,3,3,Malawi
27979,29964,31863,2010,Egypt,Nigeria,3,1,African Cup of Nations,Benguela,Angola,True,4,2,Egypt
27980,29965,31864,2010,Mozambique,Benin,2,2,African Cup of Nations,Benguela,Angola,True,4,0,Draw
27981,29966,31865,2010,Cameroon,Gabon,0,1,African Cup of Nations,Lubango,Angola,True,1,-1,Gabon
27982,29967,31866,2010,Zambia,Tunisia,1,1,African Cup of Nations,Lubango,Angola,True,2,0,Draw
27983,29968,31867,2010,Angola,Malawi,2,0,African Cup of Nations,Luanda,Angola,False,2,2,Angola
27984,29969,31868,2010,Mali,Algeria,0,1,African Cup of Nations,Luanda,Angola,True,1,-1,Algeria
27985,29970,31869,2010,Ivory Coast,Ghana,3,1,African Cup of Nations,Cabinda,Angola,True,4,2,Ivory Coast
27986,29971,31870,2010,Yemen,Kenya,3,1,Friendly,Sana'a,Yemen,False,4,2,Yemen
27987,29972,31871,2010,Egypt,Mozambique,2,0,African Cup of Nations,Benguela,Angola,True,2,2,Egypt
27988,29973,31872,2010,Nigeria,Benin,1,0,African Cup of Nations,Benguela,Angola,True,1,1,Nigeria
27989,29974,31873,2010,Cameroon,Zambia,3,2,African Cup of Nations,Lubango,Angola,True,5,1,Cameroon
27990,29975,31874,2010,Gabon,Tunisia,0,0,African Cup of Nations,Lubango,Angola,True,0,0,Draw
27991,29976,31875,2010,Thailand,Singapore,1,0,King's Cup,Nakhon Ratchasima,Thailand,False,1,1,Thailand
27992,29978,31877,2010,Angola,Algeria,0,0,African Cup of Nations,Luanda,Angola,False,0,0,Draw
27993,29980,31879,2010,Mali,Malawi,3,1,African Cup of Nations,Cabinda,Angola,True,4,2,Mali
27994,29981,31880,2010,Burkina Faso,Ghana,0,1,African Cup of Nations,Luanda,Angola,True,1,-1,Ghana
27995,29982,31881,2010,Chile,Panama,2,1,Friendly,Coquimbo,Chile,False,3,1,Chile
27996,29983,31882,2010,Egypt,Benin,2,0,African Cup of Nations,Benguela,Angola,True,2,2,Egypt
27997,29984,31883,2010,Nigeria,Mozambique,3,0,African Cup of Nations,Lubango,Angola,True,3,3,Nigeria
27998,29985,31884,2010,Oman,Sweden,0,1,Friendly,Muscat,Oman,False,1,-1,Sweden
27999,29986,31885,2010,Thailand,Poland,1,3,King's Cup,Nakhon Ratchasima,Thailand,False,4,-2,Poland
28000,29987,31886,2010,Yemen,Bahrain,3,0,AFC Asian Cup qualification,Sana'a,Yemen,False,3,3,Yemen
28001,29988,31887,2010,Cameroon,Tunisia,2,2,African Cup of Nations,Lubango,Angola,True,4,0,Draw
28002,29989,31888,2010,Gabon,Zambia,1,2,African Cup of Nations,Benguela,Angola,True,3,-1,Zambia
28003,29991,31890,2010,Poland,Singapore,6,1,King's Cup,Nakhon Ratchasima,Thailand,True,7,5,Poland
28004,29992,31891,2010,Syria,Sweden,1,1,Friendly,Damascus,Syria,False,2,0,Draw
28005,29993,31892,2010,United States,Honduras,1,3,Friendly,Carson,United States,False,4,-2,Honduras
28006,29994,31893,2010,Angola,Ghana,0,1,African Cup of Nations,Luanda,Angola,False,1,-1,Ghana
28007,29995,31894,2010,Ivory Coast,Algeria,2,3,African Cup of Nations,Cabinda,Angola,True,5,-1,Algeria
28008,29996,31895,2010,Egypt,Cameroon,3,1,African Cup of Nations,Benguela,Angola,True,4,2,Egypt
28009,29997,31896,2010,Zambia,Nigeria,0,0,African Cup of Nations,Lubango,Angola,True,0,0,Draw
28010,29998,31897,2010,Argentina,Costa Rica,3,2,Friendly,San Juan,Argentina,False,5,1,Argentina
28011,29999,31898,2010,South Africa,Zimbabwe,3,0,Friendly,Durban,South Africa,False,3,3,South Africa
28012,30000,31899,2010,Algeria,Egypt,0,4,African Cup of Nations,Benguela,Angola,True,4,-4,Egypt
28013,30001,31900,2010,Ghana,Nigeria,1,0,African Cup of Nations,Luanda,Angola,True,1,1,Ghana
28014,30002,31901,2010,Nigeria,Algeria,1,0,African Cup of Nations,Benguela,Angola,True,1,1,Nigeria
28015,30003,31902,2010,Ghana,Egypt,0,1,African Cup of Nations,Luanda,Angola,True,1,-1,Egypt
28016,30004,31903,2010,Jamaica,Canada,1,0,Friendly,Kingston,Jamaica,False,1,1,Jamaica
28017,30005,31904,2010,Japan,Venezuela,0,0,Friendly,Ōita,Japan,False,0,0,Draw
28018,30007,31907,2010,Argentina,Jamaica,2,1,Friendly,Mar del Plata,Argentina,False,3,1,Argentina
28019,30008,31909,2010,Japan,Hong Kong,3,0,EAFF Championship,Tokyo,Japan,False,3,3,Japan
28020,30011,31912,2010,Sri Lanka,Burma,0,4,AFC Challenge Cup,Colombo,Sri Lanka,False,4,-4,Burma
28021,30012,31913,2010,Tajikistan,Bangladesh,1,2,AFC Challenge Cup,Colombo,Sri Lanka,True,3,-1,Bangladesh
28022,30013,31915,2010,Bangladesh,Burma,1,2,AFC Challenge Cup,Colombo,Sri Lanka,True,3,-1,Burma
28023,30014,31916,2010,Sri Lanka,Tajikistan,1,3,AFC Challenge Cup,Colombo,Sri Lanka,False,4,-2,Tajikistan
28024,30015,31917,2010,Kuwait,Syria,1,1,Friendly,Al Ain,United Arab Emirates,True,2,0,Draw
28025,30017,31919,2010,Sri Lanka,Bangladesh,3,0,AFC Challenge Cup,Colombo,Sri Lanka,False,3,3,Sri Lanka
28026,30018,31920,2010,Tajikistan,Burma,3,0,AFC Challenge Cup,Colombo,Sri Lanka,True,3,3,Tajikistan
28027,30019,31921,2010,Turkmenistan,Kyrgyzstan,1,0,AFC Challenge Cup,Colombo,Sri Lanka,True,1,1,Turkmenistan
28028,30020,31923,2010,Mexico,Bolivia,5,0,Friendly,San Francisco,United States,True,5,5,Mexico
28029,30021,31924,2010,Tajikistan,Turkmenistan,0,2,AFC Challenge Cup,Colombo,Sri Lanka,True,2,-2,Turkmenistan
28030,30022,31925,2010,United States,El Salvador,2,1,Friendly,Tampa,United States,False,3,1,United States
28031,30023,31926,2010,Jordan,Azerbaijan,0,2,Friendly,Amman,Jordan,False,2,-2,Azerbaijan
28032,30024,31927,2010,Kuwait,Bahrain,4,1,Friendly,Al Ain,United Arab Emirates,True,5,3,Kuwait
28033,30026,31929,2010,Malaysia,Yemen,1,0,Friendly,Kuala Lumpur,Malaysia,False,1,1,Malaysia
28034,30027,31930,2010,Tajikistan,Burma,1,0,AFC Challenge Cup,Colombo,Sri Lanka,True,1,1,Tajikistan
28035,30028,31931,2010,Guadeloupe,Saint Kitts and Nevis,2,1,Friendly,Vieux-Habitants,Guadeloupe,False,3,1,Guadeloupe
28036,30029,31932,2010,Republic of Ireland,Brazil,0,2,Friendly,London,England,True,2,-2,Brazil
28037,30030,31933,2010,Albania,Northern Ireland,1,0,Friendly,Tirana,Albania,False,1,1,Albania
28038,30031,31934,2010,Algeria,Serbia,0,3,Friendly,Algiers,Algeria,False,3,-3,Serbia
28039,30032,31935,2010,Angola,Latvia,1,1,Friendly,Luanda,Angola,False,2,0,Draw
28040,30033,31936,2010,Armenia,Belarus,1,3,Friendly,Antalya,Turkey,True,4,-2,Belarus
28041,30034,31937,2010,Australia,Indonesia,1,0,AFC Asian Cup qualification,Brisbane,Australia,False,1,1,Australia
28042,30035,31938,2010,Austria,Denmark,2,1,Friendly,Vienna,Austria,False,3,1,Austria
28043,30036,31939,2010,Belgium,Croatia,0,1,Friendly,Brussels,Belgium,False,1,-1,Croatia
28044,30037,31940,2010,Bosnia and Herzegovina,Ghana,2,1,Friendly,Sarajevo,Bosnia and Herzegovina,False,3,1,Bosnia and Herzegovina
28045,30038,31941,2010,Cyprus,Iceland,0,0,Friendly,Larnaca,Cyprus,False,0,0,Draw
28046,30039,31942,2010,El Salvador,Guatemala,1,2,Friendly,Los Angeles,United States,True,3,-1,Guatemala
28047,30040,31943,2010,England,Egypt,3,1,Friendly,London,England,False,4,2,England
28048,30041,31944,2010,France,Spain,0,2,Friendly,Saint-Denis,France,False,2,-2,Spain
28049,30042,31945,2010,Georgia,Estonia,2,1,Friendly,Tbilisi,Georgia,False,3,1,Georgia
28050,30043,31946,2010,Germany,Argentina,0,1,Friendly,Munich,Germany,False,1,-1,Argentina
28051,30044,31947,2010,Greece,Senegal,0,2,Friendly,Vólos,Greece,False,2,-2,Senegal
28052,30045,31948,2010,Hong Kong,Yemen,0,0,AFC Asian Cup qualification,So Kon Po,Hong Kong,False,0,0,Draw
28053,30046,31949,2010,Hungary,Russia,1,1,Friendly,Budapest,Hungary,False,2,0,Draw
28054,30047,31950,2010,Iran,Thailand,1,0,AFC Asian Cup qualification,Teheran,Iran,False,1,1,Iran
28055,30048,31951,2010,Italy,Cameroon,0,0,Friendly,Monaco,Monaco,True,0,0,Draw
28056,30050,31953,2010,Japan,Bahrain,2,0,AFC Asian Cup qualification,Toyota,Japan,False,2,2,Japan
28057,30051,31954,2010,Jordan,Singapore,2,1,AFC Asian Cup qualification,Amman,Jordan,False,3,1,Jordan
28058,30052,31955,2010,Kazakhstan,Moldova,0,1,Friendly,Antalya,Turkey,True,1,-1,Moldova
28059,30053,31956,2010,Libya,Mali,2,1,Friendly,Tripoli,Libya,False,3,1,Libya
28060,30054,31957,2010,Luxembourg,Azerbaijan,1,2,Friendly,Luxembourg,Luxembourg,False,3,-1,Azerbaijan
28061,30055,31959,2010,Malta,Finland,1,2,Friendly,Attard,Malta,False,3,-1,Finland
28062,30056,31960,2010,Mexico,New Zealand,2,0,Friendly,Pasadena,United States,True,2,2,Mexico
28063,30057,31961,2010,Mozambique,Botswana,0,1,Friendly,Maputo,Mozambique,False,1,-1,Botswana
28064,30058,31962,2010,Netherlands,United States,2,1,Friendly,Amsterdam,Netherlands,False,3,1,Netherlands
28065,30059,31963,2010,Nigeria,DR Congo,5,2,Friendly,Abuja,Nigeria,False,7,3,Nigeria
28066,30060,31964,2010,Oman,Kuwait,0,0,AFC Asian Cup qualification,Muscat,Oman,False,0,0,Draw
28067,30061,31965,2010,Poland,Bulgaria,2,0,Friendly,Warsaw,Poland,False,2,2,Poland
28068,30063,31967,2010,Romania,Israel,0,2,Friendly,Timişoara,Romania,False,2,-2,Israel
28069,30064,31968,2010,Scotland,Czech Republic,1,0,Friendly,Glasgow,Scotland,False,1,1,Scotland
28070,30065,31969,2010,Slovakia,Norway,0,1,Friendly,Žilina,Slovakia,False,1,-1,Norway
28071,30066,31970,2010,Slovenia,Qatar,4,1,Friendly,Maribor,Slovenia,False,5,3,Slovenia
28072,30067,31971,2010,South Africa,Namibia,1,1,Friendly,Durban,South Africa,False,2,0,Draw
28073,30068,31972,2010,Switzerland,Uruguay,1,3,Friendly,St. Gallen,Switzerland,False,4,-2,Uruguay
28074,30069,31973,2010,Syria,Lebanon,4,0,AFC Asian Cup qualification,Damascus,Syria,False,4,4,Syria
28075,30070,31974,2010,Tanzania,Uganda,2,3,Friendly,Mwanza,Tanzania,False,5,-1,Uganda
28076,30071,31975,2010,Turkey,Honduras,2,0,Friendly,Istanbul,Turkey,False,2,2,Turkey
28077,30072,31976,2010,Uzbekistan,United Arab Emirates,0,1,AFC Asian Cup qualification,Tashkent,Uzbekistan,False,1,-1,United Arab Emirates
28078,30073,31977,2010,Venezuela,Panama,1,2,Friendly,Barquisimeto,Venezuela,False,3,-1,Panama
28079,30074,31978,2010,Wales,Sweden,0,1,Friendly,Swansea,Wales,False,1,-1,Sweden
28080,30075,31979,2010,Zimbabwe,Malawi,2,1,Friendly,Harare,Zimbabwe,False,3,1,Zimbabwe
28081,30077,31981,2010,Niger,Benin,2,0,Friendly,Niamey,Niger,False,2,2,Niger
28082,30079,31983,2010,Iceland,Faroe Islands,2,0,Friendly,Kópavogur,Iceland,False,2,2,Iceland
28083,30080,31984,2010,Namibia,Botswana,0,0,Friendly,Windhoek,Namibia,False,0,0,Draw
28084,30081,31985,2010,Martinique,Haiti,0,0,Friendly,Fort-de-France,Martinique,False,0,0,Draw
28085,30082,31986,2010,Mexico,Iceland,0,0,Friendly,Charlotte,United States,True,0,0,Draw
28086,30083,31987,2010,Chile,Venezuela,0,0,Friendly,Temuco,Chile,False,0,0,Draw
28087,30084,31988,2010,Paraguay,South Africa,1,1,Friendly,Asunción,Paraguay,False,2,0,Draw
28088,30085,31989,2010,Saint Kitts and Nevis,Guadeloupe,3,0,Friendly,Basseterre,Saint Kitts and Nevis,False,3,3,Saint Kitts and Nevis
28089,30086,31990,2010,Japan,Serbia,0,3,Friendly,Osaka,Japan,False,3,-3,Serbia
28090,30087,31991,2010,Honduras,Venezuela,0,1,Friendly,San Pedro Sula,Honduras,False,1,-1,Venezuela
28091,30089,31993,2010,South Africa,Jamaica,2,0,Friendly,Offenbach am Main,Germany,True,2,2,South Africa
28092,30090,31994,2010,Argentina,Haiti,4,0,Friendly,Cutral Có,Argentina,False,4,4,Argentina
28093,30091,31995,2010,Chile,Trinidad and Tobago,2,0,Friendly,Iquique,Chile,False,2,2,Chile
28094,30092,31996,2010,Mexico,Ecuador,0,0,Friendly,East Rutherford,United States,True,0,0,Draw
28095,30093,31997,2010,Mexico,Senegal,1,0,Friendly,Chicago,United States,True,1,1,Mexico
28096,30094,31998,2010,Yemen,Malawi,1,0,Friendly,Sana'a,Yemen,False,1,1,Yemen
28097,30095,31999,2010,Germany,Malta,3,0,Friendly,Aachen,Germany,False,3,3,Germany
28098,30096,32000,2010,Mexico,Angola,1,0,Friendly,Houston,United States,True,1,1,Mexico
28099,30098,32003,2010,Mexico,Chile,1,0,Friendly,Mexico City,Mexico,False,1,1,Mexico
28100,30099,32004,2010,South Africa,Thailand,4,0,Friendly,Nelspruit,South Africa,False,4,4,South Africa
28101,30100,32005,2010,Yemen,Oman,0,1,Friendly,Sana'a,Yemen,False,1,-1,Oman
28102,30101,32006,2010,Austria,Croatia,0,1,Friendly,Klagenfurt,Austria,False,1,-1,Croatia
28103,30102,32007,2010,Belgium,Bulgaria,2,1,Friendly,Brussels,Belgium,False,3,1,Belgium
28104,30103,32008,2010,Gabon,Togo,3,0,Friendly,Ajaccio,France,True,3,3,Gabon
28105,30104,32010,2010,Aruba,Venezuela,0,3,Friendly,Oranjestad,Aruba,False,3,-3,Venezuela
28106,30105,32011,2010,DR Congo,Saudi Arabia,0,2,Friendly,Schwaz,Austria,True,2,-2,Saudi Arabia
28107,30106,32012,2010,Estonia,Finland,2,0,Friendly,Tallinn,Estonia,False,2,2,Estonia
28108,30107,32015,2010,Turkey,Czech Republic,2,1,Friendly,Harrison,United States,True,3,1,Turkey
28109,30108,32016,2010,Croatia,Wales,2,0,Friendly,Osijek,Croatia,False,2,2,Croatia
28110,30109,32017,2010,Argentina,Canada,5,0,Friendly,Buenos Aires,Argentina,False,5,5,Argentina
28111,30110,32018,2010,Australia,New Zealand,2,1,Friendly,Melbourne,Australia,False,3,1,Australia
28112,30111,32019,2010,England,Mexico,3,1,Friendly,London,England,False,4,2,England
28113,30114,32022,2010,South Africa,Bulgaria,1,1,Friendly,Johannesburg,South Africa,False,2,0,Draw
28114,30115,32023,2010,Armenia,Uzbekistan,3,1,Friendly,Yerevan,Armenia,False,4,2,Armenia
28115,30116,32024,2010,Georgia,Cameroon,0,0,Friendly,Linz,Austria,True,0,0,Draw
28116,30118,32026,2010,Republic of Ireland,Paraguay,2,1,Friendly,Dublin,Republic of Ireland,False,3,1,Republic of Ireland
28117,30119,32027,2010,Montenegro,Albania,0,1,Friendly,Podgorica,Montenegro,False,1,-1,Albania
28118,30120,32028,2010,Nigeria,Saudi Arabia,0,0,Friendly,Wattens,Austria,True,0,0,Draw
28119,30121,32029,2010,Ukraine,Lithuania,4,0,Friendly,Kharkiv,Ukraine,False,4,4,Ukraine
28120,30122,32030,2010,United States,Czech Republic,2,4,Friendly,East Hartford,United States,False,6,-2,Czech Republic
28121,30123,32031,2010,Azerbaijan,Moldova,1,1,Friendly,Seekirchen am Wallersee,Austria,True,2,0,Draw
28122,30124,32032,2010,Chile,Zambia,3,0,Friendly,Calama,Chile,False,3,3,Chile
28123,30125,32033,2010,Estonia,Croatia,0,0,Friendly,Tallinn,Estonia,False,0,0,Draw
28124,30126,32034,2010,France,Costa Rica,2,1,Friendly,Lens,France,False,3,1,France
28125,30127,32035,2010,Netherlands,Mexico,2,1,Friendly,Freiburg,Germany,True,3,1,Netherlands
28126,30128,32036,2010,Northern Ireland,Turkey,0,2,Friendly,New Britain,United States,True,2,-2,Turkey
28127,30129,32037,2010,Uruguay,Israel,4,1,Friendly,Montevideo,Uruguay,False,5,3,Uruguay
28128,30130,32038,2010,Belarus,Honduras,2,2,Friendly,Villach,Austria,True,4,0,Draw
28129,30131,32039,2010,Denmark,Senegal,2,0,Friendly,Aalborg,Denmark,False,2,2,Denmark
28130,30132,32040,2010,South Africa,Colombia,2,1,Friendly,Johannesburg,South Africa,False,3,1,South Africa
28131,30133,32041,2010,Republic of Ireland,Algeria,3,0,Friendly,Dublin,Republic of Ireland,False,3,3,Republic of Ireland
28132,30135,32043,2010,Hungary,Germany,0,3,Friendly,Budapest,Hungary,False,3,-3,Germany
28133,30136,32044,2010,Iceland,Andorra,4,0,Friendly,Reykjavík,Iceland,False,4,4,Iceland
28134,30137,32045,2010,Moldova,United Arab Emirates,2,3,Friendly,Anif,Austria,True,5,-1,United Arab Emirates
28135,30138,32046,2010,New Zealand,Serbia,1,0,Friendly,Klagenfurt,Austria,True,1,1,New Zealand
28136,30139,32047,2010,Norway,Montenegro,2,1,Friendly,Oslo,Norway,False,3,1,Norway
28137,30140,32048,2010,Poland,Finland,0,0,Friendly,Kielce,Poland,False,0,0,Draw
28138,30141,32049,2010,Slovakia,Cameroon,1,1,Friendly,Klagenfurt,Austria,True,2,0,Draw
28139,30142,32050,2010,Spain,Saudi Arabia,3,2,Friendly,Innsbruck,Austria,True,5,1,Spain
28140,30143,32051,2010,Sweden,Bosnia and Herzegovina,4,2,Friendly,Solna,Sweden,False,6,2,Sweden
28141,30144,32052,2010,Ukraine,Romania,3,2,Friendly,L'viv,Ukraine,False,5,1,Ukraine
28142,30145,32053,2010,United States,Turkey,2,1,Friendly,Philadelphia,United States,False,3,1,United States
28143,30146,32054,2010,Venezuela,Canada,1,1,Friendly,Mérida,Venezuela,False,2,0,Draw
28144,30148,32056,2010,Chile,Northern Ireland,1,0,Friendly,Chillán,Chile,False,1,1,Chile
28145,30149,32057,2010,Chile,Israel,3,0,Friendly,Concepción,Chile,False,3,3,Chile
28146,30150,32058,2010,Grenada,Martinique,2,2,Friendly,Grenville,Grenada,False,4,0,Draw
28147,30151,32059,2010,Japan,England,1,2,Friendly,Graz,Austria,True,3,-1,England
28148,30152,32060,2010,Mexico,Gambia,5,1,Friendly,Bayreuth,Germany,True,6,4,Mexico
28149,30153,32061,2010,Nigeria,Colombia,1,1,Friendly,Milton Keynes,England,True,2,0,Draw
28150,30154,32062,2010,Paraguay,Ivory Coast,2,2,Friendly,Thonon-les-Bains,France,True,4,0,Draw
28151,30155,32063,2010,Tunisia,France,1,1,Friendly,Radès,Tunisia,False,2,0,Draw
28152,30156,32064,2010,South Africa,Guatemala,5,0,Friendly,Polokwane,South Africa,False,5,5,South Africa
28153,30157,32067,2010,Australia,Denmark,1,0,Friendly,Roodepoort,South Africa,True,1,1,Australia
28154,30158,32068,2010,Netherlands,Ghana,4,1,Friendly,Rotterdam,Netherlands,False,5,3,Netherlands
28155,30159,32069,2010,Portugal,Cameroon,3,1,Friendly,Covilhã,Portugal,False,4,2,Portugal
28156,30160,32070,2010,Switzerland,Costa Rica,0,1,Friendly,Sion,Switzerland,False,1,-1,Costa Rica
28157,30161,32073,2010,Albania,Andorra,1,0,Friendly,Tirana,Albania,False,1,1,Albania
28158,30162,32074,2010,Azerbaijan,Honduras,0,0,Friendly,Zell am See,Austria,True,0,0,Draw
28159,30163,32075,2010,Belarus,Sweden,0,1,Friendly,Minsk,Belarus,False,1,-1,Sweden
28160,30164,32076,2010,Greece,Paraguay,0,2,Friendly,Winterthur,Switzerland,True,2,-2,Paraguay
28161,30165,32077,2010,Norway,Ukraine,0,1,Friendly,Oslo,Norway,False,1,-1,Ukraine
28162,30167,32079,2010,Serbia,Poland,0,0,Friendly,Kufstein,Austria,True,0,0,Draw
28163,30168,32080,2010,Zimbabwe,Brazil,0,3,Friendly,Harare,Zimbabwe,False,3,-3,Brazil
28164,30169,32083,2010,Germany,Bosnia and Herzegovina,3,1,Friendly,Frankfurt am Main,Germany,False,4,2,Germany
28165,30170,32084,2010,Italy,Mexico,1,2,Friendly,Brussels,Belgium,True,3,-1,Mexico
28166,30173,32087,2010,Japan,Ivory Coast,0,2,Friendly,Sion,Switzerland,True,2,-2,Ivory Coast
28167,30174,32088,2010,Luxembourg,Faroe Islands,0,0,Friendly,Hesperange,Luxembourg,False,0,0,Draw
28168,30175,32089,2010,Slovenia,New Zealand,3,1,Friendly,Maribor,Slovenia,False,4,2,Slovenia
28169,30176,32090,2010,Sudan,Palestine,1,1,Friendly,Omdurman,Sudan,False,2,0,Draw
28170,30177,32094,2010,Algeria,United Arab Emirates,1,0,Friendly,Fürth,Germany,True,1,1,Algeria
28171,30178,32095,2010,Australia,United States,1,3,Friendly,Roodepoort,South Africa,True,4,-2,United States
28172,30179,32096,2010,Ghana,Latvia,1,0,Friendly,Milton Keynes,England,True,1,1,Ghana
28173,30180,32097,2010,Netherlands,Hungary,6,1,Friendly,Amsterdam,Netherlands,False,7,5,Netherlands
28174,30181,32098,2010,Romania,Honduras,3,0,Friendly,Sankt Veit an der Glan,Austria,True,3,3,Romania
28175,30182,32099,2010,Serbia,Cameroon,4,3,Friendly,Belgrade,Serbia,False,7,1,Serbia
28176,30183,32100,2010,Slovakia,Costa Rica,3,0,Friendly,Bratislava,Slovakia,False,3,3,Slovakia
28177,30184,32101,2010,South Africa,Denmark,1,0,Friendly,Atteridgeville,South Africa,False,1,1,South Africa
28178,30185,32102,2010,Switzerland,Italy,1,1,Friendly,Geneva,Switzerland,False,2,0,Draw
28179,30187,32106,2010,Tanzania,Brazil,1,5,Friendly,Dar es Salaam,Tanzania,False,6,-4,Brazil
28180,30188,32107,2010,Mozambique,Portugal,0,3,Friendly,Johannesburg,South Africa,True,3,-3,Portugal
28181,30189,32108,2010,Spain,Poland,6,0,Friendly,Murcia,Spain,False,6,6,Spain
28182,30190,32109,2010,South Africa,Mexico,1,1,FIFA World Cup,Johannesburg,South Africa,False,2,0,Draw
28183,30191,32110,2010,Uruguay,France,0,0,FIFA World Cup,Cape Town,South Africa,True,0,0,Draw
28184,30192,32111,2010,Argentina,Nigeria,1,0,FIFA World Cup,Johannesburg,South Africa,True,1,1,Argentina
28185,30193,32112,2010,England,United States,1,1,FIFA World Cup,Rustenburg,South Africa,True,2,0,Draw
28186,30194,32114,2010,Algeria,Slovenia,0,1,FIFA World Cup,Polokwane,South Africa,True,1,-1,Slovenia
28187,30195,32115,2010,Germany,Australia,4,0,FIFA World Cup,Durban,South Africa,True,4,4,Germany
28188,30196,32116,2010,Serbia,Ghana,0,1,FIFA World Cup,Pretoria,South Africa,True,1,-1,Ghana
28189,30197,32117,2010,Italy,Paraguay,1,1,FIFA World Cup,Cape Town,South Africa,True,2,0,Draw
28190,30198,32118,2010,Japan,Cameroon,1,0,FIFA World Cup,Bloemfontein,South Africa,True,1,1,Japan
28191,30199,32119,2010,Netherlands,Denmark,2,0,FIFA World Cup,Johannesburg,South Africa,True,2,2,Netherlands
28192,30201,32121,2010,Ivory Coast,Portugal,0,0,FIFA World Cup,Port Elizabeth,South Africa,True,0,0,Draw
28193,30202,32122,2010,New Zealand,Slovakia,1,1,FIFA World Cup,Rustenburg,South Africa,True,2,0,Draw
28194,30203,32123,2010,Honduras,Chile,0,1,FIFA World Cup,Nelspruit,South Africa,True,1,-1,Chile
28195,30204,32124,2010,South Africa,Uruguay,0,3,FIFA World Cup,Pretoria,South Africa,False,3,-3,Uruguay
28196,30205,32125,2010,Spain,Switzerland,0,1,FIFA World Cup,Durban,South Africa,True,1,-1,Switzerland
28197,30207,32127,2010,France,Mexico,0,2,FIFA World Cup,Polokwane,South Africa,True,2,-2,Mexico
28198,30208,32128,2010,Greece,Nigeria,2,1,FIFA World Cup,Bloemfontein,South Africa,True,3,1,Greece
28199,30209,32129,2010,England,Algeria,0,0,FIFA World Cup,Cape Town,South Africa,True,0,0,Draw
28200,30210,32130,2010,Germany,Serbia,0,1,FIFA World Cup,Port Elizabeth,South Africa,True,1,-1,Serbia
28201,30211,32131,2010,Lithuania,Latvia,0,0,Baltic Cup,Kaunas,Lithuania,False,0,0,Draw
28202,30212,32132,2010,Slovenia,United States,2,2,FIFA World Cup,Johannesburg,South Africa,True,4,0,Draw
28203,30213,32133,2010,Cameroon,Denmark,1,2,FIFA World Cup,Pretoria,South Africa,True,3,-1,Denmark
28204,30214,32134,2010,Estonia,Latvia,0,0,Baltic Cup,Kaunas,Lithuania,True,0,0,Draw
28205,30215,32135,2010,Ghana,Australia,1,1,FIFA World Cup,Rustenburg,South Africa,True,2,0,Draw
28206,30216,32136,2010,Netherlands,Japan,1,0,FIFA World Cup,Durban,South Africa,True,1,1,Netherlands
28207,30217,32137,2010,Niger,Chad,1,1,Friendly,Niamey,Niger,False,2,0,Draw
28208,30218,32138,2010,Northern Mariana Islands,Guam,1,1,Friendly,Susupe,Northern Mariana Islands,False,2,0,Draw
28209,30219,32139,2010,Brazil,Ivory Coast,3,1,FIFA World Cup,Johannesburg,South Africa,True,4,2,Brazil
28210,30220,32140,2010,Italy,New Zealand,1,1,FIFA World Cup,Nelspruit,South Africa,True,2,0,Draw
28211,30221,32141,2010,Lithuania,Estonia,2,0,Baltic Cup,Kaunas,Lithuania,False,2,2,Lithuania
28212,30222,32142,2010,Slovakia,Paraguay,0,2,FIFA World Cup,Bloemfontein,South Africa,True,2,-2,Paraguay
28213,30223,32143,2010,Sudan,Tunisia,2,6,Friendly,Omdurman,Sudan,False,8,-4,Tunisia
28214,30224,32144,2010,Chile,Switzerland,1,0,FIFA World Cup,Port Elizabeth,South Africa,True,1,1,Chile
28215,30226,32146,2010,Spain,Honduras,2,0,FIFA World Cup,Johannesburg,South Africa,True,2,2,Spain
28216,30227,32147,2010,Greece,Argentina,0,2,FIFA World Cup,Polokwane,South Africa,True,2,-2,Argentina
28217,30228,32148,2010,Mexico,Uruguay,0,1,FIFA World Cup,Rustenburg,South Africa,True,1,-1,Uruguay
28218,30230,32150,2010,South Africa,France,2,1,FIFA World Cup,Bloemfontein,South Africa,False,3,1,South Africa
28219,30231,32151,2010,Australia,Serbia,2,1,FIFA World Cup,Nelspruit,South Africa,True,3,1,Australia
28220,30232,32152,2010,Ghana,Germany,0,1,FIFA World Cup,Johannesburg,South Africa,True,1,-1,Germany
28221,30233,32153,2010,Slovenia,England,0,1,FIFA World Cup,Port Elizabeth,South Africa,True,1,-1,England
28222,30234,32154,2010,United States,Algeria,1,0,FIFA World Cup,Pretoria,South Africa,True,1,1,United States
28223,30235,32155,2010,Cameroon,Netherlands,1,2,FIFA World Cup,Cape Town,South Africa,True,3,-1,Netherlands
28224,30236,32156,2010,Denmark,Japan,1,3,FIFA World Cup,Rustenburg,South Africa,True,4,-2,Japan
28225,30237,32157,2010,Paraguay,New Zealand,0,0,FIFA World Cup,Polokwane,South Africa,True,0,0,Draw
28226,30238,32158,2010,Slovakia,Italy,3,2,FIFA World Cup,Johannesburg,South Africa,True,5,1,Slovakia
28227,30239,32159,2010,Chile,Spain,1,2,FIFA World Cup,Pretoria,South Africa,True,3,-1,Spain
28228,30240,32161,2010,Portugal,Brazil,0,0,FIFA World Cup,Durban,South Africa,True,0,0,Draw
28229,30241,32162,2010,Switzerland,Honduras,0,0,FIFA World Cup,Bloemfontein,South Africa,True,0,0,Draw
28230,30243,32165,2010,United States,Ghana,1,2,FIFA World Cup,Rustenburg,South Africa,True,3,-1,Ghana
28231,30244,32166,2010,Argentina,Mexico,3,1,FIFA World Cup,Johannesburg,South Africa,True,4,2,Argentina
28232,30245,32167,2010,Germany,England,4,1,FIFA World Cup,Bloemfontein,South Africa,True,5,3,Germany
28233,30246,32168,2010,Brazil,Chile,3,0,FIFA World Cup,Johannesburg,South Africa,True,3,3,Brazil
28234,30247,32169,2010,Netherlands,Slovakia,2,1,FIFA World Cup,Durban,South Africa,True,3,1,Netherlands
28235,30248,32170,2010,Paraguay,Japan,0,0,FIFA World Cup,Pretoria,South Africa,True,0,0,Draw
28236,30249,32171,2010,Spain,Portugal,1,0,FIFA World Cup,Cape Town,South Africa,True,1,1,Spain
28237,30250,32172,2010,Chad,Togo,2,2,African Cup of Nations qualification,N'Djamena,Chad,False,4,0,Draw
28238,30251,32173,2010,Tunisia,Botswana,0,1,African Cup of Nations qualification,Tunis,Tunisia,False,1,-1,Botswana
28239,30252,32174,2010,Netherlands,Brazil,2,1,FIFA World Cup,Port Elizabeth,South Africa,True,3,1,Netherlands
28240,30253,32175,2010,Uruguay,Ghana,1,1,FIFA World Cup,Johannesburg,South Africa,True,2,0,Draw
28241,30254,32176,2010,Argentina,Germany,0,4,FIFA World Cup,Cape Town,South Africa,True,4,-4,Germany
28242,30255,32177,2010,Paraguay,Spain,0,1,FIFA World Cup,Johannesburg,South Africa,True,1,-1,Spain
28243,30256,32178,2010,Uruguay,Netherlands,2,3,FIFA World Cup,Cape Town,South Africa,True,5,-1,Netherlands
28244,30257,32179,2010,Germany,Spain,0,1,FIFA World Cup,Durban,South Africa,True,1,-1,Spain
28245,30258,32180,2010,Botswana,Chad,1,0,African Cup of Nations qualification,Gaborone,Botswana,False,1,1,Botswana
28246,30259,32181,2010,Togo,Malawi,1,1,African Cup of Nations qualification,Lomé,Togo,False,2,0,Draw
28247,30260,32182,2010,Uruguay,Germany,2,3,FIFA World Cup,Port Elizabeth,South Africa,True,5,-1,Germany
28248,30261,32183,2010,Netherlands,Spain,0,1,FIFA World Cup,Johannesburg,South Africa,True,1,-1,Spain
28249,30262,32184,2010,Botswana,Zimbabwe,2,0,Friendly,Selebi-Phikwe,Botswana,False,2,2,Botswana
28250,30263,32185,2010,Anguilla,Saint Martin,1,3,Friendly,The Valley,Anguilla,False,4,-2,Saint Martin
28251,30264,32186,2010,Bosnia and Herzegovina,Qatar,1,1,Friendly,Sarajevo,Bosnia and Herzegovina,False,2,0,Draw
28252,30265,32187,2010,Italy,Ivory Coast,0,1,Friendly,London,England,True,1,-1,Ivory Coast
28253,30266,32188,2010,United States,Brazil,0,2,Friendly,East Rutherford,United States,False,2,-2,Brazil
28254,30267,32189,2010,Albania,Uzbekistan,1,0,Friendly,Durrës,Albania,False,1,1,Albania
28255,30268,32190,2010,Algeria,Gabon,1,2,Friendly,Algiers,Algeria,False,3,-1,Gabon
28256,30269,32191,2010,Angola,Uruguay,0,2,Friendly,Lisbon,Portugal,True,2,-2,Uruguay
28257,30270,32192,2010,Armenia,Iran,1,3,Friendly,Yerevan,Armenia,False,4,-2,Iran
28258,30271,32193,2010,Austria,Switzerland,0,1,Friendly,Klagenfurt,Austria,False,1,-1,Switzerland
28259,30272,32194,2010,Azerbaijan,Kuwait,1,1,Friendly,Baku,Azerbaijan,False,2,0,Draw
28260,30273,32195,2010,Benin,Niger,0,0,Friendly,Porto-Novo,Benin,False,0,0,Draw
28261,30274,32196,2010,Bolivia,Colombia,1,1,Friendly,La Paz,Bolivia,False,2,0,Draw
28262,30275,32197,2010,Burkina Faso,Congo,3,0,Friendly,Senlis,France,True,3,3,Burkina Faso
28263,30276,32198,2010,Chad,Tunisia,1,3,African Cup of Nations qualification,N'Djamena,Chad,False,4,-2,Tunisia
28264,30277,32200,2010,Cyprus,Andorra,1,0,Friendly,Larnaca,Cyprus,False,1,1,Cyprus
28265,30278,32201,2010,Czech Republic,Latvia,4,1,Friendly,Liberec,Czech Republic,False,5,3,Czech Republic
28266,30279,32202,2010,Denmark,Germany,2,2,Friendly,Copenhagen,Denmark,False,4,0,Draw
28267,30280,32203,2010,Egypt,DR Congo,6,3,Friendly,Cairo,Egypt,False,9,3,Egypt
28268,30281,32204,2010,England,Hungary,2,1,Friendly,London,England,False,3,1,England
28269,30282,32205,2010,Estonia,Faroe Islands,2,1,UEFA Euro qualification,Tallinn,Estonia,False,3,1,Estonia
28270,30283,32206,2010,Finland,Belgium,1,0,Friendly,Turku,Finland,False,1,1,Finland
28271,30284,32207,2010,Iceland,Liechtenstein,1,1,Friendly,Reykjavík,Iceland,False,2,0,Draw
28272,30285,32208,2010,Republic of Ireland,Argentina,0,1,Friendly,Dublin,Republic of Ireland,False,1,-1,Argentina
28273,30286,32209,2010,Kazakhstan,Oman,3,1,Friendly,Astana,Kazakhstan,False,4,2,Kazakhstan
28274,30287,32211,2010,Lithuania,Belarus,0,2,Friendly,Kaunas,Lithuania,False,2,-2,Belarus
28275,30288,32212,2010,Malawi,Botswana,1,1,African Cup of Nations qualification,Blantyre,Malawi,False,2,0,Draw
28276,30289,32213,2010,Mali,Guinea,0,2,Friendly,Marignane,France,True,2,-2,Guinea
28277,30291,32215,2010,Mauritania,Palestine,0,0,Friendly,Nouakchott,Mauritania,False,0,0,Draw
28278,30292,32216,2010,Mexico,Spain,1,1,Friendly,Mexico City,Mexico,False,2,0,Draw
28279,30293,32217,2010,Moldova,Georgia,0,0,Friendly,Chișinău,Moldova,False,0,0,Draw
28280,30294,32218,2010,Montenegro,Northern Ireland,2,0,Friendly,Podgorica,Montenegro,False,2,2,Montenegro
28281,30295,32219,2010,Morocco,Equatorial Guinea,2,1,Friendly,Rabat,Morocco,False,3,1,Morocco
28282,30296,32220,2010,Mozambique,Eswatini,2,1,Friendly,Maputo,Mozambique,False,3,1,Mozambique
28283,30297,32221,2010,Norway,France,2,1,Friendly,Oslo,Norway,False,3,1,Norway
28284,30298,32222,2010,Panama,Venezuela,3,1,Friendly,Panama City,Panama,False,4,2,Panama
28285,30299,32223,2010,Paraguay,Costa Rica,2,0,Friendly,Asunción,Paraguay,False,2,2,Paraguay
28286,30300,32224,2010,Poland,Cameroon,0,3,Friendly,Szczecin,Poland,False,3,-3,Cameroon
28287,30301,32225,2010,Russia,Bulgaria,1,0,Friendly,St. Petersburg,Russia,False,1,1,Russia
28288,30302,32226,2010,Saudi Arabia,Togo,1,0,Friendly,Riyadh,Saudi Arabia,False,1,1,Saudi Arabia
28289,30304,32228,2010,Serbia,Greece,0,1,Friendly,Belgrade,Serbia,False,1,-1,Greece
28290,30305,32229,2010,Slovakia,Croatia,1,1,Friendly,Bratislava,Slovakia,False,2,0,Draw
28291,30306,32230,2010,Slovenia,Australia,2,0,Friendly,Ljubljana,Slovenia,False,2,2,Slovenia
28292,30307,32231,2010,South Africa,Ghana,1,0,Friendly,Johannesburg,South Africa,False,1,1,South Africa
28293,30308,32232,2010,Sweden,Scotland,3,0,Friendly,Solna,Sweden,False,3,3,Sweden
28294,30309,32233,2010,Tanzania,Kenya,1,1,Friendly,Dar es Salaam,Tanzania,False,2,0,Draw
28295,30310,32234,2010,Thailand,Singapore,1,0,Friendly,Bangkok,Thailand,False,1,1,Thailand
28296,30311,32235,2010,Trinidad and Tobago,Jamaica,1,3,Friendly,Macoya,Trinidad and Tobago,False,4,-2,Jamaica
28297,30312,32236,2010,Turkey,Romania,2,0,Friendly,Istanbul,Turkey,False,2,2,Turkey
28298,30313,32237,2010,Uganda,Zambia,1,1,Friendly,Kampala,Uganda,False,2,0,Draw
28299,30314,32238,2010,Ukraine,Netherlands,1,1,Friendly,Donets'k,Ukraine,False,2,0,Draw
28300,30315,32239,2010,Wales,Luxembourg,5,1,Friendly,Llanelli,Wales,False,6,4,Wales
28301,30316,32240,2010,Ethiopia,Kenya,0,3,Friendly,Addis Abeba,Ethiopia,False,3,-3,Kenya
28302,30317,32241,2010,Madagascar,Mayotte,0,0,Friendly,Mahajanga,Madagascar,False,0,0,Draw
28303,30318,32242,2010,Saint Lucia,Martinique,1,3,Friendly,Vieux Fort,Saint Lucia,False,4,-2,Martinique
28304,30319,32243,2010,Saint Kitts and Nevis,Antigua and Barbuda,1,1,Friendly,Basseterre,Saint Kitts and Nevis,False,2,0,Draw
28305,30320,32244,2010,Saint Lucia,Martinique,1,1,Friendly,Vieux Fort,Saint Lucia,False,2,0,Draw
28306,30321,32245,2010,Ethiopia,Chad,1,0,Friendly,Addis Abeba,Ethiopia,False,1,1,Ethiopia
28307,30322,32246,2010,Madagascar,Comoros,1,0,Friendly,Mahajanga,Madagascar,False,1,1,Madagascar
28308,30323,32247,2010,Israel,Malta,3,1,UEFA Euro qualification,Ramat-Gan,Israel,False,4,2,Israel
28309,30324,32248,2010,Algeria,Tanzania,1,1,African Cup of Nations qualification,Blida,Algeria,False,2,0,Draw
28310,30325,32249,2010,Andorra,Russia,0,2,UEFA Euro qualification,Sant Julià de Lòria,Andorra,False,2,-2,Russia
28311,30326,32250,2010,Armenia,Republic of Ireland,0,1,UEFA Euro qualification,Yerevan,Armenia,False,1,-1,Republic of Ireland
28312,30327,32251,2010,Belgium,Germany,0,1,UEFA Euro qualification,Brussels,Belgium,False,1,-1,Germany
28313,30328,32253,2010,England,Bulgaria,4,0,UEFA Euro qualification,London,England,False,4,4,England
28314,30329,32254,2010,Estonia,Italy,1,2,UEFA Euro qualification,Tallinn,Estonia,False,3,-1,Italy
28315,30330,32255,2010,Faroe Islands,Serbia,0,3,UEFA Euro qualification,Tórshavn,Faroe Islands,False,3,-3,Serbia
28316,30331,32256,2010,France,Belarus,0,1,UEFA Euro qualification,Saint-Denis,France,False,1,-1,Belarus
28317,30332,32257,2010,Greece,Georgia,1,1,UEFA Euro qualification,Piraeus,Greece,False,2,0,Draw
28318,30333,32258,2010,Iceland,Norway,1,2,UEFA Euro qualification,Reykjavík,Iceland,False,3,-1,Norway
28319,30334,32259,2010,Kazakhstan,Turkey,0,3,UEFA Euro qualification,Astana,Kazakhstan,False,3,-3,Turkey
28320,30335,32260,2010,Kuwait,Syria,3,0,Friendly,Kuwait City,Kuwait,False,3,3,Kuwait
28321,30336,32261,2010,Latvia,Croatia,0,3,UEFA Euro qualification,Riga,Latvia,False,3,-3,Croatia
28322,30337,32262,2010,Liechtenstein,Spain,0,4,UEFA Euro qualification,Vaduz,Liechtenstein,False,4,-4,Spain
28323,30338,32263,2010,Lithuania,Scotland,0,0,UEFA Euro qualification,Kaunas,Lithuania,False,0,0,Draw
28324,30339,32264,2010,Luxembourg,Bosnia and Herzegovina,0,3,UEFA Euro qualification,Luxembourg,Luxembourg,False,3,-3,Bosnia and Herzegovina
28325,30340,32265,2010,Moldova,Finland,2,0,UEFA Euro qualification,Chişinău,Moldova,False,2,2,Moldova
28326,30341,32266,2010,Montenegro,Wales,1,0,UEFA Euro qualification,Podgorica,Montenegro,False,1,1,Montenegro
28327,30342,32267,2010,Oman,Malaysia,3,0,Friendly,Doha,Qatar,True,3,3,Oman
28328,30343,32268,2010,Panama,Costa Rica,2,2,Friendly,Panama City,Panama,False,4,0,Draw
28329,30344,32269,2010,Portugal,Cyprus,4,4,UEFA Euro qualification,Guimarães,Portugal,False,8,0,Draw
28330,30345,32270,2010,Qatar,Bahrain,1,1,Friendly,Doha,Qatar,False,2,0,Draw
28331,30346,32271,2010,Romania,Albania,1,1,UEFA Euro qualification,Piatra Neamţ,Romania,False,2,0,Draw
28332,30347,32272,2010,San Marino,Netherlands,0,5,UEFA Euro qualification,Serravalle,San Marino,False,5,-5,Netherlands
28333,30349,32274,2010,Slovenia,Northern Ireland,0,1,UEFA Euro qualification,Maribor,Slovenia,False,1,-1,Northern Ireland
28334,30350,32275,2010,Sweden,Hungary,2,0,UEFA Euro qualification,Solna,Sweden,False,2,2,Sweden
28335,30351,32276,2010,Switzerland,Australia,0,0,Friendly,St. Gallen,Switzerland,False,0,0,Draw
28336,30352,32277,2010,Venezuela,Colombia,0,2,Friendly,Puerto la Cruz,Venezuela,False,2,-2,Colombia
28337,30353,32278,2010,Botswana,Togo,2,1,African Cup of Nations qualification,Gaborone,Botswana,False,3,1,Botswana
28338,30354,32279,2010,Canada,Peru,0,2,Friendly,Toronto,Canada,False,2,-2,Peru
28339,30355,32281,2010,El Salvador,Honduras,2,2,Friendly,Los Angeles,United States,True,4,0,Draw
28340,30356,32282,2010,Guatemala,Nicaragua,5,0,Friendly,Fort Lauderdale,United States,True,5,5,Guatemala
28341,30357,32283,2010,Guinea-Bissau,Kenya,1,0,African Cup of Nations qualification,Bissau,Guinea-Bissau,False,1,1,Guinea-Bissau
28342,30358,32284,2010,Ivory Coast,Rwanda,3,0,African Cup of Nations qualification,Abidjan,Ivory Coast,False,3,3,Ivory Coast
28343,30359,32285,2010,Japan,Paraguay,1,0,Friendly,Yokohama,Japan,False,1,1,Japan
28344,30360,32286,2010,Mauritius,Cameroon,1,3,African Cup of Nations qualification,Mapou,Mauritius,False,4,-2,Cameroon
28345,30361,32287,2010,Mexico,Ecuador,1,2,Friendly,Zapopan,Mexico,False,3,-1,Ecuador
28346,30362,32288,2010,Morocco,Central African Republic,0,0,African Cup of Nations qualification,Rabat,Morocco,False,0,0,Draw
28347,30363,32289,2010,Poland,Ukraine,1,1,Friendly,Łódź,Poland,False,2,0,Draw
28348,30364,32290,2010,South Africa,Niger,2,0,African Cup of Nations qualification,Nelspruit,South Africa,False,2,2,South Africa
28349,30365,32291,2010,Sudan,Congo,2,0,African Cup of Nations qualification,Khartoum,Sudan,False,2,2,Sudan
28350,30366,32292,2010,Thailand,India,1,0,Friendly,Bangkok,Thailand,False,1,1,Thailand
28351,30367,32293,2010,Tunisia,Malawi,2,2,African Cup of Nations qualification,Radès,Tunisia,False,4,0,Draw
28352,30368,32294,2010,Uganda,Angola,3,0,African Cup of Nations qualification,Kampala,Uganda,False,3,3,Uganda
28353,30369,32295,2010,Benin,Burundi,1,1,African Cup of Nations qualification,Cotonou,Benin,False,2,0,Draw
28354,30370,32296,2010,DR Congo,Senegal,2,4,African Cup of Nations qualification,Lubumbashi,DR Congo,False,6,-2,Senegal
28355,30371,32297,2010,Egypt,Sierra Leone,1,1,African Cup of Nations qualification,Cairo,Egypt,False,2,0,Draw
28356,30372,32298,2010,Ethiopia,Guinea,1,4,African Cup of Nations qualification,Addis Ababa,Ethiopia,False,5,-3,Guinea
28357,30373,32299,2010,Jamaica,Costa Rica,1,0,Friendly,Kingston,Jamaica,False,1,1,Jamaica
28358,30374,32300,2010,Liberia,Zimbabwe,1,1,African Cup of Nations qualification,Paynesville,Liberia,False,2,0,Draw
28359,30375,32301,2010,Mozambique,Libya,0,0,African Cup of Nations qualification,Maputo,Mozambique,False,0,0,Draw
28360,30376,32302,2010,Nigeria,Madagascar,2,0,African Cup of Nations qualification,Calabar,Nigeria,False,2,2,Nigeria
28361,30377,32303,2010,Eswatini,Ghana,0,3,African Cup of Nations qualification,Lobamba,Eswatini,False,3,-3,Ghana
28362,30378,32304,2010,Burkina Faso,Gabon,1,1,Friendly,Cannes,France,True,2,0,Draw
28363,30379,32305,2010,Albania,Luxembourg,1,0,UEFA Euro qualification,Tirana,Albania,False,1,1,Albania
28364,30380,32306,2010,Argentina,Spain,4,1,Friendly,Buenos Aires,Argentina,False,5,3,Argentina
28365,30381,32307,2010,Austria,Kazakhstan,2,0,UEFA Euro qualification,Salzburg,Austria,False,2,2,Austria
28366,30382,32308,2010,Bahrain,Togo,3,0,Friendly,Riffa,Bahrain,False,3,3,Bahrain
28367,30383,32309,2010,Belarus,Romania,0,0,UEFA Euro qualification,Minsk,Belarus,False,0,0,Draw
28368,30384,32310,2010,Bosnia and Herzegovina,France,0,2,UEFA Euro qualification,Sarajevo,Bosnia and Herzegovina,False,2,-2,France
28369,30385,32311,2010,Bulgaria,Montenegro,0,1,UEFA Euro qualification,Sofia,Bulgaria,False,1,-1,Montenegro
28370,30386,32312,2010,Canada,Honduras,2,1,Friendly,Montréal,Canada,False,3,1,Canada
28371,30387,32314,2010,Croatia,Greece,0,0,UEFA Euro qualification,Zagreb,Croatia,False,0,0,Draw
28372,30388,32315,2010,Czech Republic,Lithuania,0,1,UEFA Euro qualification,Olomouc,Czech Republic,False,1,-1,Lithuania
28373,30389,32316,2010,Denmark,Iceland,1,0,UEFA Euro qualification,Copenhagen,Denmark,False,1,1,Denmark
28374,30390,32317,2010,El Salvador,Guatemala,0,2,Friendly,Washington,United States,True,2,-2,Guatemala
28375,30391,32318,2010,Estonia,Uzbekistan,3,3,Friendly,Tallinn,Estonia,False,6,0,Draw
28376,30392,32319,2010,Georgia,Israel,0,0,UEFA Euro qualification,Tbilisi,Georgia,False,0,0,Draw
28377,30393,32320,2010,Germany,Azerbaijan,6,1,UEFA Euro qualification,Cologne,Germany,False,7,5,Germany
28378,30394,32321,2010,Hungary,Moldova,2,1,UEFA Euro qualification,Budapest,Hungary,False,3,1,Hungary
28379,30395,32322,2010,Republic of Ireland,Andorra,3,1,UEFA Euro qualification,Dublin,Republic of Ireland,False,4,2,Republic of Ireland
28380,30396,32323,2010,Italy,Faroe Islands,5,0,UEFA Euro qualification,Florence,Italy,False,5,5,Italy
28381,30397,32324,2010,Jamaica,Peru,1,2,Friendly,Fort Lauderdale,United States,True,3,-1,Peru
28382,30398,32325,2010,Japan,Guatemala,2,1,Friendly,Osaka,Japan,False,3,1,Japan
28383,30399,32328,2010,Malta,Latvia,0,2,UEFA Euro qualification,Attard,Malta,False,2,-2,Latvia
28384,30400,32329,2010,Mexico,Colombia,1,0,Friendly,Monterrey,Mexico,False,1,1,Mexico
28385,30401,32330,2010,Netherlands,Finland,2,1,UEFA Euro qualification,Rotterdam,Netherlands,False,3,1,Netherlands
28386,30402,32331,2010,Norway,Portugal,1,0,UEFA Euro qualification,Oslo,Norway,False,1,1,Norway
28387,30403,32332,2010,Panama,Trinidad and Tobago,3,0,Friendly,Panama City,Panama,False,3,3,Panama
28388,30404,32333,2010,Poland,Australia,1,2,Friendly,Cracow,Poland,False,3,-1,Australia
28389,30405,32334,2010,Qatar,Oman,1,1,Friendly,Doha,Qatar,False,2,0,Draw
28390,30406,32335,2010,Russia,Slovakia,0,1,UEFA Euro qualification,Moscow,Russia,False,1,-1,Slovakia
28391,30407,32336,2010,Scotland,Liechtenstein,2,1,UEFA Euro qualification,Glasgow,Scotland,False,3,1,Scotland
28392,30408,32337,2010,Serbia,Slovenia,1,1,UEFA Euro qualification,Belgrade,Serbia,False,2,0,Draw
28393,30409,32338,2010,Sweden,San Marino,6,0,UEFA Euro qualification,Malmö,Sweden,False,6,6,Sweden
28394,30410,32339,2010,Switzerland,England,1,3,UEFA Euro qualification,Basel,Switzerland,False,4,-2,England
28395,30411,32340,2010,Turkey,Belgium,3,2,UEFA Euro qualification,Istanbul,Turkey,False,5,1,Turkey
28396,30412,32341,2010,Ukraine,Chile,2,1,Friendly,Kyïv,Ukraine,False,3,1,Ukraine
28397,30413,32342,2010,United Arab Emirates,Kuwait,3,0,Friendly,Abu Dhabi,United Arab Emirates,False,3,3,United Arab Emirates
28398,30414,32343,2010,Venezuela,Ecuador,1,0,Friendly,Barquisimeto,Venezuela,False,1,1,Venezuela
28399,30415,32344,2010,Yemen,Syria,2,1,Friendly,Sana'a,Yemen,False,3,1,Yemen
28400,30416,32345,2010,India,Thailand,1,2,Friendly,New Delhi,India,False,3,-1,Thailand
28401,30417,32346,2010,Belize,Trinidad and Tobago,0,0,Friendly,Belmopan,Belize,False,0,0,Draw
28402,30418,32347,2010,Saint Lucia,Saint Vincent and the Grenadines,1,5,Friendly,Vieux Fort,Saint Lucia,False,6,-4,Saint Vincent and the Grenadines
28403,30419,32348,2010,French Guiana,Suriname,1,2,Friendly,Cayenne,French Guiana,False,3,-1,Suriname
28404,30420,32349,2010,India,Namibia,2,0,Friendly,New Delhi,India,False,2,2,India
28405,30421,32350,2010,Jordan,Iraq,4,1,Friendly,Amman,Jordan,False,5,3,Jordan
28406,30423,32352,2010,Yemen,Zambia,0,1,Friendly,Sana'a,Yemen,False,1,-1,Zambia
28407,30424,32353,2010,Antigua and Barbuda,Trinidad and Tobago,0,1,Friendly,St. John's,Antigua and Barbuda,False,1,-1,Trinidad and Tobago
28408,30425,32354,2010,Jordan,Bahrain,2,0,Friendly,Zarqa,Jordan,False,2,2,Jordan
28409,30427,32356,2010,Iraq,Oman,3,2,Friendly,Amman,Jordan,True,5,1,Iraq
28410,30428,32357,2010,Saint Lucia,Trinidad and Tobago,0,3,Friendly,St. John's,Antigua and Barbuda,True,3,-3,Trinidad and Tobago
28411,30429,32358,2010,French Guiana,Mayotte,2,2,African Nations Championship,Saint-Gratien,France,True,4,0,Draw
28412,30431,32360,2010,Antigua and Barbuda,Saint Lucia,5,0,Friendly,St. John's,Antigua and Barbuda,False,5,5,Antigua and Barbuda
28413,30432,32361,2010,Guadeloupe,New Caledonia,1,1,African Nations Championship,Bry-sur-Marne,France,True,2,0,Draw
28414,30434,32363,2010,Iran,Bahrain,3,0,WAFF Championship,Amman,Jordan,True,3,3,Iran
28415,30435,32364,2010,Jordan,Syria,1,1,WAFF Championship,Amman,Jordan,False,2,0,Draw
28416,30438,32367,2010,Iraq,Yemen,2,1,WAFF Championship,Amman,Jordan,True,3,1,Iraq
28417,30439,32368,2010,Mayotte,Réunion,1,2,African Nations Championship,Gennevilliers,France,True,3,-1,Réunion
28418,30440,32369,2010,Bahrain,Oman,2,0,WAFF Championship,Amman,Jordan,True,2,2,Bahrain
28419,30441,32370,2010,Barbados,Dominica,1,3,Friendly,Bridgetown,Barbados,False,4,-2,Dominica
28420,30443,32372,2010,Guyana,Trinidad and Tobago,1,1,Friendly,Providence,Guyana,False,2,0,Draw
28421,30444,32373,2010,New Caledonia,Martinique,0,4,African Nations Championship,Viry-Châtillon,France,True,4,-4,Martinique
28422,30445,32374,2010,Syria,Kuwait,1,2,WAFF Championship,Amman,Jordan,True,3,-1,Kuwait
28423,30446,32375,2010,Yemen,Palestine,3,1,WAFF Championship,Amman,Jordan,True,4,2,Yemen
28424,30447,32376,2010,French Guiana,Réunion,0,1,African Nations Championship,Villemomble,France,True,1,-1,Réunion
28425,30448,32377,2010,Jordan,Kuwait,2,2,WAFF Championship,Amman,Jordan,False,4,0,Draw
28426,30450,32379,2010,Oman,Iran,2,2,WAFF Championship,Amman,Jordan,True,4,0,Draw
28427,30451,32380,2010,Guadeloupe,Martinique,2,0,African Nations Championship,Levallois-Perret,France,True,2,2,Guadeloupe
28428,30453,32382,2010,Palestine,Iraq,0,3,WAFF Championship,Amman,Jordan,True,3,-3,Iraq
28429,30454,32383,2010,Iran,Iraq,2,1,WAFF Championship,Amman,Jordan,True,3,1,Iran
28430,30455,32384,2010,Kuwait,Yemen,1,1,WAFF Championship,Amman,Jordan,True,2,0,Draw
28431,30456,32385,2010,Mayotte,Guadeloupe,0,4,African Nations Championship,Saint-Ouen,France,True,4,-4,Guadeloupe
28432,30457,32386,2010,Saint Martin,Cayman Islands,1,1,CFU Caribbean Cup qualification,Bayamón,Puerto Rico,True,2,0,Draw
28433,30458,32387,2010,Puerto Rico,Anguilla,3,1,CFU Caribbean Cup qualification,Bayamón,Puerto Rico,False,4,2,Puerto Rico
28434,30459,32388,2010,Réunion,Martinique,0,0,African Nations Championship,Créteil,France,True,0,0,Draw
28435,30460,32389,2010,Iran,Kuwait,1,2,WAFF Championship,Amman,Jordan,True,3,-1,Kuwait
28436,30461,32390,2010,Cayman Islands,Anguilla,4,1,CFU Caribbean Cup qualification,Bayamón,Puerto Rico,True,5,3,Cayman Islands
28437,30462,32391,2010,India,Hong Kong,0,1,Friendly,Pune,India,False,1,-1,Hong Kong
28438,30463,32392,2010,Puerto Rico,Saint Martin,2,0,CFU Caribbean Cup qualification,Bayamón,Puerto Rico,False,2,2,Puerto Rico
28439,30464,32393,2010,Anguilla,Saint Martin,2,1,CFU Caribbean Cup qualification,Bayamón,Puerto Rico,True,3,1,Anguilla
28440,30465,32394,2010,Barbados,Saint Kitts and Nevis,1,1,CFU Caribbean Cup qualification,Kingstown,Saint Vincent and the Grenadines,True,2,0,Draw
28441,30466,32395,2010,Puerto Rico,Cayman Islands,2,0,CFU Caribbean Cup qualification,Bayamón,Puerto Rico,False,2,2,Puerto Rico
28442,30467,32396,2010,Iran,Brazil,0,3,Friendly,Abu Dhabi,United Arab Emirates,True,3,-3,Brazil
28443,30468,32397,2010,Albania,Bosnia and Herzegovina,1,1,UEFA Euro qualification,Tirana,Albania,False,2,0,Draw
28444,30470,32399,2010,Armenia,Slovakia,3,1,UEFA Euro qualification,Yerevan,Armenia,False,4,2,Armenia
28445,30471,32400,2010,Austria,Azerbaijan,3,0,UEFA Euro qualification,Vienna,Austria,False,3,3,Austria
28446,30472,32402,2010,Colombia,Ecuador,1,0,Friendly,Harrison,United States,True,1,1,Colombia
28447,30473,32403,2010,Cyprus,Norway,1,2,UEFA Euro qualification,Larnaca,Cyprus,False,3,-1,Norway
28448,30474,32404,2010,Czech Republic,Scotland,1,0,UEFA Euro qualification,Prague,Czech Republic,False,1,1,Czech Republic
28449,30475,32405,2010,Georgia,Malta,1,0,UEFA Euro qualification,Tbilisi,Georgia,False,1,1,Georgia
28450,30476,32406,2010,Germany,Turkey,3,0,UEFA Euro qualification,Berlin,Germany,False,3,3,Germany
28451,30477,32407,2010,Greece,Latvia,1,0,UEFA Euro qualification,Piraeus,Greece,False,1,1,Greece
28452,30478,32408,2010,Hungary,San Marino,8,0,UEFA Euro qualification,Budapest,Hungary,False,8,8,Hungary
28453,30479,32409,2010,India,Vietnam,3,1,Friendly,Pune,India,False,4,2,India
28454,30480,32410,2010,Indonesia,Uruguay,1,7,Friendly,Jakarta,Indonesia,False,8,-6,Uruguay
28455,30481,32411,2010,Republic of Ireland,Russia,2,3,UEFA Euro qualification,Dublin,Republic of Ireland,False,5,-1,Russia
28456,30482,32412,2010,Japan,Argentina,1,0,Friendly,Saitama,Japan,False,1,1,Japan
28457,30483,32413,2010,Kazakhstan,Belgium,0,2,UEFA Euro qualification,Astana,Kazakhstan,False,2,-2,Belgium
28458,30484,32414,2010,Kuwait,Bahrain,1,3,Friendly,Kuwait City,Kuwait,False,4,-2,Bahrain
28459,30485,32415,2010,Luxembourg,Belarus,0,0,UEFA Euro qualification,Luxembourg,Luxembourg,False,0,0,Draw
28460,30486,32416,2010,Moldova,Netherlands,0,1,UEFA Euro qualification,Chişinău,Moldova,False,1,-1,Netherlands
28461,30487,32417,2010,Montenegro,Switzerland,1,0,UEFA Euro qualification,Podgorica,Montenegro,False,1,1,Montenegro
28462,30488,32418,2010,Montserrat,Barbados,0,5,CFU Caribbean Cup qualification,Kingstown,Saint Vincent and the Grenadines,True,5,-5,Barbados
28463,30489,32419,2010,Northern Ireland,Italy,0,0,UEFA Euro qualification,Belfast,Northern Ireland,False,0,0,Draw
28464,30490,32420,2010,Oman,Gabon,1,0,Friendly,Muscat,Oman,False,1,1,Oman
28465,30491,32421,2010,Panama,El Salvador,1,0,Friendly,Panama City,Panama,False,1,1,Panama
28466,30492,32422,2010,Peru,Costa Rica,2,0,Friendly,Lima,Peru,False,2,2,Peru
28467,30493,32423,2010,Portugal,Denmark,3,1,UEFA Euro qualification,Porto,Portugal,False,4,2,Portugal
28468,30494,32424,2010,Serbia,Estonia,1,3,UEFA Euro qualification,Belgrade,Serbia,False,4,-2,Estonia
28469,30495,32425,2010,Slovenia,Faroe Islands,5,1,UEFA Euro qualification,Ljubljana,Slovenia,False,6,4,Slovenia
28470,30496,32426,2010,Spain,Lithuania,3,1,UEFA Euro qualification,Salamanca,Spain,False,4,2,Spain
28471,30497,32427,2010,Saint Vincent and the Grenadines,Saint Kitts and Nevis,1,1,CFU Caribbean Cup qualification,Kingstown,Saint Vincent and the Grenadines,False,2,0,Draw
28472,30498,32428,2010,Ukraine,Canada,2,2,Friendly,Kyïv,Ukraine,False,4,0,Draw
28473,30499,32429,2010,Wales,Bulgaria,0,1,UEFA Euro qualification,Cardiff,Wales,False,1,-1,Bulgaria
28474,30500,32430,2010,Angola,Guinea-Bissau,1,0,African Cup of Nations qualification,Luanda,Angola,False,1,1,Angola
28475,30501,32431,2010,Australia,Paraguay,1,0,Friendly,Sydney,Australia,False,1,1,Australia
28476,30502,32432,2010,Burkina Faso,Gambia,3,1,African Cup of Nations qualification,Ouagadougou,Burkina Faso,False,4,2,Burkina Faso
28477,30503,32433,2010,Burundi,Ivory Coast,0,1,African Cup of Nations qualification,Bujumbura,Burundi,False,1,-1,Ivory Coast
28478,30504,32434,2010,Cameroon,DR Congo,1,1,African Cup of Nations qualification,Garoua,Cameroon,False,2,0,Draw
28479,30505,32435,2010,Comoros,Mozambique,0,1,African Cup of Nations qualification,Mitsamiouli,Comoros,False,1,-1,Mozambique
28480,30506,32436,2010,France,Romania,2,0,UEFA Euro qualification,Saint-Denis,France,False,2,2,France
28481,30507,32437,2010,Guatemala,Belize,4,2,Friendly,San José,Guatemala,False,6,2,Guatemala
28482,30508,32438,2010,Israel,Croatia,1,2,UEFA Euro qualification,Ramat-Gan,Israel,False,3,-1,Croatia
28483,30509,32439,2010,Kenya,Uganda,0,0,African Cup of Nations qualification,Nairobi,Kenya,False,0,0,Draw
28484,30510,32440,2010,Malawi,Chad,6,2,African Cup of Nations qualification,Blantyre,Malawi,False,8,4,Malawi
28485,30511,32441,2010,Mali,Liberia,2,1,African Cup of Nations qualification,Bamako,Mali,False,3,1,Mali
28486,30512,32442,2010,New Zealand,Honduras,1,1,Friendly,North Shore,New Zealand,False,2,0,Draw
28487,30513,32443,2010,Rwanda,Benin,0,3,African Cup of Nations qualification,Kigali,Rwanda,False,3,-3,Benin
28488,30514,32444,2010,Saudi Arabia,Uzbekistan,4,0,Friendly,Jeddah,Saudi Arabia,False,4,4,Saudi Arabia
28489,30515,32445,2010,Senegal,Mauritius,7,0,African Cup of Nations qualification,Dakar,Senegal,False,7,7,Senegal
28490,30516,32446,2010,Tanzania,Morocco,0,1,African Cup of Nations qualification,Dar es Salaam,Tanzania,False,1,-1,Morocco
28491,30517,32447,2010,United Arab Emirates,Chile,0,2,Friendly,Abu Dhabi,United Arab Emirates,False,2,-2,Chile
28492,30518,32448,2010,United States,Poland,2,2,Friendly,Chicago,United States,False,4,0,Draw
28493,30519,32449,2010,Central African Republic,Algeria,2,0,African Cup of Nations qualification,Bangui,Central African Republic,False,2,2,Central African Republic
28494,30520,32450,2010,Congo,Eswatini,3,1,African Cup of Nations qualification,Brazzaville,Congo,False,4,2,Congo
28495,30521,32451,2010,Ghana,Sudan,0,0,African Cup of Nations qualification,Kumasi,Ghana,False,0,0,Draw
28496,30522,32452,2010,Guinea,Nigeria,1,0,African Cup of Nations qualification,Conakry,Guinea,False,1,1,Guinea
28497,30523,32453,2010,Jamaica,Trinidad and Tobago,1,0,Friendly,Kingston,Jamaica,False,1,1,Jamaica
28498,30524,32454,2010,Libya,Zambia,1,0,African Cup of Nations qualification,Tripoli,Libya,False,1,1,Libya
28499,30525,32455,2010,Madagascar,Ethiopia,0,1,African Cup of Nations qualification,Antananarivo,Madagascar,False,1,-1,Ethiopia
28500,30526,32456,2010,Niger,Egypt,1,0,African Cup of Nations qualification,Niamey,Niger,False,1,1,Niger
28501,30527,32457,2010,Sierra Leone,South Africa,0,0,African Cup of Nations qualification,Freetown,Sierra Leone,False,0,0,Draw
28502,30528,32458,2010,Saint Kitts and Nevis,Montserrat,4,0,CFU Caribbean Cup qualification,Kingstown,Saint Vincent and the Grenadines,True,4,4,Saint Kitts and Nevis
28503,30529,32459,2010,Togo,Tunisia,1,2,African Cup of Nations qualification,Lomé,Togo,False,3,-1,Tunisia
28504,30531,32461,2010,Brazil,Ukraine,2,0,Friendly,Derby,England,True,2,2,Brazil
28505,30532,32462,2010,Armenia,Andorra,4,0,UEFA Euro qualification,Yerevan,Armenia,False,4,4,Armenia
28506,30533,32463,2010,Azerbaijan,Turkey,1,0,UEFA Euro qualification,Baku,Azerbaijan,False,1,1,Azerbaijan
28507,30534,32464,2010,Bahrain,Uzbekistan,2,4,Friendly,Riffa,Bahrain,False,6,-2,Uzbekistan
28508,30535,32465,2010,Belarus,Albania,2,0,UEFA Euro qualification,Minsk,Belarus,False,2,2,Belarus
28509,30536,32466,2010,Belgium,Austria,4,4,UEFA Euro qualification,Brussels,Belgium,False,8,0,Draw
28510,30537,32467,2010,Bulgaria,Saudi Arabia,2,0,Friendly,Istanbul,Turkey,True,2,2,Bulgaria
28511,30538,32469,2010,Costa Rica,El Salvador,2,1,Friendly,Ciudad Quesada,Costa Rica,False,3,1,Costa Rica
28512,30539,32470,2010,Croatia,Norway,2,1,Friendly,Zagreb,Croatia,False,3,1,Croatia
28513,30540,32471,2010,Denmark,Cyprus,2,0,UEFA Euro qualification,Copenhagen,Denmark,False,2,2,Denmark
28514,30541,32472,2010,Ecuador,Poland,2,2,Friendly,Montréal,Canada,True,4,0,Draw
28515,30542,32473,2010,England,Montenegro,0,0,UEFA Euro qualification,London,England,False,0,0,Draw
28516,30543,32474,2010,Equatorial Guinea,Botswana,2,1,Friendly,Malabo,Equatorial Guinea,False,3,1,Equatorial Guinea
28517,30544,32475,2010,Estonia,Slovenia,0,1,UEFA Euro qualification,Tallinn,Estonia,False,1,-1,Slovenia
28518,30545,32476,2010,Faroe Islands,Northern Ireland,1,1,UEFA Euro qualification,Toftir,Faroe Islands,False,2,0,Draw
28519,30546,32477,2010,Finland,Hungary,1,2,UEFA Euro qualification,Helsinki,Finland,False,3,-1,Hungary
28520,30547,32478,2010,France,Luxembourg,2,0,UEFA Euro qualification,Metz,France,False,2,2,France
28521,30548,32479,2010,Greece,Israel,2,1,UEFA Euro qualification,Piraeus,Greece,False,3,1,Greece
28522,30549,32480,2010,Guatemala,Honduras,0,2,Friendly,Los Angeles,United States,True,2,-2,Honduras
28523,30550,32481,2010,Iceland,Portugal,1,3,UEFA Euro qualification,Reykjavík,Iceland,False,4,-2,Portugal
28524,30551,32482,2010,Indonesia,Maldives,3,0,Friendly,Jakarta,Indonesia,False,3,3,Indonesia
28525,30552,32483,2010,Italy,Serbia,3,0,UEFA Euro qualification,Genoa,Italy,False,3,3,Italy
28526,30553,32484,2010,Kazakhstan,Germany,0,3,UEFA Euro qualification,Astana,Kazakhstan,False,3,-3,Germany
28527,30554,32486,2010,Kuwait,Vietnam,3,1,Friendly,Kuwait City,Kuwait,False,4,2,Kuwait
28528,30555,32487,2010,Latvia,Georgia,1,1,UEFA Euro qualification,Riga,Latvia,False,2,0,Draw
28529,30556,32488,2010,Liechtenstein,Czech Republic,0,2,UEFA Euro qualification,Vaduz,Liechtenstein,False,2,-2,Czech Republic
28530,30557,32490,2010,Mexico,Venezuela,2,2,Friendly,Ciudad Juárez,Mexico,False,4,0,Draw
28531,30558,32491,2010,Netherlands,Sweden,4,1,UEFA Euro qualification,Amsterdam,Netherlands,False,5,3,Netherlands
28532,30559,32492,2010,New Zealand,Paraguay,0,2,Friendly,Wellington,New Zealand,False,2,-2,Paraguay
28533,30560,32493,2010,Oman,Chile,0,1,Friendly,Muscat,Oman,False,1,-1,Chile
28534,30561,32494,2010,Panama,Peru,1,0,Friendly,Panama City,Panama,False,1,1,Panama
28535,30562,32495,2010,Philippines,Macau,5,0,Dragon Cup,Kaohsiung,Chinese Taipei,True,5,5,Philippines
28536,30563,32496,2010,Qatar,Iraq,1,2,Friendly,Doha,Qatar,False,3,-1,Iraq
28537,30564,32497,2010,San Marino,Moldova,0,2,UEFA Euro qualification,Serravalle,San Marino,False,2,-2,Moldova
28538,30565,32498,2010,Saudi Arabia,Gabon,1,0,Friendly,Istanbul,Turkey,True,1,1,Saudi Arabia
28539,30566,32499,2010,Scotland,Spain,2,3,UEFA Euro qualification,Glasgow,Scotland,False,5,-1,Spain
28540,30567,32500,2010,Slovakia,Republic of Ireland,1,1,UEFA Euro qualification,Žilina,Slovakia,False,2,0,Draw
28541,30568,32501,2010,Switzerland,Wales,4,1,UEFA Euro qualification,Basel,Switzerland,False,5,3,Switzerland
28542,30569,32502,2010,United Arab Emirates,Angola,0,2,Friendly,Abu Dhabi,United Arab Emirates,False,2,-2,Angola
28543,30570,32503,2010,United States,Colombia,0,0,Friendly,Chester,United States,False,0,0,Draw
28544,30571,32504,2010,Guyana,Saint Lucia,1,0,CFU Caribbean Cup qualification,Paramaribo,Suriname,True,1,1,Guyana
28545,30572,32505,2010,India,Yemen,3,6,Friendly,Pune,India,False,9,-3,Yemen
28546,30573,32506,2010,Suriname,Curaçao,2,1,CFU Caribbean Cup qualification,Paramaribo,Suriname,False,3,1,Suriname
28547,30575,32509,2010,Curaçao,Guyana,2,3,CFU Caribbean Cup qualification,Paramaribo,Suriname,True,5,-1,Guyana
28548,30576,32510,2010,Suriname,Saint Lucia,2,1,CFU Caribbean Cup qualification,Paramaribo,Suriname,False,3,1,Suriname
28549,30577,32511,2010,Dominican Republic,Dominica,0,1,CFU Caribbean Cup qualification,San Cristóbal,Dominican Republic,False,1,-1,Dominica
28550,30578,32512,2010,Saint Lucia,Curaçao,2,2,CFU Caribbean Cup qualification,Paramaribo,Suriname,True,4,0,Draw
28551,30579,32513,2010,Suriname,Guyana,0,2,CFU Caribbean Cup qualification,Paramaribo,Suriname,False,2,-2,Guyana
28552,30580,32514,2010,East Timor,Philippines,0,5,AFF Championship,Vientiane,Laos,True,5,-5,Philippines
28553,30581,32515,2010,Grenada,Puerto Rico,3,1,CFU Caribbean Cup qualification,St. George's,Grenada,False,4,2,Grenada
28554,30582,32516,2010,Laos,Cambodia,0,0,AFF Championship,Vientiane,Laos,False,0,0,Draw
28555,30583,32517,2010,Saint Kitts and Nevis,Guadeloupe,1,2,CFU Caribbean Cup qualification,St. George's,Grenada,True,3,-1,Guadeloupe
28556,30584,32518,2010,Cambodia,East Timor,4,2,AFF Championship,Vientiane,Laos,True,6,2,Cambodia
28557,30585,32519,2010,Grenada,Saint Kitts and Nevis,2,0,CFU Caribbean Cup qualification,St. George's,Grenada,False,2,2,Grenada
28558,30586,32520,2010,Guadeloupe,Puerto Rico,3,2,CFU Caribbean Cup qualification,St. George's,Grenada,True,5,1,Guadeloupe
28559,30587,32521,2010,Laos,Philippines,2,2,AFF Championship,Vientiane,Laos,False,4,0,Draw
28560,30588,32522,2010,Grenada,Guadeloupe,0,3,CFU Caribbean Cup qualification,St. George's,Grenada,False,3,-3,Guadeloupe
28561,30589,32523,2010,Laos,East Timor,6,1,AFF Championship,Vientiane,Laos,False,7,5,Laos
28562,30590,32524,2010,Panama,Cuba,0,3,Friendly,Panama City,Panama,False,3,-3,Cuba
28563,30591,32525,2010,Philippines,Cambodia,0,0,AFF Championship,Vientiane,Laos,True,0,0,Draw
28564,30592,32526,2010,Puerto Rico,Saint Kitts and Nevis,0,1,CFU Caribbean Cup qualification,St. George's,Grenada,True,1,-1,Saint Kitts and Nevis
28565,30593,32527,2010,Botswana,Eswatini,2,0,Friendly,Lobatse,Botswana,False,2,2,Botswana
28566,30594,32528,2010,Curaçao,Aruba,3,0,ABCS Tournament,Willemstad,Curaçao,False,3,3,Curaçao
28567,30595,32529,2010,Suriname,Bonaire,4,2,ABCS Tournament,Willemstad,Curaçao,True,6,2,Suriname
28568,30596,32530,2010,Aruba,Bonaire,3,3,ABCS Tournament,Willemstad,Curaçao,True,6,0,Draw
28569,30597,32531,2010,Curaçao,Suriname,2,2,ABCS Tournament,Willemstad,Curaçao,False,4,0,Draw
28570,30598,32532,2010,Haiti,Guyana,0,0,CFU Caribbean Cup qualification,San Fernando,Trinidad and Tobago,True,0,0,Draw
28571,30600,32534,2010,Trinidad and Tobago,Guyana,2,1,CFU Caribbean Cup qualification,San Fernando,Trinidad and Tobago,False,3,1,Trinidad and Tobago
28572,30601,32535,2010,Vietnam,Singapore,1,1,VFF Cup,Hanoi,Vietnam,False,2,0,Draw
28573,30602,32536,2010,Trinidad and Tobago,Haiti,4,0,CFU Caribbean Cup qualification,San Fernando,Trinidad and Tobago,False,4,4,Trinidad and Tobago
28574,30604,32538,2010,Yemen,Uganda,2,2,Friendly,Sana'a,Yemen,False,4,0,Draw
28575,30605,32539,2010,Antigua and Barbuda,Suriname,2,1,CFU Caribbean Cup qualification,St. John's,Antigua and Barbuda,False,3,1,Antigua and Barbuda
28576,30606,32540,2010,Bahrain,Uganda,0,0,Friendly,Riffa,Bahrain,False,0,0,Draw
28577,30607,32541,2010,Cuba,Dominica,4,2,CFU Caribbean Cup qualification,St. John's,Antigua and Barbuda,True,6,2,Cuba
28578,30609,32543,2010,Iraq,India,2,0,Friendly,Sharjah,United Arab Emirates,True,2,2,Iraq
28579,30610,32544,2010,Antigua and Barbuda,Dominica,0,0,CFU Caribbean Cup qualification,St. John's,Antigua and Barbuda,False,0,0,Draw
28580,30611,32545,2010,Suriname,Cuba,3,3,CFU Caribbean Cup qualification,St. John's,Antigua and Barbuda,True,6,0,Draw
28581,30612,32546,2010,Antigua and Barbuda,Cuba,0,0,CFU Caribbean Cup qualification,St. John's,Antigua and Barbuda,False,0,0,Draw
28582,30613,32547,2010,Bahrain,Syria,0,2,Friendly,Riffa,Bahrain,False,2,-2,Syria
28583,30614,32548,2010,Dominica,Suriname,0,5,CFU Caribbean Cup qualification,St. John's,Antigua and Barbuda,True,5,-5,Suriname
28584,30615,32549,2010,India,Kuwait,1,9,Friendly,Abu Dhabi,United Arab Emirates,True,10,-8,Kuwait
28585,30616,32551,2010,Jordan,Cyprus,0,0,Friendly,Amman,Jordan,False,0,0,Draw
28586,30617,32552,2010,Saudi Arabia,Uganda,0,0,Friendly,Dubai,United Arab Emirates,True,0,0,Draw
28587,30618,32553,2010,Scotland,Faroe Islands,3,0,Friendly,Aberdeen,Scotland,False,3,3,Scotland
28588,30620,32555,2010,Argentina,Brazil,1,0,Friendly,Doha,Qatar,True,1,1,Argentina
28589,30621,32556,2010,Austria,Greece,1,2,Friendly,Vienna,Austria,False,3,-1,Greece
28590,30622,32557,2010,Botswana,Tunisia,1,0,African Cup of Nations qualification,Gaborone,Botswana,False,1,1,Botswana
28591,30623,32558,2010,Bulgaria,Serbia,0,1,Friendly,Sofia,Bulgaria,False,1,-1,Serbia
28592,30624,32559,2010,Burkina Faso,Guinea,2,1,Friendly,Mantes-la-Ville,France,True,3,1,Burkina Faso
28593,30625,32560,2010,Chile,Uruguay,2,0,Friendly,Santiago,Chile,False,2,2,Chile
28594,30626,32562,2010,Colombia,Peru,1,1,Friendly,Bogotá,Colombia,False,2,0,Draw
28595,30627,32563,2010,Croatia,Malta,3,0,UEFA Euro qualification,Zagreb,Croatia,False,3,3,Croatia
28596,30628,32564,2010,Denmark,Czech Republic,0,0,Friendly,Århus,Denmark,False,0,0,Draw
28597,30629,32565,2010,Ecuador,Venezuela,4,1,Friendly,Quito,Ecuador,False,5,3,Ecuador
28598,30630,32566,2010,Egypt,Australia,3,0,Friendly,Cairo,Egypt,False,3,3,Egypt
28599,30631,32567,2010,England,France,1,2,Friendly,London,England,False,3,-1,France
28600,30632,32568,2010,Estonia,Liechtenstein,1,1,Friendly,Tallinn,Estonia,False,2,0,Draw
28601,30633,32569,2010,Finland,San Marino,8,0,UEFA Euro qualification,Helsinki,Finland,False,8,8,Finland
28602,30634,32570,2010,Gabon,Senegal,1,2,Friendly,Saint-Gratien,France,True,3,-1,Senegal
28603,30635,32571,2010,Guatemala,Guyana,3,0,Friendly,Kennesaw,United States,True,3,3,Guatemala
28604,30636,32572,2010,Hong Kong,Paraguay,0,7,Friendly,So Kon Po,Hong Kong,False,7,-7,Paraguay
28605,30637,32573,2010,Hungary,Lithuania,2,0,Friendly,Székesfehérvár,Hungary,False,2,2,Hungary
28606,30638,32574,2010,Iraq,Kuwait,1,1,Friendly,Abu Dhabi,United Arab Emirates,True,2,0,Draw
28607,30639,32575,2010,Republic of Ireland,Norway,1,2,Friendly,Dublin,Republic of Ireland,False,3,-1,Norway
28608,30640,32576,2010,Israel,Iceland,3,2,Friendly,Jaffa,Israel,False,5,1,Israel
28609,30641,32577,2010,Italy,Romania,1,1,Friendly,Klagenfurt,Austria,True,2,0,Draw
28610,30642,32578,2010,Jamaica,Costa Rica,0,0,Friendly,Fort Lauderdale,United States,True,0,0,Draw
28611,30643,32579,2010,Libya,Niger,1,1,Friendly,Tripoli,Libya,False,2,0,Draw
28612,30644,32580,2010,Luxembourg,Algeria,0,0,Friendly,Luxembourg,Luxembourg,False,0,0,Draw
28613,30645,32581,2010,Malawi,Rwanda,2,1,Friendly,Blantyre,Malawi,False,3,1,Malawi
28614,30646,32582,2010,Mali,DR Congo,3,1,Friendly,Évreux,France,True,4,2,Mali
28615,30647,32583,2010,Montenegro,Azerbaijan,2,0,Friendly,Podgorica,Montenegro,False,2,2,Montenegro
28616,30648,32584,2010,Mozambique,Zimbabwe,1,3,Friendly,Maputo,Mozambique,False,4,-2,Zimbabwe
28617,30649,32585,2010,Netherlands,Turkey,1,0,Friendly,Amsterdam,Netherlands,False,1,1,Netherlands
28618,30650,32586,2010,Northern Ireland,Morocco,1,1,Friendly,Belfast,Northern Ireland,False,2,0,Draw
28619,30651,32587,2010,Oman,Belarus,0,4,Friendly,Muscat,Oman,False,4,-4,Belarus
28620,30652,32588,2010,Panama,Honduras,2,0,Friendly,Panama City,Panama,False,2,2,Panama
28621,30653,32589,2010,Poland,Ivory Coast,3,1,Friendly,Poznań,Poland,False,4,2,Poland
28622,30654,32590,2010,Portugal,Spain,4,0,Friendly,Lisbon,Portugal,False,4,4,Portugal
28623,30655,32591,2010,Russia,Belgium,0,2,Friendly,Voronezh,Russia,False,2,-2,Belgium
28624,30656,32592,2010,Saudi Arabia,Ghana,0,0,Friendly,Dubai,United Arab Emirates,True,0,0,Draw
28625,30657,32593,2010,Slovakia,Bosnia and Herzegovina,2,3,Friendly,Bratislava,Slovakia,False,5,-1,Bosnia and Herzegovina
28626,30658,32594,2010,Slovenia,Georgia,1,2,Friendly,Koper,Slovenia,False,3,-1,Georgia
28627,30659,32595,2010,South Africa,United States,0,1,Friendly,Cape Town,South Africa,False,1,-1,United States
28628,30660,32596,2010,Sweden,Germany,0,0,Friendly,Gothenburg,Sweden,False,0,0,Draw
28629,30661,32597,2010,Switzerland,Ukraine,2,2,Friendly,Geneva,Switzerland,False,4,0,Draw
28630,30662,32598,2010,Tajikistan,Afghanistan,1,0,Friendly,Dushanbe,Tajikistan,False,1,1,Tajikistan
28631,30663,32599,2010,Togo,Chad,0,0,African Cup of Nations qualification,Lomé,Togo,False,0,0,Draw
28632,30664,32600,2010,Qatar,Haiti,0,1,Friendly,Doha,Qatar,False,1,-1,Haiti
28633,30665,32601,2010,United Arab Emirates,India,5,0,Friendly,Dubai,United Arab Emirates,False,5,5,United Arab Emirates
28634,30666,32602,2010,Indonesia,East Timor,6,0,Friendly,Palembang,Indonesia,False,6,6,Indonesia
28635,30667,32603,2010,Kuwait,Qatar,1,0,Gulf Cup,Aden,Yemen,True,1,1,Kuwait
28636,30668,32604,2010,Yemen,Saudi Arabia,0,4,Gulf Cup,Aden,Yemen,False,4,-4,Saudi Arabia
28637,30669,32605,2010,Iraq,United Arab Emirates,0,0,Gulf Cup,Aden,Yemen,True,0,0,Draw
28638,30670,32606,2010,Oman,Bahrain,1,1,Gulf Cup,Aden,Yemen,True,2,0,Draw
28639,30671,32607,2010,Tanzania,Kenya,1,0,Friendly,Dar es Salaam,Tanzania,False,1,1,Tanzania
28640,30673,32609,2010,Saudi Arabia,Kuwait,0,0,Gulf Cup,Zinjibar,Yemen,True,0,0,Draw
28641,30674,32610,2010,Yemen,Qatar,1,2,Gulf Cup,Zinjibar,Yemen,False,3,-1,Qatar
28642,30675,32611,2010,Bahrain,Iraq,2,3,Gulf Cup,Aden,Yemen,True,5,-1,Iraq
28643,30676,32612,2010,Martinique,Grenada,1,1,CFU Caribbean Cup,Fort-de-France,Martinique,False,2,0,Draw
28644,30677,32613,2010,Singapore,Laos,4,0,Friendly,Singapore,Singapore,False,4,4,Singapore
28645,30678,32614,2010,Trinidad and Tobago,Cuba,0,2,CFU Caribbean Cup,Fort-de-France,Martinique,True,2,-2,Cuba
28646,30679,32615,2010,United Arab Emirates,Oman,0,0,Gulf Cup,Aden,Yemen,True,0,0,Draw
28647,30680,32616,2010,Guyana,Guadeloupe,1,1,CFU Caribbean Cup,Rivière-Pilote,Martinique,True,2,0,Draw
28648,30681,32617,2010,Jamaica,Antigua and Barbuda,3,1,CFU Caribbean Cup,Rivière-Pilote,Martinique,True,4,2,Jamaica
28649,30682,32618,2010,Tanzania,Zambia,0,1,CECAFA Cup,Dar es Salaam,Tanzania,False,1,-1,Zambia
28650,30683,32619,2010,Burundi,Somalia,2,0,CECAFA Cup,Dar es Salaam,Tanzania,True,2,2,Burundi
28651,30684,32620,2010,Grenada,Trinidad and Tobago,1,0,CFU Caribbean Cup,Fort-de-France,Martinique,True,1,1,Grenada
28652,30685,32621,2010,Martinique,Cuba,0,1,CFU Caribbean Cup,Fort-de-France,Martinique,False,1,-1,Cuba
28653,30686,32622,2010,Qatar,Saudi Arabia,1,1,Gulf Cup,Aden,Yemen,True,2,0,Draw
28654,30687,32623,2010,Yemen,Kuwait,0,3,Gulf Cup,Zinjibar,Yemen,False,3,-3,Kuwait
28655,30688,32625,2010,Antigua and Barbuda,Guyana,1,0,CFU Caribbean Cup,Rivière-Pilote,Martinique,True,1,1,Antigua and Barbuda
28656,30689,32626,2010,Guadeloupe,Jamaica,0,2,CFU Caribbean Cup,Rivière-Pilote,Martinique,True,2,-2,Jamaica
28657,30690,32627,2010,Malawi,Kenya,3,2,CECAFA Cup,Dar es Salaam,Tanzania,True,5,1,Malawi
28658,30691,32628,2010,Oman,Iraq,0,0,Gulf Cup,Zinjibar,Yemen,True,0,0,Draw
28659,30692,32629,2010,Uganda,Ethiopia,2,1,CECAFA Cup,Dar es Salaam,Tanzania,True,3,1,Uganda
28660,30693,32630,2010,United Arab Emirates,Bahrain,3,1,Gulf Cup,Zinjibar,Yemen,True,4,2,United Arab Emirates
28661,30694,32631,2010,Cuba,Grenada,0,0,CFU Caribbean Cup,Fort-de-France,Martinique,True,0,0,Draw
28662,30695,32632,2010,Martinique,Trinidad and Tobago,0,1,CFU Caribbean Cup,Fort-de-France,Martinique,False,1,-1,Trinidad and Tobago
28663,30696,32633,2010,Tanzania,Somalia,3,0,CECAFA Cup,Dar es Salaam,Tanzania,False,3,3,Tanzania
28664,30697,32634,2010,Zambia,Burundi,0,0,CECAFA Cup,Dar es Salaam,Tanzania,True,0,0,Draw
28665,30698,32635,2010,Guadeloupe,Antigua and Barbuda,1,0,CFU Caribbean Cup,Rivière-Pilote,Martinique,True,1,1,Guadeloupe
28666,30699,32636,2010,Guyana,Jamaica,0,4,CFU Caribbean Cup,Rivière-Pilote,Martinique,True,4,-4,Jamaica
28667,30700,32637,2010,Indonesia,Malaysia,5,1,AFF Championship,Jakarta,Indonesia,False,6,4,Indonesia
28668,30701,32638,2010,Sudan,Rwanda,0,0,CECAFA Cup,Dar es Salaam,Tanzania,True,0,0,Draw
28669,30702,32639,2010,Thailand,Laos,2,2,AFF Championship,Jakarta,Indonesia,True,4,0,Draw
28670,30703,32640,2010,Ethiopia,Kenya,2,1,CECAFA Cup,Dar es Salaam,Tanzania,True,3,1,Ethiopia
28671,30704,32641,2010,Kuwait,Iraq,2,2,Gulf Cup,Aden,Yemen,True,4,0,Draw
28672,30705,32642,2010,Malawi,Uganda,1,1,CECAFA Cup,Dar es Salaam,Tanzania,True,2,0,Draw
28673,30706,32643,2010,Singapore,Philippines,1,1,AFF Championship,Hanoi,Vietnam,True,2,0,Draw
28674,30707,32644,2010,United Arab Emirates,Saudi Arabia,0,1,Gulf Cup,Aden,Yemen,True,1,-1,Saudi Arabia
28675,30708,32645,2010,Vietnam,Burma,7,1,AFF Championship,Hanoi,Vietnam,False,8,6,Vietnam
28676,30709,32646,2010,Cuba,Guadeloupe,1,2,CFU Caribbean Cup,Fort-de-France,Martinique,True,3,-1,Guadeloupe
28677,30710,32647,2010,Jamaica,Grenada,2,1,CFU Caribbean Cup,Fort-de-France,Martinique,True,3,1,Jamaica
28678,30712,32649,2010,Zambia,Somalia,6,0,CECAFA Cup,Dar es Salaam,Tanzania,True,6,6,Zambia
28679,30713,32650,2010,Indonesia,Laos,6,0,AFF Championship,Jakarta,Indonesia,False,6,6,Indonesia
28680,30714,32651,2010,Thailand,Malaysia,0,0,AFF Championship,Jakarta,Indonesia,True,0,0,Draw
28681,30715,32652,2010,Grenada,Cuba,0,1,CFU Caribbean Cup,Fort-de-France,Martinique,True,1,-1,Cuba
28682,30716,32653,2010,Guadeloupe,Jamaica,1,1,CFU Caribbean Cup,Fort-de-France,Martinique,True,2,0,Draw
28683,30717,32654,2010,Kuwait,Saudi Arabia,1,0,Gulf Cup,Aden,Yemen,True,1,1,Kuwait
28684,30718,32655,2010,Singapore,Burma,2,1,AFF Championship,Hanoi,Vietnam,True,3,1,Singapore
28685,30719,32656,2010,Uganda,Kenya,2,0,CECAFA Cup,Dar es Salaam,Tanzania,True,2,2,Uganda
28686,30720,32657,2010,Vietnam,Philippines,0,2,AFF Championship,Hanoi,Vietnam,False,2,-2,Philippines
28687,30721,32658,2010,Indonesia,Thailand,2,1,AFF Championship,Jakarta,Indonesia,False,3,1,Indonesia
28688,30722,32659,2010,Malaysia,Laos,5,1,AFF Championship,Palembang,Indonesia,True,6,4,Malaysia
28689,30723,32660,2010,Zambia,Ethiopia,1,2,CECAFA Cup,Dar es Salaam,Tanzania,True,3,-1,Ethiopia
28690,30724,32661,2010,Burma,Philippines,0,0,AFF Championship,Nam Định,Vietnam,True,0,0,Draw
28691,30725,32662,2010,Tanzania,Rwanda,1,0,CECAFA Cup,Dar es Salaam,Tanzania,False,1,1,Tanzania
28692,30727,32664,2010,Vietnam,Singapore,1,0,AFF Championship,Hanoi,Vietnam,False,1,1,Vietnam
28693,30728,32665,2010,Bosnia and Herzegovina,Poland,2,2,Friendly,Antalya,Turkey,True,4,0,Draw
28694,30729,32666,2010,Tanzania,Uganda,0,0,CECAFA Cup,Dar es Salaam,Tanzania,False,0,0,Draw
28695,30730,32667,2010,Ethiopia,Uganda,3,4,CECAFA Cup,Dar es Salaam,Tanzania,True,7,-1,Uganda
28696,30731,32668,2010,Malaysia,Vietnam,2,0,AFF Championship,Kuala Lumpur,Malaysia,False,2,2,Malaysia
28697,30732,32669,2010,Indonesia,Philippines,1,0,AFF Championship,Jakarta,Indonesia,False,1,1,Indonesia
28698,30733,32670,2010,Qatar,Egypt,2,1,Friendly,Doha,Qatar,False,3,1,Qatar
28699,30734,32672,2010,Honduras,Panama,2,1,Friendly,San Pedro Sula,Honduras,False,3,1,Honduras
28700,30735,32673,2010,Iraq,Syria,0,1,Friendly,Sulaymaniyah,Iraq,False,1,-1,Syria
28701,30736,32674,2010,Vietnam,Malaysia,0,0,AFF Championship,Hanoi,Vietnam,False,0,0,Draw
28702,30737,32675,2010,Indonesia,Philippines,1,0,AFF Championship,Jakarta,Indonesia,False,1,1,Indonesia
28703,30738,32677,2010,Qatar,Estonia,2,0,Friendly,Doha,Qatar,False,2,2,Qatar
28704,30739,32678,2010,Syria,Iraq,0,1,Friendly,Damascus,Syria,False,1,-1,Iraq
28705,30741,32680,2010,Bahrain,Uzbekistan,1,1,Friendly,Dubai,United Arab Emirates,True,2,0,Draw
28706,30742,32681,2010,Malaysia,Indonesia,3,0,AFF Championship,Kuala Lumpur,Malaysia,False,3,3,Malaysia
28707,30744,32683,2010,Bahrain,Jordan,2,1,Friendly,Dubai,United Arab Emirates,True,3,1,Bahrain
28708,30745,32684,2010,Saudi Arabia,Iraq,0,1,Friendly,Dammam,Saudi Arabia,False,1,-1,Iraq
28709,30746,32686,2010,Indonesia,Malaysia,2,1,AFF Championship,Jakarta,Indonesia,False,3,1,Indonesia
28710,30748,32689,2010,Kuwait,Zambia,4,0,Friendly,6th of October City,Egypt,True,4,4,Kuwait
28711,30750,32691,2011,Iran,Angola,1,0,Friendly,Doha,Qatar,True,1,1,Iran
28712,30752,32693,2011,Jordan,Uzbekistan,2,2,Friendly,Dubai,United Arab Emirates,True,4,0,Draw
28713,30753,32694,2011,United Arab Emirates,Syria,2,0,Friendly,Al Ain,United Arab Emirates,False,2,2,United Arab Emirates
28714,30755,32696,2011,Saudi Arabia,Angola,0,0,Friendly,Dammam,Saudi Arabia,False,0,0,Draw
28715,30756,32697,2011,Egypt,Tanzania,5,1,Nile Basin Tournament,Cairo,Egypt,False,6,4,Egypt
28716,30757,32698,2011,Kenya,Sudan,1,0,Nile Basin Tournament,Cairo,Egypt,True,1,1,Kenya
28717,30758,32699,2011,Uganda,Burundi,3,1,Nile Basin Tournament,Cairo,Egypt,True,4,2,Uganda
28718,30759,32700,2011,United Arab Emirates,Australia,0,0,Friendly,al-Ain,United Arab Emirates,False,0,0,Draw
28719,30760,32701,2011,Qatar,Uzbekistan,0,2,AFC Asian Cup,Doha,Qatar,False,2,-2,Uzbekistan
28720,30761,32702,2011,DR Congo,Kenya,1,0,Nile Basin Tournament,Cairo,Egypt,True,1,1,DR Congo
28721,30762,32703,2011,Egypt,Uganda,1,0,Nile Basin Tournament,Cairo,Egypt,False,1,1,Egypt
28722,30764,32705,2011,Tanzania,Burundi,1,1,Nile Basin Tournament,Cairo,Egypt,True,2,0,Draw
28723,30765,32706,2011,Japan,Jordan,1,1,AFC Asian Cup,Doha,Qatar,True,2,0,Draw
28724,30766,32707,2011,Saudi Arabia,Syria,1,2,AFC Asian Cup,Rayyan,Qatar,True,3,-1,Syria
28725,30767,32708,2011,India,Australia,0,4,AFC Asian Cup,Doha,Qatar,True,4,-4,Australia
28726,30768,32710,2011,DR Congo,Sudan,2,1,Nile Basin Tournament,Cairo,Egypt,True,3,1,DR Congo
28727,30769,32711,2011,Egypt,Burundi,3,0,Nile Basin Tournament,Ismailia,Egypt,False,3,3,Egypt
28728,30770,32712,2011,Iraq,Iran,1,2,AFC Asian Cup,Rayyan,Qatar,True,3,-1,Iran
28729,30771,32714,2011,Uganda,Tanzania,1,1,Nile Basin Tournament,Cairo,Egypt,True,2,0,Draw
28730,30773,32716,2011,Uzbekistan,Kuwait,2,1,AFC Asian Cup,Doha,Qatar,True,3,1,Uzbekistan
28731,30774,32717,2011,Jordan,Saudi Arabia,1,0,AFC Asian Cup,Rayyan,Qatar,True,1,1,Jordan
28732,30775,32718,2011,Syria,Japan,1,2,AFC Asian Cup,Doha,Qatar,True,3,-1,Japan
28733,30777,32720,2011,Bahrain,India,5,2,AFC Asian Cup,Doha,Qatar,True,7,3,Bahrain
28734,30778,32721,2011,DR Congo,Uganda,0,1,Nile Basin Tournament,Cairo,Egypt,True,1,-1,Uganda
28735,30779,32722,2011,Costa Rica,Honduras,1,1,UNCAF Cup,Panama City,Panama,True,2,0,Draw
28736,30780,32723,2011,Egypt,Kenya,5,1,Nile Basin Tournament,Cairo,Egypt,False,6,4,Egypt
28737,30781,32724,2011,El Salvador,Nicaragua,2,0,UNCAF Cup,Panama City,Panama,True,2,2,El Salvador
28738,30782,32725,2011,Panama,Belize,2,0,UNCAF Cup,Panama City,Panama,False,2,2,Panama
28739,30784,32727,2011,United Arab Emirates,Iraq,0,1,AFC Asian Cup,Rayyan,Qatar,True,1,-1,Iraq
28740,30785,32728,2011,Belize,El Salvador,2,5,UNCAF Cup,Panama City,Panama,True,7,-3,El Salvador
28741,30786,32730,2011,Guatemala,Costa Rica,0,2,UNCAF Cup,Panama City,Panama,True,2,-2,Costa Rica
28742,30787,32731,2011,Panama,Nicaragua,2,0,UNCAF Cup,Panama City,Panama,False,2,2,Panama
28743,30788,32732,2011,Qatar,Kuwait,3,0,AFC Asian Cup,Doha,Qatar,False,3,3,Qatar
28744,30789,32733,2011,Tanzania,Sudan,0,2,Nile Basin Tournament,Cairo,Egypt,True,2,-2,Sudan
28745,30790,32734,2011,DR Congo,Kenya,1,0,Nile Basin Tournament,Ismailia,Egypt,True,1,1,DR Congo
28746,30791,32735,2011,Egypt,Uganda,3,1,Nile Basin Tournament,Ismailia,Egypt,False,4,2,Egypt
28747,30792,32736,2011,Jordan,Syria,2,1,AFC Asian Cup,Doha,Qatar,True,3,1,Jordan
28748,30793,32737,2011,Saudi Arabia,Japan,0,5,AFC Asian Cup,Rayyan,Qatar,True,5,-5,Japan
28749,30794,32738,2011,Australia,Bahrain,1,0,AFC Asian Cup,Doha,Qatar,True,1,1,Australia
28750,30795,32739,2011,Honduras,Guatemala,3,1,UNCAF Cup,Panama City,Panama,True,4,2,Honduras
28751,30796,32741,2011,Nicaragua,Belize,1,1,UNCAF Cup,Panama City,Panama,True,2,0,Draw
28752,30797,32742,2011,Panama,El Salvador,2,0,UNCAF Cup,Panama City,Panama,False,2,2,Panama
28753,30798,32743,2011,Botswana,Sweden,1,2,Friendly,Cape Town,South Africa,True,3,-1,Sweden
28754,30800,32745,2011,United Arab Emirates,Iran,0,3,AFC Asian Cup,Doha,Qatar,True,3,-3,Iran
28755,30801,32746,2011,Honduras,El Salvador,2,0,UNCAF Cup,Panama City,Panama,True,2,2,Honduras
28756,30802,32747,2011,Nicaragua,Guatemala,1,2,UNCAF Cup,Panama City,Panama,True,3,-1,Guatemala
28757,30803,32748,2011,Panama,Costa Rica,1,1,UNCAF Cup,Panama City,Panama,False,2,0,Draw
28758,30804,32749,2011,Qatar,Japan,2,3,AFC Asian Cup,Doha,Qatar,False,5,-1,Japan
28759,30805,32750,2011,Uzbekistan,Jordan,2,1,AFC Asian Cup,Doha,Qatar,True,3,1,Uzbekistan
28760,30806,32751,2011,Australia,Iraq,1,0,AFC Asian Cup,Doha,Qatar,True,1,1,Australia
28761,30808,32753,2011,United States,Chile,1,1,Friendly,Carson,United States,False,2,0,Draw
28762,30809,32754,2011,Honduras,Costa Rica,2,1,UNCAF Cup,Panama City,Panama,True,3,1,Honduras
28763,30810,32755,2011,Panama,El Salvador,0,0,UNCAF Cup,Panama City,Panama,False,0,0,Draw
28764,30811,32756,2011,Vanuatu,New Caledonia,0,0,Friendly,Port Vila,Vanuatu,False,0,0,Draw
28765,30813,32758,2011,Uzbekistan,Australia,0,6,AFC Asian Cup,Doha,Qatar,True,6,-6,Australia
28766,30815,32760,2011,Australia,Japan,0,1,AFC Asian Cup,Doha,Qatar,True,1,-1,Japan
28767,30816,32761,2011,Moldova,Poland,0,1,Friendly,Vila Real de Santo António,Portugal,True,1,-1,Poland
28768,30817,32762,2011,Cyprus,Sweden,0,2,Cyprus International Tournament,Nicosia,Cyprus,False,2,-2,Sweden
28769,30818,32763,2011,Ghana,Togo,4,1,Friendly,Antwerp,Belgium,True,5,3,Ghana
28770,30819,32764,2011,Republic of Ireland,Wales,3,0,Nations Cup,Dublin,Republic of Ireland,False,3,3,Republic of Ireland
28771,30820,32765,2011,Mali,Ivory Coast,0,1,Friendly,Valence,France,True,1,-1,Ivory Coast
28772,30821,32766,2011,Peru,Panama,1,0,Friendly,Moquegua,Peru,False,1,1,Peru
28773,30822,32767,2011,Romania,Ukraine,2,2,Cyprus International Tournament,Paralímni,Cyprus,True,4,0,Draw
28774,30823,32768,2011,Albania,Slovenia,1,2,Friendly,Tirana,Albania,False,3,-1,Slovenia
28775,30824,32769,2011,Andorra,Moldova,1,2,Friendly,Lagos,Portugal,True,3,-1,Moldova
28776,30825,32770,2011,Argentina,Portugal,2,1,Friendly,Geneva,Switzerland,True,3,1,Argentina
28777,30826,32771,2011,Armenia,Georgia,1,2,Friendly,Limassol,Cyprus,True,3,-1,Georgia
28778,30827,32772,2011,Azerbaijan,Hungary,0,2,Friendly,Dubai,United Arab Emirates,True,2,-2,Hungary
28779,30828,32773,2011,Belarus,Kazakhstan,1,1,Friendly,Antalya,Turkey,True,2,0,Draw
28780,30829,32774,2011,Belgium,Finland,1,1,Friendly,Ghent,Belgium,False,2,0,Draw
28781,30830,32775,2011,Cambodia,Macau,3,1,AFC Challenge Cup qualification,Phnom Penh,Cambodia,False,4,2,Cambodia
28782,30831,32777,2011,DR Congo,Gabon,0,2,Friendly,Rouen,France,True,2,-2,Gabon
28783,30832,32778,2011,Croatia,Czech Republic,4,2,Friendly,Pula,Croatia,False,6,2,Croatia
28784,30833,32779,2011,Cyprus,Romania,1,1,Cyprus International Tournament,Paralímni,Cyprus,False,2,0,Draw
28785,30834,32780,2011,Denmark,England,1,2,Friendly,Copenhagen,Denmark,False,3,-1,England
28786,30835,32781,2011,El Salvador,Haiti,1,0,Friendly,San Salvador,El Salvador,False,1,1,El Salvador
28787,30836,32782,2011,France,Brazil,1,0,Friendly,Saint-Denis,France,False,1,1,France
28788,30837,32783,2011,Germany,Italy,1,1,Friendly,Dortmund,Germany,False,2,0,Draw
28789,30838,32784,2011,Greece,Canada,1,0,Friendly,Lárisa,Greece,False,1,1,Greece
28790,30839,32785,2011,Guinea-Bissau,Gambia,3,1,Friendly,Amadora,Portugal,True,4,2,Guinea-Bissau
28791,30840,32786,2011,Honduras,Ecuador,1,1,Friendly,La Ceiba,Honduras,False,2,0,Draw
28792,30841,32787,2011,Iran,Russia,1,0,Friendly,Abu Dhabi,United Arab Emirates,True,1,1,Iran
28793,30842,32788,2011,Israel,Serbia,0,2,Friendly,Jaffa,Israel,False,2,-2,Serbia
28794,30843,32789,2011,Latvia,Bolivia,2,1,Friendly,Antalya,Turkey,True,3,1,Latvia
28795,30844,32790,2011,Libya,Benin,3,2,Friendly,Tripoli,Libya,False,5,1,Libya
28796,30845,32791,2011,Luxembourg,Slovakia,2,1,Friendly,Luxembourg,Luxembourg,False,3,1,Luxembourg
28797,30846,32793,2011,Malaysia,Hong Kong,2,0,Friendly,Kuala Lumpur,Malaysia,False,2,2,Malaysia
28798,30847,32794,2011,Malta,Switzerland,0,0,Friendly,Attard,Malta,False,0,0,Draw
28799,30848,32795,2011,Mexico,Bosnia and Herzegovina,2,0,Friendly,Atlanta,United States,True,2,2,Mexico
28800,30849,32796,2011,Morocco,Niger,3,0,Friendly,Marrakech,Morocco,False,3,3,Morocco
28801,30850,32797,2011,Mozambique,Botswana,1,1,Friendly,Maputo,Mozambique,False,2,0,Draw
28802,30851,32798,2011,Namibia,Malawi,1,2,Friendly,Windhoek,Namibia,False,3,-1,Malawi
28803,30852,32799,2011,Netherlands,Austria,3,1,Friendly,Eindhoven,Netherlands,False,4,2,Netherlands
28804,30853,32800,2011,Nigeria,Sierra Leone,2,1,Friendly,Lagos,Nigeria,False,3,1,Nigeria
28805,30854,32801,2011,Norway,Poland,0,1,Friendly,Faro,Portugal,True,1,-1,Poland
28806,30855,32802,2011,Philippines,Mongolia,2,0,AFC Challenge Cup qualification,Bacolod,Philippines,False,2,2,Philippines
28807,30856,32803,2011,San Marino,Liechtenstein,0,1,Friendly,Serravalle,San Marino,False,1,-1,Liechtenstein
28808,30857,32804,2011,Scotland,Northern Ireland,3,0,Nations Cup,Dublin,Republic of Ireland,True,3,3,Scotland
28809,30858,32805,2011,Senegal,Guinea,4,0,Friendly,Dakar,Senegal,False,4,4,Senegal
28810,30859,32806,2011,South Africa,Kenya,2,0,Friendly,Rustenburg,South Africa,False,2,2,South Africa
28811,30860,32807,2011,Spain,Colombia,1,0,Friendly,Madrid,Spain,False,1,1,Spain
28812,30861,32808,2011,Eswatini,Zambia,0,4,Friendly,Manzini,Eswatini,False,4,-4,Zambia
28813,30862,32809,2011,Sweden,Ukraine,1,1,Cyprus International Tournament,Nicosia,Cyprus,True,2,0,Draw
28814,30863,32810,2011,Tanzania,Palestine,1,0,Friendly,Dar es Salaam,Tanzania,False,1,1,Tanzania
28815,30865,32812,2011,Venezuela,Costa Rica,2,2,Friendly,Puerto la Cruz,Venezuela,False,4,0,Draw
28816,30866,32813,2011,Bahrain,Kuwait,0,0,Friendly,Riffa,Bahrain,False,0,0,Draw
28817,30868,32815,2011,Macau,Cambodia,3,2,AFC Challenge Cup qualification,Macau,Macau,False,5,1,Macau
28818,30869,32816,2011,Gibraltar,Faroe Islands,3,0,Friendly,Gibraltar,Gibraltar,False,3,3,Gibraltar
28819,30870,32817,2011,Mongolia,Philippines,2,1,AFC Challenge Cup qualification,Ulaanbaatar,Mongolia,False,3,1,Mongolia
28820,30871,32818,2011,Argentina,Venezuela,4,1,Friendly,San Juan,Argentina,False,5,3,Argentina
28821,30872,32819,2011,Botswana,Namibia,1,1,Friendly,Maun,Botswana,False,2,0,Draw
28822,30873,32820,2011,Nepal,Bhutan,1,0,Friendly,Pokhara,Nepal,False,1,1,Nepal
28823,30874,32821,2011,Nepal,Bhutan,2,1,Friendly,Pokhara,Nepal,False,3,1,Nepal
28824,30875,32822,2011,Burma,Philippines,1,1,AFC Challenge Cup qualification,Rangoon,Burma,False,2,0,Draw
28825,30877,32824,2011,Maldives,Cambodia,4,0,AFC Challenge Cup qualification,Malé,Maldives,False,4,4,Maldives
28826,30878,32825,2011,Palestine,Bangladesh,2,0,AFC Challenge Cup qualification,Rangoon,Burma,True,2,2,Palestine
28827,30879,32826,2011,Tajikistan,Kyrgyzstan,1,0,AFC Challenge Cup qualification,Malé,Maldives,True,1,1,Tajikistan
28828,30880,32827,2011,Turkmenistan,Pakistan,3,0,AFC Challenge Cup qualification,Petaling Jaya,Malaysia,True,3,3,Turkmenistan
28829,30881,32828,2011,Bhutan,Afghanistan,0,3,AFC Challenge Cup qualification,Gurgaon,India,True,3,-3,Afghanistan
28830,30882,32829,2011,Burma,Bangladesh,0,2,AFC Challenge Cup qualification,Rangoon,Burma,False,2,-2,Bangladesh
28831,30883,32830,2011,Cambodia,Tajikistan,0,3,AFC Challenge Cup qualification,Malé,Maldives,True,3,-3,Tajikistan
28832,30884,32831,2011,Maldives,Kyrgyzstan,2,1,AFC Challenge Cup qualification,Malé,Maldives,False,3,1,Maldives
28833,30885,32832,2011,Pakistan,India,1,3,AFC Challenge Cup qualification,Petaling Jaya,Malaysia,True,4,-2,India
28834,30886,32833,2011,Philippines,Palestine,0,0,AFC Challenge Cup qualification,Rangoon,Burma,True,0,0,Draw
28835,30887,32834,2011,Cuba,El Salvador,0,1,Friendly,Havana,Cuba,False,1,-1,El Salvador
28836,30888,32835,2011,Afghanistan,Bhutan,2,0,AFC Challenge Cup qualification,Gurgaon,India,True,2,2,Afghanistan
28837,30889,32836,2011,Austria,Belgium,0,2,UEFA Euro qualification,Vienna,Austria,False,2,-2,Belgium
28838,30890,32837,2011,Bangladesh,Philippines,0,3,AFC Challenge Cup qualification,Rangoon,Burma,True,3,-3,Philippines
28839,30891,32838,2011,Burma,Palestine,1,3,AFC Challenge Cup qualification,Rangoon,Burma,False,4,-2,Palestine
28840,30892,32839,2011,Cambodia,Kyrgyzstan,3,4,AFC Challenge Cup qualification,Malé,Maldives,True,7,-1,Kyrgyzstan
28841,30893,32841,2011,Estonia,Uruguay,2,0,Friendly,Tallinn,Estonia,False,2,2,Estonia
28842,30894,32842,2011,Hungary,Netherlands,0,4,UEFA Euro qualification,Budapest,Hungary,False,4,-4,Netherlands
28843,30895,32843,2011,Jamaica,Venezuela,0,2,Friendly,Montego Bay,Jamaica,False,2,-2,Venezuela
28844,30896,32845,2011,Lithuania,Poland,2,0,Friendly,Kaunas,Lithuania,False,2,2,Lithuania
28845,30897,32846,2011,Luxembourg,France,0,2,UEFA Euro qualification,Luxembourg,Luxembourg,False,2,-2,France
28846,30898,32847,2011,Maldives,Tajikistan,0,0,AFC Challenge Cup qualification,Malé,Maldives,False,0,0,Draw
28847,30899,32848,2011,Montenegro,Uzbekistan,1,0,Friendly,Podgorica,Montenegro,False,1,1,Montenegro
28848,30900,32849,2011,Panama,Bolivia,2,0,Friendly,Panama City,Panama,False,2,2,Panama
28849,30901,32850,2011,Serbia,Northern Ireland,2,1,UEFA Euro qualification,Belgrade,Serbia,False,3,1,Serbia
28850,30902,32851,2011,Slovenia,Italy,0,1,UEFA Euro qualification,Ljubljana,Slovenia,False,1,-1,Italy
28851,30903,32852,2011,Spain,Czech Republic,2,1,UEFA Euro qualification,Granada,Spain,False,3,1,Spain
28852,30904,32853,2011,Turkmenistan,India,1,1,AFC Challenge Cup qualification,Petaling Jaya,Malaysia,True,2,0,Draw
28853,30905,32854,2011,Albania,Belarus,1,0,UEFA Euro qualification,Tirana,Albania,False,1,1,Albania
28854,30906,32855,2011,Andorra,Slovakia,0,1,UEFA Euro qualification,Sant Julià de Lòria,Andorra,False,1,-1,Slovakia
28855,30907,32856,2011,Armenia,Russia,0,0,UEFA Euro qualification,Yerevan,Armenia,False,0,0,Draw
28856,30908,32857,2011,Bosnia and Herzegovina,Romania,2,1,UEFA Euro qualification,Zenica,Bosnia and Herzegovina,False,3,1,Bosnia and Herzegovina
28857,30909,32858,2011,Bulgaria,Switzerland,0,0,UEFA Euro qualification,Sofia,Bulgaria,False,0,0,Draw
28858,30910,32859,2011,Burkina Faso,Namibia,4,0,African Cup of Nations qualification,Ouagadougou,Burkina Faso,False,4,4,Burkina Faso
28859,30911,32860,2011,Chad,Botswana,0,1,African Cup of Nations qualification,N'Djamena,Chad,False,1,-1,Botswana
28860,30912,32861,2011,Colombia,Ecuador,2,0,Friendly,Madrid,Spain,True,2,2,Colombia
28861,30914,32863,2011,Cyprus,Iceland,0,0,UEFA Euro qualification,Nicosia,Cyprus,False,0,0,Draw
28862,30915,32864,2011,Georgia,Croatia,1,0,UEFA Euro qualification,Tbilisi,Georgia,False,1,1,Georgia
28863,30916,32865,2011,Germany,Kazakhstan,4,0,UEFA Euro qualification,Kaiserslautern,Germany,False,4,4,Germany
28864,30917,32866,2011,Guinea-Bissau,Uganda,0,1,African Cup of Nations qualification,Bissau,Guinea-Bissau,False,1,-1,Uganda
28865,30919,32868,2011,Israel,Latvia,2,1,UEFA Euro qualification,Jaffa,Israel,False,3,1,Israel
28866,30920,32869,2011,Jordan,Kuwait,1,1,Friendly,Sharjah,United Arab Emirates,True,2,0,Draw
28867,30921,32870,2011,Kenya,Angola,2,1,African Cup of Nations qualification,Nairobi,Kenya,False,3,1,Kenya
28868,30922,32872,2011,Malawi,Togo,1,0,African Cup of Nations qualification,Blantyre,Malawi,False,1,1,Malawi
28869,30923,32873,2011,Mali,Zimbabwe,1,0,African Cup of Nations qualification,Bamako,Mali,False,1,1,Mali
28870,30924,32874,2011,Malta,Greece,0,1,UEFA Euro qualification,Attard,Malta,False,1,-1,Greece
28871,30925,32875,2011,Mexico,Paraguay,3,1,Friendly,Oakland,United States,True,4,2,Mexico
28872,30926,32876,2011,Norway,Denmark,1,1,UEFA Euro qualification,Oslo,Norway,False,2,0,Draw
28873,30927,32877,2011,Portugal,Chile,1,1,Friendly,Leiria,Portugal,False,2,0,Draw
28874,30928,32878,2011,Rwanda,Burundi,3,1,African Cup of Nations qualification,Kigali,Rwanda,False,4,2,Rwanda
28875,30929,32879,2011,Senegal,Cameroon,1,0,African Cup of Nations qualification,Dakar,Senegal,False,1,1,Senegal
28876,30930,32880,2011,South Africa,Egypt,1,0,African Cup of Nations qualification,Johannesburg,South Africa,False,1,1,South Africa
28877,30931,32881,2011,United States,Argentina,1,1,Friendly,East Rutherford,United States,False,2,0,Draw
28878,30932,32882,2011,Wales,England,0,2,UEFA Euro qualification,Cardiff,Wales,False,2,-2,England
28879,30933,32883,2011,Algeria,Morocco,1,0,African Cup of Nations qualification,Annaba,Algeria,False,1,1,Algeria
28880,30934,32884,2011,Brazil,Scotland,2,0,Friendly,London,England,True,2,2,Brazil
28881,30935,32885,2011,Congo,Ghana,0,3,African Cup of Nations qualification,Brazzaville,Congo,False,3,-3,Ghana
28882,30936,32886,2011,DR Congo,Mauritius,3,0,African Cup of Nations qualification,Kinshasa,DR Congo,False,3,3,DR Congo
28883,30937,32887,2011,Ivory Coast,Benin,2,1,African Cup of Nations qualification,Accra,Ghana,True,3,1,Ivory Coast
28884,30938,32888,2011,Madagascar,Guinea,1,1,African Cup of Nations qualification,Antananarivo,Madagascar,False,2,0,Draw
28885,30939,32889,2011,Mozambique,Zambia,0,2,African Cup of Nations qualification,Maputo,Mozambique,False,2,-2,Zambia
28886,30940,32890,2011,Niger,Sierra Leone,3,1,African Cup of Nations qualification,Niamey,Niger,False,4,2,Niger
28887,30941,32891,2011,Nigeria,Ethiopia,4,0,African Cup of Nations qualification,Abuja,Nigeria,False,4,4,Nigeria
28888,30942,32892,2011,Sri Lanka,Tajikistan,2,2,Friendly,Colombo,Sri Lanka,False,4,0,Draw
28889,30943,32893,2011,Saint Kitts and Nevis,Grenada,0,0,Friendly,Basseterre,Saint Kitts and Nevis,False,0,0,Draw
28890,30944,32894,2011,Sudan,Eswatini,3,0,African Cup of Nations qualification,Omdurman,Sudan,False,3,3,Sudan
28891,30945,32895,2011,Guatemala,Bolivia,1,1,Friendly,Mazatenango,Guatemala,False,2,0,Draw
28892,30946,32896,2011,Belarus,Canada,0,1,Friendly,Antalya,Turkey,True,1,-1,Canada
28893,30947,32897,2011,Belgium,Azerbaijan,4,1,UEFA Euro qualification,Brussels,Belgium,False,5,3,Belgium
28894,30948,32899,2011,Colombia,Chile,0,2,Friendly,The Hague,Netherlands,True,2,-2,Chile
28895,30949,32900,2011,Costa Rica,Argentina,0,0,Friendly,San José,Costa Rica,False,0,0,Draw
28896,30950,32901,2011,Cuba,Panama,0,2,Friendly,Havana,Cuba,False,2,-2,Panama
28897,30951,32902,2011,Cyprus,Bulgaria,0,1,Friendly,Larnaca,Cyprus,False,1,-1,Bulgaria
28898,30952,32903,2011,Czech Republic,Liechtenstein,2,0,UEFA Euro qualification,České Budějovice,Czech Republic,False,2,2,Czech Republic
28899,30953,32904,2011,Ecuador,Peru,0,0,Friendly,The Hague,Netherlands,True,0,0,Draw
28900,30954,32905,2011,El Salvador,Jamaica,2,3,Friendly,San Salvador,El Salvador,False,5,-1,Jamaica
28901,30955,32906,2011,England,Ghana,1,1,Friendly,London,England,False,2,0,Draw
28902,30956,32907,2011,Equatorial Guinea,Gambia,1,0,Friendly,Malabo,Equatorial Guinea,False,1,1,Equatorial Guinea
28903,30957,32908,2011,Estonia,Serbia,1,1,UEFA Euro qualification,Tallinn,Estonia,False,2,0,Draw
28904,30958,32909,2011,France,Croatia,0,0,Friendly,Saint-Denis,France,False,0,0,Draw
28905,30959,32910,2011,Germany,Australia,1,2,Friendly,Mönchengladbach,Germany,False,3,-1,Australia
28906,30960,32911,2011,Greece,Poland,0,0,Friendly,Piraeus,Greece,False,0,0,Draw
28907,30961,32912,2011,Republic of Ireland,Uruguay,2,3,Friendly,Dublin,Republic of Ireland,False,5,-1,Uruguay
28908,30962,32913,2011,Israel,Georgia,1,0,UEFA Euro qualification,Jaffa,Israel,False,1,1,Israel
28909,30964,32915,2011,Kuwait,Iraq,1,0,Friendly,Sharjah,United Arab Emirates,True,1,1,Kuwait
28910,30965,32916,2011,Lithuania,Spain,1,3,UEFA Euro qualification,Kaunas,Lithuania,False,4,-2,Spain
28911,30966,32917,2011,Mexico,Venezuela,1,1,Friendly,San Diego,United States,True,2,0,Draw
28912,30967,32918,2011,Netherlands,Hungary,5,3,UEFA Euro qualification,Amsterdam,Netherlands,False,8,2,Netherlands
28913,30968,32919,2011,Nigeria,Kenya,3,0,Friendly,Abuja,Nigeria,False,3,3,Nigeria
28914,30969,32920,2011,Northern Ireland,Slovenia,0,0,UEFA Euro qualification,Belfast,Northern Ireland,False,0,0,Draw
28915,30970,32921,2011,Oman,Tunisia,2,1,Friendly,Muscat,Oman,False,3,1,Oman
28916,30971,32922,2011,Portugal,Finland,2,0,Friendly,Aveiro,Portugal,False,2,2,Portugal
28917,30972,32923,2011,Qatar,Russia,1,1,Friendly,Doha,Qatar,False,2,0,Draw
28918,30973,32924,2011,Romania,Luxembourg,3,1,UEFA Euro qualification,Piatra Neamţ,Romania,False,4,2,Romania
28919,30974,32925,2011,Slovakia,Denmark,1,2,Friendly,Trnava,Slovakia,False,3,-1,Denmark
28920,30975,32926,2011,Sri Lanka,Tajikistan,0,2,Friendly,Colombo,Sri Lanka,False,2,-2,Tajikistan
28921,30976,32927,2011,Sweden,Moldova,2,1,UEFA Euro qualification,Solna,Sweden,False,3,1,Sweden
28922,30977,32928,2011,Turkey,Austria,2,0,UEFA Euro qualification,Istanbul,Turkey,False,2,2,Turkey
28923,30978,32929,2011,Ukraine,Italy,0,2,Friendly,Kyïv,Ukraine,False,2,-2,Italy
28924,30979,32930,2011,United States,Paraguay,0,1,Friendly,Nashville,United States,False,1,-1,Paraguay
28925,30980,32931,2011,Grenada,Saint Kitts and Nevis,0,1,Friendly,St. George's,Grenada,False,1,-1,Saint Kitts and Nevis
28926,30981,32934,2011,Nepal,Afghanistan,1,0,AFC Challenge Cup qualification,Kathmandu,Nepal,False,1,1,Nepal
28927,30983,32937,2011,Sri Lanka,Afghanistan,0,1,AFC Challenge Cup qualification,Kathmandu,Nepal,True,1,-1,Afghanistan
28928,30984,32939,2011,Nepal,Sri Lanka,0,0,AFC Challenge Cup qualification,Kathmandu,Nepal,False,0,0,Draw
28929,30985,32940,2011,Argentina,Ecuador,2,2,Friendly,Mar del Plata,Argentina,False,4,0,Draw
28930,30986,32941,2011,Mozambique,Tanzania,2,0,Friendly,Maputo,Mozambique,False,2,2,Mozambique
28931,30987,32942,2011,New Caledonia,Réunion,2,4,Friendly,Nouméa,New Caledonia,False,6,-2,Réunion
28932,30989,32944,2011,New Caledonia,Réunion,1,3,Friendly,Nouméa,New Caledonia,False,4,-2,Réunion
28933,30990,32945,2011,Tanzania,South Africa,0,1,Friendly,Dar es Salaam,Tanzania,False,1,-1,South Africa
28934,30991,32946,2011,Guyana,Barbados,0,1,Friendly,Linden,Guyana,False,1,-1,Barbados
28935,30992,32947,2011,Guyana,Barbados,3,2,Friendly,Providence,Guyana,False,5,1,Guyana
28936,30993,32948,2011,Republic of Ireland,Northern Ireland,5,0,Nations Cup,Dublin,Republic of Ireland,False,5,5,Republic of Ireland
28937,30994,32949,2011,Argentina,Paraguay,4,2,Friendly,Resistencia,Argentina,False,6,2,Argentina
28938,30995,32950,2011,Eswatini,Botswana,0,0,Friendly,Manzini,Eswatini,False,0,0,Draw
28939,30996,32951,2011,Wales,Scotland,1,3,Nations Cup,Dublin,Republic of Ireland,True,4,-2,Scotland
28940,30998,32953,2011,Cuba,Nicaragua,1,1,Friendly,Havana,Cuba,False,2,0,Draw
28941,30999,32954,2011,Grenada,Antigua and Barbuda,2,2,Friendly,St. George's,Grenada,False,4,0,Draw
28942,31000,32955,2011,Wales,Northern Ireland,2,0,Nations Cup,Dublin,Republic of Ireland,True,2,2,Wales
28943,31001,32956,2011,Cuba,Nicaragua,2,1,Friendly,Havana,Cuba,False,3,1,Cuba
28944,31002,32957,2011,Mexico,Ecuador,1,1,Friendly,Seattle,United States,True,2,0,Draw
28945,31003,32958,2011,Barbados,Guyana,1,0,Friendly,Bridgetown,Barbados,False,1,1,Barbados
28946,31004,32959,2011,El Salvador,Honduras,2,2,Friendly,Houston,United States,True,4,0,Draw
28947,31005,32960,2011,Ethiopia,Sudan,1,2,Friendly,Addis Ababa,Ethiopia,False,3,-1,Sudan
28948,31006,32961,2011,Germany,Uruguay,2,1,Friendly,Sinsheim,Germany,False,3,1,Germany
28949,31007,32962,2011,Republic of Ireland,Scotland,1,0,Nations Cup,Dublin,Republic of Ireland,False,1,1,Republic of Ireland
28950,31008,32963,2011,Panama,Grenada,2,0,Friendly,Panama City,Panama,False,2,2,Panama
28951,31009,32964,2011,Eswatini,Malawi,1,1,Friendly,Mhlume,Eswatini,False,2,0,Draw
28952,31010,32965,2011,Tunisia,Central African Republic,3,0,Friendly,Sousse,Tunisia,False,3,3,Tunisia
28953,31011,32967,2011,Canada,Ecuador,2,2,Friendly,Toronto,Canada,False,4,0,Draw
28954,31012,32968,2011,Guatemala,Venezuela,0,2,Friendly,Guatemala,Guatemala,False,2,-2,Venezuela
28955,31013,32969,2011,Japan,Peru,0,0,Kirin Cup,Niigata,Japan,False,0,0,Draw
28956,31014,32970,2011,Mexico,New Zealand,3,0,Friendly,Denver,United States,True,3,3,Mexico
28957,31015,32971,2011,Nigeria,Argentina,4,1,Friendly,Abuja,Nigeria,False,5,3,Nigeria
28958,31016,32972,2011,Ukraine,Uzbekistan,2,0,Friendly,Kyïv,Ukraine,False,2,2,Ukraine
28959,31017,32974,2011,Austria,Germany,1,2,UEFA Euro qualification,Vienna,Austria,False,3,-1,Germany
28960,31018,32975,2011,Belarus,France,1,1,UEFA Euro qualification,Minsk,Belarus,False,2,0,Draw
28961,31019,32976,2011,Belgium,Turkey,1,1,UEFA Euro qualification,Brussels,Belgium,False,2,0,Draw
28962,31020,32977,2011,Croatia,Georgia,2,1,UEFA Euro qualification,Split,Croatia,False,3,1,Croatia
28963,31021,32978,2011,Faroe Islands,Slovenia,0,2,UEFA Euro qualification,Toftir,Faroe Islands,False,2,-2,Slovenia
28964,31022,32979,2011,Hong Kong,Malaysia,1,1,Friendly,Siu Sai Wan,Hong Kong,False,2,0,Draw
28965,31023,32980,2011,Italy,Estonia,3,0,UEFA Euro qualification,Modena,Italy,False,3,3,Italy
28966,31024,32981,2011,Kazakhstan,Azerbaijan,2,1,UEFA Euro qualification,Astana,Kazakhstan,False,3,1,Kazakhstan
28967,31025,32983,2011,Liechtenstein,Lithuania,2,0,UEFA Euro qualification,Vaduz,Liechtenstein,False,2,2,Liechtenstein
28968,31026,32984,2011,Luxembourg,Hungary,0,1,Friendly,Luxembourg,Luxembourg,False,1,-1,Hungary
28969,31027,32985,2011,Moldova,Sweden,1,4,UEFA Euro qualification,Chişinău,Moldova,False,5,-3,Sweden
28970,31028,32986,2011,Romania,Bosnia and Herzegovina,3,0,UEFA Euro qualification,Bucharest,Romania,False,3,3,Romania
28971,31029,32987,2011,San Marino,Finland,0,1,UEFA Euro qualification,Serravalle,San Marino,False,1,-1,Finland
28972,31030,32988,2011,Bolivia,Paraguay,0,2,Copa Paz del Chaco,Santa Cruz,Bolivia,False,2,-2,Paraguay
28973,31031,32989,2011,Brazil,Netherlands,0,0,Friendly,Goiânia,Brazil,False,0,0,Draw
28974,31032,32990,2011,Cameroon,Senegal,0,0,African Cup of Nations qualification,Yaoundé,Cameroon,False,0,0,Draw
28975,31033,32991,2011,Central African Republic,Tanzania,2,1,African Cup of Nations qualification,Bangui,Central African Republic,False,3,1,Central African Republic
28976,31034,32992,2011,England,Switzerland,2,2,UEFA Euro qualification,London,England,False,4,0,Draw
28977,31035,32993,2011,Greece,Malta,3,1,UEFA Euro qualification,Piraeus,Greece,False,4,2,Greece
28978,31036,32994,2011,Iceland,Denmark,0,2,UEFA Euro qualification,Reykjavík,Iceland,False,2,-2,Denmark
28979,31037,32995,2011,Latvia,Israel,1,2,UEFA Euro qualification,Riga,Latvia,False,3,-1,Israel
28980,31038,32997,2011,Montenegro,Bulgaria,1,1,UEFA Euro qualification,Podgorica,Montenegro,False,2,0,Draw
28981,31039,32998,2011,Morocco,Algeria,4,0,African Cup of Nations qualification,Marrakech,Morocco,False,4,4,Morocco
28982,31040,32999,2011,Peru,Czech Republic,0,0,Kirin Cup,Matsumoto,Japan,True,0,0,Draw
28983,31041,33000,2011,Portugal,Norway,1,0,UEFA Euro qualification,Lisbon,Portugal,False,1,1,Portugal
28984,31042,33001,2011,Russia,Armenia,3,1,UEFA Euro qualification,St. Petersburg,Russia,False,4,2,Russia
28985,31043,33002,2011,Sierra Leone,Niger,1,0,African Cup of Nations qualification,Freetown,Sierra Leone,False,1,1,Sierra Leone
28986,31044,33003,2011,Slovakia,Andorra,1,0,UEFA Euro qualification,Bratislava,Slovakia,False,1,1,Slovakia
28987,31045,33004,2011,Uganda,Guinea-Bissau,2,0,African Cup of Nations qualification,Kampala,Uganda,False,2,2,Uganda
28988,31046,33005,2011,United States,Spain,0,4,Friendly,Foxborough,United States,False,4,-4,Spain
28989,31047,33006,2011,Zambia,Mozambique,3,0,African Cup of Nations qualification,Lusaka,Zambia,False,3,3,Zambia
28990,31048,33007,2011,Angola,Kenya,1,0,African Cup of Nations qualification,Luanda,Angola,False,1,1,Angola
28991,31049,33008,2011,Australia,New Zealand,3,0,Friendly,Adelaide,Australia,False,3,3,Australia
28992,31050,33009,2011,Benin,Ivory Coast,2,6,African Cup of Nations qualification,Cotonou,Benin,False,8,-4,Ivory Coast
28993,31051,33010,2011,Botswana,Malawi,0,0,African Cup of Nations qualification,Gaborone,Botswana,False,0,0,Draw
28994,31052,33011,2011,Burundi,Rwanda,3,1,African Cup of Nations qualification,Bujumbura,Burundi,False,4,2,Burundi
28995,31053,33013,2011,Comoros,Libya,1,1,African Cup of Nations qualification,Mitsamiouli,Comoros,False,2,0,Draw
28996,31054,33014,2011,Costa Rica,Cuba,5,0,Gold Cup,Arlington,United States,True,5,5,Costa Rica
28997,31055,33015,2011,Egypt,South Africa,0,0,African Cup of Nations qualification,Cairo,Egypt,False,0,0,Draw
28998,31056,33016,2011,Ethiopia,Nigeria,2,2,African Cup of Nations qualification,Addis Ababa,Ethiopia,False,4,0,Draw
28999,31057,33017,2011,Guinea,Madagascar,4,1,African Cup of Nations qualification,Conakry,Guinea,False,5,3,Guinea
29000,31059,33019,2011,Mauritius,DR Congo,1,2,African Cup of Nations qualification,Mapou,Mauritius,False,3,-1,DR Congo
29001,31060,33020,2011,Mexico,El Salvador,5,0,Gold Cup,Arlington,United States,True,5,5,Mexico
29002,31061,33021,2011,Poland,Argentina,2,1,Friendly,Warsaw,Poland,False,3,1,Poland
29003,31062,33022,2011,Eswatini,Sudan,1,2,African Cup of Nations qualification,Lobamba,Eswatini,False,3,-1,Sudan
29004,31063,33023,2011,Tunisia,Chad,5,0,African Cup of Nations qualification,Sousse,Tunisia,False,5,5,Tunisia
29005,31064,33024,2011,Zimbabwe,Mali,2,1,African Cup of Nations qualification,Harare,Zimbabwe,False,3,1,Zimbabwe
29006,31065,33025,2011,Honduras,Guatemala,0,0,Gold Cup,Carson,United States,True,0,0,Draw
29007,31066,33026,2011,Jamaica,Grenada,4,0,Gold Cup,Carson,United States,True,4,4,Jamaica
29008,31067,33027,2011,Ukraine,France,1,4,Friendly,Donets'k,Ukraine,False,5,-3,France
29009,31068,33028,2011,Australia,Serbia,0,0,Friendly,Melbourne,Australia,False,0,0,Draw
29010,31069,33029,2011,Austria,Latvia,3,1,Friendly,Graz,Austria,False,4,2,Austria
29011,31070,33030,2011,Azerbaijan,Germany,1,3,UEFA Euro qualification,Baku,Azerbaijan,False,4,-2,Germany
29012,31071,33031,2011,Belarus,Luxembourg,2,0,UEFA Euro qualification,Minsk,Belarus,False,2,2,Belarus
29013,31072,33032,2011,Bosnia and Herzegovina,Albania,2,0,UEFA Euro qualification,Zenica,Bosnia and Herzegovina,False,2,2,Bosnia and Herzegovina
29014,31073,33033,2011,Brazil,Romania,1,0,Friendly,São Paulo,Brazil,False,1,1,Brazil
29015,31074,33034,2011,Ecuador,Greece,1,1,Friendly,New York,United States,True,2,0,Draw
29016,31075,33035,2011,Faroe Islands,Estonia,2,0,UEFA Euro qualification,Toftir,Faroe Islands,False,2,2,Faroe Islands
29017,31076,33036,2011,Gabon,Gambia,0,1,Friendly,Franceville,Gabon,False,1,-1,Gambia
29018,31077,33037,2011,Italy,Republic of Ireland,0,2,Friendly,Liège,Belgium,True,2,-2,Republic of Ireland
29019,31078,33038,2011,Japan,Czech Republic,0,0,Kirin Cup,Yokohama,Japan,False,0,0,Draw
29020,31079,33040,2011,Norway,Lithuania,1,0,Friendly,Oslo,Norway,False,1,1,Norway
29021,31080,33041,2011,Panama,Guadeloupe,3,2,Gold Cup,Detroit,United States,True,5,1,Panama
29022,31081,33042,2011,Paraguay,Bolivia,0,0,Copa Paz del Chaco,Luque,Paraguay,False,0,0,Draw
29023,31082,33043,2011,Russia,Cameroon,0,0,Friendly,Salzburg,Austria,True,0,0,Draw
29024,31083,33044,2011,San Marino,Hungary,0,3,UEFA Euro qualification,Serravalle,San Marino,False,3,-3,Hungary
29025,31084,33045,2011,Sweden,Finland,5,0,UEFA Euro qualification,Solna,Sweden,False,5,5,Sweden
29026,31085,33046,2011,United States,Canada,2,0,Gold Cup,Detroit,United States,False,2,2,United States
29027,31086,33047,2011,Venezuela,Spain,0,3,Friendly,Puerto la Cruz,Venezuela,False,3,-3,Spain
29028,31087,33049,2011,Uruguay,Netherlands,1,1,Friendly,Montevideo,Uruguay,False,2,0,Draw
29029,31088,33050,2011,Costa Rica,El Salvador,1,1,Gold Cup,Charlotte,United States,True,2,0,Draw
29030,31089,33051,2011,Cuba,Mexico,0,5,Gold Cup,Charlotte,United States,True,5,-5,Mexico
29031,31090,33052,2011,Poland,France,0,1,Friendly,Warsaw,Poland,False,1,-1,France
29032,31091,33053,2011,Grenada,Honduras,1,7,Gold Cup,Miami,United States,True,8,-6,Honduras
29033,31092,33054,2011,Jamaica,Guatemala,2,0,Gold Cup,Miami,United States,True,2,2,Jamaica
29034,31093,33055,2011,Canada,Guadeloupe,1,0,Gold Cup,Tampa,United States,True,1,1,Canada
29035,31094,33056,2011,Mexico,Venezuela,0,3,Friendly,Las Vegas,United States,True,3,-3,Venezuela
29036,31095,33057,2011,Paraguay,Romania,2,0,Friendly,Asunción,Paraguay,False,2,2,Paraguay
29037,31096,33058,2011,United States,Panama,1,2,Gold Cup,Tampa,United States,False,3,-1,Panama
29038,31097,33059,2011,El Salvador,Cuba,6,1,Gold Cup,Chicago,United States,True,7,5,El Salvador
29039,31098,33060,2011,Mexico,Costa Rica,4,1,Gold Cup,Chicago,United States,True,5,3,Mexico
29040,31100,33062,2011,Guatemala,Grenada,4,0,Gold Cup,Harrison,United States,True,4,4,Guatemala
29041,31101,33063,2011,Honduras,Jamaica,0,1,Gold Cup,Harrison,United States,True,1,-1,Jamaica
29042,31102,33064,2011,Canada,Panama,1,1,Gold Cup,Kansas City,United States,True,2,0,Draw
29043,31103,33065,2011,United States,Guadeloupe,1,0,Gold Cup,Kansas City,United States,False,1,1,United States
29044,31104,33066,2011,Montserrat,Belize,2,5,FIFA World Cup qualification,Couva,Trinidad and Tobago,True,7,-3,Belize
29045,31105,33067,2011,Costa Rica,Honduras,1,1,Gold Cup,East Rutherford,United States,True,2,0,Draw
29046,31106,33068,2011,Malaysia,Burma,2,0,Friendly,Kota Baharu,Malaysia,False,2,2,Malaysia
29047,31107,33069,2011,Mexico,Guatemala,2,1,Gold Cup,East Rutherford,United States,True,3,1,Mexico
29048,31108,33070,2011,Anguilla,U.S. Virgin Islands,0,0,Friendly,The Valley,Anguilla,False,0,0,Draw
29049,31109,33071,2011,Panama,El Salvador,1,1,Gold Cup,Washington,United States,True,2,0,Draw
29050,31110,33072,2011,United States,Jamaica,2,0,Gold Cup,Washington,United States,False,2,2,United States
29051,31111,33073,2011,Argentina,Albania,4,0,Friendly,Buenos Aires,Argentina,False,4,4,Argentina
29052,31112,33074,2011,Honduras,Mexico,0,2,Gold Cup,Houston,United States,True,2,-2,Mexico
29053,31113,33075,2011,United States,Panama,1,0,Gold Cup,Houston,United States,False,1,1,United States
29054,31114,33076,2011,Paraguay,Chile,0,0,Friendly,Asunción,Paraguay,False,0,0,Draw
29055,31115,33077,2011,Colombia,Senegal,2,0,Friendly,Medellín,Colombia,False,2,2,Colombia
29056,31116,33078,2011,Kenya,Sudan,1,2,Friendly,Nairobi,Kenya,False,3,-1,Sudan
29057,31117,33079,2011,United States,Mexico,2,4,Gold Cup,Pasadena,United States,False,6,-2,Mexico
29058,31119,33085,2011,Guernsey,Falkland Islands,5,0,Island Games,Brading,England,True,5,5,Guernsey
29059,31121,33087,2011,Bolivia,Mexico,0,1,Friendly,Buenos Aires,Argentina,True,1,-1,Mexico
29060,31125,33092,2011,Isle of Man,Falkland Islands,6,0,Island Games,Rookley,England,True,6,6,Isle of Man
29061,31126,33095,2011,Peru,Senegal,1,0,Friendly,Lima,Peru,False,1,1,Peru
29062,31127,33096,2011,Greenland,Jersey,1,2,Island Games,Freshwater,England,True,3,-1,Jersey
29063,31128,33099,2011,Guernsey,Isle of Man,2,1,Island Games,East Cowes,England,True,3,1,Guernsey
29064,31130,33102,2011,Afghanistan,Palestine,0,2,FIFA World Cup qualification,Tursunzoda,Tajikistan,True,2,-2,Palestine
29065,31131,33103,2011,Bangladesh,Pakistan,3,0,FIFA World Cup qualification,Dhaka,Bangladesh,False,3,3,Bangladesh
29066,31132,33104,2011,Cambodia,Laos,4,2,FIFA World Cup qualification,Phnom Penh,Cambodia,False,6,2,Cambodia
29067,31133,33105,2011,Iraq,Syria,1,2,Friendly,Arbil,Iraq,False,3,-1,Syria
29068,31135,33107,2011,Mongolia,Burma,1,0,FIFA World Cup qualification,Ulaanbaatar,Mongolia,False,1,1,Mongolia
29069,31136,33108,2011,Nepal,East Timor,2,1,FIFA World Cup qualification,Kathmandu,Nepal,False,3,1,Nepal
29070,31137,33109,2011,Sri Lanka,Philippines,1,1,FIFA World Cup qualification,Colombo,Sri Lanka,False,2,0,Draw
29071,31138,33110,2011,Vietnam,Macau,6,0,FIFA World Cup qualification,Ho Chi Minh City,Vietnam,False,6,6,Vietnam
29072,31141,33117,2011,Guernsey,Åland Islands,3,2,Island Games,Brading,England,True,5,1,Guernsey
29073,31142,33118,2011,Argentina,Bolivia,1,1,Copa América,La Plata,Argentina,False,2,0,Draw
29074,31143,33119,2011,Jersey,Åland Islands,5,1,Island Games,Brading,England,True,6,4,Jersey
29075,31144,33121,2011,Colombia,Costa Rica,1,0,Copa América,San Salvador de Jujuy,Argentina,True,1,1,Colombia
29076,31145,33122,2011,Lebanon,Kuwait,0,6,Friendly,Beirut,Lebanon,False,6,-6,Kuwait
29077,31146,33123,2011,Nepal,East Timor,5,0,FIFA World Cup qualification,Kathmandu,Nepal,False,5,5,Nepal
29078,31147,33124,2011,Turks and Caicos Islands,Bahamas,0,4,FIFA World Cup qualification,Providenciales,Turks and Caicos Islands,False,4,-4,Bahamas
29079,31148,33125,2011,Brazil,Venezuela,0,0,Copa América,La Plata,Argentina,True,0,0,Draw
29080,31149,33126,2011,Burma,Mongolia,2,0,FIFA World Cup qualification,Rangoon,Burma,False,2,2,Burma
29081,31150,33127,2011,Laos,Cambodia,6,2,FIFA World Cup qualification,Vientiane,Laos,False,8,4,Laos
29082,31151,33128,2011,Macau,Vietnam,1,7,FIFA World Cup qualification,Macau,Macau,False,8,-6,Vietnam
29083,31152,33129,2011,Pakistan,Bangladesh,0,0,FIFA World Cup qualification,Lahore,Pakistan,False,0,0,Draw
29084,31153,33130,2011,Palestine,Afghanistan,1,1,FIFA World Cup qualification,al-Ramm,Palestine,False,2,0,Draw
29085,31154,33131,2011,Paraguay,Ecuador,0,0,Copa América,Santa Fe,Argentina,True,0,0,Draw
29086,31155,33132,2011,Philippines,Sri Lanka,4,0,FIFA World Cup qualification,Manila,Philippines,False,4,4,Philippines
29087,31157,33134,2011,Chile,Mexico,2,1,Copa América,San Juan,Argentina,True,3,1,Chile
29088,31158,33135,2011,Uruguay,Peru,1,1,Copa América,San Juan,Argentina,True,2,0,Draw
29089,31159,33136,2011,Jordan,Syria,1,3,Friendly,Istanbul,Turkey,True,4,-2,Syria
29090,31160,33137,2011,Argentina,Colombia,0,0,Copa América,Santa Fe,Argentina,False,0,0,Draw
29091,31161,33138,2011,Kuwait,Oman,1,1,Friendly,Beirut,Lebanon,True,2,0,Draw
29092,31162,33139,2011,Malawi,Namibia,0,1,Friendly,Mzuzu,Malawi,False,1,-1,Namibia
29093,31163,33140,2011,Bolivia,Costa Rica,0,2,Copa América,San Salvador de Jujuy,Argentina,True,2,-2,Costa Rica
29094,31164,33141,2011,Solomon Islands,Vanuatu,2,1,Friendly,Honiara,Solomon Islands,False,3,1,Solomon Islands
29095,31165,33142,2011,Aruba,Saint Lucia,4,2,FIFA World Cup qualification,Oranjestad,Aruba,False,6,2,Aruba
29096,31166,33143,2011,Dominican Republic,Anguilla,2,0,FIFA World Cup qualification,San Cristóbal,Dominican Republic,False,2,2,Dominican Republic
29097,31167,33144,2011,Jordan,Yemen,4,0,Friendly,Istanbul,Turkey,True,4,4,Jordan
29098,31168,33145,2011,Peru,Mexico,1,0,Copa América,Mendoza,Argentina,True,1,1,Peru
29099,31169,33146,2011,Uruguay,Chile,1,1,Copa América,Mendoza,Argentina,True,2,0,Draw
29100,31170,33147,2011,Bahamas,Turks and Caicos Islands,6,0,FIFA World Cup qualification,Nassau,Bahamas,False,6,6,Bahamas
29101,31171,33148,2011,Brazil,Paraguay,2,2,Copa América,Córdoba,Argentina,True,4,0,Draw
29102,31172,33149,2011,Lebanon,Oman,0,1,Friendly,Beirut,Lebanon,False,1,-1,Oman
29103,31173,33150,2011,Solomon Islands,Vanuatu,0,0,Friendly,Honiara,Solomon Islands,False,0,0,Draw
29104,31174,33151,2011,Venezuela,Ecuador,1,0,Copa América,Salta,Argentina,True,1,1,Venezuela
29105,31175,33153,2011,Colombia,Bolivia,2,0,Copa América,Santa Fe,Argentina,True,2,2,Colombia
29106,31176,33154,2011,Dominican Republic,Anguilla,4,0,FIFA World Cup qualification,San Cristóbal,Dominican Republic,False,4,4,Dominican Republic
29107,31177,33155,2011,Maldives,India,1,1,Friendly,Malé,Maldives,False,2,0,Draw
29108,31178,33156,2011,Argentina,Costa Rica,3,0,Copa América,Córdoba,Argentina,False,3,3,Argentina
29109,31179,33157,2011,Chile,Peru,1,0,Copa América,Mendoza,Argentina,True,1,1,Chile
29110,31180,33158,2011,Saint Lucia,Aruba,4,2,FIFA World Cup qualification,Castries,Saint Lucia,False,6,2,Saint Lucia
29111,31181,33159,2011,Uruguay,Mexico,1,0,Copa América,La Plata,Argentina,True,1,1,Uruguay
29112,31182,33160,2011,Brazil,Ecuador,4,2,Copa América,Córdoba,Argentina,True,6,2,Brazil
29113,31183,33161,2011,Iraq,Kuwait,0,2,Friendly,Amman,Jordan,True,2,-2,Kuwait
29114,31184,33162,2011,Jordan,Saudi Arabia,1,1,Friendly,Amman,Jordan,False,2,0,Draw
29115,31185,33163,2011,Paraguay,Venezuela,3,3,Copa América,Salta,Argentina,True,6,0,Draw
29116,31186,33164,2011,Thailand,Burma,1,0,Friendly,Buriram,Thailand,False,1,1,Thailand
29117,31187,33165,2011,Fiji,Vanuatu,1,2,Friendly,Lautoka,Fiji,False,3,-1,Vanuatu
29118,31188,33166,2011,Oman,Syria,1,1,Friendly,Muscat,Oman,False,2,0,Draw
29119,31189,33167,2011,Thailand,Burma,1,1,Friendly,Buriram,Thailand,False,2,0,Draw
29120,31190,33168,2011,Argentina,Uruguay,1,1,Copa América,Santa Fe,Argentina,False,2,0,Draw
29121,31191,33169,2011,Colombia,Peru,0,2,Copa América,Córdoba,Argentina,True,2,-2,Peru
29122,31192,33170,2011,Jordan,Iraq,1,1,Friendly,Amman,Jordan,False,2,0,Draw
29123,31193,33171,2011,Kuwait,Saudi Arabia,1,0,Friendly,Amman,Jordan,True,1,1,Kuwait
29124,31194,33172,2011,Belize,Montserrat,3,1,FIFA World Cup qualification,San Pedro Sula,Honduras,True,4,2,Belize
29125,31195,33173,2011,Brazil,Paraguay,0,0,Copa América,La Plata,Argentina,True,0,0,Draw
29126,31196,33174,2011,Chile,Venezuela,1,2,Copa América,San Juan,Argentina,True,3,-1,Venezuela
29127,31197,33175,2011,Iran,Madagascar,1,0,Friendly,Teheran,Iran,False,1,1,Iran
29128,31198,33176,2011,Qatar,India,1,2,Friendly,Doha,Qatar,False,3,-1,India
29129,31199,33177,2011,United Arab Emirates,Lebanon,6,2,Friendly,al-Ain,United Arab Emirates,False,8,4,United Arab Emirates
29130,31201,33179,2011,Peru,Uruguay,0,2,Copa América,La Plata,Argentina,True,2,-2,Uruguay
29131,31202,33180,2011,Paraguay,Venezuela,0,0,Copa América,Mendoza,Argentina,True,0,0,Draw
29132,31203,33182,2011,Iran,Maldives,4,0,FIFA World Cup qualification,Teheran,Iran,False,4,4,Iran
29133,31204,33183,2011,Iraq,Yemen,2,0,FIFA World Cup qualification,Arbil,Iraq,False,2,2,Iraq
29134,31205,33184,2011,Jordan,Nepal,9,0,FIFA World Cup qualification,Amman,Jordan,False,9,9,Jordan
29135,31206,33185,2011,Kuwait,Philippines,3,0,FIFA World Cup qualification,Hawalli,Kuwait,False,3,3,Kuwait
29136,31207,33186,2011,Lebanon,Bangladesh,4,0,FIFA World Cup qualification,Beirut,Lebanon,False,4,4,Lebanon
29137,31208,33187,2011,Oman,Burma,2,0,FIFA World Cup qualification,Muscat,Oman,False,2,2,Oman
29138,31209,33188,2011,Peru,Venezuela,4,1,Copa América,La Plata,Argentina,True,5,3,Peru
29139,31210,33189,2011,Qatar,Vietnam,3,0,FIFA World Cup qualification,Doha,Qatar,False,3,3,Qatar
29140,31211,33190,2011,Saudi Arabia,Hong Kong,3,0,FIFA World Cup qualification,Dammam,Saudi Arabia,False,3,3,Saudi Arabia
29141,31212,33191,2011,Singapore,Malaysia,5,3,FIFA World Cup qualification,Singapore,Singapore,False,8,2,Singapore
29142,31213,33192,2011,Syria,Tajikistan,0,3,FIFA World Cup qualification,Amman,Jordan,True,3,-3,Tajikistan
29143,31214,33193,2011,Thailand,Palestine,1,0,FIFA World Cup qualification,Buriram,Thailand,False,1,1,Thailand
29144,31215,33194,2011,Turkmenistan,Indonesia,1,1,FIFA World Cup qualification,Ashgabat,Turkmenistan,False,2,0,Draw
29145,31216,33195,2011,United Arab Emirates,India,3,0,FIFA World Cup qualification,al-Ain,United Arab Emirates,False,3,3,United Arab Emirates
29146,31217,33196,2011,Uzbekistan,Kyrgyzstan,4,0,FIFA World Cup qualification,Tashkent,Uzbekistan,False,4,4,Uzbekistan
29147,31218,33197,2011,Liberia,Gambia,3,2,Friendly,Paynesville,Liberia,False,5,1,Liberia
29148,31219,33198,2011,Uruguay,Paraguay,3,0,Copa América,Buenos Aires,Argentina,True,3,3,Uruguay
29149,31220,33199,2011,Vanuatu,Solomon Islands,0,0,Friendly,Port Vila,Vanuatu,False,0,0,Draw
29150,31221,33200,2011,Bangladesh,Lebanon,2,0,FIFA World Cup qualification,Dhaka,Bangladesh,False,2,2,Bangladesh
29151,31222,33201,2011,Burma,Oman,0,2,FIFA World Cup qualification,Rangoon,Burma,False,2,-2,Oman
29152,31223,33202,2011,Hong Kong,Saudi Arabia,0,5,FIFA World Cup qualification,Siu Sai Wan,Hong Kong,False,5,-5,Saudi Arabia
29153,31224,33203,2011,India,United Arab Emirates,2,2,FIFA World Cup qualification,New Delhi,India,False,4,0,Draw
29154,31225,33204,2011,Indonesia,Turkmenistan,4,3,FIFA World Cup qualification,Jakarta,Indonesia,False,7,1,Indonesia
29155,31226,33205,2011,Kyrgyzstan,Uzbekistan,0,3,FIFA World Cup qualification,Bishkek,Kyrgyzstan,False,3,-3,Uzbekistan
29156,31228,33207,2011,Malaysia,Singapore,1,1,FIFA World Cup qualification,Kuala Lumpur,Malaysia,False,2,0,Draw
29157,31229,33208,2011,Maldives,Iran,0,1,FIFA World Cup qualification,Malé,Maldives,False,1,-1,Iran
29158,31230,33209,2011,Nepal,Jordan,1,1,FIFA World Cup qualification,Kathmandu,Nepal,False,2,0,Draw
29159,31231,33210,2011,Palestine,Thailand,2,2,FIFA World Cup qualification,al-Ramm,Palestine,False,4,0,Draw
29160,31232,33211,2011,Philippines,Kuwait,1,2,FIFA World Cup qualification,Manila,Philippines,False,3,-1,Kuwait
29161,31233,33212,2011,Tajikistan,Syria,3,0,FIFA World Cup qualification,Tursunzoda,Tajikistan,False,3,3,Tajikistan
29162,31234,33213,2011,Vietnam,Qatar,2,1,FIFA World Cup qualification,Hanoi,Vietnam,False,3,1,Vietnam
29163,31235,33214,2011,Yemen,Iraq,0,0,FIFA World Cup qualification,al-Ain,United Arab Emirates,True,0,0,Draw
29164,31236,33215,2011,Vanuatu,Solomon Islands,2,0,Friendly,Port Vila,Vanuatu,False,2,2,Vanuatu
29165,31237,33216,2011,Eswatini,Botswana,0,2,Friendly,Pretoria,South Africa,True,2,-2,Botswana
29166,31238,33217,2011,El Salvador,Venezuela,2,1,Friendly,Washington,United States,True,3,1,El Salvador
29167,31239,33218,2011,Albania,Montenegro,3,2,Friendly,Shkodër,Albania,False,5,1,Albania
29168,31240,33219,2011,Austria,Slovakia,1,2,Friendly,Klagenfurt,Austria,False,3,-1,Slovakia
29169,31242,33221,2011,Belarus,Bulgaria,1,0,Friendly,Minsk,Belarus,False,1,1,Belarus
29170,31243,33222,2011,Bolivia,Panama,1,3,Friendly,Santa Cruz,Bolivia,False,4,-2,Panama
29171,31244,33223,2011,Bosnia and Herzegovina,Greece,0,0,Friendly,Sarajevo,Bosnia and Herzegovina,False,0,0,Draw
29172,31245,33224,2011,Botswana,Kenya,1,0,Friendly,Gaborone,Botswana,False,1,1,Botswana
29173,31246,33226,2011,Costa Rica,Ecuador,0,2,Friendly,San José,Costa Rica,False,2,-2,Ecuador
29174,31247,33227,2011,Cyprus,Moldova,3,2,Friendly,Nicosia,Cyprus,False,5,1,Cyprus
29175,31248,33228,2011,Equatorial Guinea,Guinea-Bissau,1,4,Friendly,Lisbon,Portugal,True,5,-3,Guinea-Bissau
29176,31249,33229,2011,France,Chile,1,1,Friendly,Montpellier,France,False,2,0,Draw
29177,31250,33230,2011,Gabon,Guinea,1,1,Friendly,Saint-Leu-la-Forêt,France,True,2,0,Draw
29178,31251,33231,2011,Gambia,DR Congo,3,0,Friendly,Banjul,Gambia,False,3,3,Gambia
29179,31252,33232,2011,Germany,Brazil,3,2,Friendly,Stuttgart,Germany,False,5,1,Germany
29180,31253,33233,2011,Honduras,Venezuela,2,0,Friendly,Fort Lauderdale,United States,True,2,2,Honduras
29181,31254,33234,2011,Hungary,Iceland,4,0,Friendly,Budapest,Hungary,False,4,4,Hungary
29182,31255,33235,2011,Republic of Ireland,Croatia,0,0,Friendly,Dublin,Republic of Ireland,False,0,0,Draw
29183,31256,33236,2011,Israel,Ivory Coast,3,4,Friendly,Geneva,Switzerland,True,7,-1,Ivory Coast
29184,31257,33237,2011,Italy,Spain,2,1,Friendly,Bari,Italy,False,3,1,Italy
29185,31259,33239,2011,Kazakhstan,Syria,1,1,Friendly,Astana,Kazakhstan,False,2,0,Draw
29186,31261,33241,2011,Latvia,Finland,0,2,Friendly,Riga,Latvia,False,2,-2,Finland
29187,31262,33242,2011,Liberia,Angola,0,0,Friendly,Paynesville,Liberia,False,0,0,Draw
29188,31263,33243,2011,Liechtenstein,Switzerland,1,2,Friendly,Vaduz,Liechtenstein,False,3,-1,Switzerland
29189,31264,33244,2011,Lithuania,Armenia,3,0,Friendly,Kaunas,Lithuania,False,3,3,Lithuania
29190,31265,33245,2011,Malta,Central African Republic,2,1,Friendly,Attard,Malta,False,3,1,Malta
29191,31266,33246,2011,Niger,Togo,3,3,Friendly,Niamey,Niger,False,6,0,Draw
29192,31267,33247,2011,Northern Ireland,Faroe Islands,4,0,UEFA Euro qualification,Belfast,Northern Ireland,False,4,4,Northern Ireland
29193,31268,33248,2011,Norway,Czech Republic,3,0,Friendly,Oslo,Norway,False,3,3,Norway
29194,31269,33249,2011,Oman,Bahrain,1,1,Friendly,Dubai,United Arab Emirates,True,2,0,Draw
29195,31270,33250,2011,Poland,Georgia,1,0,Friendly,Lubin,Poland,False,1,1,Poland
29196,31271,33251,2011,Portugal,Luxembourg,5,0,Friendly,Faro,Portugal,False,5,5,Portugal
29197,31272,33252,2011,Russia,Serbia,1,0,Friendly,Moscow,Russia,False,1,1,Russia
29198,31273,33253,2011,San Marino,Romania,0,1,Friendly,Serravalle,San Marino,False,1,-1,Romania
29199,31274,33254,2011,Scotland,Denmark,2,1,Friendly,Glasgow,Scotland,False,3,1,Scotland
29200,31275,33255,2011,Senegal,Morocco,0,2,Friendly,Dakar,Senegal,False,2,-2,Morocco
29201,31276,33256,2011,Slovenia,Belgium,0,0,Friendly,Ljubljana,Slovenia,False,0,0,Draw
29202,31277,33257,2011,South Africa,Burkina Faso,3,0,Friendly,Johannesburg,South Africa,False,3,3,South Africa
29203,31278,33258,2011,Tunisia,Mali,4,2,Friendly,Monastir,Tunisia,False,6,2,Tunisia
29204,31279,33259,2011,Turkey,Estonia,3,0,Friendly,Istanbul,Turkey,False,3,3,Turkey
29205,31280,33260,2011,Ukraine,Sweden,0,1,Friendly,Kharkiv,Ukraine,False,1,-1,Sweden
29206,31281,33261,2011,United States,Mexico,1,1,Friendly,Philadelphia,United States,False,2,0,Draw
29207,31282,33262,2011,Wales,Australia,1,2,Friendly,Cardiff,Wales,False,3,-1,Australia
29208,31283,33263,2011,Zimbabwe,Zambia,2,0,Friendly,Harare,Zimbabwe,False,2,2,Zimbabwe
29209,31284,33264,2011,Liberia,Niger,0,0,Friendly,Paynesville,Liberia,False,0,0,Draw
29210,31285,33265,2011,Fiji,Samoa,3,0,Friendly,Navua,Fiji,False,3,3,Fiji
29211,31286,33266,2011,Lebanon,Syria,2,3,Friendly,Sidon,Lebanon,False,5,-1,Syria
29212,31287,33267,2011,Fiji,Samoa,5,1,Friendly,Suva,Fiji,False,6,4,Fiji
29213,31288,33268,2011,Eritrea,Sudan,0,3,Friendly,Asmara,Eritrea,False,3,-3,Sudan
29214,31289,33269,2011,Qatar,Iraq,0,1,Friendly,Doha,Qatar,False,1,-1,Iraq
29215,31290,33270,2011,Dominican Republic,Curaçao,1,0,Friendly,San Cristóbal,Dominican Republic,False,1,1,Dominican Republic
29216,31291,33271,2011,Lesotho,Eswatini,0,0,Friendly,Maseru,Lesotho,False,0,0,Draw
29217,31292,33272,2011,Barbados,Saint Lucia,4,0,Friendly,Bridgetown,Barbados,False,4,4,Barbados
29218,31293,33273,2011,Dominican Republic,Curaçao,1,0,Friendly,San Cristóbal,Dominican Republic,False,1,1,Dominican Republic
29219,31294,33274,2011,Trinidad and Tobago,India,3,0,Friendly,Port of Spain,Trinidad and Tobago,False,3,3,Trinidad and Tobago
29220,31295,33275,2011,Indonesia,Palestine,4,1,Friendly,Surakarta,Indonesia,False,5,3,Indonesia
29221,31296,33276,2011,Jordan,Tunisia,3,3,Friendly,Amman,Jordan,False,6,0,Draw
29222,31297,33277,2011,Lesotho,Eswatini,0,1,Friendly,Maseru,Lesotho,False,1,-1,Eswatini
29223,31298,33278,2011,Tuvalu,Samoa,3,0,Friendly,Nausori,Fiji,True,3,3,Tuvalu
29224,31299,33279,2011,Guyana,India,2,1,Friendly,Providence,Guyana,False,3,1,Guyana
29225,31300,33280,2011,Thailand,Singapore,0,0,Friendly,Bangkok,Thailand,False,0,0,Draw
29226,31301,33281,2011,United Arab Emirates,Qatar,3,1,Friendly,al-Ain,United Arab Emirates,False,4,2,United Arab Emirates
29227,31302,33282,2011,Bahrain,Sudan,1,0,Friendly,Riffa,Bahrain,False,1,1,Bahrain
29228,31303,33283,2011,Angola,DR Congo,1,2,Friendly,Dundo,Angola,False,3,-1,DR Congo
29229,31305,33285,2011,Jordan,Indonesia,1,0,Friendly,Amman,Jordan,False,1,1,Jordan
29230,31306,33286,2011,New Caledonia,Vanuatu,5,0,Pacific Games,Nouméa,New Caledonia,False,5,5,New Caledonia
29231,31307,33287,2011,Oman,Kuwait,1,0,Friendly,Muscat,Oman,False,1,1,Oman
29232,31308,33288,2011,Papua New Guinea,Cook Islands,4,0,Pacific Games,Boulari,New Caledonia,True,4,4,Papua New Guinea
29233,31309,33289,2011,Solomon Islands,Guam,7,0,Pacific Games,Nouméa,New Caledonia,True,7,7,Solomon Islands
29234,31310,33290,2011,Tuvalu,American Samoa,4,0,Pacific Games,Nouméa,New Caledonia,True,4,4,Tuvalu
29235,31311,33291,2011,Antigua and Barbuda,Saint Vincent and the Grenadines,2,2,Friendly,Osbourn,Antigua and Barbuda,False,4,0,Draw
29236,31312,33292,2011,American Samoa,Solomon Islands,0,4,Pacific Games,Nouméa,New Caledonia,True,4,-4,Solomon Islands
29237,31313,33293,2011,Fiji,Kiribati,9,0,Pacific Games,Boulari,New Caledonia,True,9,9,Fiji
29238,31314,33294,2011,New Caledonia,Guam,9,0,Pacific Games,Nouméa,New Caledonia,False,9,9,New Caledonia
29239,31315,33296,2011,Vanuatu,Tuvalu,5,1,Pacific Games,Nouméa,New Caledonia,True,6,4,Vanuatu
29240,31316,33297,2011,American Samoa,Guam,0,2,Pacific Games,Nouméa,New Caledonia,True,2,-2,Guam
29241,31317,33298,2011,Cook Islands,Kiribati,3,0,Pacific Games,Boulari,New Caledonia,True,3,3,Cook Islands
29242,31318,33299,2011,New Caledonia,Tuvalu,8,0,Pacific Games,Nouméa,New Caledonia,False,8,8,New Caledonia
29243,31319,33301,2011,Vanuatu,Solomon Islands,1,0,Pacific Games,Nouméa,New Caledonia,True,1,1,Vanuatu
29244,31320,33302,2011,Albania,France,1,2,UEFA Euro qualification,Tirana,Albania,False,3,-1,France
29245,31321,33303,2011,Andorra,Armenia,0,3,UEFA Euro qualification,Sant Julià de Lòria,Andorra,False,3,-3,Armenia
29246,31322,33304,2011,Antigua and Barbuda,Curaçao,5,2,FIFA World Cup qualification,St. John's,Antigua and Barbuda,False,7,3,Antigua and Barbuda
29247,31323,33305,2011,Argentina,Venezuela,1,0,Friendly,Calcutta,India,True,1,1,Argentina
29248,31324,33306,2011,Australia,Thailand,2,1,FIFA World Cup qualification,Brisbane,Australia,False,3,1,Australia
29249,31325,33307,2011,Azerbaijan,Belgium,1,1,UEFA Euro qualification,Baku,Azerbaijan,False,2,0,Draw
29250,31326,33308,2011,Bahrain,Qatar,0,0,FIFA World Cup qualification,Riffa,Bahrain,False,0,0,Draw
29251,31327,33309,2011,Belarus,Bosnia and Herzegovina,0,2,UEFA Euro qualification,Minsk,Belarus,False,2,-2,Bosnia and Herzegovina
29252,31328,33310,2011,Bulgaria,England,0,3,UEFA Euro qualification,Sofia,Bulgaria,False,3,-3,England
29253,31329,33311,2011,Canada,Saint Lucia,4,1,FIFA World Cup qualification,Toronto,Canada,False,5,3,Canada
29254,31330,33313,2011,Cyprus,Portugal,0,4,UEFA Euro qualification,Nicosia,Cyprus,False,4,-4,Portugal
29255,31331,33314,2011,Dominica,Nicaragua,0,2,FIFA World Cup qualification,Roseau,Dominica,False,2,-2,Nicaragua
29256,31332,33315,2011,Ecuador,Jamaica,5,2,Friendly,Quito,Ecuador,False,7,3,Ecuador
29257,31333,33316,2011,El Salvador,Dominican Republic,3,2,FIFA World Cup qualification,San Salvador,El Salvador,False,5,1,El Salvador
29258,31334,33317,2011,Faroe Islands,Italy,0,1,UEFA Euro qualification,Tórshavn,Faroe Islands,False,1,-1,Italy
29259,31335,33318,2011,Finland,Moldova,4,1,UEFA Euro qualification,Helsinki,Finland,False,5,3,Finland
29260,31336,33319,2011,Georgia,Latvia,0,1,UEFA Euro qualification,Tbilisi,Georgia,False,1,-1,Latvia
29261,31337,33320,2011,Germany,Austria,6,2,UEFA Euro qualification,Gelsenkirchen,Germany,False,8,4,Germany
29262,31338,33321,2011,Ghana,Eswatini,2,0,African Cup of Nations qualification,Accra,Ghana,False,2,2,Ghana
29263,31339,33322,2011,Grenada,Belize,0,3,FIFA World Cup qualification,St. George's,Grenada,False,3,-3,Belize
29264,31340,33323,2011,Guyana,Barbados,2,0,FIFA World Cup qualification,Providence,Guyana,False,2,2,Guyana
29265,31341,33324,2011,Haiti,U.S. Virgin Islands,6,0,FIFA World Cup qualification,Port-au-Prince,Haiti,False,6,6,Haiti
29266,31342,33325,2011,Hungary,Sweden,2,1,UEFA Euro qualification,Budapest,Hungary,False,3,1,Hungary
29267,31343,33326,2011,Iran,Indonesia,3,0,FIFA World Cup qualification,Teheran,Iran,False,3,3,Iran
29268,31344,33327,2011,Iraq,Jordan,0,2,FIFA World Cup qualification,Arbil,Iraq,False,2,-2,Jordan
29269,31345,33328,2011,Republic of Ireland,Slovakia,0,0,UEFA Euro qualification,Dublin,Republic of Ireland,False,0,0,Draw
29270,31346,33329,2011,Israel,Greece,0,1,UEFA Euro qualification,Jaffa,Israel,False,1,-1,Greece
29271,31348,33332,2011,Lithuania,Liechtenstein,0,0,UEFA Euro qualification,Kaunas,Lithuania,False,0,0,Draw
29272,31349,33333,2011,Luxembourg,Romania,0,2,UEFA Euro qualification,Luxembourg,Luxembourg,False,2,-2,Romania
29273,31350,33334,2011,Malta,Croatia,1,3,UEFA Euro qualification,Attard,Malta,False,4,-2,Croatia
29274,31351,33335,2011,Netherlands,San Marino,11,0,UEFA Euro qualification,Eindhoven,Netherlands,False,11,11,Netherlands
29275,31352,33336,2011,Northern Ireland,Serbia,0,1,UEFA Euro qualification,Belfast,Northern Ireland,False,1,-1,Serbia
29276,31353,33337,2011,Norway,Iceland,1,0,UEFA Euro qualification,Oslo,Norway,False,1,1,Norway
29277,31354,33338,2011,Oman,Saudi Arabia,0,0,FIFA World Cup qualification,Muscat,Oman,False,0,0,Draw
29278,31355,33339,2011,Panama,Paraguay,0,2,Friendly,Panama,Panama,False,2,-2,Paraguay
29279,31356,33340,2011,Peru,Bolivia,2,2,Friendly,Lima,Peru,False,4,0,Draw
29280,31357,33341,2011,Poland,Mexico,1,1,Friendly,Warsaw,Poland,False,2,0,Draw
29281,31359,33343,2011,Slovenia,Estonia,1,2,UEFA Euro qualification,Ljubljana,Slovenia,False,3,-1,Estonia
29282,31360,33344,2011,Spain,Chile,3,2,Friendly,St. Gallen,Switzerland,True,5,1,Spain
29283,31361,33345,2011,Saint Kitts and Nevis,Puerto Rico,0,0,FIFA World Cup qualification,Basseterre,Saint Kitts and Nevis,False,0,0,Draw
29284,31362,33346,2011,Suriname,Cayman Islands,1,0,FIFA World Cup qualification,Paramaribo,Suriname,False,1,1,Suriname
29285,31363,33347,2011,Tajikistan,Uzbekistan,0,1,FIFA World Cup qualification,Tursunzoda,Tajikistan,False,1,-1,Uzbekistan
29286,31364,33348,2011,Trinidad and Tobago,Bermuda,1,0,FIFA World Cup qualification,Port of Spain,Trinidad and Tobago,False,1,1,Trinidad and Tobago
29287,31365,33349,2011,Turkey,Kazakhstan,2,1,UEFA Euro qualification,Istanbul,Turkey,False,3,1,Turkey
29288,31366,33350,2011,Ukraine,Uruguay,2,3,Friendly,Kharkiv,Ukraine,False,5,-1,Uruguay
29289,31367,33351,2011,United Arab Emirates,Kuwait,2,3,FIFA World Cup qualification,al-Ain,United Arab Emirates,False,5,-1,Kuwait
29290,31368,33352,2011,United States,Costa Rica,0,1,Friendly,Carson,United States,False,1,-1,Costa Rica
29291,31369,33353,2011,Wales,Montenegro,2,1,UEFA Euro qualification,Cardiff,Wales,False,3,1,Wales
29292,31370,33354,2011,Burkina Faso,Equatorial Guinea,1,0,Friendly,Bobo Dioulasso,Burkina Faso,False,1,1,Burkina Faso
29293,31371,33355,2011,Cameroon,Mauritius,6,0,African Cup of Nations qualification,Yaoundé,Cameroon,False,6,6,Cameroon
29294,31372,33356,2011,Cook Islands,Fiji,1,4,Pacific Games,Boulari,New Caledonia,True,5,-3,Fiji
29295,31373,33357,2011,Guam,Vanuatu,1,4,Pacific Games,Nouméa,New Caledonia,True,5,-3,Vanuatu
29296,31374,33358,2011,Honduras,Colombia,0,2,Friendly,Harrison,United States,True,2,-2,Colombia
29297,31375,33359,2011,Kenya,Guinea-Bissau,2,1,African Cup of Nations qualification,Nairobi,Kenya,False,3,1,Kenya
29298,31376,33360,2011,Kiribati,Papua New Guinea,1,17,Pacific Games,Boulari,New Caledonia,True,18,-16,Papua New Guinea
29299,31377,33361,2011,Malawi,Tunisia,0,0,African Cup of Nations qualification,Blantyre,Malawi,False,0,0,Draw
29300,31378,33362,2011,Namibia,Gambia,1,0,African Cup of Nations qualification,Windhoek,Namibia,False,1,1,Namibia
29301,31379,33363,2011,New Caledonia,American Samoa,8,0,Pacific Games,Nouméa,New Caledonia,False,8,8,New Caledonia
29302,31380,33364,2011,Rwanda,Ivory Coast,0,5,African Cup of Nations qualification,Kigali,Rwanda,False,5,-5,Ivory Coast
29303,31381,33365,2011,Scotland,Czech Republic,2,2,UEFA Euro qualification,Glasgow,Scotland,False,4,0,Draw
29304,31382,33366,2011,Senegal,DR Congo,2,0,African Cup of Nations qualification,Dakar,Senegal,False,2,2,Senegal
29305,31383,33367,2011,Sierra Leone,Egypt,2,1,African Cup of Nations qualification,Freetowm,Sierra Leone,False,3,1,Sierra Leone
29306,31384,33368,2011,Solomon Islands,Tuvalu,6,1,Pacific Games,Nouméa,New Caledonia,True,7,5,Solomon Islands
29307,31385,33369,2011,Tanzania,Algeria,1,1,African Cup of Nations qualification,Dar es Salaam,Tanzania,False,2,0,Draw
29308,31386,33370,2011,Angola,Uganda,2,0,African Cup of Nations qualification,Luanda,Angola,False,2,2,Angola
29309,31387,33371,2011,Burundi,Benin,1,1,African Cup of Nations qualification,Bujumbura,Burundi,False,2,0,Draw
29310,31388,33372,2011,Central African Republic,Morocco,0,0,African Cup of Nations qualification,Bangui,Central African Republic,False,0,0,Draw
29311,31389,33373,2011,Comoros,Zambia,1,2,African Cup of Nations qualification,Mitsamiouli,Comoros,False,3,-1,Zambia
29312,31390,33374,2011,Congo,Sudan,0,1,African Cup of Nations qualification,Brazzaville,Congo,False,1,-1,Sudan
29313,31391,33375,2011,Guinea,Ethiopia,1,0,African Cup of Nations qualification,Conakry,Guinea,False,1,1,Guinea
29314,31392,33376,2011,Madagascar,Nigeria,0,2,African Cup of Nations qualification,Antananarivo,Madagascar,False,2,-2,Nigeria
29315,31393,33377,2011,Mexico,Chile,1,0,Friendly,Barcelona,Spain,True,1,1,Mexico
29316,31394,33378,2011,Niger,South Africa,2,1,African Cup of Nations qualification,Niamey,Niger,False,3,1,Niger
29317,31395,33379,2011,Togo,Botswana,1,0,African Cup of Nations qualification,Lomé,Togo,False,1,1,Togo
29318,31396,33380,2011,Zimbabwe,Liberia,3,0,African Cup of Nations qualification,Harare,Zimbabwe,False,3,3,Zimbabwe
29319,31397,33381,2011,American Samoa,Vanuatu,0,8,Pacific Games,Nouméa,New Caledonia,True,8,-8,Vanuatu
29320,31398,33382,2011,Bolivia,Peru,0,0,Friendly,La Paz,Bolivia,False,0,0,Draw
29321,31399,33383,2011,Brazil,Ghana,1,0,Friendly,London,England,True,1,1,Brazil
29322,31400,33384,2011,Guam,Tuvalu,1,1,Pacific Games,Nouméa,New Caledonia,True,2,0,Draw
29323,31402,33386,2011,New Caledonia,Solomon Islands,1,2,Pacific Games,Nouméa,New Caledonia,False,3,-1,Solomon Islands
29324,31403,33387,2011,Papua New Guinea,Fiji,0,2,Pacific Games,Boulari,New Caledonia,True,2,-2,Fiji
29325,31404,33388,2011,Argentina,Nigeria,3,1,Friendly,Dhaka,Bangladesh,True,4,2,Argentina
29326,31405,33389,2011,Austria,Turkey,0,0,UEFA Euro qualification,Vienna,Austria,False,0,0,Draw
29327,31406,33390,2011,Azerbaijan,Kazakhstan,3,2,UEFA Euro qualification,Baku,Azerbaijan,False,5,1,Azerbaijan
29328,31407,33391,2011,Barbados,Trinidad and Tobago,0,2,FIFA World Cup qualification,Bridgetown,Barbados,False,2,-2,Trinidad and Tobago
29329,31408,33392,2011,Belgium,United States,1,0,Friendly,Brussels,Belgium,False,1,1,Belgium
29330,31409,33393,2011,Belize,Guatemala,1,2,FIFA World Cup qualification,Belmopan,Belize,False,3,-1,Guatemala
29331,31410,33394,2011,Bosnia and Herzegovina,Belarus,1,0,UEFA Euro qualification,Zenica,Bosnia and Herzegovina,False,1,1,Bosnia and Herzegovina
29332,31411,33395,2011,Cayman Islands,El Salvador,1,4,FIFA World Cup qualification,Georgetown,Cayman Islands,False,5,-3,El Salvador
29333,31412,33396,2011,Croatia,Israel,3,1,UEFA Euro qualification,Zagreb,Croatia,False,4,2,Croatia
29334,31413,33397,2011,Curaçao,Haiti,2,4,FIFA World Cup qualification,Willemstad,Curaçao,False,6,-2,Haiti
29335,31414,33398,2011,Czech Republic,Ukraine,4,0,Friendly,Prague,Czech Republic,False,4,4,Czech Republic
29336,31415,33399,2011,Denmark,Norway,2,0,UEFA Euro qualification,Copenhagen,Denmark,False,2,2,Denmark
29337,31416,33400,2011,Dominican Republic,Suriname,1,1,FIFA World Cup qualification,San Cristóbal,Dominican Republic,False,2,0,Draw
29338,31417,33401,2011,Ecuador,Costa Rica,4,0,Friendly,Quito,Ecuador,False,4,4,Ecuador
29339,31418,33402,2011,England,Wales,1,0,UEFA Euro qualification,London,England,False,1,1,England
29340,31419,33403,2011,Estonia,Northern Ireland,4,1,UEFA Euro qualification,Tallinn,Estonia,False,5,3,Estonia
29341,31420,33404,2011,Finland,Netherlands,0,2,UEFA Euro qualification,Helsinki,Finland,False,2,-2,Netherlands
29342,31421,33405,2011,Gabon,Niger,1,0,Friendly,Nice,France,True,1,1,Gabon
29343,31422,33406,2011,Guyana,Bermuda,2,1,FIFA World Cup qualification,Georgetown,Guyana,False,3,1,Guyana
29344,31423,33407,2011,Honduras,Paraguay,0,3,Friendly,San Pedro Sula,Honduras,False,3,-3,Paraguay
29345,31424,33408,2011,Iceland,Cyprus,1,0,UEFA Euro qualification,Reykjavík,Iceland,False,1,1,Iceland
29346,31425,33409,2011,Indonesia,Bahrain,0,2,FIFA World Cup qualification,Jakarta,Indonesia,False,2,-2,Bahrain
29347,31426,33410,2011,Italy,Slovenia,1,0,UEFA Euro qualification,Florence,Italy,False,1,1,Italy
29348,31427,33411,2011,Jamaica,Colombia,0,2,Friendly,Fort Lauderdale,United States,True,2,-2,Colombia
29349,31430,33415,2011,Latvia,Greece,1,1,UEFA Euro qualification,Riga,Latvia,False,2,0,Draw
29350,31431,33416,2011,Lebanon,United Arab Emirates,3,1,FIFA World Cup qualification,Beirut,Lebanon,False,4,2,Lebanon
29351,31432,33417,2011,Luxembourg,Albania,2,1,UEFA Euro qualification,Luxembourg,Luxembourg,False,3,1,Luxembourg
29352,31433,33419,2011,Malta,Georgia,1,1,UEFA Euro qualification,Attard,Malta,False,2,0,Draw
29353,31434,33420,2011,Moldova,Hungary,0,2,UEFA Euro qualification,Chişinău,Moldova,False,2,-2,Hungary
29354,31435,33421,2011,Nicaragua,Panama,1,2,FIFA World Cup qualification,Managua,Nicaragua,False,3,-1,Panama
29355,31436,33422,2011,Poland,Germany,2,2,Friendly,Gdańsk,Poland,False,4,0,Draw
29356,31437,33423,2011,Puerto Rico,Canada,0,3,FIFA World Cup qualification,Bayamón,Puerto Rico,False,3,-3,Canada
29357,31438,33424,2011,Qatar,Iran,1,1,FIFA World Cup qualification,Doha,Qatar,False,2,0,Draw
29358,31439,33425,2011,Romania,France,0,0,UEFA Euro qualification,Bucharest,Romania,False,0,0,Draw
29359,31440,33426,2011,Russia,Republic of Ireland,0,0,UEFA Euro qualification,Moscow,Russia,False,0,0,Draw
29360,31441,33427,2011,San Marino,Sweden,0,5,UEFA Euro qualification,Serravalle,San Marino,False,5,-5,Sweden
29361,31442,33428,2011,Saudi Arabia,Australia,1,3,FIFA World Cup qualification,Riyadh,Saudi Arabia,False,4,-2,Australia
29362,31443,33429,2011,Scotland,Lithuania,1,0,UEFA Euro qualification,Glasgow,Scotland,False,1,1,Scotland
29363,31444,33430,2011,Serbia,Faroe Islands,3,1,UEFA Euro qualification,Belgrade,Serbia,False,4,2,Serbia
29364,31445,33431,2011,Singapore,Iraq,0,2,FIFA World Cup qualification,Singapore,Singapore,False,2,-2,Iraq
29365,31446,33432,2011,Slovakia,Armenia,0,4,UEFA Euro qualification,Žilina,Slovakia,False,4,-4,Armenia
29366,31447,33433,2011,Spain,Liechtenstein,6,0,UEFA Euro qualification,Logroño,Spain,False,6,6,Spain
29367,31448,33434,2011,Saint Lucia,Saint Kitts and Nevis,2,4,FIFA World Cup qualification,Gros Islet,Saint Lucia,False,6,-2,Saint Kitts and Nevis
29368,31449,33435,2011,Switzerland,Bulgaria,3,1,UEFA Euro qualification,Basel,Switzerland,False,4,2,Switzerland
29369,31450,33436,2011,Thailand,Oman,3,0,FIFA World Cup qualification,Bangkok,Thailand,False,3,3,Thailand
29370,31451,33437,2011,Uzbekistan,Japan,1,1,FIFA World Cup qualification,Tashkent,Uzbekistan,False,2,0,Draw
29371,31452,33438,2011,Venezuela,Guinea,2,1,Friendly,Caracas,Venezuela,False,3,1,Venezuela
29372,31453,33439,2011,U.S. Virgin Islands,Antigua and Barbuda,1,8,FIFA World Cup qualification,Frederiksted,U.S. Virgin Islands,False,9,-7,Antigua and Barbuda
29373,31454,33440,2011,Equatorial Guinea,Central African Republic,3,0,Friendly,Malabo,Equatorial Guinea,False,3,3,Equatorial Guinea
29374,31456,33442,2011,Solomon Islands,Fiji,2,1,Pacific Games,Lifou,New Caledonia,True,3,1,Solomon Islands
29375,31457,33443,2011,New Caledonia,Solomon Islands,2,0,Pacific Games,Nouméa,New Caledonia,False,2,2,New Caledonia
29376,31458,33445,2011,Saint Vincent and the Grenadines,Dominica,1,0,Friendly,Kingstown,Saint Vincent and the Grenadines,False,1,1,Saint Vincent and the Grenadines
29377,31459,33446,2011,Argentina,Brazil,0,0,Friendly,Córdoba,Argentina,False,0,0,Draw
29378,31460,33447,2011,Suriname,Curaçao,2,0,Friendly,Paramaribo,Suriname,False,2,2,Suriname
29379,31461,33448,2011,Suriname,Curaçao,2,2,Friendly,Paramaribo,Suriname,False,4,0,Draw
29380,31462,33449,2011,Brazil,Argentina,2,0,Friendly,Belém,Brazil,False,2,2,Brazil
29381,31463,33450,2011,Antigua and Barbuda,Martinique,1,0,Friendly,Osbourn,Antigua and Barbuda,False,1,1,Antigua and Barbuda
29382,31464,33451,2011,Hong Kong,Philippines,3,3,Dragon Cup,Kaohsiung,Chinese Taipei,True,6,0,Draw
29383,31465,33452,2011,Ethiopia,Sudan,1,2,Friendly,Addis Ababa,Ethiopia,False,3,-1,Sudan
29384,31466,33453,2011,Antigua and Barbuda,Martinique,1,2,Friendly,Osbourn,Antigua and Barbuda,False,3,-1,Martinique
29385,31467,33454,2011,Hong Kong,Macau,5,1,Dragon Cup,Kaohsiung,Chinese Taipei,True,6,4,Hong Kong
29386,31468,33455,2011,Ethiopia,Malawi,0,0,Friendly,Addis Ababa,Ethiopia,False,0,0,Draw
29387,31469,33456,2011,Philippines,Macau,2,0,Dragon Cup,Kaohsiung,Chinese Taipei,True,2,2,Philippines
29388,31470,33457,2011,Iran,Palestine,7,0,Friendly,Teheran,Iran,False,7,7,Iran
29389,31471,33459,2011,Thailand,Jordan,0,0,Friendly,Bangkok,Thailand,False,0,0,Draw
29390,31472,33460,2011,Andorra,Republic of Ireland,0,2,UEFA Euro qualification,Sant Julià de Lòria,Andorra,False,2,-2,Republic of Ireland
29391,31473,33461,2011,Argentina,Chile,4,1,FIFA World Cup qualification,Buenos Aires,Argentina,False,5,3,Argentina
29392,31475,33463,2011,Australia,Malaysia,5,0,Friendly,Canberra,Australia,False,5,5,Australia
29393,31476,33464,2011,Azerbaijan,Austria,1,4,UEFA Euro qualification,Baku,Azerbaijan,False,5,-3,Austria
29394,31477,33465,2011,Barbados,Guyana,0,2,FIFA World Cup qualification,Bridgetown,Barbados,False,2,-2,Guyana
29395,31478,33466,2011,Belgium,Kazakhstan,4,1,UEFA Euro qualification,Brussels,Belgium,False,5,3,Belgium
29396,31479,33467,2011,Belize,Grenada,1,4,FIFA World Cup qualification,Belmopan,Belize,False,5,-3,Grenada
29397,31480,33468,2011,Bermuda,Trinidad and Tobago,2,1,FIFA World Cup qualification,Hamilton,Bermuda,False,3,1,Bermuda
29398,31481,33469,2011,Bosnia and Herzegovina,Luxembourg,5,0,UEFA Euro qualification,Zenica,Bosnia and Herzegovina,False,5,5,Bosnia and Herzegovina
29399,31482,33470,2011,Cayman Islands,Suriname,0,1,FIFA World Cup qualification,Georgetown,Cayman Islands,False,1,-1,Suriname
29400,31483,33471,2011,DR Congo,Cameroon,2,3,African Cup of Nations qualification,Kinshasa,DR Congo,False,5,-1,Cameroon
29401,31484,33472,2011,Costa Rica,Brazil,0,1,Friendly,San José,Costa Rica,False,1,-1,Brazil
29402,31485,33473,2011,Curaçao,Antigua and Barbuda,0,1,FIFA World Cup qualification,Willemstad,Curaçao,False,1,-1,Antigua and Barbuda
29403,31486,33474,2011,Cyprus,Denmark,1,4,UEFA Euro qualification,Nicosia,Cyprus,False,5,-3,Denmark
29404,31487,33475,2011,Czech Republic,Spain,0,2,UEFA Euro qualification,Prague,Czech Republic,False,2,-2,Spain
29405,31488,33476,2011,Dominica,Panama,0,5,FIFA World Cup qualification,Roseau,Dominica,False,5,-5,Panama
29406,31489,33477,2011,Dominican Republic,El Salvador,1,2,FIFA World Cup qualification,San Cristóbal,Dominican Republic,False,3,-1,El Salvador
29407,31490,33478,2011,Ecuador,Venezuela,2,0,FIFA World Cup qualification,Quito,Ecuador,False,2,2,Ecuador
29408,31491,33479,2011,Finland,Sweden,1,2,UEFA Euro qualification,Helsinki,Finland,False,3,-1,Sweden
29409,31492,33480,2011,France,Albania,3,0,UEFA Euro qualification,Saint-Denis,France,False,3,3,France
29410,31493,33481,2011,Gabon,Equatorial Guinea,2,0,Friendly,Nice,France,True,2,2,Gabon
29411,31494,33482,2011,Greece,Croatia,2,0,UEFA Euro qualification,Piraeus,Greece,False,2,2,Greece
29412,31495,33483,2011,Indonesia,Saudi Arabia,0,0,Friendly,Kuala Lumpur,Malaysia,True,0,0,Draw
29413,31496,33484,2011,Japan,Vietnam,1,0,Friendly,Kobe,Japan,False,1,1,Japan
29414,31497,33486,2011,Latvia,Malta,2,0,UEFA Euro qualification,Riga,Latvia,False,2,2,Latvia
29415,31498,33487,2011,Montenegro,England,2,2,UEFA Euro qualification,Podgorica,Montenegro,False,4,0,Draw
29416,31499,33488,2011,Netherlands,Moldova,1,0,UEFA Euro qualification,Rotterdam,Netherlands,False,1,1,Netherlands
29417,31500,33489,2011,Northern Ireland,Estonia,1,2,UEFA Euro qualification,Belfast,Northern Ireland,False,3,-1,Estonia
29418,31501,33490,2011,Peru,Paraguay,2,0,FIFA World Cup qualification,Lima,Peru,False,2,2,Peru
29419,31502,33491,2011,Portugal,Iceland,5,3,UEFA Euro qualification,Porto,Portugal,False,8,2,Portugal
29420,31503,33492,2011,Puerto Rico,Saint Kitts and Nevis,1,1,FIFA World Cup qualification,Bayamón,Puerto Rico,False,2,0,Draw
29421,31504,33493,2011,Romania,Belarus,2,2,UEFA Euro qualification,Bucharest,Romania,False,4,0,Draw
29422,31505,33494,2011,Serbia,Italy,1,1,UEFA Euro qualification,Belgrade,Serbia,False,2,0,Draw
29423,31506,33495,2011,Singapore,Philippines,2,0,Friendly,Singapore,Singapore,False,2,2,Singapore
29424,31507,33496,2011,Slovakia,Russia,0,1,UEFA Euro qualification,Žilina,Slovakia,False,1,-1,Russia
29425,31508,33497,2011,Saint Lucia,Canada,0,7,FIFA World Cup qualification,Gros Islet,Saint Lucia,False,7,-7,Canada
29426,31509,33498,2011,Turkey,Germany,1,3,UEFA Euro qualification,Istanbul,Turkey,False,4,-2,Germany
29427,31510,33499,2011,Ukraine,Bulgaria,3,0,Friendly,Kyïv,Ukraine,False,3,3,Ukraine
29428,31511,33500,2011,Uruguay,Bolivia,4,2,FIFA World Cup qualification,Montevideo,Uruguay,False,6,2,Uruguay
29429,31512,33501,2011,U.S. Virgin Islands,Haiti,0,7,FIFA World Cup qualification,Frederiksted,U.S. Virgin Islands,False,7,-7,Haiti
29430,31513,33502,2011,Wales,Switzerland,2,0,UEFA Euro qualification,Swansea,Wales,False,2,2,Wales
29431,31514,33504,2011,Chad,Malawi,2,2,African Cup of Nations qualification,N'Djamena,Chad,False,4,0,Draw
29432,31515,33505,2011,Egypt,Niger,3,0,African Cup of Nations qualification,Cairo,Egypt,False,3,3,Egypt
29433,31516,33506,2011,Ethiopia,Madagascar,4,2,African Cup of Nations qualification,Addis Ababa,Ethiopia,False,6,2,Ethiopia
29434,31517,33507,2011,Gambia,Burkina Faso,1,1,African Cup of Nations qualification,Bakau,Gambia,False,2,0,Draw
29435,31518,33508,2011,Guinea-Bissau,Angola,0,2,African Cup of Nations qualification,Bissau,Guinea-Bissau,False,2,-2,Angola
29436,31519,33509,2011,Liberia,Mali,1,2,African Cup of Nations qualification,Paynesville,Liberia,False,3,-1,Mali
29437,31520,33510,2011,Liechtenstein,Scotland,0,1,UEFA Euro qualification,Vaduz,Liechtenstein,False,1,-1,Scotland
29438,31521,33511,2011,Mozambique,Comoros,3,0,African Cup of Nations qualification,Maputo,Mozambique,False,3,3,Mozambique
29439,31522,33512,2011,Nigeria,Guinea,2,2,African Cup of Nations qualification,Abuja,Nigeria,False,4,0,Draw
29440,31523,33513,2011,South Africa,Sierra Leone,0,0,African Cup of Nations qualification,Nelspriut,South Africa,False,0,0,Draw
29441,31524,33514,2011,Sudan,Ghana,0,2,African Cup of Nations qualification,Khartoum,Sudan,False,2,-2,Ghana
29442,31525,33515,2011,Eswatini,Congo,0,1,African Cup of Nations qualification,Lobamba,Eswatini,False,1,-1,Congo
29443,31526,33516,2011,Tunisia,Togo,2,0,African Cup of Nations qualification,Radès,Tunisia,False,2,2,Tunisia
29444,31527,33517,2011,Uganda,Kenya,0,0,African Cup of Nations qualification,Kampala,Uganda,False,0,0,Draw
29445,31528,33518,2011,United States,Honduras,1,0,Friendly,Miami Gardens,United States,False,1,1,United States
29446,31529,33519,2011,Zambia,Libya,0,0,African Cup of Nations qualification,Chingola,Zambia,False,0,0,Draw
29447,31530,33520,2011,Algeria,Central African Republic,2,0,African Cup of Nations qualification,Algiers,Algeria,False,2,2,Algeria
29448,31531,33521,2011,Benin,Rwanda,0,1,African Cup of Nations qualification,Cotonou,Benin,False,1,-1,Rwanda
29449,31532,33522,2011,Ivory Coast,Burundi,2,1,African Cup of Nations qualification,Abidjan,Ivory Coast,False,3,1,Ivory Coast
29450,31533,33523,2011,Mauritius,Senegal,0,2,African Cup of Nations qualification,Mapou,Mauritius,False,2,-2,Senegal
29451,31534,33524,2011,Morocco,Tanzania,3,1,African Cup of Nations qualification,Marrakech,Morocco,False,4,2,Morocco
29452,31535,33525,2011,Albania,Romania,1,1,UEFA Euro qualification,Tirana,Albania,False,2,0,Draw
29453,31536,33526,2011,Antigua and Barbuda,U.S. Virgin Islands,10,0,FIFA World Cup qualification,St. John's,Antigua and Barbuda,False,10,10,Antigua and Barbuda
29454,31537,33527,2011,Australia,Oman,3,0,FIFA World Cup qualification,Sydney,Australia,False,3,3,Australia
29455,31538,33528,2011,Belarus,Poland,0,2,Friendly,Wiesbaden,Germany,True,2,-2,Poland
29456,31539,33529,2011,Bermuda,Guyana,1,1,FIFA World Cup qualification,Hamilton,Bermuda,False,2,0,Draw
29457,31540,33530,2011,Bolivia,Colombia,1,2,FIFA World Cup qualification,La Paz,Bolivia,False,3,-1,Colombia
29458,31541,33531,2011,Bulgaria,Wales,0,1,UEFA Euro qualification,Sofia,Bulgaria,False,1,-1,Wales
29459,31542,33532,2011,Canada,Puerto Rico,0,0,FIFA World Cup qualification,Toronto,Canada,False,0,0,Draw
29460,31543,33533,2011,Chile,Peru,4,2,FIFA World Cup qualification,Santiago,Chile,False,6,2,Chile
29461,31544,33535,2011,Croatia,Latvia,2,0,UEFA Euro qualification,Rijeka,Croatia,False,2,2,Croatia
29462,31545,33536,2011,Denmark,Portugal,2,1,UEFA Euro qualification,Copenhagen,Denmark,False,3,1,Denmark
29463,31546,33537,2011,El Salvador,Cayman Islands,4,0,FIFA World Cup qualification,San Salvador,El Salvador,False,4,4,El Salvador
29464,31547,33538,2011,Equatorial Guinea,Cameroon,1,1,Friendly,Malabo,Equatorial Guinea,False,2,0,Draw
29465,31548,33539,2011,Estonia,Ukraine,0,2,Friendly,Tallinn,Estonia,False,2,-2,Ukraine
29466,31549,33540,2011,France,Bosnia and Herzegovina,1,1,UEFA Euro qualification,Saint-Denis,France,False,2,0,Draw
29467,31550,33541,2011,Georgia,Greece,1,2,UEFA Euro qualification,Tbilisi,Georgia,False,3,-1,Greece
29468,31551,33542,2011,Germany,Belgium,3,1,UEFA Euro qualification,Düsseldorf,Germany,False,4,2,Germany
29469,31552,33543,2011,Ghana,Nigeria,0,0,Friendly,Watford,England,True,0,0,Draw
29470,31553,33544,2011,Guatemala,Belize,3,1,FIFA World Cup qualification,Guatemala,Guatemala,False,4,2,Guatemala
29471,31554,33545,2011,Haiti,Curaçao,2,2,FIFA World Cup qualification,Port-au-Prince,Haiti,False,4,0,Draw
29472,31555,33546,2011,Honduras,Jamaica,2,1,Friendly,La Ceiba,Honduras,False,3,1,Honduras
29473,31556,33547,2011,Hungary,Finland,0,0,UEFA Euro qualification,Budapest,Hungary,False,0,0,Draw
29474,31557,33548,2011,Indonesia,Qatar,2,3,FIFA World Cup qualification,Jakarta,Indonesia,False,5,-1,Qatar
29475,31558,33549,2011,Iran,Bahrain,6,0,FIFA World Cup qualification,Teheran,Iran,False,6,6,Iran
29476,31559,33550,2011,Republic of Ireland,Armenia,2,1,UEFA Euro qualification,Dublin,Republic of Ireland,False,3,1,Republic of Ireland
29477,31560,33551,2011,Italy,Northern Ireland,3,0,UEFA Euro qualification,Pescara,Italy,False,3,3,Italy
29478,31561,33552,2011,Japan,Tajikistan,8,0,FIFA World Cup qualification,Osaka,Japan,False,8,8,Japan
29479,31562,33553,2011,Kazakhstan,Austria,0,0,UEFA Euro qualification,Astana,Kazakhstan,False,0,0,Draw
29480,31563,33556,2011,Lebanon,Kuwait,2,2,FIFA World Cup qualification,Beirut,Lebanon,False,4,0,Draw
29481,31564,33557,2011,Lithuania,Czech Republic,1,4,UEFA Euro qualification,Kaunas,Lithuania,False,5,-3,Czech Republic
29482,31565,33559,2011,Malta,Israel,0,2,UEFA Euro qualification,Attard,Malta,False,2,-2,Israel
29483,31566,33560,2011,Mexico,Brazil,1,2,Friendly,Torreón,Mexico,False,3,-1,Brazil
29484,31567,33561,2011,Moldova,San Marino,4,0,UEFA Euro qualification,Chişinău,Moldova,False,4,4,Moldova
29485,31568,33562,2011,Norway,Cyprus,3,1,UEFA Euro qualification,Oslo,Norway,False,4,2,Norway
29486,31569,33563,2011,Panama,Nicaragua,5,1,FIFA World Cup qualification,Panama City,Panama,False,6,4,Panama
29487,31570,33564,2011,Paraguay,Uruguay,1,1,FIFA World Cup qualification,Asunción,Paraguay,False,2,0,Draw
29488,31571,33565,2011,Philippines,Nepal,4,0,Friendly,Manila,Philippines,False,4,4,Philippines
29489,31572,33566,2011,Russia,Andorra,6,0,UEFA Euro qualification,Moscow,Russia,False,6,6,Russia
29490,31573,33567,2011,Singapore,Jordan,0,3,FIFA World Cup qualification,Singapore,Singapore,False,3,-3,Jordan
29491,31574,33568,2011,Slovenia,Serbia,1,0,UEFA Euro qualification,Maribor,Slovenia,False,1,1,Slovenia
29492,31575,33569,2011,Spain,Scotland,3,1,UEFA Euro qualification,Alicante,Spain,False,4,2,Spain
29493,31576,33570,2011,Saint Kitts and Nevis,Saint Lucia,1,1,FIFA World Cup qualification,Basseterre,Saint Kitts and Nevis,False,2,0,Draw
29494,31577,33571,2011,Suriname,Dominican Republic,1,3,FIFA World Cup qualification,Paramaribo,Suriname,False,4,-2,Dominican Republic
29495,31578,33572,2011,Sweden,Netherlands,3,2,UEFA Euro qualification,Solna,Sweden,False,5,1,Sweden
29496,31579,33573,2011,Switzerland,Montenegro,2,0,UEFA Euro qualification,Basel,Switzerland,False,2,2,Switzerland
29497,31580,33574,2011,Thailand,Saudi Arabia,0,0,FIFA World Cup qualification,Bangkok,Thailand,False,0,0,Draw
29498,31581,33575,2011,Trinidad and Tobago,Barbados,4,0,FIFA World Cup qualification,Port of Spain,Trinidad and Tobago,False,4,4,Trinidad and Tobago
29499,31582,33576,2011,Turkey,Azerbaijan,1,0,UEFA Euro qualification,Istanbul,Turkey,False,1,1,Turkey
29500,31583,33577,2011,United States,Ecuador,0,1,Friendly,Harrison,United States,False,1,-1,Ecuador
29501,31584,33578,2011,Venezuela,Argentina,1,0,FIFA World Cup qualification,Puerto la Cruz,Venezuela,False,1,1,Venezuela
29502,31585,33579,2011,Namibia,Lesotho,0,0,Friendly,Windhoek,Namibia,False,0,0,Draw
29503,31586,33580,2011,Kuwait,Bahrain,0,1,Friendly,Kuwait City,Kuwait,False,1,-1,Bahrain
29504,31587,33581,2011,Qatar,Oman,0,0,Friendly,Doha,Qatar,False,0,0,Draw
29505,31588,33582,2011,Antigua and Barbuda,Guadeloupe,0,0,Friendly,Osbourn,Antigua and Barbuda,False,0,0,Draw
29506,31589,33583,2011,Iraq,Lebanon,1,0,Friendly,Doha,Qatar,True,1,1,Iraq
29507,31590,33584,2011,Lesotho,DR Congo,0,3,Friendly,Pretoria,South Africa,True,3,-3,DR Congo
29508,31591,33585,2011,Gabon,Brazil,0,2,Friendly,Libreville,Gabon,False,2,-2,Brazil
29509,31592,33586,2011,Albania,Azerbaijan,0,1,Friendly,Tirana,Albania,False,1,-1,Azerbaijan
29510,31593,33587,2011,Antigua and Barbuda,Haiti,1,0,FIFA World Cup qualification,St. John's,Antigua and Barbuda,False,1,1,Antigua and Barbuda
29511,31594,33588,2011,Argentina,Bolivia,1,1,FIFA World Cup qualification,Buenos Aires,Argentina,False,2,0,Draw
29512,31595,33589,2011,Bahrain,Iran,1,1,FIFA World Cup qualification,Riffa,Bahrain,False,2,0,Draw
29513,31596,33590,2011,Belgium,Romania,2,1,Friendly,Liège,Belgium,False,3,1,Belgium
29514,31597,33591,2011,Bermuda,Barbados,2,1,FIFA World Cup qualification,Hamilton,Bermuda,False,3,1,Bermuda
29515,31598,33592,2011,Bosnia and Herzegovina,Portugal,0,0,UEFA Euro qualification,Zenica,Bosnia and Herzegovina,False,0,0,Draw
29516,31599,33593,2011,Burkina Faso,Mali,1,1,Friendly,Saint-Leu-la-Forêt,France,True,2,0,Draw
29517,31600,33594,2011,Cameroon,Sudan,3,1,Friendly,Marrakech,Morocco,True,4,2,Cameroon
29518,31601,33595,2011,Chad,Tanzania,1,2,FIFA World Cup qualification,N'Djamena,Chad,False,3,-1,Tanzania
29519,31602,33596,2011,Colombia,Venezuela,1,1,FIFA World Cup qualification,Barranquilla,Colombia,False,2,0,Draw
29520,31603,33597,2011,Comoros,Mozambique,0,1,FIFA World Cup qualification,Mitsamiouli,Comoros,False,1,-1,Mozambique
29521,31604,33598,2011,Cyprus,Scotland,1,2,Friendly,Larnaca,Cyprus,False,3,-1,Scotland
29522,31605,33599,2011,Czech Republic,Montenegro,2,0,UEFA Euro qualification,Prague,Czech Republic,False,2,2,Czech Republic
29523,31606,33600,2011,Denmark,Sweden,2,0,Friendly,Copenhagen,Denmark,False,2,2,Denmark
29524,31607,33601,2011,Djibouti,Namibia,0,4,FIFA World Cup qualification,Djibouti,Djibouti,False,4,-4,Namibia
29525,31608,33602,2011,Dominican Republic,Cayman Islands,4,0,FIFA World Cup qualification,San Cristóbal,Dominican Republic,False,4,4,Dominican Republic
29526,31609,33603,2011,Equatorial Guinea,Madagascar,2,0,FIFA World Cup qualification,Malabo,Equatorial Guinea,False,2,2,Equatorial Guinea
29527,31610,33604,2011,Eritrea,Rwanda,1,1,FIFA World Cup qualification,Asmara,Eritrea,False,2,0,Draw
29528,31611,33605,2011,Estonia,Republic of Ireland,0,4,UEFA Euro qualification,Tallinn,Estonia,False,4,-4,Republic of Ireland
29529,31612,33606,2011,France,United States,1,0,Friendly,Saint-Denis,France,False,1,1,France
29530,31613,33607,2011,Georgia,Moldova,2,0,Friendly,Tbilisi,Georgia,False,2,2,Georgia
29531,31614,33608,2011,Greece,Russia,1,1,Friendly,Piraeus,Greece,False,2,0,Draw
29532,31615,33609,2011,Guatemala,Grenada,3,0,FIFA World Cup qualification,Guatemala,Guatemala,False,3,3,Guatemala
29533,31616,33610,2011,Guinea-Bissau,Togo,1,1,FIFA World Cup qualification,Bissau,Guinea-Bissau,False,2,0,Draw
29534,31617,33611,2011,Guyana,Trinidad and Tobago,2,1,FIFA World Cup qualification,Providence,Guyana,False,3,1,Guyana
29535,31618,33612,2011,Hungary,Liechtenstein,5,0,Friendly,Budapest,Hungary,False,5,5,Hungary
29536,31620,33614,2011,Jordan,Singapore,2,0,FIFA World Cup qualification,Amman,Jordan,False,2,2,Jordan
29537,31621,33615,2011,Kuwait,Lebanon,0,1,FIFA World Cup qualification,Kuwait City,Kuwait,False,1,-1,Lebanon
29538,31622,33616,2011,Lesotho,Burundi,1,0,FIFA World Cup qualification,Maseru,Lesotho,False,1,1,Lesotho
29539,31623,33617,2011,Mexico,Serbia,2,0,Friendly,Querétaro,Mexico,False,2,2,Mexico
29540,31624,33618,2011,Morocco,Uganda,0,1,Friendly,Marrakech,Morocco,False,1,-1,Uganda
29541,31625,33619,2011,Netherlands,Switzerland,0,0,Friendly,Amsterdam,Netherlands,False,0,0,Draw
29542,31626,33620,2011,Nicaragua,Dominica,1,0,FIFA World Cup qualification,Managua,Nicaragua,False,1,1,Nicaragua
29543,31627,33621,2011,Oman,Australia,1,0,FIFA World Cup qualification,Muscat,Oman,False,1,1,Oman
29544,31628,33622,2011,Panama,Costa Rica,2,0,Friendly,Panama City,Panama,False,2,2,Panama
29545,31629,33623,2011,Paraguay,Ecuador,2,1,FIFA World Cup qualification,Asunción,Paraguay,False,3,1,Paraguay
29546,31630,33624,2011,Poland,Italy,0,2,Friendly,Wrocław,Poland,False,2,-2,Italy
29547,31631,33625,2011,Puerto Rico,Saint Lucia,4,0,FIFA World Cup qualification,Bayamón,Puerto Rico,False,4,4,Puerto Rico
29548,31632,33626,2011,Qatar,Indonesia,4,0,FIFA World Cup qualification,Doha,Qatar,False,4,4,Qatar
29549,31633,33627,2011,São Tomé and Príncipe,Congo,0,5,FIFA World Cup qualification,São Tomé,São Tomé and Príncipe,False,5,-5,Congo
29550,31634,33628,2011,Saudi Arabia,Thailand,3,0,FIFA World Cup qualification,Riyadh,Saudi Arabia,False,3,3,Saudi Arabia
29551,31635,33629,2011,Seychelles,Kenya,0,3,FIFA World Cup qualification,Victoria,Seychelles,False,3,-3,Kenya
29552,31636,33630,2011,Saint Kitts and Nevis,Canada,0,0,FIFA World Cup qualification,Basseterre,Saint Kitts and Nevis,False,0,0,Draw
29553,31637,33631,2011,Suriname,El Salvador,1,3,FIFA World Cup qualification,Paramaribo,Suriname,False,4,-2,El Salvador
29554,31638,33632,2011,Eswatini,DR Congo,1,3,FIFA World Cup qualification,Lobamba,Eswatini,False,4,-2,DR Congo
29555,31639,33633,2011,Tajikistan,Japan,0,4,FIFA World Cup qualification,Dushanbe,Tajikistan,False,4,-4,Japan
29556,31640,33634,2011,Turkey,Croatia,0,3,UEFA Euro qualification,Istanbul,Turkey,False,3,-3,Croatia
29557,31641,33635,2011,Ukraine,Germany,3,3,Friendly,Kyïv,Ukraine,False,6,0,Draw
29558,31643,33637,2011,Uruguay,Chile,4,0,FIFA World Cup qualification,Montevideo,Uruguay,False,4,4,Uruguay
29559,31645,33639,2011,U.S. Virgin Islands,Curaçao,0,3,FIFA World Cup qualification,Frederiksted,U.S. Virgin Islands,False,3,-3,Curaçao
29560,31646,33640,2011,Algeria,Tunisia,1,0,Friendly,Algiers,Algeria,False,1,1,Algeria
29561,31647,33641,2011,England,Spain,1,0,Friendly,London,England,False,1,1,England
29562,31648,33642,2011,Nigeria,Botswana,0,0,Friendly,Abuja,Nigeria,False,0,0,Draw
29563,31649,33643,2011,Somalia,Ethiopia,0,0,FIFA World Cup qualification,Djibouti,Djibouti,True,0,0,Draw
29564,31650,33644,2011,South Africa,Ivory Coast,1,1,Friendly,Port Elizabeth,South Africa,False,2,0,Draw
29565,31651,33645,2011,Wales,Norway,4,1,Friendly,Cardiff,Wales,False,5,3,Wales
29566,31652,33646,2011,India,Malaysia,1,1,Friendly,Guwahati,India,False,2,0,Draw
29567,31653,33647,2011,Morocco,Cameroon,1,1,Friendly,Marrakech,Morocco,False,2,0,Draw
29568,31654,33648,2011,Sudan,Uganda,0,0,Friendly,Marrakech,Morocco,True,0,0,Draw
29569,31655,33649,2011,Bermuda,Barbados,2,1,FIFA World Cup qualification,Hamilton,Bermuda,False,3,1,Bermuda
29570,31656,33650,2011,Brazil,Egypt,2,0,Friendly,al-Rayyan,Qatar,True,2,2,Brazil
29571,31657,33651,2011,Cayman Islands,Dominican Republic,1,1,FIFA World Cup qualification,Georgetown,Cayman Islands,False,2,0,Draw
29572,31658,33652,2011,Honduras,Serbia,2,0,Friendly,San Pedro Sula,Honduras,False,2,2,Honduras
29573,31659,33653,2011,Puerto Rico,Saint Lucia,3,0,FIFA World Cup qualification,Mayagüez,Puerto Rico,False,3,3,Puerto Rico
29574,31660,33654,2011,Belarus,Libya,1,1,Friendly,Dubai,United Arab Emirates,True,2,0,Draw
29575,31661,33655,2011,Burundi,Lesotho,2,2,FIFA World Cup qualification,Bujumbura,Burundi,False,4,0,Draw
29576,31662,33656,2011,Canada,Saint Kitts and Nevis,4,0,FIFA World Cup qualification,Toronto,Canada,False,4,4,Canada
29577,31663,33657,2011,Chile,Paraguay,2,0,FIFA World Cup qualification,Santiago,Chile,False,2,2,Chile
29578,31664,33658,2011,Colombia,Argentina,1,2,FIFA World Cup qualification,Barranquilla,Colombia,False,3,-1,Argentina
29579,31665,33659,2011,Congo,São Tomé and Príncipe,1,1,FIFA World Cup qualification,Pointe-Noire,Congo,False,2,0,Draw
29580,31666,33660,2011,DR Congo,Eswatini,5,1,FIFA World Cup qualification,Kinshasa,DR Congo,False,6,4,DR Congo
29581,31667,33661,2011,Costa Rica,Spain,2,2,Friendly,San José,Costa Rica,False,4,0,Draw
29582,31668,33662,2011,Croatia,Turkey,0,0,UEFA Euro qualification,Zagreb,Croatia,False,0,0,Draw
29583,31669,33663,2011,Curaçao,U.S. Virgin Islands,6,1,FIFA World Cup qualification,Willemstad,Curaçao,False,7,5,Curaçao
29584,31670,33664,2011,Denmark,Finland,2,1,Friendly,Esbjerg,Denmark,False,3,1,Denmark
29585,31671,33665,2011,Ecuador,Peru,2,0,FIFA World Cup qualification,Quito,Ecuador,False,2,2,Ecuador
29586,31672,33666,2011,El Salvador,Suriname,4,0,FIFA World Cup qualification,San Salvador,El Salvador,False,4,4,El Salvador
29587,31673,33667,2011,England,Sweden,1,0,Friendly,London,England,False,1,1,England
29588,31674,33668,2011,France,Belgium,0,0,Friendly,Saint-Denis,France,False,0,0,Draw
29589,31675,33669,2011,Germany,Netherlands,3,0,Friendly,Hamburg,Germany,False,3,3,Germany
29590,31676,33670,2011,Ghana,Gabon,2,1,Friendly,Saint-Leu-la-Forêt,France,True,3,1,Ghana
29591,31677,33671,2011,Greece,Romania,1,3,Friendly,Altach,Austria,True,4,-2,Romania
29592,31678,33672,2011,Grenada,Guatemala,1,4,FIFA World Cup qualification,St. George's,Grenada,False,5,-3,Guatemala
29593,31679,33673,2011,Guinea,Burkina Faso,1,1,Friendly,Viry-Châtillon,France,True,2,0,Draw
29594,31680,33674,2011,Haiti,Antigua and Barbuda,2,1,FIFA World Cup qualification,Port-au-Prince,Haiti,False,3,1,Haiti
29595,31681,33675,2011,Indonesia,Iran,1,4,FIFA World Cup qualification,Jakarta,Indonesia,False,5,-3,Iran
29596,31682,33676,2011,Republic of Ireland,Estonia,1,1,UEFA Euro qualification,Dublin,Republic of Ireland,False,2,0,Draw
29597,31683,33677,2011,Italy,Uruguay,0,1,Friendly,Rome,Italy,False,1,-1,Uruguay
29598,31684,33678,2011,Jordan,Iraq,1,3,FIFA World Cup qualification,Amman,Jordan,False,4,-2,Iraq
29599,31685,33679,2011,Kenya,Seychelles,4,0,FIFA World Cup qualification,Nairobi,Kenya,False,4,4,Kenya
29600,31686,33681,2011,Kuwait,United Arab Emirates,2,1,FIFA World Cup qualification,Kuwait City,Kuwait,False,3,1,Kuwait
29601,31688,33683,2011,Luxembourg,Switzerland,0,1,Friendly,Luxembourg,Luxembourg,False,1,-1,Switzerland
29602,31689,33685,2011,Madagascar,Equatorial Guinea,2,1,FIFA World Cup qualification,Antananarivo,Madagascar,False,3,1,Madagascar
29603,31690,33686,2011,Montenegro,Czech Republic,0,1,UEFA Euro qualification,Podgorica,Montenegro,False,1,-1,Czech Republic
29604,31691,33687,2011,Mozambique,Comoros,4,1,FIFA World Cup qualification,Maputo,Mozambique,False,5,3,Mozambique
29605,31692,33688,2011,Namibia,Djibouti,4,0,FIFA World Cup qualification,Windhoek,Namibia,False,4,4,Namibia
29606,31693,33689,2011,Niger,Botswana,1,1,Friendly,Niamey,Niger,False,2,0,Draw
29607,31694,33690,2011,Nigeria,Zambia,2,0,Friendly,Kaduna,Nigeria,False,2,2,Nigeria
29608,31695,33691,2011,Panama,Dominica,3,0,FIFA World Cup qualification,Panama City,Panama,False,3,3,Panama
29609,31696,33692,2011,Poland,Hungary,2,1,Friendly,Poznań,Poland,False,3,1,Poland
29610,31697,33693,2011,Portugal,Bosnia and Herzegovina,6,2,UEFA Euro qualification,Lisbon,Portugal,False,8,4,Portugal
29611,31698,33694,2011,Qatar,Bahrain,0,0,FIFA World Cup qualification,Doha,Qatar,False,0,0,Draw
29612,31699,33695,2011,Rwanda,Eritrea,3,1,FIFA World Cup qualification,Kigali,Rwanda,False,4,2,Rwanda
29613,31700,33696,2011,Saudi Arabia,Oman,0,0,FIFA World Cup qualification,Riyadh,Saudi Arabia,False,0,0,Draw
29614,31702,33698,2011,Slovenia,United States,2,3,Friendly,Ljubljana,Slovenia,False,5,-1,United States
29615,31703,33699,2011,Tanzania,Chad,0,1,FIFA World Cup qualification,Dar es Salaam,Tanzania,False,1,-1,Chad
29616,31704,33700,2011,Thailand,Australia,0,1,FIFA World Cup qualification,Bangkok,Thailand,False,1,-1,Australia
29617,31705,33701,2011,Togo,Guinea-Bissau,1,0,FIFA World Cup qualification,Lomé,Togo,False,1,1,Togo
29618,31706,33702,2011,Trinidad and Tobago,Guyana,2,0,FIFA World Cup qualification,Port of Spain,Trinidad and Tobago,False,2,2,Trinidad and Tobago
29619,31707,33703,2011,Ukraine,Austria,2,1,Friendly,L'viv,Ukraine,False,3,1,Ukraine
29620,31708,33704,2011,Uzbekistan,Tajikistan,3,0,FIFA World Cup qualification,Tashkent,Uzbekistan,False,3,3,Uzbekistan
29621,31709,33705,2011,Venezuela,Bolivia,1,0,FIFA World Cup qualification,San Cristóbal,Venezuela,False,1,1,Venezuela
29622,31710,33706,2011,Zimbabwe,South Africa,2,1,Friendly,Harare,Zimbabwe,False,3,1,Zimbabwe
29623,31711,33707,2011,Ethiopia,Somalia,5,0,FIFA World Cup qualification,Addis Ababa,Ethiopia,False,5,5,Ethiopia
29624,31712,33708,2011,India,Malaysia,3,2,Friendly,Calcutta,India,False,5,1,India
29625,31713,33709,2011,American Samoa,Tonga,2,1,Oceania Nations Cup qualification,Apia,Samoa,True,3,1,American Samoa
29626,31714,33710,2011,Maldives,Seychelles,3,0,Friendly,Malé,Maldives,False,3,3,Maldives
29627,31715,33711,2011,Samoa,Cook Islands,3,2,Oceania Nations Cup qualification,Apia,Samoa,False,5,1,Samoa
29628,31716,33712,2011,American Samoa,Cook Islands,1,1,Oceania Nations Cup qualification,Apia,Samoa,True,2,0,Draw
29629,31717,33713,2011,Maldives,Seychelles,2,1,Friendly,Malé,Maldives,False,3,1,Maldives
29630,31718,33714,2011,Samoa,Tonga,1,1,Oceania Nations Cup qualification,Apia,Samoa,False,2,0,Draw
29631,31719,33715,2011,Burundi,Somalia,4,1,CECAFA Cup,Dar es Salaam,Tanzania,True,5,3,Burundi
29632,31721,33717,2011,Samoa,American Samoa,1,0,Oceania Nations Cup qualification,Apia,Samoa,False,1,1,Samoa
29633,31722,33718,2011,Tanzania,Rwanda,0,1,CECAFA Cup,Dar es Salaam,Tanzania,False,1,-1,Rwanda
29634,31723,33719,2011,Tonga,Cook Islands,2,1,Oceania Nations Cup qualification,Apia,Samoa,True,3,1,Tonga
29635,31724,33721,2011,Zimbabwe,Djibouti,2,0,CECAFA Cup,Dar es Salaam,Tanzania,True,2,2,Zimbabwe
29636,31725,33722,2011,Kenya,Malawi,0,2,CECAFA Cup,Dar es Salaam,Tanzania,True,2,-2,Malawi
29637,31726,33723,2011,Somalia,Uganda,0,4,CECAFA Cup,Chamazi,Tanzania,True,4,-4,Uganda
29638,31727,33724,2011,Sudan,Ethiopia,1,1,CECAFA Cup,Dar es Salaam,Tanzania,True,2,0,Draw
29639,31728,33725,2011,India,Zambia,0,5,Friendly,Margao,India,False,5,-5,Zambia
29640,31729,33726,2011,Rwanda,Zimbabwe,2,0,CECAFA Cup,Dar es Salaam,Tanzania,True,2,2,Rwanda
29641,31730,33727,2011,Tanzania,Djibouti,3,0,CECAFA Cup,Dar es Salaam,Tanzania,False,3,3,Tanzania
29642,31731,33728,2011,Ethiopia,Kenya,0,2,CECAFA Cup,Dar es Salaam,Tanzania,True,2,-2,Kenya
29643,31732,33729,2011,Malawi,Sudan,0,0,CECAFA Cup,Dar es Salaam,Tanzania,True,0,0,Draw
29644,31733,33730,2011,Burundi,Uganda,1,0,CECAFA Cup,Dar es Salaam,Tanzania,True,1,1,Burundi
29645,31735,33732,2011,Bangladesh,Pakistan,0,0,SAFF Cup,New Delhi,India,True,0,0,Draw
29646,31736,33733,2011,Curaçao,Bonaire,1,3,ABCS Tournament,Paramaribo,Suriname,True,4,-2,Bonaire
29647,31737,33734,2011,Ethiopia,Malawi,1,1,CECAFA Cup,Dar es Salaam,Tanzania,True,2,0,Draw
29648,31738,33735,2011,Maldives,Nepal,1,1,SAFF Cup,New Delhi,India,True,2,0,Draw
29649,31739,33736,2011,Rwanda,Djibouti,5,2,CECAFA Cup,Dar es Salaam,Tanzania,True,7,3,Rwanda
29650,31740,33737,2011,Suriname,Aruba,0,0,ABCS Tournament,Paramaribo,Suriname,False,0,0,Draw
29651,31741,33738,2011,India,Afghanistan,1,1,SAFF Cup,New Delhi,India,False,2,0,Draw
29652,31742,33739,2011,Kenya,Sudan,0,1,CECAFA Cup,Dar es Salaam,Tanzania,True,1,-1,Sudan
29653,31743,33740,2011,Sri Lanka,Bhutan,3,0,SAFF Cup,New Delhi,India,True,3,3,Sri Lanka
29654,31744,33741,2011,Tanzania,Zimbabwe,1,2,CECAFA Cup,Dar es Salaam,Tanzania,False,3,-1,Zimbabwe
29655,31745,33742,2011,Bangladesh,Nepal,0,1,SAFF Cup,New Delhi,India,True,1,-1,Nepal
29656,31746,33743,2011,Bonaire,Aruba,2,2,ABCS Tournament,Paramaribo,Suriname,True,4,0,Draw
29657,31747,33744,2011,Maldives,Pakistan,0,0,SAFF Cup,New Delhi,India,True,0,0,Draw
29658,31748,33745,2011,Suriname,Curaçao,2,0,ABCS Tournament,Paramaribo,Suriname,False,2,2,Suriname
29659,31749,33746,2011,Burundi,Sudan,0,2,CECAFA Cup,Dar es Salaam,Tanzania,True,2,-2,Sudan
29660,31750,33747,2011,India,Bhutan,5,0,SAFF Cup,New Delhi,India,False,5,5,India
29661,31752,33749,2011,Sri Lanka,Afghanistan,1,3,SAFF Cup,New Delhi,India,True,4,-2,Afghanistan
29662,31753,33750,2011,Bahrain,Palestine,0,1,Friendly,Arad,Bahrain,False,1,-1,Palestine
29663,31754,33751,2011,Maldives,Bangladesh,3,1,SAFF Cup,New Delhi,India,True,4,2,Maldives
29664,31755,33752,2011,Pakistan,Nepal,1,1,SAFF Cup,New Delhi,India,True,2,0,Draw
29665,31756,33753,2011,Tanzania,Malawi,1,0,CECAFA Cup,Dar es Salaam,Tanzania,False,1,1,Tanzania
29666,31757,33754,2011,Uganda,Zimbabwe,1,0,CECAFA Cup,Dar es Salaam,Tanzania,True,1,1,Uganda
29667,31758,33755,2011,Bhutan,Afghanistan,1,8,SAFF Cup,New Delhi,India,True,9,-7,Afghanistan
29668,31759,33756,2011,India,Sri Lanka,3,0,SAFF Cup,New Delhi,India,False,3,3,India
29669,31760,33757,2011,Sudan,Rwanda,1,2,CECAFA Cup,Dar es Salaam,Tanzania,True,3,-1,Rwanda
29670,31761,33758,2011,Tanzania,Uganda,1,3,CECAFA Cup,Dar es Salaam,Tanzania,False,4,-2,Uganda
29671,31762,33759,2011,Afghanistan,Nepal,1,0,SAFF Cup,New Delhi,India,True,1,1,Afghanistan
29672,31763,33760,2011,India,Maldives,3,1,SAFF Cup,New Delhi,India,False,4,2,India
29673,31764,33761,2011,Rwanda,Uganda,2,2,CECAFA Cup,Dar es Salaam,Tanzania,True,4,0,Draw
29674,31765,33762,2011,Tanzania,Sudan,0,1,CECAFA Cup,Dar es Salaam,Tanzania,False,1,-1,Sudan
29675,31766,33763,2011,Cuba,Costa Rica,1,1,Friendly,Havana,Cuba,False,2,0,Draw
29676,31767,33764,2011,India,Afghanistan,4,0,SAFF Cup,New Delhi,India,False,4,4,India
29677,31768,33765,2011,Angola,Cameroon,1,1,Friendly,Cabinda,Angola,False,2,0,Draw
29678,31769,33766,2011,Angola,Zambia,1,0,Friendly,Dundo,Angola,False,1,1,Angola
29679,31770,33767,2011,Chile,Paraguay,3,2,Friendly,La Serena,Chile,False,5,1,Chile
29680,31771,33768,2011,Angola,Namibia,0,0,Friendly,Lubango,Angola,False,0,0,Draw
29681,31772,33769,2011,Venezuela,Costa Rica,0,2,Friendly,Barquisimeto,Venezuela,False,2,-2,Costa Rica
29682,31773,33772,2012,Equatorial Guinea,South Africa,0,0,Friendly,Bata,Equatorial Guinea,False,0,0,Draw
29683,31774,33773,2012,Botswana,Zimbabwe,0,0,Friendly,Gaborone,Botswana,False,0,0,Draw
29684,31775,33774,2012,Gabon,Burkina Faso,0,0,Friendly,Bitam,Gabon,False,0,0,Draw
29685,31776,33775,2012,Tunisia,Sudan,3,0,Friendly,Sharjah,United Arab Emirates,True,3,3,Tunisia
29686,31777,33776,2012,Nigeria,Angola,0,0,Friendly,Abuja,Nigeria,False,0,0,Draw
29687,31778,33777,2012,Senegal,Sudan,1,0,Friendly,Dakar,Senegal,False,1,1,Senegal
29688,31779,33778,2012,Tunisia,Ivory Coast,0,2,Friendly,Abu Dhabi,United Arab Emirates,True,2,-2,Ivory Coast
29689,31780,33779,2012,Angola,Sierra Leone,3,1,Friendly,Cabinda,Angola,False,4,2,Angola
29690,31781,33780,2012,Zambia,Namibia,0,0,Friendly,Johannesburg,South Africa,True,0,0,Draw
29691,31782,33781,2012,Oman,DR Congo,2,2,Friendly,Muscat,Oman,False,4,0,Draw
29692,31783,33782,2012,São Tomé and Príncipe,Lesotho,1,0,African Cup of Nations qualification,São Tomé,São Tomé and Príncipe,False,1,1,São Tomé and Príncipe
29693,31784,33783,2012,Gabon,Sudan,0,0,Friendly,Franceville,Gabon,False,0,0,Draw
29694,31785,33784,2012,Ivory Coast,Libya,1,0,Friendly,Abu Dhabi,United Arab Emirates,True,1,1,Ivory Coast
29695,31786,33785,2012,Kuwait,Uzbekistan,1,0,Friendly,Kuwait City,Kuwait,False,1,1,Kuwait
29696,31787,33786,2012,Bahrain,Sweden,0,2,Friendly,Doha,Qatar,True,2,-2,Sweden
29697,31788,33787,2012,Thailand,Norway,0,1,King's Cup,Bangkok,Thailand,False,1,-1,Norway
29698,31789,33788,2012,Equatorial Guinea,Libya,1,0,African Cup of Nations,Bata,Equatorial Guinea,False,1,1,Equatorial Guinea
29699,31790,33789,2012,Senegal,Zambia,1,2,African Cup of Nations,Bata,Equatorial Guinea,True,3,-1,Zambia
29700,31791,33790,2012,United States,Venezuela,1,0,Friendly,Glendale,United States,False,1,1,United States
29701,31792,33791,2012,Burkina Faso,Angola,1,2,African Cup of Nations,Malabo,Equatorial Guinea,True,3,-1,Angola
29702,31793,33792,2012,Ivory Coast,Sudan,1,0,African Cup of Nations,Malabo,Equatorial Guinea,True,1,1,Ivory Coast
29703,31794,33793,2012,Lebanon,Iraq,1,0,Friendly,Beirut,Lebanon,False,1,1,Lebanon
29704,31795,33794,2012,Lesotho,São Tomé and Príncipe,0,0,African Cup of Nations qualification,Maseru,Lesotho,False,0,0,Draw
29705,31796,33795,2012,Trinidad and Tobago,Finland,2,3,Friendly,Port of Spain,Trinidad and Tobago,False,5,-1,Finland
29706,31797,33796,2012,Gabon,Niger,2,0,African Cup of Nations,Libreville,Gabon,False,2,2,Gabon
29707,31798,33797,2012,Morocco,Tunisia,1,2,African Cup of Nations,Libreville,Gabon,True,3,-1,Tunisia
29708,31799,33798,2012,Ghana,Botswana,1,0,African Cup of Nations,Franceville,Gabon,True,1,1,Ghana
29709,31800,33799,2012,Mali,Guinea,1,0,African Cup of Nations,Franceville,Gabon,True,1,1,Mali
29710,31801,33800,2012,Equatorial Guinea,Senegal,2,1,African Cup of Nations,Bata,Equatorial Guinea,False,3,1,Equatorial Guinea
29711,31802,33801,2012,Libya,Zambia,2,2,African Cup of Nations,Bata,Equatorial Guinea,True,4,0,Draw
29712,31803,33802,2012,Mexico,Venezuela,3,1,Friendly,Houston,United States,True,4,2,Mexico
29713,31804,33803,2012,Panama,United States,0,1,Friendly,Panama City,Panama,False,1,-1,United States
29714,31805,33804,2012,Ivory Coast,Burkina Faso,2,0,African Cup of Nations,Malabo,Equatorial Guinea,True,2,2,Ivory Coast
29715,31806,33805,2012,Sudan,Angola,2,2,African Cup of Nations,Malabo,Equatorial Guinea,True,4,0,Draw
29716,31807,33806,2012,Gabon,Morocco,3,2,African Cup of Nations,Libreville,Gabon,False,5,1,Gabon
29717,31808,33807,2012,Niger,Tunisia,1,2,African Cup of Nations,Libreville,Gabon,True,3,-1,Tunisia
29718,31809,33808,2012,Romania,Turkmenistan,4,0,Friendly,Belek,Turkey,True,4,4,Romania
29719,31810,33809,2012,Botswana,Guinea,1,6,African Cup of Nations,Franceville,Gabon,True,7,-5,Guinea
29720,31811,33810,2012,Ghana,Mali,2,0,African Cup of Nations,Franceville,Gabon,True,2,2,Ghana
29721,31812,33811,2012,Equatorial Guinea,Zambia,0,1,African Cup of Nations,Malabo,Equatorial Guinea,False,1,-1,Zambia
29722,31813,33812,2012,Libya,Senegal,2,1,African Cup of Nations,Bata,Equatorial Guinea,True,3,1,Libya
29723,31814,33813,2012,United Arab Emirates,Uzbekistan,1,0,Friendly,Dubai,United Arab Emirates,False,1,1,United Arab Emirates
29724,31815,33814,2012,Ivory Coast,Angola,2,0,African Cup of Nations,Malabo,Equatorial Guinea,True,2,2,Ivory Coast
29725,31816,33815,2012,Sudan,Burkina Faso,2,1,African Cup of Nations,Bata,Equatorial Guinea,True,3,1,Sudan
29726,31817,33816,2012,Gabon,Tunisia,1,0,African Cup of Nations,Franceville,Gabon,False,1,1,Gabon
29727,31818,33817,2012,Niger,Morocco,0,1,African Cup of Nations,Libreville,Gabon,True,1,-1,Morocco
29728,31819,33818,2012,Botswana,Mali,1,2,African Cup of Nations,Libreville,Gabon,True,3,-1,Mali
29729,31820,33819,2012,Ghana,Guinea,1,1,African Cup of Nations,Franceville,Gabon,True,2,0,Draw
29730,31821,33820,2012,Equatorial Guinea,Ivory Coast,0,3,African Cup of Nations,Malabo,Equatorial Guinea,False,3,-3,Ivory Coast
29731,31822,33821,2012,Zambia,Sudan,3,0,African Cup of Nations,Bata,Equatorial Guinea,True,3,3,Zambia
29732,31823,33822,2012,Gabon,Mali,1,1,African Cup of Nations,Libreville,Gabon,False,2,0,Draw
29733,31824,33823,2012,Ghana,Tunisia,2,1,African Cup of Nations,Franceville,Gabon,True,3,1,Ghana
29734,31825,33824,2012,Mali,Ivory Coast,0,1,African Cup of Nations,Libreville,Gabon,True,1,-1,Ivory Coast
29735,31826,33825,2012,Zambia,Ghana,1,0,African Cup of Nations,Bata,Equatorial Guinea,True,1,1,Zambia
29736,31827,33826,2012,Ghana,Mali,0,2,African Cup of Nations,Malabo,Equatorial Guinea,True,2,-2,Mali
29737,31828,33827,2012,Zambia,Ivory Coast,0,0,African Cup of Nations,Libreville,Gabon,True,0,0,Draw
29738,31829,33828,2012,Liberia,Nigeria,0,2,Friendly,Monrovia,Liberia,False,2,-2,Nigeria
29739,31830,33829,2012,Paraguay,Chile,2,0,Friendly,Luque,Paraguay,False,2,2,Paraguay
29740,31831,33832,2012,Grenada,Guyana,1,2,Friendly,St. George's,Grenada,False,3,-1,Guyana
29741,31832,33833,2012,Jamaica,Cuba,1,0,Friendly,Kingston,Jamaica,False,1,1,Jamaica
29742,31833,33834,2012,Paraguay,Guatemala,2,1,Friendly,Luque,Paraguay,False,3,1,Paraguay
29743,31834,33835,2012,Iran,Jordan,2,2,Friendly,Dubai,United Arab Emirates,True,4,0,Draw
29744,31835,33836,2012,Oman,India,5,1,Friendly,Seeb,Oman,False,6,4,Oman
29745,31836,33837,2012,Tanzania,DR Congo,0,0,Friendly,Dar es Salaam,Tanzania,False,0,0,Draw
29746,31837,33838,2012,Jamaica,Cuba,3,0,Friendly,Montego Bay,Jamaica,False,3,3,Jamaica
29747,31838,33839,2012,Japan,Iceland,3,1,Friendly,Osaka,Japan,False,4,2,Japan
29748,31839,33840,2012,Nicaragua,Puerto Rico,1,0,Friendly,Managua,Nicaragua,False,1,1,Nicaragua
29749,31840,33841,2012,Singapore,Azerbaijan,2,2,Friendly,Dubai,United Arab Emirates,True,4,0,Draw
29750,31841,33842,2012,Thailand,Maldives,3,0,Friendly,Chiang Mai,Thailand,False,3,3,Thailand
29751,31842,33843,2012,United Arab Emirates,Palestine,3,0,Friendly,Abu Dhabi,United Arab Emirates,False,3,3,United Arab Emirates
29752,31843,33845,2012,Nicaragua,Puerto Rico,4,1,Friendly,Managua,Nicaragua,False,5,3,Nicaragua
29753,31844,33846,2012,Egypt,Kenya,5,0,Friendly,Doha,Qatar,True,5,5,Egypt
29754,31845,33847,2012,India,Azerbaijan,0,3,Friendly,Dubai,United Arab Emirates,True,3,-3,Azerbaijan
29755,31846,33848,2012,Armenia,Serbia,0,2,Friendly,Limassol,Cyprus,True,2,-2,Serbia
29756,31847,33849,2012,Bosnia and Herzegovina,Brazil,1,2,Friendly,St. Gallen,Switzerland,True,3,-1,Brazil
29757,31848,33850,2012,Antigua and Barbuda,Trinidad and Tobago,0,4,Friendly,St. John's,Antigua and Barbuda,False,4,-4,Trinidad and Tobago
29758,31849,33851,2012,Armenia,Canada,3,1,Friendly,Limassol,Cyprus,True,4,2,Armenia
29759,31850,33852,2012,Australia,Saudi Arabia,4,2,FIFA World Cup qualification,Melbourne,Australia,False,6,2,Australia
29760,31851,33853,2012,Austria,Finland,3,1,Friendly,Klagenfurt,Austria,False,4,2,Austria
29761,31852,33854,2012,Bahrain,Indonesia,10,0,FIFA World Cup qualification,Riffa,Bahrain,False,10,10,Bahrain
29762,31853,33855,2012,Bolivia,Cuba,1,0,Friendly,Cochabamba,Bolivia,False,1,1,Bolivia
29763,31854,33856,2012,Burundi,Zimbabwe,2,1,African Cup of Nations qualification,Bujumbura,Burundi,False,3,1,Burundi
29764,31855,33857,2012,Chad,Malawi,3,2,African Cup of Nations qualification,N'Djamena,Chad,False,5,1,Chad
29765,31856,33858,2012,Chile,Ghana,1,1,Friendly,Chester,United States,True,2,0,Draw
29766,31857,33860,2012,Congo,Uganda,3,1,African Cup of Nations qualification,Brazzaville,Congo,False,4,2,Congo
29767,31858,33861,2012,Croatia,Sweden,1,3,Friendly,Zagreb,Croatia,False,4,-2,Sweden
29768,31859,33862,2012,Cyprus,Serbia,0,0,Friendly,Larnaca,Cyprus,False,0,0,Draw
29769,31860,33863,2012,Denmark,Russia,0,2,Friendly,Copenhagen,Denmark,False,2,-2,Russia
29770,31861,33864,2012,Ecuador,Honduras,2,0,Friendly,Guayaquil,Ecuador,False,2,2,Ecuador
29771,31862,33865,2012,Egypt,Niger,1,0,Friendly,Doha,Qatar,True,1,1,Egypt
29772,31863,33866,2012,El Salvador,Estonia,0,2,Friendly,Los Angeles,United States,True,2,-2,Estonia
29773,31864,33867,2012,England,Netherlands,2,3,Friendly,London,England,False,5,-1,Netherlands
29774,31865,33868,2012,Ethiopia,Benin,0,0,African Cup of Nations qualification,Addis Ababa,Ethiopia,False,0,0,Draw
29775,31866,33869,2012,Gambia,Algeria,1,2,African Cup of Nations qualification,Bakau,Gambia,False,3,-1,Algeria
29776,31867,33870,2012,Georgia,Albania,2,1,Friendly,Tbilisi,Georgia,False,3,1,Georgia
29777,31868,33871,2012,Germany,France,1,2,Friendly,Bremen,Germany,False,3,-1,France
29778,31869,33872,2012,Greece,Belgium,1,1,Friendly,Heraklion,Greece,False,2,0,Draw
29779,31870,33873,2012,Guinea-Bissau,Cameroon,0,1,African Cup of Nations qualification,Bissau,Guinea-Bissau,False,1,-1,Cameroon
29780,31871,33874,2012,Guyana,Guatemala,0,2,Friendly,Providence,Guyana,False,2,-2,Guatemala
29781,31873,33876,2012,Hungary,Bulgaria,1,1,Friendly,Győr,Hungary,False,2,0,Draw
29782,31874,33877,2012,Iran,Qatar,2,2,FIFA World Cup qualification,Teheran,Iran,False,4,0,Draw
29783,31875,33878,2012,Iraq,Singapore,7,1,FIFA World Cup qualification,Doha,Qatar,True,8,6,Iraq
29784,31876,33879,2012,Republic of Ireland,Czech Republic,1,1,Friendly,Dublin,Republic of Ireland,False,2,0,Draw
29785,31877,33880,2012,Israel,Ukraine,2,3,Friendly,Petah Tikva,Israel,False,5,-1,Ukraine
29786,31878,33881,2012,Italy,United States,0,1,Friendly,Genoa,Italy,False,1,-1,United States
29787,31879,33882,2012,Ivory Coast,Guinea,0,0,Friendly,Abidjan,Ivory Coast,False,0,0,Draw
29788,31880,33883,2012,Japan,Uzbekistan,0,1,FIFA World Cup qualification,Toyota,Japan,False,1,-1,Uzbekistan
29789,31881,33884,2012,Kenya,Togo,2,1,African Cup of Nations qualification,Nairobi,Kenya,False,3,1,Kenya
29790,31882,33886,2012,Latvia,Kazakhstan,0,0,Friendly,Antalya,Turkey,True,0,0,Draw
29791,31883,33887,2012,Liberia,Namibia,1,0,African Cup of Nations qualification,Monrovia,Liberia,False,1,1,Liberia
29792,31886,33890,2012,Malta,Liechtenstein,2,1,Friendly,Attard,Malta,False,3,1,Malta
29793,31887,33891,2012,Mexico,Colombia,0,2,Friendly,Miami Gardens,United States,True,2,-2,Colombia
29794,31888,33892,2012,Moldova,Belarus,0,0,Friendly,Antalya,Turkey,True,0,0,Draw
29795,31889,33893,2012,Montenegro,Iceland,2,1,Friendly,Podgorica,Montenegro,False,3,1,Montenegro
29796,31890,33894,2012,Morocco,Burkina Faso,2,0,Friendly,Marrakech,Morocco,False,2,2,Morocco
29797,31891,33895,2012,New Zealand,Jamaica,2,3,Friendly,Auckland,New Zealand,False,5,-1,Jamaica
29798,31892,33896,2012,Northern Ireland,Norway,0,3,Friendly,Belfast,Northern Ireland,False,3,-3,Norway
29799,31893,33897,2012,Oman,Thailand,2,0,FIFA World Cup qualification,Muscat,Oman,False,2,2,Oman
29800,31894,33898,2012,Palestine,Azerbaijan,2,0,Friendly,Dubai,United Arab Emirates,True,2,2,Palestine
29801,31895,33899,2012,Paraguay,Panama,1,0,Friendly,Asunción,Paraguay,False,1,1,Paraguay
29802,31896,33900,2012,Philippines,Malaysia,1,1,Friendly,Manila,Philippines,False,2,0,Draw
29803,31897,33901,2012,Poland,Portugal,0,0,Friendly,Warsaw,Poland,False,0,0,Draw
29804,31898,33902,2012,Romania,Uruguay,1,1,Friendly,Bucharest,Romania,False,2,0,Draw
29805,31899,33903,2012,Rwanda,Nigeria,0,0,African Cup of Nations qualification,Kigali,Rwanda,False,0,0,Draw
29806,31900,33904,2012,São Tomé and Príncipe,Sierra Leone,2,1,African Cup of Nations qualification,São Tomé,São Tomé and Príncipe,False,3,1,São Tomé and Príncipe
29807,31901,33905,2012,Seychelles,DR Congo,0,4,African Cup of Nations qualification,Victoria,Seychelles,False,4,-4,DR Congo
29808,31902,33906,2012,Slovenia,Scotland,1,1,Friendly,Koper,Slovenia,False,2,0,Draw
29809,31903,33907,2012,South Africa,Senegal,0,0,Friendly,Durban,South Africa,False,0,0,Draw
29810,31904,33908,2012,Spain,Venezuela,5,0,Friendly,Málaga,Spain,False,5,5,Spain
29811,31905,33909,2012,Switzerland,Argentina,1,3,Friendly,Berne,Switzerland,False,4,-2,Argentina
29812,31907,33911,2012,Tanzania,Mozambique,1,1,African Cup of Nations qualification,Dar es Salaam,Tanzania,False,2,0,Draw
29813,31908,33912,2012,Tunisia,Peru,1,1,Friendly,Tunis,Tunisia,False,2,0,Draw
29814,31909,33913,2012,Turkey,Slovakia,1,2,Friendly,Bursa,Turkey,False,3,-1,Slovakia
29815,31910,33914,2012,United Arab Emirates,Lebanon,4,2,FIFA World Cup qualification,Abu Dhabi,United Arab Emirates,False,6,2,United Arab Emirates
29816,31911,33915,2012,Wales,Costa Rica,0,1,Friendly,Cardiff,Wales,False,1,-1,Costa Rica
29817,31912,33916,2012,Egypt,DR Congo,0,0,Friendly,Doha,Qatar,True,0,0,Draw
29818,31913,33917,2012,Martinique,Guadeloupe,1,2,Friendly,Le Lamentin,Martinique,False,3,-1,Guadeloupe
29819,31914,33918,2012,Saint Kitts and Nevis,Antigua and Barbuda,1,0,Friendly,Basseterre,Saint Kitts and Nevis,False,1,1,Saint Kitts and Nevis
29820,31915,33919,2012,Nepal,Palestine,0,2,AFC Challenge Cup,Kathmandu,Nepal,False,2,-2,Palestine
29821,31916,33920,2012,Turkmenistan,Maldives,3,1,AFC Challenge Cup,Kathmandu,Nepal,True,4,2,Turkmenistan
29822,31917,33921,2012,India,Tajikistan,0,2,AFC Challenge Cup,Kathmandu,Nepal,True,2,-2,Tajikistan
29823,31918,33923,2012,Nepal,Maldives,0,1,AFC Challenge Cup,Kathmandu,Nepal,False,1,-1,Maldives
29824,31919,33924,2012,Palestine,Turkmenistan,0,0,AFC Challenge Cup,Kathmandu,Nepal,True,0,0,Draw
29825,31920,33925,2012,Philippines,India,2,0,AFC Challenge Cup,Kathmandu,Nepal,True,2,2,Philippines
29826,31922,33927,2012,Maldives,Palestine,0,2,AFC Challenge Cup,Kathmandu,Nepal,True,2,-2,Palestine
29827,31923,33928,2012,Nepal,Turkmenistan,0,3,AFC Challenge Cup,Kathmandu,Nepal,False,3,-3,Turkmenistan
29828,31924,33930,2012,Tajikistan,Philippines,1,2,AFC Challenge Cup,Kathmandu,Nepal,True,3,-1,Philippines
29829,31925,33932,2012,Turkmenistan,Philippines,2,1,AFC Challenge Cup,Kathmandu,Nepal,True,3,1,Turkmenistan
29830,31926,33933,2012,Philippines,Palestine,4,3,AFC Challenge Cup,Kathmandu,Nepal,True,7,1,Philippines
29831,31928,33935,2012,Chile,Peru,3,1,Copa del Pacífico,Arica,Chile,False,4,2,Chile
29832,31929,33936,2012,French Guiana,Guyana,1,0,Friendly,Cayenne,French Guiana,False,1,1,French Guiana
29833,31930,33937,2012,Jamaica,Costa Rica,0,0,Friendly,Kingston,Jamaica,False,0,0,Draw
29834,31931,33938,2012,French Guiana,Guyana,0,2,Friendly,Cayenne,French Guiana,False,2,-2,Guyana
29835,31932,33939,2012,Egypt,Uganda,2,1,Friendly,Omdurman,Sudan,True,3,1,Egypt
29836,31933,33940,2012,Egypt,Chad,4,0,Friendly,Omdurman,Sudan,True,4,4,Egypt
29837,31934,33941,2012,Guadeloupe,Martinique,0,1,Friendly,Les Abymes,Guadeloupe,False,1,-1,Martinique
29838,31935,33942,2012,Costa Rica,Honduras,1,1,Friendly,San José,Costa Rica,False,2,0,Draw
29839,31936,33943,2012,Peru,Chile,0,3,Copa del Pacífico,Tacna,Peru,False,3,-3,Chile
29840,31937,33944,2012,Egypt,Nigeria,3,2,Friendly,Dubai,United Arab Emirates,True,5,1,Egypt
29841,31938,33945,2012,Egypt,Mauritania,3,0,Friendly,Dubai,United Arab Emirates,True,3,3,Egypt
29842,31939,33946,2012,Egypt,Iraq,0,0,Friendly,Dubai,United Arab Emirates,True,0,0,Draw
29843,31940,33947,2012,Iran,Mauritania,2,0,Friendly,Teheran,Iran,False,2,2,Iran
29844,31941,33948,2012,Guatemala,Paraguay,0,1,Friendly,Guatemala,Guatemala,False,1,-1,Paraguay
29845,31942,33949,2012,Malaysia,Sri Lanka,6,0,Friendly,Kuala Lumpur,Malaysia,False,6,6,Malaysia
29846,31943,33950,2012,Iran,Mozambique,3,0,Friendly,Karaj,Iran,False,3,3,Iran
29847,31944,33951,2012,Martinique,Guyana,2,2,Friendly,Le Lamentin,Martinique,False,4,0,Draw
29848,31945,33952,2012,Guadeloupe,Guyana,1,2,Friendly,Les Abymes,Guadeloupe,False,3,-1,Guyana
29849,31946,33953,2012,Lebanon,Egypt,1,4,Friendly,Tripoli,Lebanon,False,5,-3,Egypt
29850,31947,33954,2012,Angola,Zambia,0,0,Friendly,Luanda,Angola,False,0,0,Draw
29851,31948,33955,2012,Jamaica,Guyana,1,0,Friendly,Montego Bay,Jamaica,False,1,1,Jamaica
29852,31949,33956,2012,Lebanon,Jordan,1,2,Friendly,Sidon,Lebanon,False,3,-1,Jordan
29853,31950,33957,2012,Egypt,Cameroon,2,1,Friendly,Omdurman,Sudan,True,3,1,Egypt
29854,31951,33958,2012,Panama,Guyana,2,0,Friendly,Panama City,Panama,False,2,2,Panama
29855,31952,33959,2012,Albania,Qatar,2,1,Friendly,Madrid,Spain,True,3,1,Albania
29856,31953,33960,2012,Egypt,Togo,3,0,Friendly,Omdurman,Sudan,True,3,3,Egypt
29857,31954,33961,2012,Latvia,Poland,0,1,Friendly,Klagenfurt,Austria,True,1,-1,Poland
29858,31955,33962,2012,Botswana,Lesotho,3,0,Friendly,Gaborone,Botswana,False,3,3,Botswana
29859,31956,33963,2012,El Salvador,New Zealand,2,2,Friendly,Houston,United States,True,4,0,Draw
29860,31957,33964,2012,Iraq,Sierra Leone,1,0,Friendly,Istanbul,Turkey,True,1,1,Iraq
29861,31958,33965,2012,Japan,Azerbaijan,2,0,Friendly,Shizuoka,Japan,False,2,2,Japan
29862,31959,33966,2012,Libya,Rwanda,2,0,Friendly,Tunis,Tunisia,True,2,2,Libya
29863,31960,33967,2012,Peru,Nigeria,1,0,Friendly,Lima,Peru,False,1,1,Peru
29864,31961,33968,2012,Venezuela,Moldova,4,0,Friendly,Puerto Ordaz,Venezuela,False,4,4,Venezuela
29865,31962,33969,2012,Georgia,Turkey,1,3,Friendly,Salzburg,Austria,True,4,-2,Turkey
29866,31963,33970,2012,Belgium,Montenegro,2,2,Friendly,Brussels,Belgium,False,4,0,Draw
29867,31964,33971,2012,Costa Rica,Guatemala,3,2,Friendly,San José,Costa Rica,False,5,1,Costa Rica
29868,31965,33972,2012,Croatia,Estonia,3,1,Friendly,Rijeka,Croatia,False,4,2,Croatia
29869,31966,33973,2012,Morocco,Senegal,0,1,Friendly,Marrakech,Morocco,False,1,-1,Senegal
29870,31967,33974,2012,Russia,Uruguay,1,1,Friendly,Moscow,Russia,False,2,0,Draw
29871,31968,33975,2012,Algeria,Niger,3,0,Friendly,Blida,Algeria,False,3,3,Algeria
29872,31969,33976,2012,Burkina Faso,Benin,2,2,Friendly,Ouagadougou,Burkina Faso,False,4,0,Draw
29873,31970,33977,2012,Czech Republic,Israel,2,1,Friendly,Graz,Austria,True,3,1,Czech Republic
29874,31971,33978,2012,Denmark,Brazil,1,3,Friendly,Hamburg,Germany,True,4,-2,Brazil
29875,31972,33979,2012,El Salvador,Moldova,2,0,Friendly,Dallas,United States,True,2,2,El Salvador
29876,31973,33980,2012,Finland,Turkey,3,2,Friendly,Salzburg,Austria,True,5,1,Finland
29877,31974,33981,2012,Greece,Slovenia,1,1,Friendly,Kufstein,Austria,True,2,0,Draw
29878,31975,33982,2012,Guinea,Cameroon,1,2,Friendly,Amanvillers,France,True,3,-1,Cameroon
29879,31976,33983,2012,Honduras,New Zealand,0,1,Friendly,Dallas,United States,True,1,-1,New Zealand
29880,31977,33984,2012,Republic of Ireland,Bosnia and Herzegovina,1,0,Friendly,Dublin,Republic of Ireland,False,1,1,Republic of Ireland
29881,31978,33985,2012,Jordan,Sierra Leone,4,0,Friendly,Amman,Jordan,False,4,4,Jordan
29882,31979,33986,2012,Mozambique,Namibia,0,0,Friendly,Würzburg,Germany,True,0,0,Draw
29883,31980,33987,2012,Netherlands,Bulgaria,1,2,Friendly,Amsterdam,Netherlands,False,3,-1,Bulgaria
29884,31981,33988,2012,Norway,England,0,1,Friendly,Oslo,Norway,False,1,-1,England
29885,31982,33989,2012,Poland,Slovakia,1,0,Friendly,Klagenfurt,Austria,True,1,1,Poland
29886,31984,33991,2012,Spain,Serbia,2,0,Friendly,St. Gallen,Switzerland,True,2,2,Spain
29887,31985,33992,2012,Switzerland,Germany,5,3,Friendly,Basel,Switzerland,False,8,2,Switzerland
29888,31986,33993,2012,Tanzania,Malawi,0,0,Friendly,Dar es Salaam,Tanzania,False,0,0,Draw
29889,31987,33994,2012,United States,Scotland,5,1,Friendly,Jacksonville,United States,False,6,4,United States
29890,31988,33995,2012,Albania,Iran,1,0,Friendly,Istanbul,Turkey,True,1,1,Albania
29891,31989,33996,2012,Chad,Libya,0,1,Friendly,Tunis,Tunisia,True,1,-1,Libya
29892,31990,33997,2012,France,Iceland,3,2,Friendly,Valenciennes,France,False,5,1,France
29893,31991,33998,2012,Jamaica,Panama,0,1,Friendly,Kingston,Jamaica,False,1,-1,Panama
29894,31992,33999,2012,Mexico,Wales,2,0,Friendly,East Rutherford,United States,True,2,2,Mexico
29895,31993,34000,2012,Oman,Lebanon,1,1,Friendly,Muscat,Oman,False,2,0,Draw
29896,31994,34001,2012,Tunisia,Rwanda,5,1,Friendly,Monastir,Tunisia,False,6,4,Tunisia
29897,31995,34002,2012,Iraq,Botswana,1,1,Friendly,Istanbul,Turkey,True,2,0,Draw
29898,31996,34003,2012,Qatar,Palestine,0,0,Friendly,Doha,Qatar,False,0,0,Draw
29899,31997,34004,2012,Ukraine,Estonia,4,0,Friendly,Kufstein,Austria,True,4,4,Ukraine
29900,31999,34006,2012,Bulgaria,Turkey,0,2,Friendly,Salzburg,Austria,True,2,-2,Turkey
29901,32000,34007,2012,Lithuania,Russia,0,0,Friendly,Nyon,Switzerland,True,0,0,Draw
29902,32001,34008,2012,Azerbaijan,Andorra,0,0,Friendly,Kelsterbach,Germany,True,0,0,Draw
29903,32002,34009,2012,Chad,Rwanda,1,1,Friendly,Port el-Kantaoui,Tunisia,True,2,0,Draw
29904,32003,34010,2012,Netherlands,Slovakia,2,0,Friendly,Rotterdam,Netherlands,False,2,2,Netherlands
29905,32005,34012,2012,Sweden,Iceland,3,2,Friendly,Gothenburg,Sweden,False,5,1,Sweden
29906,32006,34013,2012,Switzerland,Romania,0,1,Friendly,Lucerne,Switzerland,False,1,-1,Romania
29907,32007,34014,2012,United States,Brazil,1,4,Friendly,Washington,United States,False,5,-3,Brazil
29908,32008,34015,2012,Armenia,Greece,0,1,Friendly,Kufstein,Austria,True,1,-1,Greece
29909,32009,34016,2012,France,Serbia,2,0,Friendly,Reims,France,False,2,2,France
29910,32010,34017,2012,Germany,Israel,2,0,Friendly,Leipzig,Germany,False,2,2,Germany
29911,32011,34018,2012,Mexico,Bosnia and Herzegovina,2,1,Friendly,Chicago,United States,True,3,1,Mexico
29912,32012,34019,2012,Austria,Ukraine,3,2,Friendly,Innsbruck,Austria,False,5,1,Austria
29913,32013,34020,2012,Czech Republic,Hungary,1,2,Friendly,Prague,Czech Republic,False,3,-1,Hungary
29914,32014,34021,2012,Egypt,Mozambique,2,0,FIFA World Cup qualification,Alexandria,Egypt,False,2,2,Egypt
29915,32015,34022,2012,Estonia,Finland,1,2,Baltic Cup,Tartu,Estonia,False,3,-1,Finland
29916,32016,34023,2012,Ghana,Lesotho,7,0,FIFA World Cup qualification,Kumasi,Ghana,False,7,7,Ghana
29917,32017,34024,2012,Guatemala,Costa Rica,1,0,Friendly,Guatemala,Guatemala,False,1,1,Guatemala
29918,32018,34025,2012,Hong Kong,Singapore,1,0,Friendly,So Kon Po,Hong Kong,False,1,1,Hong Kong
29919,32019,34026,2012,Italy,Russia,0,3,Friendly,Zürich,Switzerland,True,3,-3,Russia
29920,32020,34027,2012,Kazakhstan,Kyrgyzstan,5,2,Friendly,Almaty,Kazakhstan,False,7,3,Kazakhstan
29921,32021,34028,2012,Latvia,Lithuania,5,0,Baltic Cup,Võru,Estonia,True,5,5,Latvia
29922,32022,34029,2012,Malaysia,Philippines,0,0,Friendly,Shah Alam,Malaysia,False,0,0,Draw
29923,32023,34030,2012,Panama,Jamaica,2,1,Friendly,Panama City,Panama,False,3,1,Panama
29924,32024,34031,2012,Puerto Rico,Nicaragua,3,1,Friendly,Bayamón,Puerto Rico,False,4,2,Puerto Rico
29925,32026,34033,2012,Vanuatu,New Caledonia,2,5,Oceania Nations Cup,Honiara,Solomon Islands,True,7,-3,New Caledonia
29926,32027,34034,2012,Algeria,Rwanda,4,0,FIFA World Cup qualification,Blida,Algeria,False,4,4,Algeria
29927,32028,34035,2012,Argentina,Ecuador,4,0,FIFA World Cup qualification,Buenos Aires,Argentina,False,4,4,Argentina
29928,32029,34036,2012,Bolivia,Chile,0,2,FIFA World Cup qualification,La Paz,Bolivia,False,2,-2,Chile
29929,32030,34037,2012,Burkina Faso,Congo,0,3,FIFA World Cup qualification,Ouagadougou,Burkina Faso,False,3,-3,Congo
29930,32031,34038,2012,Cameroon,DR Congo,1,0,FIFA World Cup qualification,Yaoundé,Cameroon,False,1,1,Cameroon
29931,32032,34039,2012,Central African Republic,Botswana,2,0,FIFA World Cup qualification,Bangui,Central African Republic,False,2,2,Central African Republic
29932,32033,34040,2012,Denmark,Australia,2,0,Friendly,Copenhagen,Denmark,False,2,2,Denmark
29933,32034,34041,2012,El Salvador,Honduras,0,3,Friendly,Washington,United States,True,3,-3,Honduras
29934,32035,34042,2012,England,Belgium,1,0,Friendly,London,England,False,1,1,England
29935,32036,34043,2012,Fiji,New Zealand,0,1,Oceania Nations Cup,Honiara,Solomon Islands,True,1,-1,New Zealand
29936,32037,34044,2012,Gambia,Morocco,1,1,FIFA World Cup qualification,Bakau,Gambia,False,2,0,Draw
29937,32038,34045,2012,Ivory Coast,Tanzania,2,0,FIFA World Cup qualification,Abidjan,Ivory Coast,False,2,2,Ivory Coast
29938,32039,34046,2012,Kenya,Malawi,0,0,FIFA World Cup qualification,Nairobi,Kenya,False,0,0,Draw
29939,32040,34047,2012,Luxembourg,Malta,0,2,Friendly,Luxembourg,Luxembourg,False,2,-2,Malta
29940,32041,34048,2012,Netherlands,Northern Ireland,6,0,Friendly,Amsterdam,Netherlands,False,6,6,Netherlands
29941,32042,34049,2012,Norway,Croatia,1,1,Friendly,Oslo,Norway,False,2,0,Draw
29942,32043,34050,2012,Poland,Andorra,4,0,Friendly,Warsaw,Poland,False,4,4,Poland
29943,32044,34051,2012,Portugal,Turkey,1,3,Friendly,Lisbon,Portugal,False,4,-2,Turkey
29944,32045,34052,2012,Senegal,Liberia,3,1,FIFA World Cup qualification,Dakar,Senegal,False,4,2,Senegal
29945,32047,34054,2012,Solomon Islands,Papua New Guinea,1,0,Oceania Nations Cup,Honiara,Solomon Islands,False,1,1,Solomon Islands
29946,32048,34055,2012,Sudan,Zambia,0,3,FIFA World Cup qualification,Khartoum,Sudan,False,3,-3,Zambia
29947,32049,34056,2012,Tunisia,Equatorial Guinea,3,1,FIFA World Cup qualification,Monastir,Tunisia,False,4,2,Tunisia
29948,32050,34057,2012,Uruguay,Venezuela,1,1,FIFA World Cup qualification,Montevideo,Uruguay,False,2,0,Draw
29949,32051,34058,2012,Angola,Uganda,1,1,FIFA World Cup qualification,Luanda,Angola,False,2,0,Draw
29950,32052,34059,2012,Benin,Mali,1,0,FIFA World Cup qualification,Cotonou,Benin,False,1,1,Benin
29951,32053,34060,2012,Canada,United States,0,0,Friendly,Toronto,Canada,False,0,0,Draw
29952,32054,34061,2012,Estonia,Lithuania,1,0,Baltic Cup,Tartu,Estonia,False,1,1,Estonia
29953,32055,34062,2012,Finland,Latvia,1,1,Baltic Cup,Võru,Estonia,True,2,0,Draw
29954,32056,34063,2012,Japan,Oman,3,0,FIFA World Cup qualification,Saitama,Japan,False,3,3,Japan
29955,32057,34064,2012,Jordan,Iraq,1,1,FIFA World Cup qualification,Amman,Jordan,False,2,0,Draw
29956,32058,34065,2012,Lebanon,Qatar,0,1,FIFA World Cup qualification,Beirut,Lebanon,False,1,-1,Qatar
29957,32059,34066,2012,Mexico,Brazil,2,0,Friendly,Arlington,United States,True,2,2,Mexico
29958,32060,34067,2012,Niger,Gabon,3,0,FIFA World Cup qualification,Niamey,Niger,False,3,3,Niger
29959,32061,34068,2012,Nigeria,Namibia,1,0,FIFA World Cup qualification,Calabar,Nigeria,False,1,1,Nigeria
29960,32062,34069,2012,Peru,Colombia,0,1,FIFA World Cup qualification,Lima,Peru,False,1,-1,Colombia
29961,32063,34070,2012,Puerto Rico,Nicaragua,1,1,Friendly,Bayamón,Puerto Rico,False,2,0,Draw
29962,32064,34071,2012,South Africa,Ethiopia,1,1,FIFA World Cup qualification,Rustenburg,South Africa,False,2,0,Draw
29963,32066,34074,2012,Togo,Libya,1,1,FIFA World Cup qualification,Lomé,Togo,False,2,0,Draw
29964,32067,34075,2012,Uzbekistan,Iran,0,1,FIFA World Cup qualification,Tashkent,Uzbekistan,False,1,-1,Iran
29965,32068,34076,2012,Vanuatu,Samoa,5,0,Oceania Nations Cup,Honiara,Solomon Islands,True,5,5,Vanuatu
29966,32069,34077,2012,Zimbabwe,Guinea,0,1,FIFA World Cup qualification,Harare,Zimbabwe,False,1,-1,Guinea
29967,32070,34078,2012,Hungary,Republic of Ireland,0,0,Friendly,Budapest,Hungary,False,0,0,Draw
29968,32071,34079,2012,Papua New Guinea,New Zealand,1,2,Oceania Nations Cup,Honiara,Solomon Islands,True,3,-1,New Zealand
29969,32072,34080,2012,Solomon Islands,Fiji,0,0,Oceania Nations Cup,Honiara,Solomon Islands,False,0,0,Draw
29970,32073,34084,2012,Armenia,Kazakhstan,3,0,Friendly,Yerevan,Armenia,False,3,3,Armenia
29971,32074,34085,2012,Austria,Romania,0,0,Friendly,Innsbruck,Austria,False,0,0,Draw
29972,32075,34086,2012,France,Estonia,4,0,Friendly,Le Mans,France,False,4,4,France
29973,32076,34087,2012,New Caledonia,Samoa,9,0,Oceania Nations Cup,Honiara,Solomon Islands,True,9,9,New Caledonia
29974,32077,34088,2012,Philippines,Indonesia,2,2,Friendly,Manila,Philippines,False,4,0,Draw
29975,32078,34089,2012,Sweden,Serbia,2,1,Friendly,Solna,Sweden,False,3,1,Sweden
29976,32079,34091,2012,Turkey,Ukraine,2,0,Friendly,Ingolstadt,Germany,True,2,2,Turkey
29977,32081,34095,2012,Papua New Guinea,Fiji,1,1,Oceania Nations Cup,Honiara,Solomon Islands,True,2,0,Draw
29978,32082,34096,2012,Solomon Islands,New Zealand,1,1,Oceania Nations Cup,Honiara,Solomon Islands,False,2,0,Draw
29979,32083,34100,2012,Belarus,Lithuania,1,1,Friendly,Minsk,Belarus,False,2,0,Draw
29980,32085,34103,2012,Bahrain,Kuwait,1,1,Friendly,6th of October City,Egypt,True,2,0,Draw
29981,32086,34105,2012,Costa Rica,El Salvador,2,2,FIFA World Cup qualification,San José,Costa Rica,False,4,0,Draw
29982,32087,34106,2012,Cuba,Canada,0,1,FIFA World Cup qualification,Havana,Cuba,False,1,-1,Canada
29983,32088,34107,2012,Honduras,Panama,0,2,FIFA World Cup qualification,San Pedro Sula,Honduras,False,2,-2,Panama
29984,32089,34108,2012,Jamaica,Guatemala,2,1,FIFA World Cup qualification,Kingston,Jamaica,False,3,1,Jamaica
29985,32090,34109,2012,Japan,Jordan,6,0,FIFA World Cup qualification,Saitama,Japan,False,6,6,Japan
29986,32091,34110,2012,Lebanon,Uzbekistan,1,1,FIFA World Cup qualification,Beirut,Lebanon,False,2,0,Draw
29987,32092,34111,2012,Mexico,Guyana,3,1,FIFA World Cup qualification,Mexico City,Mexico,False,4,2,Mexico
29988,32093,34112,2012,New Zealand,New Caledonia,0,2,Oceania Nations Cup,Honiara,Solomon Islands,True,2,-2,New Caledonia
29989,32094,34113,2012,Oman,Australia,0,0,FIFA World Cup qualification,Muscat,Oman,False,0,0,Draw
29990,32095,34114,2012,Poland,Greece,1,1,UEFA Euro,Warsaw,Poland,False,2,0,Draw
29991,32097,34116,2012,Russia,Czech Republic,4,1,UEFA Euro,Wrocław,Poland,True,5,3,Russia
29992,32098,34117,2012,Singapore,Malaysia,2,2,Friendly,Singapore,Singapore,False,4,0,Draw
29993,32100,34119,2012,United States,Antigua and Barbuda,3,1,FIFA World Cup qualification,Tampa,United States,False,4,2,United States
29994,32102,34123,2012,Bolivia,Paraguay,3,1,FIFA World Cup qualification,La Paz,Bolivia,False,4,2,Bolivia
29995,32103,34124,2012,Botswana,South Africa,1,1,FIFA World Cup qualification,Gaborone,Botswana,False,2,0,Draw
29996,32104,34125,2012,Brazil,Argentina,3,4,Friendly,East Rutherford,United States,True,7,-1,Argentina
29997,32105,34127,2012,Congo,Niger,1,0,FIFA World Cup qualification,Pointe-Noire,Congo,False,1,1,Congo
29998,32106,34128,2012,Equatorial Guinea,Sierra Leone,2,2,FIFA World Cup qualification,Malabo,Equatorial Guinea,False,4,0,Draw
29999,32107,34129,2012,French Guiana,Suriname,2,1,Friendly,Cayenne,French Guiana,False,3,1,French Guiana
30000,32108,34130,2012,Gabon,Burkina Faso,1,0,FIFA World Cup qualification,Libreville,Gabon,False,1,1,Gabon
30001,32109,34131,2012,Germany,Portugal,1,0,UEFA Euro,L'viv,Ukraine,True,1,1,Germany
30002,32110,34132,2012,Malawi,Nigeria,1,1,FIFA World Cup qualification,Blantyre,Malawi,False,2,0,Draw
30003,32111,34133,2012,Morocco,Ivory Coast,2,2,FIFA World Cup qualification,Marrakech,Morocco,False,4,0,Draw
30004,32112,34134,2012,Namibia,Kenya,1,0,FIFA World Cup qualification,Windhoek,Namibia,False,1,1,Namibia
30005,32113,34135,2012,Netherlands,Denmark,0,1,UEFA Euro,Kharkiv,Ukraine,True,1,-1,Denmark
30006,32114,34136,2012,Uganda,Senegal,1,1,FIFA World Cup qualification,Kampala,Uganda,False,2,0,Draw
30007,32115,34137,2012,Venezuela,Chile,0,2,FIFA World Cup qualification,Puerto la Cruz,Venezuela,False,2,-2,Chile
30008,32116,34138,2012,Zambia,Ghana,1,0,FIFA World Cup qualification,Ndola,Zambia,False,1,1,Zambia
30009,32117,34143,2012,DR Congo,Togo,2,0,FIFA World Cup qualification,Kinshasa,DR Congo,False,2,2,DR Congo
30010,32118,34144,2012,Ecuador,Colombia,1,0,FIFA World Cup qualification,Quito,Ecuador,False,1,1,Ecuador
30011,32119,34145,2012,Ethiopia,Central African Republic,2,0,FIFA World Cup qualification,Addis Ababa,Ethiopia,False,2,2,Ethiopia
30012,32120,34146,2012,Guinea,Egypt,2,3,FIFA World Cup qualification,Conakry,Guinea,False,5,-1,Egypt
30013,32121,34147,2012,Hong Kong,Vietnam,1,2,Friendly,Kowloon,Hong Kong,False,3,-1,Vietnam
30014,32122,34148,2012,Republic of Ireland,Croatia,1,3,UEFA Euro,Poznań,Poland,True,4,-2,Croatia
30015,32123,34149,2012,Lesotho,Sudan,0,0,FIFA World Cup qualification,Maseru,Lesotho,False,0,0,Draw
30016,32124,34150,2012,Liberia,Angola,0,0,FIFA World Cup qualification,Monrovia,Liberia,False,0,0,Draw
30017,32125,34151,2012,Libya,Cameroon,2,1,FIFA World Cup qualification,Sfax,Tunisia,True,3,1,Libya
30018,32126,34152,2012,Mali,Algeria,2,1,FIFA World Cup qualification,Ouagadougou,Burkina Faso,True,3,1,Mali
30019,32127,34153,2012,Mozambique,Zimbabwe,0,0,FIFA World Cup qualification,Maputo,Mozambique,False,0,0,Draw
30020,32128,34154,2012,Rwanda,Benin,1,1,FIFA World Cup qualification,Kigali,Rwanda,False,2,0,Draw
30021,32129,34155,2012,Solomon Islands,New Zealand,3,4,Oceania Nations Cup,Honiara,Solomon Islands,False,7,-1,New Zealand
30022,32130,34156,2012,Spain,Italy,1,1,UEFA Euro,Gdańsk,Poland,True,2,0,Draw
30023,32131,34158,2012,Tanzania,Gambia,2,1,FIFA World Cup qualification,Dar es Salaam,Tanzania,False,3,1,Tanzania
30024,32132,34159,2012,Uruguay,Peru,4,2,FIFA World Cup qualification,Montevideo,Uruguay,False,6,2,Uruguay
30025,32133,34160,2012,France,England,1,1,UEFA Euro,Donets'k,Ukraine,True,2,0,Draw
30026,32134,34161,2012,Ukraine,Sweden,2,1,UEFA Euro,Kyïv,Ukraine,False,3,1,Ukraine
30027,32135,34162,2012,Antigua and Barbuda,Jamaica,0,0,FIFA World Cup qualification,St. John's,Antigua and Barbuda,False,0,0,Draw
30028,32136,34163,2012,Australia,Japan,1,1,FIFA World Cup qualification,Brisbane,Australia,False,2,0,Draw
30029,32137,34164,2012,Bahrain,Kuwait,0,1,Friendly,6th of October City,Egypt,True,1,-1,Kuwait
30030,32138,34165,2012,Canada,Honduras,0,0,FIFA World Cup qualification,Toronto,Canada,False,0,0,Draw
30031,32139,34166,2012,El Salvador,Mexico,1,2,FIFA World Cup qualification,San Salvador,El Salvador,False,3,-1,Mexico
30032,32140,34167,2012,Greece,Czech Republic,1,2,UEFA Euro,Wrocław,Poland,True,3,-1,Czech Republic
30033,32141,34168,2012,Guatemala,United States,1,1,FIFA World Cup qualification,Guatemala,Guatemala,False,2,0,Draw
30034,32142,34169,2012,Guyana,Costa Rica,0,4,FIFA World Cup qualification,Providence,Guyana,False,4,-4,Costa Rica
30035,32143,34170,2012,Iran,Qatar,0,0,FIFA World Cup qualification,Teheran,Iran,False,0,0,Draw
30036,32144,34171,2012,Iraq,Oman,1,1,FIFA World Cup qualification,Doha,Qatar,True,2,0,Draw
30037,32145,34173,2012,Malaysia,Singapore,2,0,Friendly,Shah Alam,Malaysia,False,2,2,Malaysia
30038,32146,34174,2012,Panama,Cuba,1,0,FIFA World Cup qualification,Panama City,Panama,False,1,1,Panama
30039,32147,34175,2012,Philippines,Guam,3,0,Friendly,Bacalod,Philippines,False,3,3,Philippines
30040,32148,34176,2012,Poland,Russia,1,1,UEFA Euro,Warsaw,Poland,False,2,0,Draw
30041,32149,34177,2012,Denmark,Portugal,2,3,UEFA Euro,L'viv,Ukraine,True,5,-1,Portugal
30042,32150,34178,2012,Netherlands,Germany,1,2,UEFA Euro,Kharkiv,Ukraine,True,3,-1,Germany
30043,32151,34179,2012,Italy,Croatia,1,1,UEFA Euro,Poznań,Poland,True,2,0,Draw
30044,32152,34180,2012,Spain,Republic of Ireland,4,0,UEFA Euro,Gdańsk,Poland,True,4,4,Spain
30045,32153,34181,2012,Algeria,Gambia,4,1,African Cup of Nations qualification,Blida,Algeria,False,5,3,Algeria
30046,32154,34182,2012,Egypt,Central African Republic,2,3,African Cup of Nations qualification,Alexandria,Egypt,False,5,-1,Central African Republic
30047,32155,34183,2012,South Africa,Gabon,3,0,Friendly,Nelspruit,South Africa,False,3,3,South Africa
30048,32156,34184,2012,Sweden,England,2,3,UEFA Euro,Kyïv,Ukraine,True,5,-1,England
30049,32157,34185,2012,Ukraine,France,0,2,UEFA Euro,Donets'k,Ukraine,False,2,-2,France
30050,32158,34186,2012,Cameroon,Guinea-Bissau,1,0,African Cup of Nations qualification,Yaoundé,Cameroon,False,1,1,Cameroon
30051,32159,34188,2012,Greece,Russia,1,0,UEFA Euro,Warsaw,Poland,True,1,1,Greece
30052,32160,34189,2012,Malawi,Chad,2,0,African Cup of Nations qualification,Blantyre,Malawi,False,2,2,Malawi
30053,32161,34190,2012,Namibia,Liberia,0,0,African Cup of Nations qualification,Windhoek,Namibia,False,0,0,Draw
30054,32162,34191,2012,Nigeria,Rwanda,2,0,African Cup of Nations qualification,Calabar,Nigeria,False,2,2,Nigeria
30055,32163,34192,2012,Poland,Czech Republic,0,1,UEFA Euro,Wrocław,Poland,False,1,-1,Czech Republic
30056,32164,34193,2012,Sierra Leone,São Tomé and Príncipe,4,2,African Cup of Nations qualification,Freetown,Sierra Leone,False,6,2,Sierra Leone
30057,32165,34194,2012,Uganda,Congo,4,0,African Cup of Nations qualification,Kampala,Uganda,False,4,4,Uganda
30058,32166,34195,2012,Benin,Ethiopia,1,1,African Cup of Nations qualification,Cotonou,Benin,False,2,0,Draw
30059,32167,34196,2012,DR Congo,Seychelles,3,0,African Cup of Nations qualification,Kinshasa,DR Congo,False,3,3,DR Congo
30060,32168,34197,2012,Denmark,Germany,1,2,UEFA Euro,L'viv,Ukraine,True,3,-1,Germany
30061,32169,34198,2012,Portugal,Netherlands,2,1,UEFA Euro,Kharkiv,Ukraine,True,3,1,Portugal
30062,32170,34199,2012,Togo,Kenya,1,0,African Cup of Nations qualification,Lomé,Togo,False,1,1,Togo
30063,32171,34200,2012,Zimbabwe,Burundi,1,0,African Cup of Nations qualification,Harare,Zimbabwe,False,1,1,Zimbabwe
30064,32172,34201,2012,Croatia,Spain,0,1,UEFA Euro,Gdańsk,Poland,True,1,-1,Spain
30065,32173,34202,2012,Italy,Republic of Ireland,2,0,UEFA Euro,Poznań,Poland,True,2,2,Italy
30066,32174,34203,2012,Saudi Arabia,Morocco,4,0,Friendly,Ta’if,Saudi Arabia,False,4,4,Saudi Arabia
30067,32175,34204,2012,Yemen,Palestine,1,2,Friendly,Sana'a,Yemen,False,3,-1,Palestine
30068,32176,34205,2012,Sweden,France,2,0,UEFA Euro,Kyïv,Ukraine,True,2,2,Sweden
30069,32177,34206,2012,Ukraine,England,0,1,UEFA Euro,Donets'k,Ukraine,False,1,-1,England
30070,32178,34207,2012,Czech Republic,Portugal,0,1,UEFA Euro,Warsaw,Poland,True,1,-1,Portugal
30071,32179,34208,2012,Germany,Greece,4,2,UEFA Euro,Gdańsk,Poland,True,6,2,Germany
30072,32180,34209,2012,Saudi Arabia,Kuwait,4,0,UAFA Cup,Ta’if,Saudi Arabia,False,4,4,Saudi Arabia
30073,32181,34210,2012,Libya,Yemen,3,1,UAFA Cup,Jeddah,Saudi Arabia,True,4,2,Libya
30074,32182,34211,2012,Morocco,Bahrain,4,0,UAFA Cup,Jeddah,Saudi Arabia,True,4,4,Morocco
30075,32183,34212,2012,Spain,France,2,0,UEFA Euro,Donets'k,Ukraine,True,2,2,Spain
30076,32184,34213,2012,England,Italy,0,0,UEFA Euro,Kyïv,Ukraine,True,0,0,Draw
30077,32185,34214,2012,Iraq,Lebanon,1,0,UAFA Cup,Jeddah,Saudi Arabia,True,1,1,Iraq
30078,32186,34215,2012,Kuwait,Palestine,2,0,UAFA Cup,Ta’if,Saudi Arabia,True,2,2,Kuwait
30079,32187,34216,2012,Bahrain,Yemen,0,2,UAFA Cup,Jeddah,Saudi Arabia,True,2,-2,Yemen
30080,32188,34217,2012,Libya,Morocco,0,0,UAFA Cup,Jeddah,Saudi Arabia,True,0,0,Draw
30081,32189,34218,2012,Lebanon,Sudan,0,2,UAFA Cup,Jeddah,Saudi Arabia,True,2,-2,Sudan
30082,32190,34219,2012,Portugal,Spain,0,0,UEFA Euro,Donets'k,Ukraine,True,0,0,Draw
30083,32191,34220,2012,Germany,Italy,1,2,UEFA Euro,Warsaw,Poland,True,3,-1,Italy
30084,32192,34221,2012,Saudi Arabia,Palestine,2,2,UAFA Cup,Ta’if,Saudi Arabia,False,4,0,Draw
30085,32193,34222,2012,Libya,Bahrain,2,1,UAFA Cup,Ta’if,Saudi Arabia,True,3,1,Libya
30086,32194,34223,2012,Yemen,Morocco,0,4,UAFA Cup,Jeddah,Saudi Arabia,True,4,-4,Morocco
30087,32195,34224,2012,Central African Republic,Egypt,1,1,African Cup of Nations qualification,Bangui,Central African Republic,False,2,0,Draw
30088,32196,34225,2012,Sudan,Iraq,1,1,UAFA Cup,Jeddah,Saudi Arabia,True,2,0,Draw
30089,32197,34226,2012,Spain,Italy,4,0,UEFA Euro,Kyïv,Ukraine,True,4,4,Spain
30090,32198,34227,2012,Morocco,Iraq,2,1,UAFA Cup,Jeddah,Saudi Arabia,True,3,1,Morocco
30091,32199,34228,2012,Saudi Arabia,Libya,0,2,UAFA Cup,Jeddah,Saudi Arabia,False,2,-2,Libya
30092,32200,34229,2012,Saudi Arabia,Iraq,0,1,UAFA Cup,Jeddah,Saudi Arabia,False,1,-1,Iraq
30093,32201,34230,2012,Libya,Morocco,1,1,UAFA Cup,Jeddah,Saudi Arabia,True,2,0,Draw
30094,32202,34231,2012,Malawi,Zambia,1,0,Friendly,Blantyre,Malawi,False,1,1,Malawi
30095,32203,34233,2012,South Sudan,Uganda,2,2,Friendly,Juba,South Sudan,False,4,0,Draw
30096,32204,34234,2012,Kenya,Botswana,3,1,Friendly,Nairobi,Kenya,False,4,2,Kenya
30097,32205,34235,2012,Aruba,Curaçao,3,2,ABCS Tournament,Oranjestad,Aruba,False,5,1,Aruba
30098,32206,34236,2012,Suriname,Bonaire,8,0,ABCS Tournament,Oranjestad,Aruba,True,8,8,Suriname
30099,32207,34237,2012,Aruba,Suriname,1,0,ABCS Tournament,Oranjestad,Aruba,False,1,1,Aruba
30100,32208,34238,2012,Bonaire,Curaçao,2,9,ABCS Tournament,Oranjestad,Aruba,True,11,-7,Curaçao
30101,32209,34239,2012,Botswana,Zimbabwe,1,0,Friendly,Molepolole,Botswana,False,1,1,Botswana
30102,32210,34240,2012,Zimbabwe,Lesotho,5,3,Friendly,Molepolole,Botswana,True,8,2,Zimbabwe
30103,32211,34241,2012,Botswana,Lesotho,0,0,Friendly,Molepolole,Botswana,False,0,0,Draw
30104,32212,34242,2012,Guam,Northern Mariana Islands,3,1,EAFF Championship,Yona,Guam,False,4,2,Guam
30105,32213,34243,2012,Northern Mariana Islands,Macau,1,5,EAFF Championship,Yona,Guam,True,6,-4,Macau
30106,32214,34244,2012,Guam,Macau,3,0,EAFF Championship,Yona,Guam,False,3,3,Guam
30107,32215,34245,2012,Zambia,Zimbabwe,2,1,Friendly,Ndola,Zambia,False,3,1,Zambia
30108,32216,34246,2012,El Salvador,Guatemala,1,0,Friendly,Carson,United States,True,1,1,El Salvador
30109,32217,34247,2012,Jordan,Uzbekistan,0,1,Friendly,Amman,Jordan,False,1,-1,Uzbekistan
30110,32218,34248,2012,Burkina Faso,Togo,3,0,Friendly,Saint-Leu-la-Forêt,France,True,3,3,Burkina Faso
30111,32219,34249,2012,Liechtenstein,Andorra,1,0,Friendly,Vaduz,Liechtenstein,False,1,1,Liechtenstein
30112,32220,34250,2012,San Marino,Malta,2,3,Friendly,Serravalle,San Marino,False,5,-1,Malta
30113,32221,34251,2012,Albania,Moldova,0,0,Friendly,Tirana,Albania,False,0,0,Draw
30114,32222,34252,2012,Angola,Mozambique,2,0,Friendly,Benguela,Angola,False,2,2,Angola
30115,32223,34253,2012,Armenia,Belarus,1,2,Friendly,Yerevan,Armenia,False,3,-1,Belarus
30116,32224,34254,2012,Austria,Turkey,2,0,Friendly,Vienna,Austria,False,2,2,Austria
30117,32225,34255,2012,Azerbaijan,Bahrain,3,0,Friendly,Bakıxanov,Azerbaijan,False,3,3,Azerbaijan
30118,32226,34256,2012,Belgium,Netherlands,4,2,Friendly,Brussels,Belgium,False,6,2,Belgium
30119,32227,34257,2012,Bolivia,Guyana,2,0,Friendly,Santa Cruz,Bolivia,False,2,2,Bolivia
30120,32228,34258,2012,Botswana,Tanzania,3,3,Friendly,Molepolole,Botswana,False,6,0,Draw
30121,32229,34259,2012,Bulgaria,Cyprus,1,0,Friendly,Sofia,Bulgaria,False,1,1,Bulgaria
30122,32230,34260,2012,Canada,Trinidad and Tobago,2,0,Friendly,Lauderhill,United States,True,2,2,Canada
30123,32231,34262,2012,Costa Rica,Peru,0,1,Friendly,San José,Costa Rica,False,1,-1,Peru
30124,32232,34263,2012,Croatia,Switzerland,2,4,Friendly,Split,Croatia,False,6,-2,Switzerland
30125,32233,34264,2012,Denmark,Slovakia,1,3,Friendly,Odense,Denmark,False,4,-2,Slovakia
30126,32234,34265,2012,Ecuador,Chile,3,0,Friendly,New York,United States,True,3,3,Ecuador
30127,32235,34266,2012,El Salvador,Jamaica,0,2,Friendly,Washington,United States,True,2,-2,Jamaica
30128,32236,34267,2012,England,Italy,2,1,Friendly,Berne,Switzerland,True,3,1,England
30129,32237,34268,2012,Equatorial Guinea,Liberia,1,0,Friendly,Malabo,Equatorial Guinea,False,1,1,Equatorial Guinea
30130,32238,34269,2012,Estonia,Poland,1,0,Friendly,Tallinn,Estonia,False,1,1,Estonia
30131,32239,34270,2012,France,Uruguay,0,0,Friendly,Le Havre,France,False,0,0,Draw
30132,32240,34271,2012,Germany,Argentina,1,3,Friendly,Frankfurt am Main,Germany,False,4,-2,Argentina
30133,32241,34272,2012,Guatemala,Paraguay,3,3,Friendly,Washington,United States,True,6,0,Draw
30134,32242,34273,2012,Hungary,Israel,1,1,Friendly,Budapest,Hungary,False,2,0,Draw
30135,32243,34274,2012,Iceland,Faroe Islands,2,0,Friendly,Reykjavík,Iceland,False,2,2,Iceland
30136,32244,34275,2012,Iran,Tunisia,2,2,Friendly,Kecskemét,Hungary,True,4,0,Draw
30137,32245,34276,2012,Japan,Venezuela,1,1,Friendly,Sapporo,Japan,False,2,0,Draw
30138,32246,34277,2012,Jordan,Uzbekistan,2,0,Friendly,Amman,Jordan,False,2,2,Jordan
30139,32247,34279,2012,Luxembourg,Georgia,1,2,Friendly,Differdange,Luxembourg,False,3,-1,Georgia
30140,32248,34281,2012,Mexico,United States,0,1,Friendly,Mexico City,Mexico,False,1,-1,United States
30141,32249,34282,2012,Montenegro,Latvia,2,0,Friendly,Podgorica,Montenegro,False,2,2,Montenegro
30142,32250,34283,2012,Morocco,Guinea,1,2,Friendly,Rabat,Morocco,False,3,-1,Guinea
30143,32251,34284,2012,Niger,Nigeria,0,0,Friendly,Niamey,Niger,False,0,0,Draw
30144,32252,34285,2012,Northern Ireland,Finland,3,3,Friendly,Belfast,Northern Ireland,False,6,0,Draw
30145,32253,34286,2012,Norway,Greece,2,3,Friendly,Oslo,Norway,False,5,-1,Greece
30146,32254,34287,2012,Oman,Egypt,1,1,Friendly,Salalah,Oman,False,2,0,Draw
30147,32255,34288,2012,Portugal,Panama,2,0,Friendly,Faro,Portugal,False,2,2,Portugal
30148,32256,34289,2012,Puerto Rico,Spain,1,2,Friendly,Bayamón,Puerto Rico,False,3,-1,Spain
30149,32257,34290,2012,Russia,Ivory Coast,1,1,Friendly,Moscow,Russia,False,2,0,Draw
30150,32258,34291,2012,Scotland,Australia,3,1,Friendly,Edinburgh,Scotland,False,4,2,Scotland
30151,32259,34292,2012,Serbia,Republic of Ireland,0,0,Friendly,Belgrade,Serbia,False,0,0,Draw
30152,32260,34293,2012,Singapore,Hong Kong,2,0,Friendly,Jurong,Singapore,False,2,2,Singapore
30153,32261,34294,2012,Slovenia,Romania,4,3,Friendly,Celje,Slovenia,False,7,1,Slovenia
30154,32262,34295,2012,Sweden,Brazil,0,3,Friendly,Solna,Sweden,False,3,-3,Brazil
30155,32263,34296,2012,Ukraine,Czech Republic,0,0,Friendly,L'viv,Ukraine,False,0,0,Draw
30156,32264,34297,2012,Wales,Bosnia and Herzegovina,0,2,Friendly,Llanelli,Wales,False,2,-2,Bosnia and Herzegovina
30157,32265,34298,2012,India,Syria,2,1,Nehru Cup,New Delhi,India,False,3,1,India
30158,32266,34299,2012,Maldives,Nepal,2,1,Nehru Cup,New Delhi,India,True,3,1,Maldives
30159,32267,34300,2012,Syria,Cameroon,2,2,Nehru Cup,New Delhi,India,True,4,0,Draw
30160,32268,34301,2012,India,Maldives,3,0,Nehru Cup,New Delhi,India,False,3,3,India
30161,32269,34302,2012,Botswana,Uganda,0,0,Friendly,Gaborone,Botswana,False,0,0,Draw
30162,32270,34303,2012,Libya,Sudan,3,0,Friendly,Tunis,Tunisia,True,3,3,Libya
30163,32271,34304,2012,Nepal,Cameroon,0,5,Nehru Cup,New Delhi,India,True,5,-5,Cameroon
30164,32272,34305,2012,Maldives,Syria,2,1,Nehru Cup,New Delhi,India,True,3,1,Maldives
30165,32273,34306,2012,India,Nepal,0,0,Nehru Cup,New Delhi,India,False,0,0,Draw
30166,32274,34307,2012,Cameroon,Maldives,3,1,Nehru Cup,New Delhi,India,True,4,2,Cameroon
30167,32275,34308,2012,Syria,Nepal,2,0,Nehru Cup,New Delhi,India,True,2,2,Syria
30168,32276,34309,2012,India,Cameroon,0,1,Nehru Cup,New Delhi,India,False,1,-1,Cameroon
30169,32277,34310,2012,India,Cameroon,2,2,Nehru Cup,New Delhi,India,False,4,0,Draw
30170,32278,34311,2012,Liberia,Malawi,1,0,Friendly,Paynesville,Liberia,False,1,1,Liberia
30171,32279,34312,2012,Cambodia,Philippines,0,0,Friendly,Phnom Penh,Cambodia,False,0,0,Draw
30172,32280,34313,2012,Jordan,Iran,0,0,Friendly,Amman,Jordan,False,0,0,Draw
30173,32282,34315,2012,Montserrat,Suriname,1,7,CFU Caribbean Cup qualification,Le Lamentin,Martinique,True,8,-6,Suriname
30174,32283,34316,2012,Japan,United Arab Emirates,1,0,Friendly,Niigata,Japan,False,1,1,Japan
30175,32284,34317,2012,Lebanon,Australia,0,3,Friendly,Tripoli,Lebanon,False,3,-3,Australia
30176,32285,34318,2012,Qatar,Tajikistan,1,2,Friendly,Ingolstadt,Germany,True,3,-1,Tajikistan
30177,32287,34320,2012,Albania,Cyprus,3,1,FIFA World Cup qualification,Tirana,Albania,False,4,2,Albania
30178,32288,34321,2012,Andorra,Hungary,0,5,FIFA World Cup qualification,Sant Julià de Lòria,Andorra,False,5,-5,Hungary
30179,32289,34322,2012,Argentina,Paraguay,3,1,FIFA World Cup qualification,Córdoba,Argentina,False,4,2,Argentina
30180,32290,34323,2012,Azerbaijan,Israel,1,1,FIFA World Cup qualification,Baku,Azerbaijan,False,2,0,Draw
30181,32291,34324,2012,Bermuda,Puerto Rico,1,2,CFU Caribbean Cup qualification,Port-au-Prince,Haiti,True,3,-1,Puerto Rico
30182,32292,34325,2012,Brazil,South Africa,1,0,Friendly,São Paulo,Brazil,False,1,1,Brazil
30183,32293,34327,2012,Bulgaria,Italy,2,2,FIFA World Cup qualification,Sofia,Bulgaria,False,4,0,Draw
30184,32294,34328,2012,Canada,Panama,1,0,FIFA World Cup qualification,Toronto,Canada,False,1,1,Canada
30185,32295,34329,2012,Colombia,Uruguay,4,0,FIFA World Cup qualification,Barranquilla,Colombia,False,4,4,Colombia
30186,32296,34330,2012,Costa Rica,Mexico,0,2,FIFA World Cup qualification,San José,Costa Rica,False,2,-2,Mexico
30187,32298,34332,2012,Cuba,Honduras,0,3,FIFA World Cup qualification,Havana,Cuba,False,3,-3,Honduras
30188,32299,34333,2012,Ecuador,Bolivia,1,0,FIFA World Cup qualification,Quito,Ecuador,False,1,1,Ecuador
30189,32300,34334,2012,El Salvador,Guyana,2,2,FIFA World Cup qualification,San Salvador,El Salvador,False,4,0,Draw
30190,32301,34335,2012,Estonia,Romania,0,2,FIFA World Cup qualification,Tallinn,Estonia,False,2,-2,Romania
30191,32302,34336,2012,Finland,France,0,1,FIFA World Cup qualification,Helsinki,Finland,False,1,-1,France
30192,32303,34337,2012,Georgia,Belarus,1,0,FIFA World Cup qualification,Tbilisi,Georgia,False,1,1,Georgia
30193,32304,34338,2012,Germany,Faroe Islands,3,0,FIFA World Cup qualification,Hanover,Germany,False,3,3,Germany
30194,32305,34339,2012,Guatemala,Antigua and Barbuda,3,1,FIFA World Cup qualification,Guatemala,Guatemala,False,4,2,Guatemala
30195,32306,34340,2012,Haiti,Saint Martin,7,0,CFU Caribbean Cup qualification,Port-au-Prince,Haiti,False,7,7,Haiti
30196,32307,34341,2012,Iceland,Norway,2,0,FIFA World Cup qualification,Reykjavík,Iceland,False,2,2,Iceland
30197,32308,34342,2012,Jamaica,United States,2,1,FIFA World Cup qualification,Kingston,Jamaica,False,3,1,Jamaica
30198,32309,34343,2012,Kazakhstan,Republic of Ireland,1,2,FIFA World Cup qualification,Astana,Kazakhstan,False,3,-1,Republic of Ireland
30199,32310,34344,2012,Latvia,Greece,1,2,FIFA World Cup qualification,Riga,Latvia,False,3,-1,Greece
30200,32311,34345,2012,Liechtenstein,Bosnia and Herzegovina,1,8,FIFA World Cup qualification,Vaduz,Liechtenstein,False,9,-7,Bosnia and Herzegovina
30201,32312,34346,2012,Lithuania,Slovakia,1,1,FIFA World Cup qualification,Vilnius,Lithuania,False,2,0,Draw
30202,32313,34347,2012,Luxembourg,Portugal,1,2,FIFA World Cup qualification,Luxembourg,Luxembourg,False,3,-1,Portugal
30203,32314,34348,2012,Malta,Armenia,0,1,FIFA World Cup qualification,Attard,Malta,False,1,-1,Armenia
30204,32315,34349,2012,Martinique,Montserrat,5,0,CFU Caribbean Cup qualification,Rivière-Pilote,Martinique,False,5,5,Martinique
30205,32316,34350,2012,Moldova,England,0,5,FIFA World Cup qualification,Chişinău,Moldova,False,5,-5,England
30206,32317,34351,2012,Montenegro,Poland,2,2,FIFA World Cup qualification,Podgorica,Montenegro,False,4,0,Draw
30207,32318,34352,2012,Netherlands,Turkey,2,0,FIFA World Cup qualification,Amsterdam,Netherlands,False,2,2,Netherlands
30208,32319,34353,2012,New Caledonia,New Zealand,0,2,FIFA World Cup qualification,Nouméa,New Caledonia,False,2,-2,New Zealand
30209,32320,34354,2012,Peru,Venezuela,2,1,FIFA World Cup qualification,Lima,Peru,False,3,1,Peru
30210,32321,34355,2012,Russia,Northern Ireland,2,0,FIFA World Cup qualification,Moscow,Russia,False,2,2,Russia
30211,32322,34356,2012,Singapore,Philippines,0,2,Friendly,Jurong,Singapore,False,2,-2,Philippines
30212,32323,34357,2012,Slovenia,Switzerland,0,2,FIFA World Cup qualification,Ljubljana,Slovenia,False,2,-2,Switzerland
30213,32325,34359,2012,Spain,Saudi Arabia,5,0,Friendly,Pontevedra,Spain,False,5,5,Spain
30214,32326,34360,2012,Uzbekistan,Kuwait,3,0,Friendly,Tashkent,Uzbekistan,False,3,3,Uzbekistan
30215,32327,34361,2012,Wales,Belgium,0,2,FIFA World Cup qualification,Cardiff,Wales,False,2,-2,Belgium
30216,32328,34363,2012,Central African Republic,Burkina Faso,1,0,African Cup of Nations qualification,Bangui,Central African Republic,False,1,1,Central African Republic
30217,32329,34364,2012,DR Congo,Equatorial Guinea,4,0,African Cup of Nations qualification,Kinshasa,DR Congo,False,4,4,DR Congo
30218,32330,34365,2012,Denmark,Czech Republic,0,0,FIFA World Cup qualification,Copenhagen,Denmark,False,0,0,Draw
30219,32331,34366,2012,Gabon,Togo,1,1,African Cup of Nations qualification,Libreville,Gabon,False,2,0,Draw
30220,32332,34367,2012,Ghana,Malawi,2,0,African Cup of Nations qualification,Accra,Ghana,False,2,2,Ghana
30221,32333,34368,2012,Ivory Coast,Senegal,4,2,African Cup of Nations qualification,Abidjan,Ivory Coast,False,6,2,Ivory Coast
30222,32334,34369,2012,Liberia,Nigeria,2,2,African Cup of Nations qualification,Paynesville,Liberia,False,4,0,Draw
30223,32335,34370,2012,Mali,Botswana,3,0,African Cup of Nations qualification,Bamako,Mali,False,3,3,Mali
30224,32336,34371,2012,Scotland,Serbia,0,0,FIFA World Cup qualification,Glasgow,Scotland,False,0,0,Draw
30225,32337,34372,2012,Sierra Leone,Tunisia,2,2,African Cup of Nations qualification,Freetown,Sierra Leone,False,4,0,Draw
30226,32338,34373,2012,Sudan,Ethiopia,5,3,African Cup of Nations qualification,Khartoum,Sudan,False,8,2,Sudan
30227,32339,34374,2012,Zambia,Uganda,1,0,African Cup of Nations qualification,Ndola,Zambia,False,1,1,Zambia
30228,32340,34376,2012,Guinea,Niger,1,0,African Cup of Nations qualification,Conakry,Guinea,False,1,1,Guinea
30229,32341,34377,2012,Haiti,Bermuda,3,1,CFU Caribbean Cup qualification,Port-au-Prince,Haiti,False,4,2,Haiti
30230,32342,34378,2012,Libya,Algeria,0,1,African Cup of Nations qualification,Casablanca,Morocco,True,1,-1,Algeria
30231,32343,34379,2012,Martinique,Suriname,2,2,CFU Caribbean Cup qualification,Fort-de-France,Martinique,False,4,0,Draw
30232,32344,34380,2012,Mozambique,Morocco,2,0,African Cup of Nations qualification,Maputo,Mozambique,False,2,2,Mozambique
30233,32345,34381,2012,Puerto Rico,Saint Martin,9,0,CFU Caribbean Cup qualification,Port-au-Prince,Haiti,True,9,9,Puerto Rico
30234,32346,34382,2012,Zimbabwe,Angola,3,1,African Cup of Nations qualification,Harare,Zimbabwe,False,4,2,Zimbabwe
30235,32349,34385,2012,Laos,Philippines,2,1,Friendly,Vientiane,Laos,False,3,1,Laos
30236,32350,34386,2012,Antigua and Barbuda,Guatemala,0,1,FIFA World Cup qualification,St. John's,Antigua and Barbuda,False,1,-1,Guatemala
30237,32351,34387,2012,Austria,Germany,1,2,FIFA World Cup qualification,Vienna,Austria,False,3,-1,Germany
30238,32352,34388,2012,Belgium,Croatia,1,1,FIFA World Cup qualification,Brussels,Belgium,False,2,0,Draw
30239,32353,34389,2012,Bosnia and Herzegovina,Latvia,4,1,FIFA World Cup qualification,Zenica,Bosnia and Herzegovina,False,5,3,Bosnia and Herzegovina
30240,32354,34390,2012,Bulgaria,Armenia,1,0,FIFA World Cup qualification,Sofia,Bulgaria,False,1,1,Bulgaria
30241,32355,34391,2012,Burma,Singapore,1,1,Friendly,Rangoon,Burma,False,2,0,Draw
30242,32356,34392,2012,Chile,Colombia,1,3,FIFA World Cup qualification,Santiago,Chile,False,4,-2,Colombia
30243,32357,34393,2012,Cyprus,Iceland,1,0,FIFA World Cup qualification,Larnaca,Cyprus,False,1,1,Cyprus
30244,32358,34394,2012,Czech Republic,Finland,0,1,Friendly,Teplice,Czech Republic,False,1,-1,Finland
30245,32359,34395,2012,England,Ukraine,1,1,FIFA World Cup qualification,London,England,False,2,0,Draw
30246,32360,34396,2012,France,Belarus,3,1,FIFA World Cup qualification,Saint-Denis,France,False,4,2,France
30247,32361,34397,2012,Gabon,Saudi Arabia,1,0,Friendly,Amiens,France,True,1,1,Gabon
30248,32362,34398,2012,Georgia,Spain,0,1,FIFA World Cup qualification,Tbilisi,Georgia,False,1,-1,Spain
30249,32363,34399,2012,Greece,Lithuania,2,0,FIFA World Cup qualification,Piraeus,Greece,False,2,2,Greece
30250,32364,34400,2012,Guyana,El Salvador,2,3,FIFA World Cup qualification,Providence,Guyana,False,5,-1,El Salvador
30251,32365,34401,2012,Haiti,Puerto Rico,2,1,CFU Caribbean Cup qualification,Port-au-Prince,Haiti,False,3,1,Haiti
30252,32366,34402,2012,Honduras,Cuba,1,0,FIFA World Cup qualification,San Pedro Sula,Honduras,False,1,1,Honduras
30253,32367,34403,2012,Hungary,Netherlands,1,4,FIFA World Cup qualification,Budapest,Hungary,False,5,-3,Netherlands
30254,32368,34404,2012,Republic of Ireland,Oman,4,1,Friendly,London,England,True,5,3,Republic of Ireland
30255,32369,34405,2012,Israel,Russia,0,4,FIFA World Cup qualification,Ramat-Gan,Israel,False,4,-4,Russia
30256,32370,34406,2012,Italy,Malta,2,0,FIFA World Cup qualification,Modena,Italy,False,2,2,Italy
30257,32371,34407,2012,Japan,Iraq,1,0,FIFA World Cup qualification,Saitama,Japan,False,1,1,Japan
30258,32372,34408,2012,Jordan,Australia,2,1,FIFA World Cup qualification,Amman,Jordan,False,3,1,Jordan
30259,32373,34409,2012,Lebanon,Iran,1,0,FIFA World Cup qualification,Beirut,Lebanon,False,1,1,Lebanon
30260,32374,34410,2012,Liberia,Ghana,2,0,Friendly,Paynesville,Liberia,False,2,2,Liberia
30261,32375,34411,2012,Malaysia,Vietnam,0,2,Friendly,Shah Alam,Malaysia,False,2,-2,Vietnam
30262,32376,34412,2012,Mexico,Costa Rica,1,0,FIFA World Cup qualification,Mexico City,Mexico,False,1,1,Mexico
30263,32377,34413,2012,New Zealand,Solomon Islands,6,1,FIFA World Cup qualification,Auckland,New Zealand,False,7,5,New Zealand
30264,32378,34414,2012,Northern Ireland,Luxembourg,1,1,FIFA World Cup qualification,Belfast,Northern Ireland,False,2,0,Draw
30265,32379,34415,2012,Norway,Slovenia,2,1,FIFA World Cup qualification,Oslo,Norway,False,3,1,Norway
30266,32380,34416,2012,Panama,Canada,2,0,FIFA World Cup qualification,Panama City,Panama,False,2,2,Panama
30267,32381,34417,2012,Paraguay,Venezuela,0,2,FIFA World Cup qualification,Asunción,Paraguay,False,2,-2,Venezuela
30268,32382,34418,2012,Peru,Argentina,1,1,FIFA World Cup qualification,Lima,Peru,False,2,0,Draw
30269,32383,34419,2012,Poland,Moldova,2,0,FIFA World Cup qualification,Wrocław,Poland,False,2,2,Poland
30270,32384,34420,2012,Portugal,Azerbaijan,3,0,FIFA World Cup qualification,Braga,Portugal,False,3,3,Portugal
30271,32385,34421,2012,Romania,Andorra,4,0,FIFA World Cup qualification,Bucharest,Romania,False,4,4,Romania
30272,32386,34422,2012,San Marino,Montenegro,0,6,FIFA World Cup qualification,Serravalle,San Marino,False,6,-6,Montenegro
30273,32388,34424,2012,Serbia,Wales,6,1,FIFA World Cup qualification,Novi Sad,Serbia,False,7,5,Serbia
30274,32389,34425,2012,Slovakia,Liechtenstein,2,0,FIFA World Cup qualification,Bratislava,Slovakia,False,2,2,Slovakia
30275,32390,34426,2012,South Africa,Mozambique,2,0,Friendly,Nelspruit,South Africa,False,2,2,South Africa
30276,32391,34427,2012,Saint Martin,Bermuda,0,8,CFU Caribbean Cup qualification,Port-au-Prince,Haiti,True,8,-8,Bermuda
30277,32392,34428,2012,Sweden,Kazakhstan,2,0,FIFA World Cup qualification,Malmö,Sweden,False,2,2,Sweden
30278,32393,34429,2012,Switzerland,Albania,2,0,FIFA World Cup qualification,Lucerne,Switzerland,False,2,2,Switzerland
30279,32394,34431,2012,Turkey,Estonia,3,0,FIFA World Cup qualification,Istanbul,Turkey,False,3,3,Turkey
30280,32395,34432,2012,United Arab Emirates,Kuwait,3,0,Friendly,Dubai,United Arab Emirates,False,3,3,United Arab Emirates
30281,32396,34433,2012,Uruguay,Ecuador,1,1,FIFA World Cup qualification,Montevideo,Uruguay,False,2,0,Draw
30282,32397,34434,2012,United States,Jamaica,1,0,FIFA World Cup qualification,Columbus,United States,False,1,1,United States
30283,32399,34436,2012,Thailand,Laos,2,1,Friendly,Bangkok,Thailand,False,3,1,Thailand
30284,32400,34437,2012,Senegal,Ivory Coast,0,2,African Cup of Nations qualification,Dakar,Senegal,False,2,-2,Ivory Coast
30285,32401,34438,2012,Uganda,Zambia,1,0,African Cup of Nations qualification,Kampala,Uganda,False,1,1,Uganda
30286,32402,34439,2012,Equatorial Guinea,DR Congo,2,1,African Cup of Nations qualification,Malabo,Equatorial Guinea,False,3,1,Equatorial Guinea
30287,32403,34440,2012,French Guiana,Haiti,1,2,Friendly,Cayenne,French Guiana,False,3,-1,Haiti
30288,32404,34441,2012,Brazil,Argentina,2,1,Friendly,Goiânia,Brazil,False,3,1,Brazil
30289,32405,34442,2012,Nepal,Bangladesh,1,1,Friendly,Kathmandu,Nepal,False,2,0,Draw
30290,32407,34444,2012,Martinique,New Caledonia,2,0,African Nations Championship,Issy-les-Moulineaux,France,True,2,2,Martinique
30291,32408,34445,2012,Réunion,French Guiana,2,0,African Nations Championship,Versailles,France,True,2,2,Réunion
30292,32409,34447,2012,Aruba,Dominican Republic,2,2,CFU Caribbean Cup qualification,Bridgetown,Barbados,True,4,0,Draw
30293,32410,34448,2012,Barbados,Dominica,1,0,CFU Caribbean Cup qualification,Bridgetown,Barbados,False,1,1,Barbados
30294,32411,34449,2012,Guadeloupe,French Guiana,4,2,African Nations Championship,Saint-Ouen,France,True,6,2,Guadeloupe
30295,32413,34451,2012,New Caledonia,Mayotte,0,2,African Nations Championship,Corbeil-Essonnes,France,True,2,-2,Mayotte
30296,32415,34453,2012,Barbados,Dominican Republic,0,1,CFU Caribbean Cup qualification,Bridgetown,Barbados,False,1,-1,Dominican Republic
30297,32416,34454,2012,Dominica,Aruba,3,2,CFU Caribbean Cup qualification,Bridgetown,Barbados,True,5,1,Dominica
30298,32417,34455,2012,Philippines,Guam,1,0,Friendly,Manila,Philippines,False,1,1,Philippines
30299,32419,34458,2012,Martinique,Mayotte,3,0,African Nations Championship,Saint-Ouen-l'Aumône,France,True,3,3,Martinique
30300,32421,34460,2012,Réunion,Guadeloupe,2,1,African Nations Championship,Franconville,France,True,3,1,Réunion
30301,32422,34461,2012,Barbados,Aruba,2,1,CFU Caribbean Cup qualification,Bridgetown,Barbados,False,3,1,Barbados
30302,32423,34462,2012,Dominican Republic,Dominica,2,1,CFU Caribbean Cup qualification,Bridgetown,Barbados,True,3,1,Dominican Republic
30303,32424,34463,2012,Philippines,Macau,5,0,Friendly,Manila,Philippines,False,5,5,Philippines
30304,32426,34465,2012,Oman,Yemen,2,1,Friendly,Muscat,Oman,False,3,1,Oman
30305,32427,34467,2012,Guadeloupe,Mayotte,1,0,African Nations Championship,Saint-Gratien,France,True,1,1,Guadeloupe
30306,32428,34468,2012,Macau,Guam,0,3,Friendly,Manila,Philippines,True,3,-3,Guam
30307,32430,34470,2012,Réunion,Martinique,2,2,African Nations Championship,Saint-Gratien,France,True,4,0,Draw
30308,32431,34471,2012,Burma,Brunei,1,0,AFF Championship,Rangoon,Burma,False,1,1,Burma
30309,32432,34472,2012,Cambodia,East Timor,1,5,AFF Championship,Rangoon,Burma,True,6,-4,East Timor
30310,32433,34473,2012,Burma,East Timor,2,1,AFF Championship,Rangoon,Burma,False,3,1,Burma
30311,32434,34474,2012,Laos,Cambodia,1,0,AFF Championship,Rangoon,Burma,True,1,1,Laos
30312,32435,34475,2012,Cambodia,Brunei,2,3,AFF Championship,Rangoon,Burma,True,5,-1,Brunei
30313,32436,34476,2012,East Timor,Laos,3,1,AFF Championship,Rangoon,Burma,True,4,2,East Timor
30314,32437,34477,2012,French Guiana,Trinidad and Tobago,1,4,CFU Caribbean Cup qualification,Basseterre,Saint Kitts and Nevis,True,5,-3,Trinidad and Tobago
30315,32438,34478,2012,Brazil,Iraq,6,0,Friendly,Malmö,Sweden,True,6,6,Brazil
30316,32439,34479,2012,Brunei,Laos,1,3,AFF Championship,Rangoon,Burma,True,4,-2,Laos
30317,32440,34480,2012,Burma,Cambodia,3,0,AFF Championship,Rangoon,Burma,False,3,3,Burma
30318,32441,34481,2012,Kuwait,Syria,1,1,Friendly,Muscat,Oman,True,2,0,Draw
30319,32442,34482,2012,Albania,Iceland,1,2,FIFA World Cup qualification,Tirana,Albania,False,3,-1,Iceland
30320,32443,34483,2012,Antigua and Barbuda,United States,1,2,FIFA World Cup qualification,St. John's,Antigua and Barbuda,False,3,-1,United States
30321,32444,34484,2012,Argentina,Uruguay,3,0,FIFA World Cup qualification,Mendoza,Argentina,False,3,3,Argentina
30322,32445,34485,2012,Armenia,Italy,1,3,FIFA World Cup qualification,Yerevan,Armenia,False,4,-2,Italy
30323,32446,34486,2012,Bahrain,Philippines,0,0,Friendly,Arad,Bahrain,False,0,0,Draw
30324,32447,34487,2012,Belarus,Spain,0,4,FIFA World Cup qualification,Minsk,Belarus,False,4,-4,Spain
30325,32448,34488,2012,Bolivia,Peru,1,1,FIFA World Cup qualification,La Paz,Bolivia,False,2,0,Draw
30326,32449,34489,2012,Bulgaria,Denmark,1,1,FIFA World Cup qualification,Sofia,Bulgaria,False,2,0,Draw
30327,32450,34490,2012,Canada,Cuba,3,0,FIFA World Cup qualification,Toronto,Canada,False,3,3,Canada
30328,32451,34491,2012,Colombia,Paraguay,2,0,FIFA World Cup qualification,Barranquilla,Colombia,False,2,2,Colombia
30329,32452,34492,2012,Czech Republic,Malta,3,1,FIFA World Cup qualification,Plzeň,Czech Republic,False,4,2,Czech Republic
30330,32453,34493,2012,Ecuador,Chile,3,1,FIFA World Cup qualification,Quito,Ecuador,False,4,2,Ecuador
30331,32454,34494,2012,Egypt,Congo,3,0,Friendly,Sharjah,United Arab Emirates,True,3,3,Egypt
30332,32455,34495,2012,El Salvador,Costa Rica,0,1,FIFA World Cup qualification,San Salvador,El Salvador,False,1,-1,Costa Rica
30333,32456,34496,2012,England,San Marino,5,0,FIFA World Cup qualification,London,England,False,5,5,England
30334,32457,34497,2012,Estonia,Hungary,0,1,FIFA World Cup qualification,Tallinn,Estonia,False,1,-1,Hungary
30335,32458,34498,2012,Faroe Islands,Sweden,1,2,FIFA World Cup qualification,Tórshavn,Faroe Islands,False,3,-1,Sweden
30336,32459,34499,2012,Finland,Georgia,1,1,FIFA World Cup qualification,Helsinki,Finland,False,2,0,Draw
30337,32460,34500,2012,France,Japan,0,1,Friendly,Saint-Denis,France,False,1,-1,Japan
30338,32461,34501,2012,French Guiana,Anguilla,4,1,CFU Caribbean Cup qualification,Basseterre,Saint Kitts and Nevis,True,5,3,French Guiana
30339,32462,34502,2012,Greece,Bosnia and Herzegovina,0,0,FIFA World Cup qualification,Piraeus,Greece,False,0,0,Draw
30340,32463,34503,2012,Guatemala,Jamaica,2,1,FIFA World Cup qualification,Guatemala,Guatemala,False,3,1,Guatemala
30341,32464,34504,2012,Guyana,Mexico,0,5,FIFA World Cup qualification,Houston,United States,True,5,-5,Mexico
30342,32465,34505,2012,Republic of Ireland,Germany,1,6,FIFA World Cup qualification,Dublin,Republic of Ireland,False,7,-5,Germany
30343,32466,34506,2012,Kazakhstan,Austria,0,0,FIFA World Cup qualification,Astana,Kazakhstan,False,0,0,Draw
30344,32467,34507,2012,Lesotho,Eswatini,2,1,Friendly,Maseru,Lesotho,False,3,1,Lesotho
30345,32468,34508,2012,Liechtenstein,Lithuania,0,2,FIFA World Cup qualification,Vaduz,Liechtenstein,False,2,-2,Lithuania
30346,32469,34509,2012,Luxembourg,Israel,0,6,FIFA World Cup qualification,Luxembourg,Luxembourg,False,6,-6,Israel
30347,32470,34511,2012,Moldova,Ukraine,0,0,FIFA World Cup qualification,Chişinău,Moldova,False,0,0,Draw
30348,32471,34512,2012,Netherlands,Andorra,3,0,FIFA World Cup qualification,Rotterdam,Netherlands,False,3,3,Netherlands
30349,32472,34513,2012,Panama,Honduras,0,0,FIFA World Cup qualification,Panama City,Panama,False,0,0,Draw
30350,32473,34514,2012,Poland,South Africa,1,0,Friendly,Warsaw,Poland,False,1,1,Poland
30351,32474,34515,2012,Russia,Portugal,1,0,FIFA World Cup qualification,Moscow,Russia,False,1,1,Russia
30352,32475,34516,2012,Serbia,Belgium,0,3,FIFA World Cup qualification,Belgrade,Serbia,False,3,-3,Belgium
30353,32476,34517,2012,Slovakia,Latvia,2,1,FIFA World Cup qualification,Bratislava,Slovakia,False,3,1,Slovakia
30354,32477,34518,2012,Slovenia,Cyprus,2,1,FIFA World Cup qualification,Maribor,Slovenia,False,3,1,Slovenia
30355,32478,34519,2012,Solomon Islands,New Caledonia,2,6,FIFA World Cup qualification,Honiara,Solomon Islands,False,8,-4,New Caledonia
30356,32479,34520,2012,Switzerland,Norway,1,1,FIFA World Cup qualification,Berne,Switzerland,False,2,0,Draw
30357,32480,34522,2012,Turkey,Romania,0,1,FIFA World Cup qualification,Istanbul,Turkey,False,1,-1,Romania
30358,32481,34523,2012,United Arab Emirates,Uzbekistan,2,2,Friendly,Dubai,United Arab Emirates,False,4,0,Draw
30359,32482,34524,2012,Wales,Scotland,2,1,FIFA World Cup qualification,Cardiff,Wales,False,3,1,Wales
30360,32483,34525,2012,Brunei,East Timor,2,1,AFF Championship,Rangoon,Burma,True,3,1,Brunei
30361,32484,34526,2012,Burma,Laos,0,0,AFF Championship,Rangoon,Burma,False,0,0,Draw
30362,32485,34527,2012,Namibia,Rwanda,0,0,Friendly,Windhoek,Namibia,False,0,0,Draw
30363,32486,34528,2012,Lesotho,Eswatini,0,1,Friendly,Maseru,Lesotho,False,1,-1,Eswatini
30364,32487,34529,2012,Saudi Arabia,Congo,3,2,Friendly,al-Ahsa,Saudi Arabia,False,5,1,Saudi Arabia
30365,32488,34530,2012,Saint Kitts and Nevis,French Guiana,0,3,CFU Caribbean Cup qualification,Basseterre,Saint Kitts and Nevis,False,3,-3,French Guiana
30366,32489,34531,2012,Trinidad and Tobago,Anguilla,10,0,CFU Caribbean Cup qualification,Basseterre,Saint Kitts and Nevis,True,10,10,Trinidad and Tobago
30367,32490,34532,2012,Albania,Slovenia,1,0,FIFA World Cup qualification,Tirana,Albania,False,1,1,Albania
30368,32491,34533,2012,Andorra,Estonia,0,1,FIFA World Cup qualification,Sant Julià de Lòria,Andorra,False,1,-1,Estonia
30369,32492,34534,2012,Austria,Kazakhstan,4,0,FIFA World Cup qualification,Vienna,Austria,False,4,4,Austria
30370,32493,34535,2012,Belarus,Georgia,2,0,FIFA World Cup qualification,Minsk,Belarus,False,2,2,Belarus
30371,32494,34536,2012,Belgium,Scotland,2,0,FIFA World Cup qualification,Brussels,Belgium,False,2,2,Belgium
30372,32495,34537,2012,Bolivia,Uruguay,4,1,FIFA World Cup qualification,La Paz,Bolivia,False,5,3,Bolivia
30373,32496,34538,2012,Bosnia and Herzegovina,Lithuania,3,0,FIFA World Cup qualification,Zenica,Bosnia and Herzegovina,False,3,3,Bosnia and Herzegovina
30374,32497,34539,2012,Chile,Argentina,1,2,FIFA World Cup qualification,Santiago,Chile,False,3,-1,Argentina
30375,32498,34540,2012,Colombia,Cameroon,3,0,Friendly,Barranquilla,Colombia,False,3,3,Colombia
30376,32499,34541,2012,Costa Rica,Guyana,7,0,FIFA World Cup qualification,San José,Costa Rica,False,7,7,Costa Rica
30377,32500,34542,2012,Croatia,Wales,2,0,FIFA World Cup qualification,Osijek,Croatia,False,2,2,Croatia
30378,32501,34543,2012,Cuba,Panama,1,1,FIFA World Cup qualification,Havana,Cuba,False,2,0,Draw
30379,32502,34544,2012,Cyprus,Norway,1,3,FIFA World Cup qualification,Larnaca,Cyprus,False,4,-2,Norway
30380,32503,34545,2012,Czech Republic,Bulgaria,0,0,FIFA World Cup qualification,Prague,Czech Republic,False,0,0,Draw
30381,32504,34546,2012,Egypt,Tunisia,0,1,Friendly,Abu Dhabi,United Arab Emirates,True,1,-1,Tunisia
30382,32505,34547,2012,Faroe Islands,Republic of Ireland,1,4,FIFA World Cup qualification,Tórshavn,Faroe Islands,False,5,-3,Republic of Ireland
30383,32506,34548,2012,Germany,Sweden,4,4,FIFA World Cup qualification,Berlin,Germany,False,8,0,Draw
30384,32507,34549,2012,Honduras,Canada,8,1,FIFA World Cup qualification,San Pedro Sula,Honduras,False,9,7,Honduras
30385,32508,34550,2012,Hong Kong,Malaysia,0,3,Friendly,Kowloon,Hong Kong,False,3,-3,Malaysia
30386,32509,34551,2012,Hungary,Turkey,3,1,FIFA World Cup qualification,Budapest,Hungary,False,4,2,Hungary
30387,32510,34552,2012,Iceland,Switzerland,0,2,FIFA World Cup qualification,Reykjavík,Iceland,False,2,-2,Switzerland
30388,32512,34554,2012,Iraq,Australia,1,2,FIFA World Cup qualification,Doha,Qatar,True,3,-1,Australia
30389,32513,34555,2012,Israel,Luxembourg,3,0,FIFA World Cup qualification,Ramat-Gan,Israel,False,3,3,Israel
30390,32514,34556,2012,Italy,Denmark,3,1,FIFA World Cup qualification,Milan,Italy,False,4,2,Italy
30391,32515,34557,2012,Jamaica,Antigua and Barbuda,4,1,FIFA World Cup qualification,Kingston,Jamaica,False,5,3,Jamaica
30392,32516,34558,2012,Japan,Brazil,0,4,Friendly,Wrocław,Poland,True,4,-4,Brazil
30393,32517,34559,2012,Kenya,South Africa,1,2,Friendly,Nairobi,Kenya,False,3,-1,South Africa
30394,32518,34560,2012,Kuwait,Philippines,2,1,Friendly,Hawalli,Kuwait,False,3,1,Kuwait
30395,32519,34561,2012,Latvia,Liechtenstein,2,0,FIFA World Cup qualification,Riga,Latvia,False,2,2,Latvia
30396,32520,34562,2012,Lebanon,Yemen,2,1,Friendly,Beirut,Lebanon,False,3,1,Lebanon
30397,32521,34564,2012,Mexico,El Salvador,2,0,FIFA World Cup qualification,Torreón,Mexico,False,2,2,Mexico
30398,32522,34565,2012,New Caledonia,Solomon Islands,5,0,FIFA World Cup qualification,Nouméa,New Caledonia,False,5,5,New Caledonia
30399,32524,34567,2012,Oman,Jordan,2,1,FIFA World Cup qualification,Muscat,Oman,False,3,1,Oman
30400,32525,34568,2012,Paraguay,Peru,1,0,FIFA World Cup qualification,Asunción,Paraguay,False,1,1,Paraguay
30401,32526,34569,2012,Portugal,Northern Ireland,1,1,FIFA World Cup qualification,Porto,Portugal,False,2,0,Draw
30402,32527,34570,2012,Qatar,Uzbekistan,0,1,FIFA World Cup qualification,Doha,Qatar,False,1,-1,Uzbekistan
30403,32528,34571,2012,Romania,Netherlands,1,4,FIFA World Cup qualification,Bucharest,Romania,False,5,-3,Netherlands
30404,32529,34572,2012,Russia,Azerbaijan,1,0,FIFA World Cup qualification,Moscow,Russia,False,1,1,Russia
30405,32530,34573,2012,San Marino,Moldova,0,2,FIFA World Cup qualification,Serravalle,San Marino,False,2,-2,Moldova
30406,32531,34574,2012,Singapore,India,2,0,Friendly,Choa Chu Kang,Singapore,False,2,2,Singapore
30407,32532,34575,2012,Slovakia,Greece,0,1,FIFA World Cup qualification,Bratislava,Slovakia,False,1,-1,Greece
30408,32533,34576,2012,Spain,France,1,1,FIFA World Cup qualification,Madrid,Spain,False,2,0,Draw
30409,32534,34577,2012,Ukraine,Montenegro,0,1,FIFA World Cup qualification,Kyïv,Ukraine,False,1,-1,Montenegro
30410,32535,34578,2012,United Arab Emirates,Bahrain,6,2,Friendly,Dubai,United Arab Emirates,False,8,4,United Arab Emirates
30411,32536,34579,2012,United States,Guatemala,3,1,FIFA World Cup qualification,Kansas City,United States,False,4,2,United States
30412,32537,34580,2012,Venezuela,Ecuador,0,0,FIFA World Cup qualification,Puerto la Cruz,Venezuela,False,0,0,Draw
30413,32538,34581,2012,Vietnam,Indonesia,0,0,Friendly,Hanoi,Vietnam,False,0,0,Draw
30414,32539,34582,2012,Poland,England,1,1,FIFA World Cup qualification,Warsaw,Poland,False,2,0,Draw
30415,32540,34583,2012,Saint Lucia,Curaçao,5,1,CFU Caribbean Cup qualification,Gros Islet,Saint Lucia,False,6,4,Saint Lucia
30416,32541,34585,2012,Curaçao,Guyana,1,2,CFU Caribbean Cup qualification,Gros Islet,Saint Lucia,True,3,-1,Guyana
30417,32542,34586,2012,Guadeloupe,Dominican Republic,0,2,CFU Caribbean Cup qualification,Les Abymes,Guadeloupe,False,2,-2,Dominican Republic
30418,32543,34587,2012,Martinique,Puerto Rico,2,1,CFU Caribbean Cup qualification,Les Abymes,Guadeloupe,True,3,1,Martinique
30419,32544,34588,2012,Vietnam,Turkmenistan,0,1,VFF Cup,Ho Chi Minh City,Vietnam,False,1,-1,Turkmenistan
30420,32545,34589,2012,Dominican Republic,Martinique,1,1,CFU Caribbean Cup qualification,Les Abymes,Guadeloupe,True,2,0,Draw
30421,32546,34590,2012,Guadeloupe,Puerto Rico,4,1,CFU Caribbean Cup qualification,Les Abymes,Guadeloupe,False,5,3,Guadeloupe
30422,32547,34591,2012,Saint Vincent and the Grenadines,Curaçao,4,0,CFU Caribbean Cup qualification,Gros Islet,Saint Lucia,True,4,4,Saint Vincent and the Grenadines
30423,32548,34592,2012,Vietnam,Laos,4,0,VFF Cup,Ho Chi Minh City,Vietnam,False,4,4,Vietnam
30424,32549,34593,2012,Guadeloupe,Martinique,3,3,CFU Caribbean Cup qualification,Les Abymes,Guadeloupe,False,6,0,Draw
30425,32550,34594,2012,Puerto Rico,Dominican Republic,1,3,CFU Caribbean Cup qualification,Les Abymes,Guadeloupe,True,4,-2,Dominican Republic
30426,32551,34595,2012,Laos,Turkmenistan,2,4,VFF Cup,Ho Chi Minh City,Vietnam,True,6,-2,Turkmenistan
30427,32552,34596,2012,Vietnam,Malaysia,1,0,Friendly,Hanoi,Vietnam,False,1,1,Vietnam
30428,32553,34597,2012,Iran,Tajikistan,6,1,Friendly,Teheran,Iran,False,7,5,Iran
30429,32554,34598,2012,Thailand,Malaysia,2,0,Friendly,Nonthaburi,Thailand,False,2,2,Thailand
30430,32555,34599,2012,Bahrain,Jordan,3,0,Friendly,Arad,Bahrain,False,3,3,Bahrain
30431,32556,34600,2012,Oman,Estonia,1,2,Friendly,Muscat,Oman,False,3,-1,Estonia
30432,32557,34601,2012,Eswatini,Lesotho,0,0,Friendly,Lobamba,Eswatini,False,0,0,Draw
30433,32558,34602,2012,Albania,Cameroon,0,0,Friendly,Geneva,Switzerland,True,0,0,Draw
30434,32559,34603,2012,Algeria,Bosnia and Herzegovina,0,1,Friendly,Algiers,Algeria,False,1,-1,Bosnia and Herzegovina
30435,32560,34604,2012,Andorra,Iceland,0,2,Friendly,Sant Julià de Lòria,Andorra,False,2,-2,Iceland
30436,32561,34605,2012,Angola,Congo,1,1,Friendly,Estoril,Portugal,True,2,0,Draw
30437,32562,34606,2012,Armenia,Lithuania,4,2,Friendly,Yerevan,Armenia,False,6,2,Armenia
30438,32563,34607,2012,Austria,Ivory Coast,0,3,Friendly,Linz,Austria,False,3,-3,Ivory Coast
30439,32564,34608,2012,Bolivia,Costa Rica,1,1,Friendly,Santa Cruz,Bolivia,False,2,0,Draw
30440,32565,34609,2012,Brazil,Colombia,1,1,Friendly,East Rutherford,United States,True,2,0,Draw
30441,32566,34610,2012,Bulgaria,Ukraine,0,1,Friendly,Sofia,Bulgaria,False,1,-1,Ukraine
30442,32567,34613,2012,DR Congo,Burkina Faso,0,1,Friendly,Kinshasa,DR Congo,False,1,-1,Burkina Faso
30443,32568,34614,2012,Cuba,Suriname,5,0,CFU Caribbean Cup qualification,Bacolet,Trinidad and Tobago,True,5,5,Cuba
30444,32569,34615,2012,Cyprus,Finland,0,3,Friendly,Nicosia,Cyprus,False,3,-3,Finland
30445,32570,34616,2012,Czech Republic,Slovakia,3,0,Friendly,Olomouc,Czech Republic,False,3,3,Czech Republic
30446,32571,34617,2012,Gabon,Portugal,2,2,Friendly,Libreville,Gabon,False,4,0,Draw
30447,32572,34618,2012,Georgia,Egypt,0,0,Friendly,Tbilisi,Georgia,False,0,0,Draw
30448,32573,34619,2012,Grenada,French Guiana,1,1,CFU Caribbean Cup qualification,St. George's,Grenada,False,2,0,Draw
30449,32574,34620,2012,Haiti,Guyana,1,0,CFU Caribbean Cup qualification,St. George's,Grenada,True,1,1,Haiti
30450,32575,34621,2012,Honduras,Peru,0,0,Friendly,Houston,United States,True,0,0,Draw
30451,32576,34622,2012,Hungary,Norway,0,2,Friendly,Budapest,Hungary,False,2,-2,Norway
30452,32577,34623,2012,Indonesia,East Timor,1,0,Friendly,Jakarta,Indonesia,False,1,1,Indonesia
30453,32578,34624,2012,Iran,Uzbekistan,0,1,FIFA World Cup qualification,Teheran,Iran,False,1,-1,Uzbekistan
30454,32579,34625,2012,Iraq,Jordan,1,0,FIFA World Cup qualification,Doha,Qatar,True,1,1,Iraq
30455,32580,34626,2012,Republic of Ireland,Greece,0,1,Friendly,Dublin,Republic of Ireland,False,1,-1,Greece
30456,32581,34627,2012,Israel,Belarus,1,2,Friendly,Jerusalem,Israel,False,3,-1,Belarus
30457,32582,34628,2012,Italy,France,1,2,Friendly,Parma,Italy,False,3,-1,France
30458,32583,34630,2012,Kuwait,Bahrain,1,1,Friendly,Kuwait City,Kuwait,False,2,0,Draw
30459,32584,34631,2012,Liechtenstein,Malta,0,1,Friendly,Vaduz,Liechtenstein,False,1,-1,Malta
30460,32585,34632,2012,Luxembourg,Scotland,1,2,Friendly,Luxembourg,Luxembourg,False,3,-1,Scotland
30461,32586,34634,2012,Malaysia,Hong Kong,1,1,Friendly,Shah Alam,Malaysia,False,2,0,Draw
30462,32587,34635,2012,Montenegro,San Marino,3,0,FIFA World Cup qualification,Podgorica,Montenegro,False,3,3,Montenegro
30463,32588,34636,2012,Morocco,Togo,0,1,Friendly,Casablanca,Morocco,False,1,-1,Togo
30464,32589,34637,2012,Netherlands,Germany,0,0,Friendly,Amsterdam,Netherlands,False,0,0,Draw
30465,32590,34638,2012,Niger,Senegal,1,1,Friendly,Niamey,Niger,False,2,0,Draw
30466,32591,34639,2012,Northern Ireland,Azerbaijan,1,1,FIFA World Cup qualification,Belfast,Northern Ireland,False,2,0,Draw
30467,32592,34640,2012,Oman,Japan,1,2,FIFA World Cup qualification,Muscat,Oman,False,3,-1,Japan
30468,32593,34641,2012,Panama,Spain,1,5,Friendly,Panama City,Panama,False,6,-4,Spain
30469,32594,34642,2012,Paraguay,Guatemala,3,1,Friendly,Luque,Paraguay,False,4,2,Paraguay
30470,32595,34643,2012,Poland,Uruguay,1,3,Friendly,Gdańsk,Poland,False,4,-2,Uruguay
30471,32596,34644,2012,Qatar,Lebanon,1,0,FIFA World Cup qualification,Doha,Qatar,False,1,1,Qatar
30472,32597,34645,2012,Romania,Belgium,2,1,Friendly,Bucharest,Romania,False,3,1,Romania
30473,32598,34646,2012,Russia,United States,2,2,Friendly,Krasnodar,Russia,False,4,0,Draw
30474,32599,34647,2012,Rwanda,Namibia,2,2,Friendly,Kigali,Rwanda,False,4,0,Draw
30475,32600,34648,2012,Saudi Arabia,Argentina,0,0,Friendly,Riyadh,Saudi Arabia,False,0,0,Draw
30476,32601,34649,2012,Serbia,Chile,3,1,Friendly,St. Gallen,Switzerland,True,4,2,Serbia
30477,32602,34650,2012,South Africa,Zambia,0,1,Friendly,Johannesburg,South Africa,False,1,-1,Zambia
30478,32603,34651,2012,Sweden,England,4,2,Friendly,Solna,Sweden,False,6,2,Sweden
30479,32604,34652,2012,Tanzania,Kenya,1,0,Friendly,Mwanza,Tanzania,False,1,1,Tanzania
30480,32605,34653,2012,Thailand,Bhutan,5,0,Friendly,Bangkok,Thailand,False,5,5,Thailand
30481,32606,34654,2012,Tunisia,Switzerland,1,2,Friendly,Sousse,Tunisia,False,3,-1,Switzerland
30482,32607,34655,2012,Turkey,Denmark,1,1,Friendly,Istanbul,Turkey,False,2,0,Draw
30483,32608,34656,2012,United Arab Emirates,Estonia,2,1,Friendly,Abu Dhabi,United Arab Emirates,False,3,1,United Arab Emirates
30484,32609,34657,2012,Venezuela,Nigeria,1,3,Friendly,Miami,United States,True,4,-2,Nigeria
30485,32610,34658,2012,Philippines,Singapore,1,0,Friendly,Cebu City,Philippines,False,1,1,Philippines
30486,32611,34659,2012,French Guiana,Haiti,1,0,CFU Caribbean Cup qualification,St. George's,Grenada,True,1,1,French Guiana
30487,32612,34660,2012,Trinidad and Tobago,Suriname,3,0,CFU Caribbean Cup qualification,Bacolet,Trinidad and Tobago,False,3,3,Trinidad and Tobago
30488,32613,34661,2012,Indonesia,Cameroon,0,0,Friendly,Jakarta,Indonesia,False,0,0,Draw
30489,32614,34662,2012,Palestine,Syria,1,1,Friendly,Amman,Jordan,True,2,0,Draw
30490,32615,34663,2012,Thailand,Bangladesh,5,0,Friendly,Bangkok,Thailand,False,5,5,Thailand
30491,32616,34664,2012,Guyana,French Guiana,4,3,CFU Caribbean Cup qualification,St. George's,Grenada,True,7,1,Guyana
30492,32617,34665,2012,Singapore,Pakistan,4,0,Friendly,Jurong,Singapore,False,4,4,Singapore
30493,32618,34666,2012,Malaysia,Bangladesh,1,1,Friendly,Kuala Lumpur,Malaysia,False,2,0,Draw
30494,32619,34667,2012,Palestine,Syria,2,1,Friendly,Zarqa,Jordan,True,3,1,Palestine
30495,32620,34668,2012,Argentina,Brazil,2,1,Friendly,Buenos Aires,Argentina,False,3,1,Argentina
30496,32621,34669,2012,Ethiopia,South Sudan,1,0,CECAFA Cup,Kampala,Uganda,True,1,1,Ethiopia
30497,32622,34670,2012,Guam,Northern Mariana Islands,8,0,Friendly,Yona,Guam,False,8,8,Guam
30498,32623,34671,2012,Thailand,Philippines,2,1,AFF Championship,Bangkok,Thailand,False,3,1,Thailand
30499,32624,34672,2012,Uganda,Kenya,1,0,CECAFA Cup,Kampala,Uganda,False,1,1,Uganda
30500,32625,34673,2012,Vietnam,Burma,1,1,AFF Championship,Bangkok,Thailand,True,2,0,Draw
30501,32626,34674,2012,Burundi,Somalia,5,1,CECAFA Cup,Kampala,Uganda,True,6,4,Burundi
30502,32627,34675,2012,Indonesia,Laos,2,2,AFF Championship,Kuala Lumpur,Malaysia,True,4,0,Draw
30503,32628,34676,2012,Malaysia,Singapore,0,3,AFF Championship,Kuala Lumpur,Malaysia,False,3,-3,Singapore
30504,32629,34677,2012,Tanzania,Sudan,2,0,CECAFA Cup,Kampala,Uganda,True,2,2,Tanzania
30505,32630,34678,2012,Rwanda,Malawi,2,0,CECAFA Cup,Kampala,Uganda,True,2,2,Rwanda
30506,32631,34680,2012,South Sudan,Kenya,0,2,CECAFA Cup,Kampala,Uganda,True,2,-2,Kenya
30507,32632,34681,2012,Thailand,Burma,4,0,AFF Championship,Bangkok,Thailand,False,4,4,Thailand
30508,32633,34682,2012,Uganda,Ethiopia,1,0,CECAFA Cup,Kampala,Uganda,False,1,1,Uganda
30509,32634,34683,2012,Vietnam,Philippines,0,1,AFF Championship,Bangkok,Thailand,True,1,-1,Philippines
30510,32635,34684,2012,Indonesia,Singapore,1,0,AFF Championship,Kuala Lumpur,Malaysia,True,1,1,Indonesia
30511,32636,34685,2012,Malaysia,Laos,4,1,AFF Championship,Kuala Lumpur,Malaysia,False,5,3,Malaysia
30512,32637,34686,2012,Somalia,Sudan,0,1,CECAFA Cup,Kampala,Uganda,True,1,-1,Sudan
30513,32638,34687,2012,Tanzania,Burundi,0,1,CECAFA Cup,Kampala,Uganda,True,1,-1,Burundi
30514,32639,34688,2012,Malawi,Eritrea,3,2,CECAFA Cup,Kampala,Uganda,True,5,1,Malawi
30515,32640,34689,2012,Palestine,Bahrain,0,2,Friendly,al-Wakrah,Qatar,True,2,-2,Bahrain
30516,32642,34691,2012,Kenya,Ethiopia,3,1,CECAFA Cup,Kampala,Uganda,True,4,2,Kenya
30517,32643,34692,2012,Philippines,Burma,2,0,AFF Championship,Bangkok,Thailand,True,2,2,Philippines
30518,32644,34693,2012,Thailand,Vietnam,3,1,AFF Championship,Bangkok,Thailand,False,4,2,Thailand
30519,32645,34694,2012,Uganda,South Sudan,4,0,CECAFA Cup,Kampala,Uganda,False,4,4,Uganda
30520,32646,34695,2012,Burkina Faso,Togo,2,1,African Nations Championship,Ouagadougou,Burkina Faso,False,3,1,Burkina Faso
30521,32647,34696,2012,Eritrea,Rwanda,0,2,CECAFA Cup,Kampala,Uganda,True,2,-2,Rwanda
30522,32648,34697,2012,Hong Kong,Guam,2,1,EAFF Championship,Kowloon,Hong Kong,False,3,1,Hong Kong
30523,32650,34699,2012,Malaysia,Indonesia,2,0,AFF Championship,Kuala Lumpur,Malaysia,False,2,2,Malaysia
30524,32651,34700,2012,Mauritius,Comoros,2,0,African Nations Championship,Curepipe,Mauritius,False,2,2,Mauritius
30525,32652,34701,2012,Singapore,Laos,4,3,AFF Championship,Shah Alam,Malaysia,True,7,1,Singapore
30526,32653,34702,2012,Somalia,Tanzania,0,7,CECAFA Cup,Kampala,Uganda,True,7,-7,Tanzania
30527,32654,34703,2012,Sudan,Burundi,0,1,CECAFA Cup,Kampala,Uganda,True,1,-1,Burundi
30528,32655,34704,2012,Guinea,Sierra Leone,0,0,African Nations Championship,Conakry,Guinea,False,0,0,Draw
30529,32656,34705,2012,Liberia,Mauritania,0,1,African Nations Championship,Paynesville,Liberia,False,1,-1,Mauritania
30530,32657,34706,2012,Mozambique,Seychelles,4,0,African Nations Championship,Maputo,Mozambique,False,4,4,Mozambique
30531,32659,34708,2012,Hong Kong,Australia,0,1,EAFF Championship,Kowloon,Hong Kong,False,1,-1,Australia
30532,32660,34710,2012,Rwanda,Tanzania,0,2,CECAFA Cup,Kampala,Uganda,True,2,-2,Tanzania
30533,32661,34711,2012,Kenya,Malawi,1,0,CECAFA Cup,Kampala,Uganda,True,1,1,Kenya
30534,32662,34712,2012,Uganda,Ethiopia,2,0,CECAFA Cup,Kampala,Uganda,False,2,2,Uganda
30535,32663,34714,2012,Uganda,Tanzania,3,0,CECAFA Cup,Kampala,Uganda,False,3,3,Uganda
30536,32664,34716,2012,Antigua and Barbuda,Dominican Republic,1,2,CFU Caribbean Cup,St. John's,Antigua and Barbuda,False,3,-1,Dominican Republic
30537,32665,34717,2012,Guam,Australia,0,9,EAFF Championship,So Kon Po,Hong Kong,True,9,-9,Australia
30538,32666,34718,2012,Haiti,Trinidad and Tobago,0,0,CFU Caribbean Cup,St. John's,Antigua and Barbuda,True,0,0,Draw
30539,32668,34720,2012,Jamaica,French Guiana,1,2,CFU Caribbean Cup,North Sound,Antigua and Barbuda,True,3,-1,French Guiana
30540,32669,34721,2012,Kuwait,Palestine,2,1,WAFF Championship,Kuwait City,Kuwait,False,3,1,Kuwait
30541,32670,34722,2012,Martinique,Cuba,1,0,CFU Caribbean Cup,North Sound,Antigua and Barbuda,True,1,1,Martinique
30542,32671,34723,2012,Oman,Lebanon,0,1,WAFF Championship,al-Farwaniyah,Kuwait,True,1,-1,Lebanon
30543,32672,34724,2012,Philippines,Singapore,0,0,AFF Championship,Manila,Philippines,False,0,0,Draw
30544,32674,34726,2012,Uganda,Kenya,2,1,CECAFA Cup,Kampala,Uganda,False,3,1,Uganda
30545,32675,34727,2012,Antigua and Barbuda,Trinidad and Tobago,2,0,CFU Caribbean Cup,St. John's,Antigua and Barbuda,False,2,2,Antigua and Barbuda
30546,32677,34729,2012,Bahrain,Yemen,1,0,WAFF Championship,al-Farwaniyah,Kuwait,True,1,1,Bahrain
30547,32678,34730,2012,Dominican Republic,Haiti,1,2,CFU Caribbean Cup,St. John's,Antigua and Barbuda,True,3,-1,Haiti
30548,32680,34732,2012,Iran,Saudi Arabia,0,0,WAFF Championship,Kuwait City,Kuwait,True,0,0,Draw
30549,32681,34733,2012,Malaysia,Thailand,1,1,AFF Championship,Kuala Lumpur,Malaysia,False,2,0,Draw
30550,32682,34734,2012,Cuba,French Guiana,2,1,CFU Caribbean Cup,North Sound,Antigua and Barbuda,True,3,1,Cuba
30551,32683,34735,2012,Iraq,Jordan,1,0,WAFF Championship,al-Farwaniyah,Kuwait,True,1,1,Iraq
30552,32684,34736,2012,Jamaica,Martinique,0,0,CFU Caribbean Cup,North Sound,Antigua and Barbuda,True,0,0,Draw
30553,32685,34737,2012,Antigua and Barbuda,Haiti,0,1,CFU Caribbean Cup,St. John's,Antigua and Barbuda,False,1,-1,Haiti
30554,32686,34738,2012,Kuwait,Oman,0,2,WAFF Championship,Kuwait City,Kuwait,False,2,-2,Oman
30555,32687,34739,2012,Lebanon,Palestine,0,1,WAFF Championship,al-Farwaniyah,Kuwait,True,1,-1,Palestine
30556,32688,34740,2012,Trinidad and Tobago,Dominican Republic,2,1,CFU Caribbean Cup,St. John's,Antigua and Barbuda,True,3,1,Trinidad and Tobago
30557,32689,34741,2012,French Guiana,Martinique,1,3,CFU Caribbean Cup,North Sound,Antigua and Barbuda,True,4,-2,Martinique
30558,32690,34742,2012,Iran,Bahrain,0,0,WAFF Championship,Kuwait City,Kuwait,True,0,0,Draw
30559,32691,34743,2012,Jamaica,Cuba,0,1,CFU Caribbean Cup,North Sound,Antigua and Barbuda,True,1,-1,Cuba
30560,32692,34744,2012,Singapore,Philippines,1,0,AFF Championship,Singapore,Singapore,False,1,1,Singapore
30561,32693,34745,2012,Yemen,Saudi Arabia,0,1,WAFF Championship,al-Farwaniyah,Kuwait,True,1,-1,Saudi Arabia
30562,32694,34746,2012,Iraq,Syria,1,1,WAFF Championship,Kuwait City,Kuwait,True,2,0,Draw
30563,32695,34747,2012,Thailand,Malaysia,2,0,AFF Championship,Bangkok,Thailand,False,2,2,Thailand
30564,32696,34748,2012,Haiti,Cuba,0,1,CFU Caribbean Cup,St. John's,Antigua and Barbuda,True,1,-1,Cuba
30565,32697,34749,2012,Kuwait,Lebanon,2,1,WAFF Championship,Kuwait City,Kuwait,False,3,1,Kuwait
30566,32698,34751,2012,Martinique,Trinidad and Tobago,1,1,CFU Caribbean Cup,St. John's,Antigua and Barbuda,True,2,0,Draw
30567,32699,34752,2012,Oman,Palestine,2,1,WAFF Championship,al-Farwaniyah,Kuwait,True,3,1,Oman
30568,32700,34753,2012,Angola,Gambia,1,1,Friendly,Benguela,Angola,False,2,0,Draw
30569,32701,34754,2012,Bahrain,Saudi Arabia,1,0,WAFF Championship,al-Farwaniyah,Kuwait,True,1,1,Bahrain
30570,32702,34755,2012,Comoros,Mauritius,0,0,African Nations Championship,Mitsamiouli,Comoros,False,0,0,Draw
30571,32703,34756,2012,Iran,Yemen,2,1,WAFF Championship,Kuwait City,Kuwait,True,3,1,Iran
30572,32704,34757,2012,Mauritania,Liberia,2,1,African Nations Championship,Nouakchott,Mauritania,False,3,1,Mauritania
30573,32705,34758,2012,Seychelles,Mozambique,1,2,African Nations Championship,Roche Caiman,Seychelles,False,3,-1,Mozambique
30574,32706,34759,2012,Sierra Leone,Guinea,1,1,African Nations Championship,Freetown,Sierra Leone,False,2,0,Draw
30575,32707,34760,2012,Burundi,Kenya,1,0,African Nations Championship,Bujumbura,Burundi,False,1,1,Burundi
30576,32708,34761,2012,Cuba,Trinidad and Tobago,1,0,CFU Caribbean Cup,St. John's,Antigua and Barbuda,True,1,1,Cuba
30577,32709,34762,2012,Haiti,Martinique,1,0,CFU Caribbean Cup,St. John's,Antigua and Barbuda,True,1,1,Haiti
30578,32710,34763,2012,Syria,Jordan,2,1,WAFF Championship,Kuwait City,Kuwait,True,3,1,Syria
30579,32711,34764,2012,Togo,Burkina Faso,0,1,African Nations Championship,Lomé,Togo,False,1,-1,Burkina Faso
30580,32712,34765,2012,Bahrain,Syria,1,1,WAFF Championship,Kuwait City,Kuwait,True,2,0,Draw
30581,32713,34766,2012,Oman,Iraq,0,2,WAFF Championship,al-Farwaniyah,Kuwait,True,2,-2,Iraq
30582,32714,34767,2012,Oman,Benin,2,0,Friendly,Sur,Oman,False,2,2,Oman
30583,32715,34768,2012,Singapore,Thailand,3,1,AFF Championship,Singapore,Singapore,False,4,2,Singapore
30584,32716,34769,2012,Iraq,Syria,0,1,WAFF Championship,Kuwait City,Kuwait,True,1,-1,Syria
30585,32717,34770,2012,Oman,Bahrain,1,0,WAFF Championship,Kuwait City,Kuwait,True,1,1,Oman
30586,32718,34771,2012,Angola,Rwanda,1,0,Friendly,Luanda,Angola,False,1,1,Angola
30587,32719,34772,2012,South Africa,Malawi,3,1,Friendly,Durban,South Africa,False,4,2,South Africa
30588,32720,34773,2012,Tanzania,Zambia,1,0,Friendly,Dar es Salaam,Tanzania,False,1,1,Tanzania
30589,32721,34774,2012,Thailand,Singapore,1,0,AFF Championship,Bangkok,Thailand,False,1,1,Thailand
30590,32722,34775,2012,United Arab Emirates,Yemen,2,0,Friendly,Doha,Qatar,True,2,2,United Arab Emirates
30591,32723,34776,2012,Bahrain,Burkina Faso,0,0,Friendly,Riffa,Bahrain,False,0,0,Draw
30592,32724,34777,2012,Qatar,Egypt,0,2,Friendly,Doha,Qatar,False,2,-2,Egypt
30593,32725,34778,2012,Bahrain,Guinea,3,0,Friendly,Riffa,Bahrain,False,3,3,Bahrain
30594,32726,34779,2012,Oman,Togo,0,1,Friendly,Sohar,Oman,False,1,-1,Togo
30595,32727,34780,2012,United Arab Emirates,Yemen,3,1,Friendly,Doha,Qatar,True,4,2,United Arab Emirates
30596,32728,34782,2012,Ethiopia,Niger,1,0,Friendly,Addis Ababa,Ethiopia,False,1,1,Ethiopia
30597,32729,34783,2012,Iraq,Tunisia,1,2,Friendly,Baghdad,Iraq,False,3,-1,Tunisia
30598,32730,34785,2013,Bahrain,Oman,0,0,Gulf Cup,Riffa,Bahrain,False,0,0,Draw
30599,32731,34786,2013,Niger,Togo,3,1,Friendly,Niamey,Niger,False,4,2,Niger
30600,32732,34787,2013,Qatar,United Arab Emirates,1,3,Gulf Cup,Riffa,Bahrain,True,4,-2,United Arab Emirates
30601,32733,34788,2013,Zambia,Angola,0,2,Friendly,Johannesburg,South Africa,True,2,-2,Angola
30602,32734,34789,2013,Kenya,Burundi,0,0,African Nations Championship,Nairobi,Kenya,False,0,0,Draw
30603,32735,34790,2013,Kuwait,Yemen,2,0,Gulf Cup,Isa Town,Bahrain,True,2,2,Kuwait
30604,32736,34791,2013,Saudi Arabia,Iraq,0,2,Gulf Cup,Isa Town,Bahrain,True,2,-2,Iraq
30605,32737,34792,2013,Tunisia,Ethiopia,1,1,Friendly,al-Wakrah,Qatar,True,2,0,Draw
30606,32738,34793,2013,Bahrain,United Arab Emirates,1,2,Gulf Cup,Riffa,Bahrain,False,3,-1,United Arab Emirates
30607,32739,34794,2013,Qatar,Oman,2,1,Gulf Cup,Riffa,Bahrain,True,3,1,Qatar
30608,32740,34795,2013,South Africa,Norway,0,1,Friendly,Cape Town,South Africa,False,1,-1,Norway
30609,32741,34796,2013,Zambia,Morocco,0,0,Friendly,Johannesburg,South Africa,True,0,0,Draw
30610,32742,34798,2013,Iraq,Kuwait,1,0,Gulf Cup,Isa Town,Bahrain,True,1,1,Iraq
30611,32743,34799,2013,Yemen,Saudi Arabia,0,2,Gulf Cup,Isa Town,Bahrain,True,2,-2,Saudi Arabia
30612,32744,34800,2013,Gabon,Tunisia,1,1,Friendly,Abu Dhabi,United Arab Emirates,True,2,0,Draw
30613,32745,34801,2013,Ghana,Egypt,3,0,Friendly,Abu Dhabi,United Arab Emirates,True,3,3,Ghana
30614,32746,34802,2013,Panama,Guatemala,3,0,Friendly,Panama City,Panama,False,3,3,Panama
30615,32747,34803,2013,Bahrain,Qatar,1,0,Gulf Cup,Riffa,Bahrain,False,1,1,Bahrain
30616,32748,34804,2013,Ethiopia,Tanzania,2,1,Friendly,Addis Ababa,Ethiopia,False,3,1,Ethiopia
30617,32749,34805,2013,United Arab Emirates,Oman,2,0,Gulf Cup,Isa Town,Bahrain,True,2,2,United Arab Emirates
30618,32750,34806,2013,Iraq,Yemen,2,0,Gulf Cup,Isa Town,Bahrain,True,2,2,Iraq
30619,32751,34807,2013,Kuwait,Saudi Arabia,1,0,Gulf Cup,Riffa,Bahrain,True,1,1,Kuwait
30620,32752,34808,2013,Namibia,Morocco,1,2,Friendly,Johannesburg,South Africa,True,3,-1,Morocco
30621,32753,34809,2013,South Africa,Algeria,0,0,Friendly,Johannesburg,South Africa,False,0,0,Draw
30622,32754,34810,2013,Zambia,Norway,0,0,Friendly,Ndola,Zambia,False,0,0,Draw
30623,32755,34811,2013,Angola,Botswana,2,0,Friendly,Johannesburg,South Africa,True,2,2,Angola
30624,32756,34812,2013,Ghana,Tunisia,4,2,Friendly,Abu Dhabi,United Arab Emirates,True,6,2,Ghana
30625,32757,34813,2013,Panama,Guatemala,2,0,Friendly,Panama City,Panama,False,2,2,Panama
30626,32758,34814,2013,Togo,Niger,2,1,Friendly,Lomé,Togo,False,3,1,Togo
30627,32759,34815,2013,Ivory Coast,Egypt,4,2,Friendly,Abu Dhabi,United Arab Emirates,True,6,2,Ivory Coast
30628,32760,34816,2013,Bahrain,Iraq,1,1,Gulf Cup,Riffa,Bahrain,False,2,0,Draw
30629,32761,34817,2013,Lebanon,Gabon,0,0,Friendly,Sidon,Lebanon,False,0,0,Draw
30630,32762,34818,2013,United Arab Emirates,Kuwait,1,0,Gulf Cup,Riffa,Bahrain,True,1,1,United Arab Emirates
30631,32763,34819,2013,Eswatini,Burkina Faso,0,3,Friendly,Nelspruit,South Africa,True,3,-3,Burkina Faso
30632,32764,34820,2013,Bahrain,Kuwait,1,6,Gulf Cup,Isa Town,Bahrain,False,7,-5,Kuwait
30633,32765,34821,2013,Costa Rica,Belize,1,0,UNCAF Cup,San José,Costa Rica,False,1,1,Costa Rica
30634,32766,34822,2013,Guatemala,Nicaragua,1,1,UNCAF Cup,San José,Costa Rica,True,2,0,Draw
30635,32767,34823,2013,Honduras,El Salvador,1,1,UNCAF Cup,San José,Costa Rica,True,2,0,Draw
30636,32768,34824,2013,United Arab Emirates,Iraq,2,1,Gulf Cup,Riffa,Bahrain,True,3,1,United Arab Emirates
30637,32769,34825,2013,Angola,Morocco,0,0,African Cup of Nations,Johannesburg,South Africa,True,0,0,Draw
30638,32770,34826,2013,Chile,Haiti,3,0,Friendly,Concepción,Chile,False,3,3,Chile
30639,32772,34828,2013,Belize,Guatemala,0,0,UNCAF Cup,San José,Costa Rica,True,0,0,Draw
30640,32773,34829,2013,Costa Rica,Nicaragua,2,0,UNCAF Cup,San José,Costa Rica,False,2,2,Costa Rica
30641,32774,34830,2013,El Salvador,Panama,0,0,UNCAF Cup,San José,Costa Rica,True,0,0,Draw
30642,32775,34831,2013,Ghana,DR Congo,2,2,African Cup of Nations,Port Elizabeth,South Africa,True,4,0,Draw
30643,32776,34832,2013,Mali,Niger,1,0,African Cup of Nations,Port Elizabeth,South Africa,True,1,1,Mali
30644,32777,34833,2013,Nigeria,Burkina Faso,1,1,African Cup of Nations,Nelspruit,South Africa,True,2,0,Draw
30645,32778,34834,2013,Zambia,Ethiopia,1,1,African Cup of Nations,Nelspruit,South Africa,True,2,0,Draw
30646,32779,34835,2013,Costa Rica,Guatemala,1,1,UNCAF Cup,San José,Costa Rica,False,2,0,Draw
30647,32780,34836,2013,Ivory Coast,Togo,2,1,African Cup of Nations,Rustenburg,South Africa,True,3,1,Ivory Coast
30648,32781,34837,2013,Nicaragua,Belize,1,2,UNCAF Cup,San José,Costa Rica,True,3,-1,Belize
30649,32782,34838,2013,Panama,Honduras,1,1,UNCAF Cup,San José,Costa Rica,True,2,0,Draw
30650,32783,34839,2013,Tunisia,Algeria,1,0,African Cup of Nations,Rustenburg,South Africa,True,1,1,Tunisia
30651,32785,34841,2013,South Africa,Angola,2,0,African Cup of Nations,Durban,South Africa,False,2,2,South Africa
30652,32787,34843,2013,Thailand,Finland,1,3,King's Cup,Chiang Mai,Thailand,False,4,-2,Finland
30653,32788,34844,2013,Ghana,Mali,1,0,African Cup of Nations,Port Elizabeth,South Africa,True,1,1,Ghana
30654,32789,34845,2013,Niger,DR Congo,0,0,African Cup of Nations,Port Elizabeth,South Africa,True,0,0,Draw
30655,32790,34846,2013,Burkina Faso,Ethiopia,4,0,African Cup of Nations,Nelspruit,South Africa,True,4,4,Burkina Faso
30656,32791,34847,2013,Costa Rica,El Salvador,1,0,UNCAF Cup,San José,Costa Rica,False,1,1,Costa Rica
30657,32792,34848,2013,Guatemala,Panama,1,3,UNCAF Cup,San José,Costa Rica,True,4,-2,Panama
30658,32793,34849,2013,Honduras,Belize,1,0,UNCAF Cup,San José,Costa Rica,True,1,1,Honduras
30659,32794,34850,2013,Zambia,Nigeria,1,1,African Cup of Nations,Nelspruit,South Africa,True,2,0,Draw
30660,32795,34851,2013,Algeria,Togo,0,2,African Cup of Nations,Rustenburg,South Africa,True,2,-2,Togo
30661,32796,34852,2013,Ivory Coast,Tunisia,3,0,African Cup of Nations,Rustenburg,South Africa,True,3,3,Ivory Coast
30662,32797,34853,2013,Sweden,Finland,3,0,King's Cup,Chiang Mai,Thailand,True,3,3,Sweden
30663,32799,34856,2013,Costa Rica,Honduras,1,0,UNCAF Cup,San José,Costa Rica,False,1,1,Costa Rica
30664,32800,34857,2013,El Salvador,Belize,1,0,UNCAF Cup,San José,Costa Rica,True,1,1,El Salvador
30665,32801,34858,2013,South Africa,Morocco,2,2,African Cup of Nations,Durban,South Africa,False,4,0,Draw
30666,32802,34859,2013,DR Congo,Mali,1,1,African Cup of Nations,Durban,South Africa,True,2,0,Draw
30667,32803,34860,2013,Niger,Ghana,0,3,African Cup of Nations,Port Elizabeth,South Africa,True,3,-3,Ghana
30668,32804,34861,2013,Burkina Faso,Zambia,0,0,African Cup of Nations,Nelspruit,South Africa,True,0,0,Draw
30669,32805,34862,2013,Ethiopia,Nigeria,0,2,African Cup of Nations,Rustenburg,South Africa,True,2,-2,Nigeria
30670,32806,34863,2013,United States,Canada,0,0,Friendly,Houston,United States,False,0,0,Draw
30671,32807,34864,2013,Algeria,Ivory Coast,2,2,African Cup of Nations,Rustenburg,South Africa,True,4,0,Draw
30672,32809,34866,2013,Togo,Tunisia,1,1,African Cup of Nations,Nelspruit,South Africa,True,2,0,Draw
30673,32810,34867,2013,Jordan,Indonesia,5,0,Friendly,Amman,Jordan,False,5,5,Jordan
30674,32811,34868,2013,Qatar,Lebanon,1,0,Friendly,Doha,Qatar,False,1,1,Qatar
30675,32812,34869,2013,Uzbekistan,Azerbaijan,0,0,Friendly,Dubai,United Arab Emirates,True,0,0,Draw
30676,32814,34871,2013,Romania,Poland,1,4,Friendly,Málaga,Spain,True,5,-3,Poland
30677,32815,34872,2013,South Africa,Mali,1,1,African Cup of Nations,Durban,South Africa,False,2,0,Draw
30678,32816,34873,2013,Burkina Faso,Togo,1,0,African Cup of Nations,Nelspruit,South Africa,True,1,1,Burkina Faso
30679,32817,34874,2013,Ivory Coast,Nigeria,1,2,African Cup of Nations,Rustenburg,South Africa,True,3,-1,Nigeria
30680,32818,34875,2013,Armenia,Luxembourg,1,1,Friendly,Valence,France,True,2,0,Draw
30681,32819,34876,2013,Albania,Georgia,1,2,Friendly,Tirana,Albania,False,3,-1,Georgia
30682,32820,34877,2013,Azerbaijan,Liechtenstein,1,0,Friendly,Dubai,United Arab Emirates,True,1,1,Azerbaijan
30683,32821,34878,2013,Belgium,Slovakia,2,1,Friendly,Bruges,Belgium,False,3,1,Belgium
30684,32822,34879,2013,Burkina Faso,Ghana,1,1,African Cup of Nations,Nelspruit,South Africa,True,2,0,Draw
30685,32823,34880,2013,Burma,Philippines,0,1,Friendly,Rangoon,Burma,False,1,-1,Philippines
30686,32824,34881,2013,Chile,Egypt,2,1,Friendly,Madrid,Spain,True,3,1,Chile
30687,32826,34883,2013,Cyprus,Serbia,1,3,Friendly,Nicosia,Cyprus,False,4,-2,Serbia
30688,32827,34884,2013,England,Brazil,2,1,Friendly,London,England,False,3,1,England
30689,32828,34885,2013,France,Germany,1,2,Friendly,Saint-Denis,France,False,3,-1,Germany
30690,32829,34886,2013,Greece,Switzerland,0,0,Friendly,Piraeus,Greece,False,0,0,Draw
30691,32830,34887,2013,Honduras,United States,2,1,FIFA World Cup qualification,San Pedro Sula,Honduras,False,3,1,Honduras
30692,32831,34888,2013,Hungary,Belarus,1,1,Friendly,Belek,Turkey,True,2,0,Draw
30693,32832,34889,2013,Iceland,Russia,0,2,Friendly,Marbella,Spain,True,2,-2,Russia
30694,32833,34890,2013,India,Palestine,2,4,Friendly,Kochi,India,False,6,-2,Palestine
30695,32834,34891,2013,Iran,Lebanon,5,0,AFC Asian Cup qualification,Teheran,Iran,False,5,5,Iran
30696,32835,34892,2013,Iraq,Indonesia,1,0,AFC Asian Cup qualification,Dubai,United Arab Emirates,True,1,1,Iraq
30697,32836,34893,2013,Republic of Ireland,Poland,2,0,Friendly,Dublin,Republic of Ireland,False,2,2,Republic of Ireland
30698,32837,34894,2013,Israel,Finland,2,1,Friendly,Netanya,Israel,False,3,1,Israel
30699,32838,34895,2013,Japan,Latvia,3,0,Friendly,Kobe,Japan,False,3,3,Japan
30700,32839,34896,2013,Jordan,Singapore,4,0,AFC Asian Cup qualification,Amman,Jordan,False,4,4,Jordan
30701,32840,34897,2013,Kenya,Libya,3,0,Friendly,Tunis,Tunisia,True,3,3,Kenya
30702,32841,34900,2013,Mali,Nigeria,1,4,African Cup of Nations,Durban,South Africa,True,5,-3,Nigeria
30703,32842,34901,2013,Malta,Northern Ireland,0,0,Friendly,Attard,Malta,False,0,0,Draw
30704,32843,34902,2013,Mexico,Jamaica,0,0,FIFA World Cup qualification,Mexico City,Mexico,False,0,0,Draw
30705,32844,34903,2013,Moldova,Kazakhstan,1,3,Friendly,Antalya,Turkey,True,4,-2,Kazakhstan
30706,32845,34904,2013,Nepal,Pakistan,0,1,Friendly,Kathmandu,Nepal,False,1,-1,Pakistan
30707,32846,34905,2013,Netherlands,Italy,1,1,Friendly,Amsterdam,Netherlands,False,2,0,Draw
30708,32847,34906,2013,Norway,Ukraine,0,2,Friendly,Seville,Spain,True,2,-2,Ukraine
30709,32848,34907,2013,Oman,Syria,1,0,AFC Asian Cup qualification,Muscat,Oman,False,1,1,Oman
30710,32849,34908,2013,Panama,Costa Rica,2,2,FIFA World Cup qualification,Panama City,Panama,False,4,0,Draw
30711,32850,34909,2013,Portugal,Ecuador,2,3,Friendly,Guimarães,Portugal,False,5,-1,Ecuador
30712,32851,34910,2013,Qatar,Malaysia,2,0,AFC Asian Cup qualification,Doha,Qatar,False,2,2,Qatar
30713,32852,34911,2013,Romania,Australia,3,2,Friendly,Málaga,Spain,True,5,1,Romania
30714,32853,34912,2013,Rwanda,Uganda,2,2,Friendly,Kigali,Rwanda,False,4,0,Draw
30715,32855,34914,2013,Scotland,Estonia,1,0,Friendly,Aberdeen,Scotland,False,1,1,Scotland
30716,32856,34915,2013,Slovenia,Bosnia and Herzegovina,0,3,Friendly,Ljubljana,Slovenia,False,3,-3,Bosnia and Herzegovina
30717,32857,34916,2013,Spain,Uruguay,3,1,Friendly,Doha,Qatar,True,4,2,Spain
30718,32858,34917,2013,Sweden,Argentina,2,3,Friendly,Solna,Sweden,False,5,-1,Argentina
30719,32859,34918,2013,Tanzania,Cameroon,1,0,Friendly,Dar es Salaam,Tanzania,False,1,1,Tanzania
30720,32860,34919,2013,Thailand,Kuwait,1,3,AFC Asian Cup qualification,Bangkok,Thailand,False,4,-2,Kuwait
30721,32861,34920,2013,Turkey,Czech Republic,0,2,Friendly,Manisa,Turkey,False,2,-2,Czech Republic
30722,32862,34921,2013,Uzbekistan,Hong Kong,0,0,AFC Asian Cup qualification,Tashkent,Uzbekistan,False,0,0,Draw
30723,32863,34922,2013,Vietnam,United Arab Emirates,1,2,AFC Asian Cup qualification,Hanoi,Vietnam,False,3,-1,United Arab Emirates
30724,32864,34923,2013,Wales,Austria,2,1,Friendly,Swansea,Wales,False,3,1,Wales
30725,32865,34924,2013,Yemen,Bahrain,0,2,AFC Asian Cup qualification,Sharjah,United Arab Emirates,True,2,-2,Bahrain
30726,32866,34925,2013,Zimbabwe,Botswana,2,1,Friendly,Harare,Zimbabwe,False,3,1,Zimbabwe
30727,32867,34926,2013,Mali,Ghana,3,1,African Cup of Nations,Port Elizabeth,South Africa,True,4,2,Mali
30728,32868,34927,2013,Nepal,Pakistan,0,1,Friendly,Kathmandu,Nepal,False,1,-1,Pakistan
30729,32869,34928,2013,Nigeria,Burkina Faso,1,0,African Cup of Nations,Johannesburg,South Africa,True,1,1,Nigeria
30730,32870,34929,2013,Maldives,Pakistan,1,1,Friendly,Malé,Maldives,False,2,0,Draw
30731,32871,34930,2013,Maldives,Pakistan,3,0,Friendly,Malé,Maldives,False,3,3,Maldives
30732,32872,34931,2013,Gambia,Mauritania,0,2,Friendly,Bakau,Gambia,False,2,-2,Mauritania
30733,32873,34932,2013,Afghanistan,Sri Lanka,1,0,AFC Challenge Cup qualification,Vientiane,Laos,True,1,1,Afghanistan
30734,32874,34933,2013,Burma,Guam,5,0,AFC Challenge Cup qualification,Rangoon,Burma,False,5,5,Burma
30735,32875,34934,2013,Gambia,Mauritania,0,0,Friendly,Bakau,Gambia,False,0,0,Draw
30736,32877,34936,2013,Laos,Mongolia,1,1,AFC Challenge Cup qualification,Vientiane,Laos,False,2,0,Draw
30737,32878,34937,2013,Nepal,Northern Mariana Islands,6,0,AFC Challenge Cup qualification,Kathmandu,Nepal,False,6,6,Nepal
30738,32879,34938,2013,Palestine,Bangladesh,1,0,AFC Challenge Cup qualification,Kathmandu,Nepal,True,1,1,Palestine
30739,32880,34939,2013,Guam,India,0,4,AFC Challenge Cup qualification,Rangoon,Burma,True,4,-4,India
30740,32881,34940,2013,Laos,Sri Lanka,4,2,AFC Challenge Cup qualification,Vientiane,Laos,False,6,2,Laos
30741,32882,34941,2013,Mongolia,Afghanistan,0,1,AFC Challenge Cup qualification,Vientiane,Laos,True,1,-1,Afghanistan
30742,32883,34942,2013,Nepal,Bangladesh,0,2,AFC Challenge Cup qualification,Kathmandu,Nepal,False,2,-2,Bangladesh
30743,32884,34943,2013,Northern Mariana Islands,Palestine,0,9,AFC Challenge Cup qualification,Kathmandu,Nepal,True,9,-9,Palestine
30744,32885,34944,2013,Bangladesh,Northern Mariana Islands,4,0,AFC Challenge Cup qualification,Kathmandu,Nepal,True,4,4,Bangladesh
30745,32886,34945,2013,Burma,India,1,0,AFC Challenge Cup qualification,Rangoon,Burma,False,1,1,Burma
30746,32887,34946,2013,Laos,Afghanistan,1,1,AFC Challenge Cup qualification,Vientiane,Laos,False,2,0,Draw
30747,32888,34947,2013,Nepal,Palestine,0,0,AFC Challenge Cup qualification,Kathmandu,Nepal,False,0,0,Draw
30748,32889,34948,2013,Sri Lanka,Mongolia,3,0,AFC Challenge Cup qualification,Vientiane,Laos,True,3,3,Sri Lanka
30749,32890,34949,2013,Qatar,Egypt,3,1,Friendly,Doha,Qatar,False,4,2,Qatar
30750,32891,34950,2013,Senegal,Libya,0,4,Friendly,Casablanca,Morocco,True,4,-4,Libya
30751,32892,34951,2013,Bahrain,Lebanon,0,0,Friendly,Riffa,Bahrain,False,0,0,Draw
30752,32893,34952,2013,Kyrgyzstan,Macau,1,0,AFC Challenge Cup qualification,Bishkek,Kyrgyzstan,False,1,1,Kyrgyzstan
30753,32894,34953,2013,Malaysia,Saudi Arabia,1,4,Friendly,Shah Alam,Malaysia,False,5,-3,Saudi Arabia
30754,32895,34954,2013,Qatar,Thailand,1,0,Friendly,Doha,Qatar,False,1,1,Qatar
30755,32896,34955,2013,Tajikistan,Pakistan,1,0,AFC Challenge Cup qualification,Bishkek,Kyrgyzstan,True,1,1,Tajikistan
30756,32897,34956,2013,Botswana,Malawi,1,0,Friendly,Gaborone,Botswana,False,1,1,Botswana
30757,32898,34957,2013,Kyrgyzstan,Pakistan,1,0,AFC Challenge Cup qualification,Bishkek,Kyrgyzstan,False,1,1,Kyrgyzstan
30758,32899,34958,2013,Macau,Tajikistan,0,3,AFC Challenge Cup qualification,Bishkek,Kyrgyzstan,True,3,-3,Tajikistan
30759,32900,34959,2013,Oman,Haiti,3,0,Friendly,Muscat,Oman,False,3,3,Oman
30760,32901,34960,2013,Rwanda,Libya,0,1,Friendly,Kigali,Rwanda,False,1,-1,Libya
30761,32902,34961,2013,Ecuador,El Salvador,5,0,Friendly,Quito,Ecuador,False,5,5,Ecuador
30762,32903,34962,2013,Italy,Brazil,2,2,Friendly,Geneva,Switzerland,True,4,0,Draw
30763,32904,34963,2013,Jordan,Belarus,1,0,Friendly,Amman,Jordan,False,1,1,Jordan
30764,32905,34964,2013,Kuwait,Palestine,2,1,Friendly,Kuwait City,Kuwait,False,3,1,Kuwait
30765,32906,34965,2013,Kyrgyzstan,Tajikistan,1,0,AFC Challenge Cup qualification,Bishkek,Kyrgyzstan,False,1,1,Kyrgyzstan
30766,32907,34966,2013,Pakistan,Macau,2,0,AFC Challenge Cup qualification,Bishkek,Kyrgyzstan,True,2,2,Pakistan
30767,32908,34967,2013,Andorra,Turkey,0,2,FIFA World Cup qualification,Sant Julià de Lòria,Andorra,False,2,-2,Turkey
30768,32909,34968,2013,Argentina,Venezuela,3,0,FIFA World Cup qualification,Buenos Aires,Argentina,False,3,3,Argentina
30769,32910,34969,2013,Austria,Faroe Islands,6,0,FIFA World Cup qualification,Vienna,Austria,False,6,6,Austria
30770,32911,34970,2013,Bahrain,Qatar,1,0,AFC Asian Cup qualification,Riffa,Bahrain,False,1,1,Bahrain
30771,32912,34971,2013,Bosnia and Herzegovina,Greece,3,1,FIFA World Cup qualification,Zenica,Bosnia and Herzegovina,False,4,2,Bosnia and Herzegovina
30772,32913,34972,2013,Bulgaria,Malta,6,0,FIFA World Cup qualification,Sofia,Bulgaria,False,6,6,Bulgaria
30773,32914,34974,2013,Colombia,Bolivia,5,0,FIFA World Cup qualification,Barranquilla,Colombia,False,5,5,Colombia
30774,32915,34975,2013,Croatia,Serbia,2,0,FIFA World Cup qualification,Zagreb,Croatia,False,2,2,Croatia
30775,32916,34976,2013,Czech Republic,Denmark,0,3,FIFA World Cup qualification,Olomouc,Czech Republic,False,3,-3,Denmark
30776,32917,34977,2013,Egypt,Eswatini,10,0,Friendly,Alexandria,Egypt,False,10,10,Egypt
30777,32918,34978,2013,France,Georgia,3,1,FIFA World Cup qualification,Saint-Denis,France,False,4,2,France
30778,32919,34979,2013,Honduras,Mexico,2,2,FIFA World Cup qualification,San Pedro Sula,Honduras,False,4,0,Draw
30779,32920,34980,2013,Hong Kong,Vietnam,1,0,AFC Asian Cup qualification,Kowloon,Hong Kong,False,1,1,Hong Kong
30780,32921,34981,2013,Hungary,Romania,2,2,FIFA World Cup qualification,Budapest,Hungary,False,4,0,Draw
30781,32922,34982,2013,Israel,Portugal,3,3,FIFA World Cup qualification,Ramat-Gan,Israel,False,6,0,Draw
30782,32923,34983,2013,Jamaica,Panama,1,1,FIFA World Cup qualification,Kingston,Jamaica,False,2,0,Draw
30783,32924,34984,2013,Japan,Canada,2,1,Friendly,Doha,Qatar,True,3,1,Japan
30784,32925,34985,2013,Kazakhstan,Germany,0,3,FIFA World Cup qualification,Astana,Kazakhstan,False,3,-3,Germany
30785,32926,34986,2013,Lebanon,Thailand,5,2,AFC Asian Cup qualification,Beirut,Lebanon,False,7,3,Lebanon
30786,32927,34987,2013,Liechtenstein,Latvia,1,1,FIFA World Cup qualification,Vaduz,Liechtenstein,False,2,0,Draw
30787,32928,34988,2013,Luxembourg,Azerbaijan,0,0,FIFA World Cup qualification,Luxembourg,Luxembourg,False,0,0,Draw
30788,32929,34990,2013,Malaysia,Yemen,2,1,AFC Asian Cup qualification,Shah Alam,Malaysia,False,3,1,Malaysia
30789,32930,34991,2013,Moldova,Montenegro,0,1,FIFA World Cup qualification,Chişinău,Moldova,False,1,-1,Montenegro
30790,32931,34992,2013,Netherlands,Estonia,3,0,FIFA World Cup qualification,Amsterdam,Netherlands,False,3,3,Netherlands
30791,32932,34993,2013,New Zealand,New Caledonia,2,1,FIFA World Cup qualification,Dunedin,New Zealand,False,3,1,New Zealand
30792,32933,34994,2013,Norway,Albania,0,1,FIFA World Cup qualification,Oslo,Norway,False,1,-1,Albania
30793,32934,34995,2013,Peru,Chile,1,0,FIFA World Cup qualification,Lima,Peru,False,1,1,Peru
30794,32935,34996,2013,Poland,Ukraine,1,3,FIFA World Cup qualification,Warsaw,Poland,False,4,-2,Ukraine
30795,32936,34997,2013,San Marino,England,0,8,FIFA World Cup qualification,Serravalle,San Marino,False,8,-8,England
30796,32937,34998,2013,Scotland,Wales,1,2,FIFA World Cup qualification,Glasgow,Scotland,False,3,-1,Wales
30797,32938,34999,2013,Slovakia,Lithuania,1,1,FIFA World Cup qualification,Žilina,Slovakia,False,2,0,Draw
30798,32939,35000,2013,Slovenia,Iceland,1,2,FIFA World Cup qualification,Ljubljana,Slovenia,False,3,-1,Iceland
30799,32940,35001,2013,Spain,Finland,1,1,FIFA World Cup qualification,Gijón,Spain,False,2,0,Draw
30800,32941,35002,2013,Sweden,Republic of Ireland,0,0,FIFA World Cup qualification,Solna,Sweden,False,0,0,Draw
30801,32942,35004,2013,Turkmenistan,Cambodia,7,0,AFC Challenge Cup qualification,Manila,Philippines,True,7,7,Turkmenistan
30802,32943,35005,2013,United Arab Emirates,Uzbekistan,2,1,AFC Asian Cup qualification,Abu Dhabi,United Arab Emirates,False,3,1,United Arab Emirates
30803,32944,35006,2013,Uruguay,Paraguay,1,1,FIFA World Cup qualification,Montevideo,Uruguay,False,2,0,Draw
30804,32945,35007,2013,United States,Costa Rica,1,0,FIFA World Cup qualification,Commerce City,United States,False,1,1,United States
30805,32946,35008,2013,Belize,Trinidad and Tobago,0,0,Friendly,Belmopan,Belize,False,0,0,Draw
30806,32947,35009,2013,Burkina Faso,Niger,4,0,FIFA World Cup qualification,Ouagadougou,Burkina Faso,False,4,4,Burkina Faso
30807,32948,35010,2013,Cameroon,Togo,2,1,FIFA World Cup qualification,Yaoundé,Cameroon,False,3,1,Cameroon
30808,32949,35011,2013,Congo,Gabon,1,0,FIFA World Cup qualification,Pointe-Noire,Congo,False,1,1,Congo
30809,32950,35012,2013,Cyprus,Switzerland,0,0,FIFA World Cup qualification,Nicosia,Cyprus,False,0,0,Draw
30810,32951,35013,2013,Indonesia,Saudi Arabia,1,2,AFC Asian Cup qualification,Jakarta,Indonesia,False,3,-1,Saudi Arabia
30811,32952,35014,2013,Ivory Coast,Gambia,3,0,FIFA World Cup qualification,Abidjan,Ivory Coast,False,3,3,Ivory Coast
30812,32953,35015,2013,Namibia,Malawi,0,1,FIFA World Cup qualification,Windhoek,Namibia,False,1,-1,Malawi
30813,32954,35016,2013,Nigeria,Kenya,1,1,FIFA World Cup qualification,Calabar,Nigeria,False,2,0,Draw
30814,32955,35017,2013,Senegal,Angola,1,1,FIFA World Cup qualification,Conakry,Guinea,True,2,0,Draw
30815,32956,35018,2013,South Africa,Central African Republic,2,0,FIFA World Cup qualification,Cape Town,South Africa,False,2,2,South Africa
30816,32957,35019,2013,Tunisia,Sierra Leone,2,1,FIFA World Cup qualification,Radès,Tunisia,False,3,1,Tunisia
30817,32958,35020,2013,DR Congo,Libya,0,0,FIFA World Cup qualification,Kinshasa,DR Congo,False,0,0,Draw
30818,32959,35021,2013,Dominican Republic,Haiti,3,1,Friendly,San Cristóbal,Dominican Republic,False,4,2,Dominican Republic
30819,32961,35023,2013,Ethiopia,Botswana,1,0,FIFA World Cup qualification,Addis Ababa,Ethiopia,False,1,1,Ethiopia
30820,32962,35024,2013,Ghana,Sudan,4,0,FIFA World Cup qualification,Kumasi,Ghana,False,4,4,Ghana
30821,32963,35025,2013,Lesotho,Zambia,1,1,FIFA World Cup qualification,Maseru,Lesotho,False,2,0,Draw
30822,32964,35026,2013,Liberia,Uganda,2,0,FIFA World Cup qualification,Paynesville,Liberia,False,2,2,Liberia
30823,32965,35027,2013,Mozambique,Guinea,0,0,FIFA World Cup qualification,Maputo,Mozambique,False,0,0,Draw
30824,32966,35028,2013,Philippines,Cambodia,8,0,AFC Challenge Cup qualification,Manila,Philippines,False,8,8,Philippines
30825,32967,35029,2013,Rwanda,Mali,1,2,FIFA World Cup qualification,Kigali,Rwanda,False,3,-1,Mali
30826,32968,35030,2013,Tanzania,Morocco,3,1,FIFA World Cup qualification,Dar es Salaam,Tanzania,False,4,2,Tanzania
30827,32969,35031,2013,Canada,Belarus,0,2,Friendly,Doha,Qatar,True,2,-2,Belarus
30828,32970,35032,2013,Russia,Brazil,1,1,Friendly,London,England,True,2,0,Draw
30829,32971,35033,2013,Albania,Lithuania,4,1,Friendly,Tirana,Albania,False,5,3,Albania
30830,32972,35034,2013,Algeria,Benin,3,1,FIFA World Cup qualification,Blida,Algeria,False,4,2,Algeria
30831,32973,35035,2013,Armenia,Czech Republic,0,3,FIFA World Cup qualification,Yerevan,Armenia,False,3,-3,Czech Republic
30832,32974,35036,2013,Australia,Oman,2,2,FIFA World Cup qualification,Sydney,Australia,False,4,0,Draw
30833,32975,35037,2013,Azerbaijan,Portugal,0,2,FIFA World Cup qualification,Baku,Azerbaijan,False,2,-2,Portugal
30834,32977,35039,2013,Bolivia,Argentina,1,1,FIFA World Cup qualification,La Paz,Bolivia,False,2,0,Draw
30835,32978,35040,2013,Chile,Uruguay,2,0,FIFA World Cup qualification,Santiago,Chile,False,2,2,Chile
30836,32979,35041,2013,Costa Rica,Jamaica,2,0,FIFA World Cup qualification,San José,Costa Rica,False,2,2,Costa Rica
30837,32980,35042,2013,Denmark,Bulgaria,1,1,FIFA World Cup qualification,Copenhagen,Denmark,False,2,0,Draw
30838,32981,35043,2013,Ecuador,Paraguay,4,1,FIFA World Cup qualification,Quito,Ecuador,False,5,3,Ecuador
30839,32982,35044,2013,Egypt,Zimbabwe,2,1,FIFA World Cup qualification,Alexandria,Egypt,False,3,1,Egypt
30840,32983,35045,2013,Estonia,Andorra,2,0,FIFA World Cup qualification,Tallinn,Estonia,False,2,2,Estonia
30841,32984,35046,2013,France,Spain,0,1,FIFA World Cup qualification,Saint-Denis,France,False,1,-1,Spain
30842,32985,35047,2013,Germany,Kazakhstan,4,1,FIFA World Cup qualification,Nuremberg,Germany,False,5,3,Germany
30843,32986,35048,2013,Iraq,Syria,2,1,Friendly,Baghdad,Iraq,False,3,1,Iraq
30844,32987,35049,2013,Republic of Ireland,Austria,2,2,FIFA World Cup qualification,Dublin,Republic of Ireland,False,4,0,Draw
30845,32988,35050,2013,Jordan,Japan,2,1,FIFA World Cup qualification,Amman,Jordan,False,3,1,Jordan
30846,32989,35052,2013,Kuwait,Iran,1,1,AFC Asian Cup qualification,Kuwait City,Kuwait,False,2,0,Draw
30847,32990,35053,2013,Luxembourg,Finland,0,3,Friendly,Luxembourg,Luxembourg,False,3,-3,Finland
30848,32991,35054,2013,Malaysia,Palestine,0,2,Friendly,Kuantan,Malaysia,False,2,-2,Palestine
30849,32992,35055,2013,Malta,Italy,0,2,FIFA World Cup qualification,Attard,Malta,False,2,-2,Italy
30850,32993,35056,2013,Mexico,United States,0,0,FIFA World Cup qualification,Mexico City,Mexico,False,0,0,Draw
30851,32994,35057,2013,Montenegro,England,1,1,FIFA World Cup qualification,Podgorica,Montenegro,False,2,0,Draw
30852,32995,35058,2013,Netherlands,Romania,4,0,FIFA World Cup qualification,Amsterdam,Netherlands,False,4,4,Netherlands
30853,32997,35060,2013,Northern Ireland,Israel,0,2,FIFA World Cup qualification,Belfast,Northern Ireland,False,2,-2,Israel
30854,32998,35061,2013,Panama,Honduras,2,0,FIFA World Cup qualification,Panama City,Panama,False,2,2,Panama
30855,32999,35062,2013,Peru,Trinidad and Tobago,3,0,Friendly,Lima,Peru,False,3,3,Peru
30856,33000,35063,2013,Philippines,Turkmenistan,1,0,AFC Challenge Cup qualification,Manila,Philippines,False,1,1,Philippines
30857,33001,35064,2013,Poland,San Marino,5,0,FIFA World Cup qualification,Warsaw,Poland,False,5,5,Poland
30858,33002,35065,2013,Serbia,Scotland,2,0,FIFA World Cup qualification,Novi Sad,Serbia,False,2,2,Serbia
30859,33003,35066,2013,Slovakia,Sweden,0,0,Friendly,Žilina,Slovakia,False,0,0,Draw
30860,33004,35067,2013,Solomon Islands,New Zealand,0,2,FIFA World Cup qualification,Honiara,Solomon Islands,False,2,-2,New Zealand
30861,33005,35068,2013,Turkey,Hungary,1,1,FIFA World Cup qualification,Istanbul,Turkey,False,2,0,Draw
30862,33006,35069,2013,Ukraine,Moldova,2,1,FIFA World Cup qualification,Odesa,Ukraine,False,3,1,Ukraine
30863,33007,35070,2013,Uzbekistan,Lebanon,1,0,FIFA World Cup qualification,Tashkent,Uzbekistan,False,1,1,Uzbekistan
30864,33008,35071,2013,Venezuela,Colombia,1,0,FIFA World Cup qualification,Puerto Ordaz,Venezuela,False,1,1,Venezuela
30865,33009,35072,2013,Wales,Croatia,1,2,FIFA World Cup qualification,Swansea,Wales,False,3,-1,Croatia
30866,33010,35073,2013,Bolivia,Brazil,0,4,Friendly,Santa Cruz,Bolivia,False,4,-4,Brazil
30867,33011,35074,2013,Mexico,Peru,0,0,Friendly,San Francisco,United States,True,0,0,Draw
30868,33012,35075,2013,Qatar,Palestine,2,0,Friendly,Doha,Qatar,False,2,2,Qatar
30869,33013,35076,2013,Saint Vincent and the Grenadines,Saint Lucia,0,2,Windward Islands Tournament,Kingstown,Saint Vincent and the Grenadines,False,2,-2,Saint Lucia
30870,33014,35077,2013,Brazil,Chile,2,2,Friendly,Belo Horizonte,Brazil,False,4,0,Draw
30871,33015,35078,2013,Zambia,Zimbabwe,2,0,Friendly,Lusaka,Zambia,False,2,2,Zambia
30872,33016,35079,2013,Libya,Mauritania,2,0,Friendly,Tripoli,Libya,False,2,2,Libya
30873,33017,35080,2013,Oman,Iran,3,1,Friendly,Muscat,Oman,False,4,2,Oman
30874,33018,35081,2013,Venezuela,El Salvador,2,1,Friendly,Mérida,Venezuela,False,3,1,Venezuela
30875,33019,35082,2013,Qatar,Latvia,3,1,Friendly,Doha,Qatar,False,4,2,Qatar
30876,33020,35083,2013,Algeria,Mauritania,1,0,Friendly,Blida,Algeria,False,1,1,Algeria
30877,33021,35084,2013,Ethiopia,Sudan,2,0,Friendly,Addis Ababa,Ethiopia,False,2,2,Ethiopia
30878,33022,35085,2013,Malawi,Zimbabwe,1,1,Friendly,Blantyre,Malawi,False,2,0,Draw
30879,33023,35086,2013,Namibia,Zambia,0,0,Friendly,Windhoek,Namibia,False,0,0,Draw
30880,33024,35087,2013,Iraq,Liberia,0,1,Friendly,Baghdad,Iraq,False,1,-1,Liberia
30881,33025,35088,2013,Jordan,Libya,1,0,Friendly,Amman,Jordan,False,1,1,Jordan
30882,33026,35089,2013,Canada,Costa Rica,0,1,Friendly,Edmonton,Canada,False,1,-1,Costa Rica
30883,33027,35090,2013,Turkey,Latvia,3,3,Friendly,Duisburg,Germany,True,6,0,Draw
30884,33028,35092,2013,Ecuador,Germany,2,4,Friendly,Boca Raton,United States,True,6,-2,Germany
30885,33029,35093,2013,England,Republic of Ireland,1,1,Friendly,London,England,False,2,0,Draw
30886,33030,35094,2013,Oman,Lebanon,1,1,Friendly,Doha,Qatar,True,2,0,Draw
30887,33031,35095,2013,Qatar,Azerbaijan,1,1,Friendly,Doha,Qatar,False,2,0,Draw
30888,33032,35096,2013,United States,Belgium,2,4,Friendly,Cleveland,United States,False,6,-2,Belgium
30889,33033,35097,2013,Japan,Bulgaria,0,2,Friendly,Toyota,Japan,False,2,-2,Bulgaria
30890,33034,35098,2013,Italy,San Marino,4,0,Friendly,Bologna,Italy,False,4,4,Italy
30891,33035,35099,2013,Mexico,Nigeria,2,2,Friendly,Houston,United States,True,4,0,Draw
30892,33036,35100,2013,Turkey,Slovenia,0,2,Friendly,Bielefeld,Germany,True,2,-2,Slovenia
30893,33037,35101,2013,Libya,Uganda,3,0,Friendly,Tripoli,Libya,False,3,3,Libya
30894,33038,35102,2013,Panama,Peru,1,2,Friendly,Panama City,Panama,False,3,-1,Peru
30895,33039,35103,2013,Algeria,Burkina Faso,2,0,Friendly,Blida,Algeria,False,2,2,Algeria
30896,33040,35104,2013,Brazil,England,2,2,Friendly,Rio de Janeiro,Brazil,False,4,0,Draw
30897,33041,35105,2013,Honduras,Israel,0,2,Friendly,New York,United States,True,2,-2,Israel
30898,33042,35106,2013,Republic of Ireland,Georgia,4,0,Friendly,Dublin,Republic of Ireland,False,4,4,Republic of Ireland
30899,33043,35107,2013,Lesotho,South Africa,0,2,Friendly,Maseru,Lesotho,False,2,-2,South Africa
30900,33044,35108,2013,Sudan,Tanzania,0,0,Friendly,Addis Ababa,Ethiopia,True,0,0,Draw
30901,33045,35109,2013,Ukraine,Cameroon,0,0,Friendly,Kyïv,Ukraine,False,0,0,Draw
30902,33046,35110,2013,United States,Germany,4,3,Friendly,Washington,United States,False,7,1,United States
30903,33047,35111,2013,Estonia,Belarus,0,2,Friendly,Tallinn,Estonia,False,2,-2,Belarus
30904,33049,35113,2013,Burma,Singapore,0,2,Friendly,Rangoon,Burma,False,2,-2,Singapore
30905,33050,35114,2013,Egypt,Botswana,1,1,Friendly,Cairo,Egypt,False,2,0,Draw
30906,33051,35115,2013,Hong Kong,Philippines,0,1,Friendly,Kowloon,Hong Kong,False,1,-1,Philippines
30907,33052,35116,2013,Jamaica,Mexico,0,1,FIFA World Cup qualification,Kingston,Jamaica,False,1,-1,Mexico
30908,33053,35117,2013,Japan,Australia,1,1,FIFA World Cup qualification,Saitama,Japan,False,2,0,Draw
30909,33054,35118,2013,Kazakhstan,Bulgaria,1,2,Friendly,Almaty,Kazakhstan,False,3,-1,Bulgaria
30910,33056,35120,2013,Oman,Iraq,1,0,FIFA World Cup qualification,Muscat,Oman,False,1,1,Oman
30911,33057,35121,2013,Poland,Liechtenstein,2,0,Friendly,Cracow,Poland,False,2,2,Poland
30912,33058,35122,2013,Qatar,Iran,0,1,FIFA World Cup qualification,Doha,Qatar,False,1,-1,Iran
30913,33059,35123,2013,Romania,Trinidad and Tobago,4,0,Friendly,Bucharest,Romania,False,4,4,Romania
30914,33060,35124,2013,Tajikistan,Afghanistan,3,2,Friendly,Qurghonteppa,Tajikistan,False,5,1,Tajikistan
30915,33061,35125,2013,Denmark,Georgia,2,1,Friendly,Aalborg,Denmark,False,3,1,Denmark
30916,33062,35126,2013,Kenya,Nigeria,0,1,FIFA World Cup qualification,Nairobi,Kenya,False,1,-1,Nigeria
30917,33063,35127,2013,Malawi,Namibia,0,0,FIFA World Cup qualification,Blantyre,Malawi,False,0,0,Draw
30918,33064,35128,2013,Uruguay,France,1,0,Friendly,Montevideo,Uruguay,False,1,1,Uruguay
30919,33065,35130,2013,Hungary,Kuwait,1,0,Friendly,Győr,Hungary,False,1,1,Hungary
30920,33066,35131,2013,Albania,Norway,1,1,FIFA World Cup qualification,Tirana,Albania,False,2,0,Draw
30921,33067,35132,2013,Argentina,Colombia,0,0,FIFA World Cup qualification,Buenos Aires,Argentina,False,0,0,Draw
30922,33068,35133,2013,Armenia,Malta,0,1,FIFA World Cup qualification,Yerevan,Armenia,False,1,-1,Malta
30923,33069,35134,2013,Austria,Sweden,2,1,FIFA World Cup qualification,Vienna,Austria,False,3,1,Austria
30924,33070,35135,2013,Azerbaijan,Luxembourg,1,1,FIFA World Cup qualification,Baku,Azerbaijan,False,2,0,Draw
30925,33071,35136,2013,Belgium,Serbia,2,1,FIFA World Cup qualification,Brussels,Belgium,False,3,1,Belgium
30926,33072,35137,2013,Bolivia,Venezuela,1,1,FIFA World Cup qualification,La Paz,Bolivia,False,2,0,Draw
30927,33073,35138,2013,Costa Rica,Honduras,1,0,FIFA World Cup qualification,San José,Costa Rica,False,1,1,Costa Rica
30928,33074,35139,2013,Croatia,Scotland,0,1,FIFA World Cup qualification,Zagreb,Croatia,False,1,-1,Scotland
30929,33075,35140,2013,Czech Republic,Italy,0,0,FIFA World Cup qualification,Prague,Czech Republic,False,0,0,Draw
30930,33076,35141,2013,Estonia,Trinidad and Tobago,1,0,Friendly,Tallinn,Estonia,False,1,1,Estonia
30931,33077,35142,2013,Finland,Belarus,1,0,FIFA World Cup qualification,Helsinki,Finland,False,1,1,Finland
30932,33078,35143,2013,Iceland,Slovenia,2,4,FIFA World Cup qualification,Reykjavík,Iceland,False,6,-2,Slovenia
30933,33079,35144,2013,Indonesia,Netherlands,0,3,Friendly,Jakarta,Indonesia,False,3,-3,Netherlands
30934,33080,35145,2013,Republic of Ireland,Faroe Islands,3,0,FIFA World Cup qualification,Dublin,Republic of Ireland,False,3,3,Republic of Ireland
30935,33081,35146,2013,Jamaica,United States,1,2,FIFA World Cup qualification,Kingston,Jamaica,False,3,-1,United States
30936,33082,35147,2013,Laos,Singapore,2,5,Friendly,Vientiane,Laos,False,7,-3,Singapore
30937,33083,35148,2013,Latvia,Bosnia and Herzegovina,0,5,FIFA World Cup qualification,Riga,Latvia,False,5,-5,Bosnia and Herzegovina
30938,33084,35149,2013,Libya,DR Congo,0,0,FIFA World Cup qualification,Tripoli,Libya,False,0,0,Draw
30939,33085,35150,2013,Liechtenstein,Slovakia,1,1,FIFA World Cup qualification,Vaduz,Liechtenstein,False,2,0,Draw
30940,33086,35151,2013,Lithuania,Greece,0,1,FIFA World Cup qualification,Vilnius,Lithuania,False,1,-1,Greece
30941,33087,35152,2013,Moldova,Poland,1,1,FIFA World Cup qualification,Chişinău,Moldova,False,2,0,Draw
30942,33088,35153,2013,Montenegro,Ukraine,0,4,FIFA World Cup qualification,Podgorica,Montenegro,False,4,-4,Ukraine
30943,33089,35154,2013,Panama,Mexico,0,0,FIFA World Cup qualification,Panama City,Panama,False,0,0,Draw
30944,33090,35155,2013,Paraguay,Chile,1,2,FIFA World Cup qualification,Asunción,Paraguay,False,3,-1,Chile
30945,33091,35156,2013,Peru,Ecuador,1,0,FIFA World Cup qualification,Lima,Peru,False,1,1,Peru
30946,33092,35157,2013,Portugal,Russia,1,0,FIFA World Cup qualification,Lisbon,Portugal,False,1,1,Portugal
30947,33093,35158,2013,Sudan,Ghana,1,3,FIFA World Cup qualification,Omdurman,Sudan,False,4,-2,Ghana
30948,33094,35160,2013,Angola,Senegal,1,1,FIFA World Cup qualification,Luanda,Angola,False,2,0,Draw
30949,33095,35161,2013,Botswana,Ethiopia,3,0,FIFA World Cup qualification,Lobatse,Botswana,False,3,3,Botswana
30950,33096,35163,2013,Central African Republic,South Africa,0,3,FIFA World Cup qualification,Yaoundé,Cameroon,True,3,-3,South Africa
30951,33097,35164,2013,Gabon,Congo,0,0,FIFA World Cup qualification,Franceville,Gabon,False,0,0,Draw
30952,33098,35165,2013,Gambia,Ivory Coast,0,3,FIFA World Cup qualification,Bakau,Gambia,False,3,-3,Ivory Coast
30953,33099,35166,2013,Haiti,Spain,1,2,Friendly,Miami Gardens,United States,True,3,-1,Spain
30954,33100,35167,2013,Morocco,Tanzania,2,1,FIFA World Cup qualification,Marrakech,Morocco,False,3,1,Morocco
30955,33101,35168,2013,Sierra Leone,Tunisia,2,2,FIFA World Cup qualification,Freetown,Sierra Leone,False,4,0,Draw
30956,33102,35169,2013,Switzerland,Cyprus,1,0,FIFA World Cup qualification,Geneva,Switzerland,False,1,1,Switzerland
30957,33103,35170,2013,Uganda,Liberia,1,0,FIFA World Cup qualification,Kampala,Uganda,False,1,1,Uganda
30958,33104,35171,2013,Zambia,Lesotho,4,0,FIFA World Cup qualification,Ndola,Zambia,False,4,4,Zambia
30959,33105,35172,2013,Benin,Algeria,1,3,FIFA World Cup qualification,Porto-Novo,Benin,False,4,-2,Algeria
30960,33106,35173,2013,Brazil,France,3,0,Friendly,Porto Alegre,Brazil,False,3,3,Brazil
30961,33107,35174,2013,Guinea,Mozambique,6,1,FIFA World Cup qualification,Conakry,Guinea,False,7,5,Guinea
30962,33108,35175,2013,Mali,Rwanda,1,1,FIFA World Cup qualification,Bamako,Mali,False,2,0,Draw
30963,33109,35176,2013,Niger,Burkina Faso,0,1,FIFA World Cup qualification,Niamey,Niger,False,1,-1,Burkina Faso
30964,33110,35177,2013,Togo,Cameroon,0,3,FIFA World Cup qualification,Lomé,Togo,False,3,-3,Cameroon
30965,33111,35178,2013,Zimbabwe,Egypt,2,4,FIFA World Cup qualification,Harare,Zimbabwe,False,6,-2,Egypt
30966,33112,35179,2013,Croatia,Portugal,0,1,Friendly,Geneva,Switzerland,True,1,-1,Portugal
30967,33113,35180,2013,Australia,Jordan,4,0,FIFA World Cup qualification,Melbourne,Australia,False,4,4,Australia
30968,33114,35181,2013,Belarus,Finland,1,1,FIFA World Cup qualification,Homel,Belarus,False,2,0,Draw
30969,33115,35182,2013,Chile,Bolivia,3,1,FIFA World Cup qualification,Santiago,Chile,False,4,2,Chile
30970,33116,35184,2013,Colombia,Peru,2,0,FIFA World Cup qualification,Barranquilla,Colombia,False,2,2,Colombia
30971,33117,35185,2013,Denmark,Armenia,0,4,FIFA World Cup qualification,Copenhagen,Denmark,False,4,-4,Armenia
30972,33118,35186,2013,Ecuador,Argentina,1,1,FIFA World Cup qualification,Quito,Ecuador,False,2,0,Draw
30973,33119,35187,2013,Estonia,Kyrgyzstan,1,1,Friendly,Tallinn,Estonia,False,2,0,Draw
30974,33120,35188,2013,Guatemala,Belize,0,0,Friendly,Antigua Guatemala,Guatemala,False,0,0,Draw
30975,33121,35189,2013,Honduras,Jamaica,2,0,FIFA World Cup qualification,Tegucigalpa,Honduras,False,2,2,Honduras
30976,33122,35190,2013,Iran,Lebanon,4,0,FIFA World Cup qualification,Teheran,Iran,False,4,4,Iran
30977,33123,35191,2013,Iraq,Japan,0,1,FIFA World Cup qualification,Doha,Qatar,True,1,-1,Japan
30978,33124,35192,2013,Italy,Haiti,2,2,Friendly,Rio de Janeiro,Brazil,True,4,0,Draw
30979,33125,35194,2013,Mexico,Costa Rica,0,0,FIFA World Cup qualification,Mexico City,Mexico,False,0,0,Draw
30980,33128,35197,2013,Spain,Republic of Ireland,2,0,Friendly,New York,United States,True,2,2,Spain
30981,33129,35198,2013,Sweden,Faroe Islands,2,0,FIFA World Cup qualification,Solna,Sweden,False,2,2,Sweden
30982,33130,35199,2013,United States,Panama,2,0,FIFA World Cup qualification,Seattle,United States,False,2,2,United States
30983,33131,35200,2013,Venezuela,Uruguay,0,1,FIFA World Cup qualification,Puerto Ordaz,Venezuela,False,1,-1,Uruguay
30984,33132,35201,2013,Ghana,Ivory Coast,2,1,Friendly,Kumasi,Ghana,False,3,1,Ghana
30985,33133,35202,2013,Malawi,Kenya,2,2,FIFA World Cup qualification,Blantyre,Malawi,False,4,0,Draw
30986,33134,35203,2013,Namibia,Nigeria,1,1,FIFA World Cup qualification,Windhoek,Namibia,False,2,0,Draw
30987,33135,35204,2013,Ghana,Ivory Coast,1,1,Friendly,Obuasi,Ghana,False,2,0,Draw
30988,33136,35205,2013,Guatemala,Argentina,0,4,Friendly,Guatemala,Guatemala,False,4,-4,Argentina
30989,33137,35206,2013,Libya,Togo,2,0,FIFA World Cup qualification,Tripoli,Libya,False,2,2,Libya
30990,33138,35207,2013,Moldova,Kyrgyzstan,2,1,Friendly,Tiraspol,Moldova,False,3,1,Moldova
30991,33139,35208,2013,Botswana,Central African Republic,3,2,FIFA World Cup qualification,Lobatse,Botswana,False,5,1,Botswana
30992,33140,35209,2013,Brazil,Japan,3,0,Confederations Cup,Brasília,Brazil,False,3,3,Brazil
30993,33141,35212,2013,Congo,Burkina Faso,0,1,FIFA World Cup qualification,Pointe-Noire,Congo,False,1,-1,Burkina Faso
30994,33142,35213,2013,Gabon,Niger,4,1,FIFA World Cup qualification,Franceville,Gabon,False,5,3,Gabon
30995,33143,35214,2013,Morocco,Gambia,2,0,FIFA World Cup qualification,Marrakech,Morocco,False,2,2,Morocco
30996,33144,35215,2013,Uganda,Angola,2,1,FIFA World Cup qualification,Kampala,Uganda,False,3,1,Uganda
30997,33145,35216,2013,Zambia,Sudan,1,1,FIFA World Cup qualification,Ndola,Zambia,False,2,0,Draw
30998,33146,35217,2013,DR Congo,Cameroon,0,0,FIFA World Cup qualification,Kinshasa,DR Congo,False,0,0,Draw
30999,33147,35218,2013,Equatorial Guinea,Tunisia,1,1,FIFA World Cup qualification,Malabo,Equatorial Guinea,False,2,0,Draw
31000,33148,35219,2013,Ethiopia,South Africa,2,1,FIFA World Cup qualification,Addis Ababa,Ethiopia,False,3,1,Ethiopia
31001,33149,35220,2013,Guinea,Zimbabwe,2,0,FIFA World Cup qualification,Conakry,Guinea,False,2,2,Guinea
31002,33150,35221,2013,Lesotho,Ghana,0,2,FIFA World Cup qualification,Maseru,Lesotho,False,2,-2,Ghana
31003,33151,35222,2013,Liberia,Senegal,0,2,FIFA World Cup qualification,Paynesville,Liberia,False,2,-2,Senegal
31004,33152,35223,2013,Mali,Benin,2,2,FIFA World Cup qualification,Bamako,Mali,False,4,0,Draw
31005,33153,35224,2013,Mexico,Italy,1,2,Confederations Cup,Rio de Janeiro,Brazil,True,3,-1,Italy
31006,33154,35225,2013,Mozambique,Egypt,0,1,FIFA World Cup qualification,Maputo,Mozambique,False,1,-1,Egypt
31007,33155,35226,2013,Rwanda,Algeria,0,1,FIFA World Cup qualification,Kigali,Rwanda,False,1,-1,Algeria
31008,33156,35227,2013,Spain,Uruguay,2,1,Confederations Cup,Recife,Brazil,True,3,1,Spain
31009,33157,35228,2013,Tanzania,Ivory Coast,2,4,FIFA World Cup qualification,Dar es Salaam,Tanzania,False,6,-2,Ivory Coast
31010,33158,35230,2013,Australia,Iraq,1,0,FIFA World Cup qualification,Sydney,Australia,False,1,1,Australia
31011,33159,35231,2013,Costa Rica,Panama,2,0,FIFA World Cup qualification,San José,Costa Rica,False,2,2,Costa Rica
31012,33160,35232,2013,Jordan,Oman,1,0,FIFA World Cup qualification,Amman,Jordan,False,1,1,Jordan
31013,33161,35234,2013,United States,Honduras,1,0,FIFA World Cup qualification,Sandy,United States,False,1,1,United States
31014,33162,35235,2013,Uzbekistan,Qatar,5,1,FIFA World Cup qualification,Tashkent,Uzbekistan,False,6,4,Uzbekistan
31015,33163,35236,2013,Brazil,Mexico,2,0,Confederations Cup,Fortaleza,Brazil,False,2,2,Brazil
31016,33164,35237,2013,Italy,Japan,4,3,Confederations Cup,Recife,Brazil,True,7,1,Italy
31017,33165,35238,2013,Nigeria,Uruguay,1,2,Confederations Cup,Salvador,Brazil,True,3,-1,Uruguay
31018,33167,35240,2013,Brazil,Italy,4,2,Confederations Cup,Salvador,Brazil,False,6,2,Brazil
31019,33168,35241,2013,Japan,Mexico,1,2,Confederations Cup,Belo Horizonte,Brazil,True,3,-1,Mexico
31020,33170,35243,2013,Nigeria,Spain,0,3,Confederations Cup,Fortaleza,Brazil,True,3,-3,Spain
31021,33171,35244,2013,Eswatini,Angola,0,1,African Nations Championship,Lobamba,Eswatini,False,1,-1,Angola
31022,33173,35246,2013,Brazil,Uruguay,2,1,Confederations Cup,Belo Horizonte,Brazil,False,3,1,Brazil
31023,33174,35247,2013,Spain,Italy,0,0,Confederations Cup,Fortaleza,Brazil,True,0,0,Draw
31024,33175,35248,2013,Angola,Eswatini,1,0,African Nations Championship,Luanda,Angola,False,1,1,Angola
31025,33176,35249,2013,Libya,Burkina Faso,2,1,Friendly,Misrata,Libya,False,3,1,Libya
31026,33177,35250,2013,Brazil,Spain,3,0,Confederations Cup,Rio de Janeiro,Brazil,False,3,3,Brazil
31027,33178,35251,2013,Uruguay,Italy,2,2,Confederations Cup,Salvador,Brazil,True,4,0,Draw
31028,33179,35252,2013,Mali,Guinea,3,1,African Nations Championship,Bamako,Mali,False,4,2,Mali
31029,33180,35253,2013,Nigeria,Ivory Coast,4,1,African Nations Championship,Kaduna,Nigeria,False,5,3,Nigeria
31030,33181,35254,2013,Namibia,Mauritius,2,1,COSAFA Cup,Lusaka,Zambia,True,3,1,Namibia
31031,33182,35255,2013,Botswana,Eswatini,0,0,COSAFA Cup,Kitwe,Zambia,True,0,0,Draw
31032,33183,35256,2013,Canada,Martinique,0,1,Gold Cup,Pasadena,United States,True,1,-1,Martinique
31033,33184,35257,2013,DR Congo,Congo,2,1,African Nations Championship,Kinshasa,DR Congo,False,3,1,DR Congo
31034,33185,35258,2013,Mexico,Panama,1,2,Gold Cup,Pasadena,United States,True,3,-1,Panama
31035,33186,35259,2013,El Salvador,Trinidad and Tobago,2,2,Gold Cup,Harrison,United States,True,4,0,Draw
31036,33187,35260,2013,Haiti,Honduras,0,2,Gold Cup,Harrison,United States,True,2,-2,Honduras
31037,33188,35261,2013,Kenya,Lesotho,2,2,COSAFA Cup,Kitwe,Zambia,True,4,0,Draw
31038,33189,35262,2013,Namibia,Seychelles,4,2,COSAFA Cup,Lusaka,Zambia,True,6,2,Namibia
31039,33190,35263,2013,Costa Rica,Cuba,3,0,Gold Cup,Portland,United States,True,3,3,Costa Rica
31040,33191,35264,2013,Kenya,Eswatini,2,0,COSAFA Cup,Kitwe,Zambia,True,2,2,Kenya
31041,33192,35265,2013,Lesotho,Botswana,3,3,COSAFA Cup,Kitwe,Zambia,True,6,0,Draw
31042,33193,35266,2013,United States,Belize,6,1,Gold Cup,Portland,United States,False,7,5,United States
31043,33194,35267,2013,Mauritius,Seychelles,4,0,COSAFA Cup,Kitwe,Zambia,True,4,4,Mauritius
31044,33195,35268,2013,Kenya,Botswana,1,2,COSAFA Cup,Kitwe,Zambia,True,3,-1,Botswana
31045,33196,35269,2013,Lesotho,Eswatini,2,0,COSAFA Cup,Lusaka,Zambia,True,2,2,Lesotho
31046,33197,35270,2013,Mexico,Canada,2,0,Gold Cup,Seattle,United States,True,2,2,Mexico
31047,33198,35271,2013,Panama,Martinique,1,0,Gold Cup,Seattle,United States,True,1,1,Panama
31048,33199,35272,2013,Honduras,El Salvador,1,0,Gold Cup,Miami Gardens,United States,True,1,1,Honduras
31049,33200,35273,2013,Trinidad and Tobago,Haiti,0,2,Gold Cup,Miami Gardens,United States,True,2,-2,Haiti
31050,33201,35274,2013,Costa Rica,Belize,1,0,Gold Cup,Sandy,United States,True,1,1,Costa Rica
31051,33202,35275,2013,Morocco,Tunisia,0,0,African Nations Championship,Tangier,Morocco,False,0,0,Draw
31052,33203,35276,2013,South Africa,Namibia,2,1,COSAFA Cup,Lusaka,Zambia,True,3,1,South Africa
31053,33204,35277,2013,United States,Cuba,4,1,Gold Cup,Sandy,United States,False,5,3,United States
31054,33205,35278,2013,Zimbabwe,Malawi,1,1,COSAFA Cup,Lusaka,Zambia,True,2,0,Draw
31055,33206,35279,2013,Martinique,Mexico,1,3,Gold Cup,Denver,United States,True,4,-2,Mexico
31056,33207,35280,2013,Panama,Canada,0,0,Gold Cup,Denver,United States,True,0,0,Draw
31057,33208,35281,2013,Zambia,Mozambique,3,1,COSAFA Cup,Kitwe,Zambia,False,4,2,Zambia
31058,33209,35282,2013,Bermuda,Greenland,3,0,Island Games,Hamilton,Bermuda,False,3,3,Bermuda
31059,33210,35284,2013,El Salvador,Haiti,1,0,Gold Cup,Houston,United States,True,1,1,El Salvador
31060,33211,35285,2013,Honduras,Trinidad and Tobago,0,2,Gold Cup,Houston,United States,True,2,-2,Trinidad and Tobago
31061,33212,35286,2013,Bermuda,Falkland Islands,8,0,Island Games,Hamilton,Bermuda,True,8,8,Bermuda
31062,33214,35288,2013,Cuba,Belize,4,0,Gold Cup,East Hartford,United States,True,4,4,Cuba
31063,33215,35289,2013,Namibia,Mozambique,0,1,COSAFA Cup,Kitwe,Zambia,True,1,-1,Mozambique
31064,33216,35290,2013,United States,Costa Rica,1,0,Gold Cup,East Hartford,United States,False,1,1,United States
31065,33217,35291,2013,Zambia,South Africa,0,0,COSAFA Cup,Ndola,Zambia,False,0,0,Draw
31066,33218,35292,2013,Zimbabwe,Lesotho,2,1,COSAFA Cup,Ndola,Zambia,True,3,1,Zimbabwe
31067,33219,35293,2013,Falkland Islands,Greenland,0,9,Island Games,Hamilton,Bermuda,True,9,-9,Greenland
31068,33222,35296,2013,Bermuda,Greenland,1,0,Island Games,Hamilton,Bermuda,False,1,1,Bermuda
31069,33223,35298,2013,Lesotho,South Africa,1,2,COSAFA Cup,Ndola,Zambia,True,3,-1,South Africa
31070,33224,35299,2013,Mauritania,Senegal,2,0,African Nations Championship,Nouakchott,Mauritania,False,2,2,Mauritania
31071,33225,35300,2013,Mexico,Trinidad and Tobago,1,0,Gold Cup,Atlanta,United States,True,1,1,Mexico
31072,33226,35301,2013,Panama,Cuba,6,1,Gold Cup,Atlanta,United States,True,7,5,Panama
31073,33227,35302,2013,Zambia,Zimbabwe,2,0,COSAFA Cup,Ndola,Zambia,False,2,2,Zambia
31074,33228,35303,2013,Honduras,Costa Rica,1,0,Gold Cup,Baltimore,United States,True,1,1,Honduras
31075,33230,35305,2013,United States,El Salvador,5,1,Gold Cup,Baltimore,United States,False,6,4,United States
31076,33231,35307,2013,Panama,Mexico,2,1,Gold Cup,Arlington,United States,True,3,1,Panama
31077,33232,35308,2013,United States,Honduras,3,1,Gold Cup,Arlington,United States,False,4,2,United States
31078,33233,35309,2013,Japan,Australia,3,2,EAFF Championship,Hwaseong,South Korea,True,5,1,Japan
31079,33234,35310,2013,Ivory Coast,Nigeria,2,0,African Nations Championship,Marcory,Ivory Coast,False,2,2,Ivory Coast
31080,33235,35311,2013,Niger,Burkina Faso,1,0,African Nations Championship,Niamey,Niger,False,1,1,Niger
31081,33236,35312,2013,Rwanda,Ethiopia,1,0,African Nations Championship,Kigali,Rwanda,False,1,1,Rwanda
31082,33237,35313,2013,Uganda,Tanzania,3,1,African Nations Championship,Kampala,Uganda,False,4,2,Uganda
31083,33239,35315,2013,Cameroon,Gabon,1,0,African Nations Championship,Yaoundé,Cameroon,False,1,1,Cameroon
31084,33240,35316,2013,Congo,DR Congo,1,0,African Nations Championship,Dolisie,Congo,False,1,1,Congo
31085,33241,35317,2013,Guinea,Mali,1,0,African Nations Championship,Conakry,Guinea,False,1,1,Guinea
31086,33242,35319,2013,Mauritius,Zimbabwe,0,3,African Nations Championship,Curepipe,Mauritius,False,3,-3,Zimbabwe
31087,33243,35320,2013,Mozambique,Namibia,3,0,African Nations Championship,Maputo,Mozambique,False,3,3,Mozambique
31088,33244,35321,2013,Sudan,Burundi,1,1,African Nations Championship,Omdurman,Sudan,False,2,0,Draw
31089,33245,35322,2013,United States,Panama,1,0,Gold Cup,Chicago,United States,False,1,1,United States
31090,33246,35323,2013,Namibia,Mozambique,3,0,African Nations Championship,Windhoek,Namibia,False,3,3,Namibia
31091,33247,35324,2013,Zimbabwe,Mauritius,1,0,African Nations Championship,Harare,Zimbabwe,False,1,1,Zimbabwe
31092,33248,35325,2013,Gabon,Cameroon,1,0,African Nations Championship,Libreville,Gabon,False,1,1,Gabon
31093,33249,35326,2013,Jordan,Libya,2,1,Friendly,Amman,Jordan,False,3,1,Jordan
31094,33250,35327,2013,Albania,Armenia,2,0,Friendly,Tirana,Albania,False,2,2,Albania
31095,33251,35328,2013,Algeria,Guinea,2,2,Friendly,Blida,Algeria,False,4,0,Draw
31096,33252,35329,2013,Austria,Greece,0,2,Friendly,Salzburg,Austria,False,2,-2,Greece
31097,33253,35330,2013,Azerbaijan,Malta,3,0,Friendly,Baku,Azerbaijan,False,3,3,Azerbaijan
31098,33254,35331,2013,Belarus,Montenegro,1,1,Friendly,Zhodzina,Belarus,False,2,0,Draw
31099,33255,35332,2013,Belgium,France,0,0,Friendly,Brussels,Belgium,False,0,0,Draw
31100,33256,35333,2013,Bosnia and Herzegovina,United States,3,4,Friendly,Sarajevo,Bosnia and Herzegovina,False,7,-1,United States
31101,33257,35334,2013,Chile,Iraq,6,0,Friendly,Brøndby,Denmark,True,6,6,Chile
31102,33258,35335,2013,Colombia,Serbia,1,0,Friendly,Barcelona,Spain,True,1,1,Colombia
31103,33259,35336,2013,Dominican Republic,Costa Rica,0,4,Friendly,Santo Domingo,Dominican Republic,False,4,-4,Costa Rica
31104,33260,35337,2013,Ecuador,Spain,0,2,Friendly,Guayaquil,Ecuador,False,2,-2,Spain
31105,33261,35338,2013,Egypt,Uganda,3,0,Friendly,el-Gouna,Egypt,False,3,3,Egypt
31106,33262,35339,2013,England,Scotland,3,2,Friendly,London,England,False,5,1,England
31107,33263,35340,2013,Estonia,Latvia,1,1,Friendly,Tallinn,Estonia,False,2,0,Draw
31108,33264,35341,2013,Finland,Slovenia,2,0,Friendly,Turku,Finland,False,2,2,Finland
31109,33266,35343,2013,Germany,Paraguay,3,3,Friendly,Kaiserslautern,Germany,False,6,0,Draw
31110,33267,35344,2013,Hungary,Czech Republic,1,1,Friendly,Budapest,Hungary,False,2,0,Draw
31111,33268,35345,2013,Iceland,Faroe Islands,1,0,Friendly,Reykjavík,Iceland,False,1,1,Iceland
31112,33269,35346,2013,Indonesia,Philippines,2,0,Friendly,Surakarta,Indonesia,False,2,2,Indonesia
31113,33270,35347,2013,Italy,Argentina,1,2,Friendly,Rome,Italy,False,3,-1,Argentina
31114,33271,35348,2013,Japan,Uruguay,2,4,Friendly,Rifu,Japan,False,6,-2,Uruguay
31115,33272,35349,2013,Kazakhstan,Georgia,1,0,Friendly,Astana,Kazakhstan,False,1,1,Kazakhstan
31116,33273,35351,2013,Libya,Central African Republic,0,0,Friendly,Tripoli,Libya,False,0,0,Draw
31117,33274,35352,2013,Liechtenstein,Croatia,2,3,Friendly,Vaduz,Liechtenstein,False,5,-1,Croatia
31118,33275,35353,2013,Luxembourg,Lithuania,2,1,Friendly,Luxembourg,Luxembourg,False,3,1,Luxembourg
31119,33276,35355,2013,Mexico,Ivory Coast,4,1,Friendly,East Rutherford,United States,True,5,3,Mexico
31120,33277,35356,2013,Moldova,Andorra,1,1,Friendly,Chișinău,Moldova,False,2,0,Draw
31121,33278,35357,2013,Morocco,Burkina Faso,1,2,Friendly,Tangier,Morocco,False,3,-1,Burkina Faso
31122,33279,35358,2013,Northern Ireland,Russia,1,0,FIFA World Cup qualification,Belfast,Northern Ireland,False,1,1,Northern Ireland
31123,33280,35359,2013,Poland,Denmark,3,2,Friendly,Gdańsk,Poland,False,5,1,Poland
31124,33281,35360,2013,Portugal,Netherlands,1,1,Friendly,Faro,Portugal,False,2,0,Draw
31125,33282,35361,2013,Romania,Slovakia,1,1,Friendly,Bucharest,Romania,False,2,0,Draw
31126,33283,35362,2013,Rwanda,Malawi,0,1,Friendly,Kigali,Rwanda,False,1,-1,Malawi
31127,33284,35363,2013,Singapore,Oman,0,2,AFC Asian Cup qualification,Jalan Besar,Singapore,False,2,-2,Oman
31128,33285,35364,2013,South Africa,Nigeria,0,2,Friendly,Durban,South Africa,False,2,-2,Nigeria
31129,33286,35365,2013,Sweden,Norway,4,2,Friendly,Solna,Sweden,False,6,2,Sweden
31130,33287,35366,2013,Switzerland,Brazil,1,0,Friendly,Basel,Switzerland,False,1,1,Switzerland
31131,33288,35367,2013,Tajikistan,India,3,0,Friendly,Khujand,Tajikistan,False,3,3,Tajikistan
31132,33289,35368,2013,Tunisia,Congo,3,0,Friendly,Radès,Tunisia,False,3,3,Tunisia
31133,33290,35369,2013,Turkey,Ghana,2,2,Friendly,Istanbul,Turkey,False,4,0,Draw
31134,33291,35370,2013,Ukraine,Israel,2,0,Friendly,Kyïv,Ukraine,False,2,2,Ukraine
31135,33292,35371,2013,Venezuela,Bolivia,2,2,Friendly,San Cristóbal,Venezuela,False,4,0,Draw
31136,33293,35372,2013,Wales,Republic of Ireland,0,0,Friendly,Cardiff,Wales,False,0,0,Draw
31137,33294,35373,2013,Zambia,Senegal,1,1,Friendly,Saint-Leu-la-Forêt,France,True,2,0,Draw
31138,33295,35374,2013,Syria,Jordan,1,1,AFC Asian Cup qualification,Teheran,Iran,True,2,0,Draw
31139,33296,35375,2013,South Africa,Burkina Faso,2,0,Friendly,Johannesburg,South Africa,False,2,2,South Africa
31140,33297,35376,2013,Zimbabwe,Zambia,0,0,African Nations Championship,Harare,Zimbabwe,False,0,0,Draw
31141,33298,35377,2013,Afghanistan,Pakistan,3,0,Friendly,Kabul,Afghanistan,False,3,3,Afghanistan
31142,33299,35378,2013,Zambia,Zimbabwe,0,1,African Nations Championship,Ndola,Zambia,False,1,-1,Zimbabwe
31143,33300,35379,2013,Mozambique,Angola,0,0,African Nations Championship,Maputo,Mozambique,False,0,0,Draw
31144,33301,35380,2013,Cameroon,DR Congo,0,1,African Nations Championship,Garoua,Cameroon,False,1,-1,DR Congo
31145,33302,35381,2013,Libya,Mali,1,0,Friendly,Aïn Draham,Tunisia,True,1,1,Libya
31146,33303,35382,2013,Botswana,Uganda,1,3,Friendly,Gaborone,Botswana,False,4,-2,Uganda
31147,33304,35383,2013,DR Congo,Cameroon,1,1,African Nations Championship,Lubumbashi,DR Congo,False,2,0,Draw
31148,33305,35384,2013,Libya,Ghana,1,0,Friendly,Aïn Draham,Tunisia,True,1,1,Libya
31149,33306,35385,2013,Angola,Mozambique,1,1,African Nations Championship,Benguela,Angola,False,2,0,Draw
31150,33307,35386,2013,Nepal,Bangladesh,2,0,SAFF Cup,Kathmandu,Nepal,False,2,2,Nepal
31151,33308,35387,2013,India,Pakistan,1,0,SAFF Cup,Kathmandu,Nepal,True,1,1,India
31152,33309,35388,2013,Afghanistan,Bhutan,3,0,SAFF Cup,Kathmandu,Nepal,True,3,3,Afghanistan
31153,33310,35389,2013,Maldives,Sri Lanka,10,0,SAFF Cup,Kathmandu,Nepal,True,10,10,Maldives
31154,33311,35390,2013,Bangladesh,India,1,1,SAFF Cup,Kathmandu,Nepal,True,2,0,Draw
31155,33312,35391,2013,Botswana,Malawi,1,0,Friendly,Gaborone,Botswana,False,1,1,Botswana
31156,33313,35392,2013,Nepal,Pakistan,1,1,SAFF Cup,Kathmandu,Nepal,False,2,0,Draw
31157,33314,35393,2013,Bhutan,Maldives,2,8,SAFF Cup,Kathmandu,Nepal,True,10,-6,Maldives
31158,33315,35394,2013,Equatorial Guinea,Libya,1,1,Friendly,Malabo,Equatorial Guinea,False,2,0,Draw
31159,33316,35395,2013,Sri Lanka,Afghanistan,1,3,SAFF Cup,Kathmandu,Nepal,True,4,-2,Afghanistan
31160,33317,35396,2013,Bangladesh,Pakistan,1,2,SAFF Cup,Kathmandu,Nepal,True,3,-1,Pakistan
31161,33318,35397,2013,Nepal,India,2,1,SAFF Cup,Kathmandu,Nepal,False,3,1,Nepal
31162,33319,35398,2013,Qatar,Mauritius,3,0,Friendly,Doha,Qatar,False,3,3,Qatar
31163,33320,35399,2013,Saudi Arabia,New Zealand,0,1,OSN Cup,Riyadh,Saudi Arabia,False,1,-1,New Zealand
31164,33321,35400,2013,United Arab Emirates,Trinidad and Tobago,3,3,OSN Cup,Riyadh,Saudi Arabia,True,6,0,Draw
31165,33322,35401,2013,Afghanistan,Maldives,0,0,SAFF Cup,Kathmandu,Nepal,True,0,0,Draw
31166,33323,35402,2013,Belarus,Kyrgyzstan,3,1,Friendly,Barysaw,Belarus,False,4,2,Belarus
31167,33324,35403,2013,Bosnia and Herzegovina,Slovakia,0,1,FIFA World Cup qualification,Zenica,Bosnia and Herzegovina,False,1,-1,Slovakia
31168,33325,35404,2013,Burma,Hong Kong,0,0,Friendly,Rangoon,Burma,False,0,0,Draw
31169,33326,35405,2013,Chile,Venezuela,3,0,FIFA World Cup qualification,Santiago,Chile,False,3,3,Chile
31170,33327,35407,2013,Colombia,Ecuador,1,0,FIFA World Cup qualification,Barranquilla,Colombia,False,1,1,Colombia
31171,33328,35408,2013,Costa Rica,United States,3,1,FIFA World Cup qualification,San José,Costa Rica,False,4,2,Costa Rica
31172,33329,35409,2013,Czech Republic,Armenia,1,2,FIFA World Cup qualification,Prague,Czech Republic,False,3,-1,Armenia
31173,33330,35410,2013,England,Moldova,4,0,FIFA World Cup qualification,London,England,False,4,4,England
31174,33331,35411,2013,Estonia,Netherlands,2,2,FIFA World Cup qualification,Tallinn,Estonia,False,4,0,Draw
31175,33332,35412,2013,Finland,Spain,0,2,FIFA World Cup qualification,Helsinki,Finland,False,2,-2,Spain
31176,33333,35413,2013,Georgia,France,0,0,FIFA World Cup qualification,Tbilisi,Georgia,False,0,0,Draw
31177,33334,35414,2013,Germany,Austria,3,0,FIFA World Cup qualification,Munich,Germany,False,3,3,Germany
31178,33335,35415,2013,Ghana,Zambia,2,1,FIFA World Cup qualification,Kumasi,Ghana,False,3,1,Ghana
31179,33336,35416,2013,Republic of Ireland,Sweden,1,2,FIFA World Cup qualification,Dublin,Republic of Ireland,False,3,-1,Sweden
31180,33337,35417,2013,Italy,Bulgaria,1,0,FIFA World Cup qualification,Palermo,Italy,False,1,1,Italy
31181,33338,35418,2013,Japan,Guatemala,3,0,Friendly,Osaka,Japan,False,3,3,Japan
31182,33339,35419,2013,Jordan,Uzbekistan,1,1,FIFA World Cup qualification,Amman,Jordan,False,2,0,Draw
31183,33340,35420,2013,Kazakhstan,Faroe Islands,2,1,FIFA World Cup qualification,Astana,Kazakhstan,False,3,1,Kazakhstan
31184,33342,35423,2013,Latvia,Lithuania,2,1,FIFA World Cup qualification,Riga,Latvia,False,3,1,Latvia
31185,33343,35424,2013,Lebanon,Syria,2,0,Friendly,Beirut,Lebanon,False,2,2,Lebanon
31186,33344,35425,2013,Liechtenstein,Greece,0,1,FIFA World Cup qualification,Vaduz,Liechtenstein,False,1,-1,Greece
31187,33345,35427,2013,Malta,Denmark,1,2,FIFA World Cup qualification,Attard,Malta,False,3,-1,Denmark
31188,33346,35428,2013,Mexico,Honduras,1,2,FIFA World Cup qualification,Mexico City,Mexico,False,3,-1,Honduras
31189,33347,35429,2013,Northern Ireland,Portugal,2,4,FIFA World Cup qualification,Belfast,Northern Ireland,False,6,-2,Portugal
31190,33348,35430,2013,Norway,Cyprus,2,0,FIFA World Cup qualification,Oslo,Norway,False,2,2,Norway
31191,33349,35431,2013,Panama,Jamaica,0,0,FIFA World Cup qualification,Panama City,Panama,False,0,0,Draw
31192,33350,35432,2013,Paraguay,Bolivia,4,0,FIFA World Cup qualification,Asunción,Paraguay,False,4,4,Paraguay
31193,33351,35433,2013,Peru,Uruguay,1,2,FIFA World Cup qualification,Lima,Peru,False,3,-1,Uruguay
31194,33352,35434,2013,Poland,Montenegro,1,1,FIFA World Cup qualification,Warsaw,Poland,False,2,0,Draw
31195,33353,35435,2013,Romania,Hungary,3,0,FIFA World Cup qualification,Bucharest,Romania,False,3,3,Romania
31196,33354,35436,2013,Russia,Luxembourg,4,1,FIFA World Cup qualification,Kazan,Russia,False,5,3,Russia
31197,33355,35437,2013,Scotland,Belgium,0,2,FIFA World Cup qualification,Glasgow,Scotland,False,2,-2,Belgium
31198,33356,35438,2013,Serbia,Croatia,1,1,FIFA World Cup qualification,Belgrade,Serbia,False,2,0,Draw
31199,33357,35439,2013,Slovenia,Albania,1,0,FIFA World Cup qualification,Ljubljana,Slovenia,False,1,1,Slovenia
31200,33358,35440,2013,Sri Lanka,Bhutan,5,2,SAFF Cup,Kathmandu,Nepal,True,7,3,Sri Lanka
31201,33359,35441,2013,Switzerland,Iceland,4,4,FIFA World Cup qualification,Berne,Switzerland,False,8,0,Draw
31202,33360,35442,2013,Turkey,Andorra,5,0,FIFA World Cup qualification,Kayseri,Turkey,False,5,5,Turkey
31203,33361,35443,2013,Ukraine,San Marino,9,0,FIFA World Cup qualification,L'viv,Ukraine,False,9,9,Ukraine
31204,33362,35444,2013,Angola,Liberia,4,1,FIFA World Cup qualification,Lubango,Angola,False,5,3,Angola
31205,33363,35445,2013,Brazil,Australia,6,0,Friendly,Brasília,Brazil,False,6,6,Brazil
31206,33364,35446,2013,Burkina Faso,Gabon,1,0,FIFA World Cup qualification,Ouagadougou,Burkina Faso,False,1,1,Burkina Faso
31207,33365,35447,2013,Central African Republic,Ethiopia,1,2,FIFA World Cup qualification,Brazzaville,Congo,True,3,-1,Ethiopia
31208,33366,35448,2013,Gambia,Tanzania,2,0,FIFA World Cup qualification,Bakau,Gambia,False,2,2,Gambia
31209,33367,35449,2013,Israel,Azerbaijan,1,1,FIFA World Cup qualification,Ramat-Gan,Israel,False,2,0,Draw
31210,33368,35450,2013,Ivory Coast,Morocco,1,1,FIFA World Cup qualification,Abidjan,Ivory Coast,False,2,0,Draw
31211,33369,35451,2013,Niger,Congo,2,2,FIFA World Cup qualification,Niamey,Niger,False,4,0,Draw
31212,33370,35452,2013,Nigeria,Malawi,2,0,FIFA World Cup qualification,Calabar,Nigeria,False,2,2,Nigeria
31213,33371,35453,2013,Senegal,Uganda,1,0,FIFA World Cup qualification,Marrakech,Morocco,True,1,1,Senegal
31214,33372,35454,2013,Sierra Leone,Equatorial Guinea,3,2,FIFA World Cup qualification,Freetown,Sierra Leone,False,5,1,Sierra Leone
31215,33373,35455,2013,South Africa,Botswana,4,1,FIFA World Cup qualification,Durban,South Africa,False,5,3,South Africa
31216,33375,35457,2013,Benin,Rwanda,2,0,FIFA World Cup qualification,Porto-Novo,Benin,False,2,2,Benin
31217,33376,35458,2013,Cameroon,Libya,1,0,FIFA World Cup qualification,Yaoundé,Cameroon,False,1,1,Cameroon
31218,33377,35459,2013,Canada,Mauritania,0,0,Friendly,Oliva,Spain,True,0,0,Draw
31219,33378,35460,2013,Kenya,Namibia,1,0,FIFA World Cup qualification,Nairobi,Kenya,False,1,1,Kenya
31220,33379,35461,2013,Nepal,Afghanistan,0,1,SAFF Cup,Kathmandu,Nepal,False,1,-1,Afghanistan
31221,33380,35462,2013,Sudan,Lesotho,1,3,FIFA World Cup qualification,Omdurman,Sudan,False,4,-2,Lesotho
31222,33381,35463,2013,Togo,DR Congo,2,1,FIFA World Cup qualification,Lomé,Togo,False,3,1,Togo
31223,33382,35464,2013,Zimbabwe,Mozambique,1,1,FIFA World Cup qualification,Harare,Zimbabwe,False,2,0,Draw
31224,33383,35465,2013,Kuwait,Bahrain,2,1,Friendly,Kuwait City,Kuwait,False,3,1,Kuwait
31225,33384,35466,2013,Maldives,India,0,1,SAFF Cup,Kathmandu,Nepal,True,1,-1,India
31226,33385,35467,2013,Qatar,Lebanon,1,1,Friendly,Doha,Qatar,False,2,0,Draw
31227,33386,35468,2013,Saudi Arabia,Trinidad and Tobago,1,3,OSN Cup,Riyadh,Saudi Arabia,False,4,-2,Trinidad and Tobago
31228,33387,35469,2013,United Arab Emirates,New Zealand,2,0,OSN Cup,Riyadh,Saudi Arabia,True,2,2,United Arab Emirates
31229,33388,35470,2013,Algeria,Mali,1,0,FIFA World Cup qualification,Blida,Algeria,False,1,1,Algeria
31230,33389,35471,2013,Andorra,Netherlands,0,2,FIFA World Cup qualification,Sant Julià de Lòria,Andorra,False,2,-2,Netherlands
31231,33390,35472,2013,Armenia,Denmark,0,1,FIFA World Cup qualification,Yerevan,Armenia,False,1,-1,Denmark
31232,33391,35473,2013,Austria,Republic of Ireland,1,0,FIFA World Cup qualification,Vienna,Austria,False,1,1,Austria
31233,33392,35474,2013,Belarus,France,2,4,FIFA World Cup qualification,Homel,Belarus,False,6,-2,France
31234,33393,35475,2013,Bolivia,Ecuador,1,1,FIFA World Cup qualification,La Paz,Bolivia,False,2,0,Draw
31235,33394,35476,2013,Brazil,Portugal,3,1,Friendly,Foxborough,United States,True,4,2,Brazil
31236,33395,35477,2013,Canada,Mauritania,0,1,Friendly,Oliva,Spain,True,1,-1,Mauritania
31237,33396,35479,2013,Cyprus,Slovenia,0,2,FIFA World Cup qualification,Nicosia,Cyprus,False,2,-2,Slovenia
31238,33397,35480,2013,Egypt,Guinea,4,2,FIFA World Cup qualification,el-Gouna,Egypt,False,6,2,Egypt
31239,33398,35481,2013,Faroe Islands,Germany,0,3,FIFA World Cup qualification,Tórshavn,Faroe Islands,False,3,-3,Germany
31240,33399,35482,2013,Georgia,Finland,0,1,FIFA World Cup qualification,Tbilisi,Georgia,False,1,-1,Finland
31241,33400,35483,2013,Greece,Latvia,1,0,FIFA World Cup qualification,Piraeus,Greece,False,1,1,Greece
31242,33401,35484,2013,Honduras,Panama,2,2,FIFA World Cup qualification,Tegucigalpa,Honduras,False,4,0,Draw
31243,33402,35485,2013,Hong Kong,Singapore,1,0,Friendly,Kowloon,Hong Kong,False,1,1,Hong Kong
31244,33403,35486,2013,Hungary,Estonia,5,1,FIFA World Cup qualification,Budapest,Hungary,False,6,4,Hungary
31245,33404,35487,2013,Iceland,Albania,2,1,FIFA World Cup qualification,Reykjavík,Iceland,False,3,1,Iceland
31246,33405,35488,2013,Italy,Czech Republic,2,1,FIFA World Cup qualification,Turin,Italy,False,3,1,Italy
31247,33406,35489,2013,Jamaica,Costa Rica,1,1,FIFA World Cup qualification,Kingston,Jamaica,False,2,0,Draw
31248,33407,35490,2013,Japan,Ghana,3,1,Friendly,Saitama,Japan,False,4,2,Japan
31249,33408,35491,2013,Kazakhstan,Sweden,0,1,FIFA World Cup qualification,Astana,Kazakhstan,False,1,-1,Sweden
31250,33409,35493,2013,Lithuania,Liechtenstein,2,0,FIFA World Cup qualification,Marijampolė,Lithuania,False,2,2,Lithuania
31251,33410,35494,2013,Luxembourg,Northern Ireland,3,2,FIFA World Cup qualification,Luxembourg,Luxembourg,False,5,1,Luxembourg
31252,33411,35496,2013,Malta,Bulgaria,1,2,FIFA World Cup qualification,Attard,Malta,False,3,-1,Bulgaria
31253,33412,35497,2013,Nigeria,Burkina Faso,4,1,Friendly,Kaduna,Nigeria,False,5,3,Nigeria
31254,33413,35498,2013,Norway,Switzerland,0,2,FIFA World Cup qualification,Oslo,Norway,False,2,-2,Switzerland
31255,33414,35499,2013,Paraguay,Argentina,2,5,FIFA World Cup qualification,Asunción,Paraguay,False,7,-3,Argentina
31256,33415,35500,2013,Romania,Turkey,0,2,FIFA World Cup qualification,Bucharest,Romania,False,2,-2,Turkey
31257,33416,35501,2013,Russia,Israel,3,1,FIFA World Cup qualification,St. Petersburg,Russia,False,4,2,Russia
31258,33417,35502,2013,San Marino,Poland,1,5,FIFA World Cup qualification,Serravalle,San Marino,False,6,-4,Poland
31259,33418,35503,2013,Slovakia,Bosnia and Herzegovina,1,2,FIFA World Cup qualification,Žilina,Slovakia,False,3,-1,Bosnia and Herzegovina
31260,33419,35504,2013,South Africa,Zimbabwe,1,2,Friendly,Johannesburg,South Africa,False,3,-1,Zimbabwe
31261,33420,35505,2013,Spain,Chile,2,2,Friendly,Geneva,Switzerland,True,4,0,Draw
31262,33421,35506,2013,Ukraine,England,0,0,FIFA World Cup qualification,Kyïv,Ukraine,False,0,0,Draw
31263,33422,35507,2013,Uruguay,Colombia,2,0,FIFA World Cup qualification,Montevideo,Uruguay,False,2,2,Uruguay
31264,33423,35508,2013,United States,Mexico,2,0,FIFA World Cup qualification,Columbus,United States,False,2,2,United States
31265,33424,35509,2013,Uzbekistan,Jordan,1,1,FIFA World Cup qualification,Tashkent,Uzbekistan,False,2,0,Draw
31266,33425,35510,2013,Venezuela,Peru,3,2,FIFA World Cup qualification,Puerto la Cruz,Venezuela,False,5,1,Venezuela
31267,33426,35511,2013,Wales,Serbia,0,3,FIFA World Cup qualification,Cardiff,Wales,False,3,-3,Serbia
31268,33427,35512,2013,Botswana,Burkina Faso,1,0,Friendly,Gaborone,Botswana,False,1,1,Botswana
31269,33428,35513,2013,Egypt,Uganda,2,0,Friendly,Cairo,Egypt,False,2,2,Egypt
31270,33429,35514,2013,Iraq,Yemen,3,2,Friendly,Beirut,Lebanon,True,5,1,Iraq
31271,33430,35515,2013,Lebanon,Iraq,1,1,Friendly,Beirut,Lebanon,False,2,0,Draw
31272,33431,35516,2013,Jordan,Kuwait,1,1,Friendly,Amman,Jordan,False,2,0,Draw
31273,33432,35517,2013,Oman,Mauritania,0,0,Friendly,Muscat,Oman,False,0,0,Draw
31274,33433,35518,2013,Qatar,Vietnam,1,2,Friendly,Doha,Qatar,False,3,-1,Vietnam
31275,33434,35519,2013,Singapore,Laos,1,0,Friendly,Singapore,Singapore,False,1,1,Singapore
31276,33435,35520,2013,Thailand,Bahrain,1,0,Friendly,Bangkok,Thailand,False,1,1,Thailand
31277,33436,35521,2013,Albania,Switzerland,1,2,FIFA World Cup qualification,Tirana,Albania,False,3,-1,Switzerland
31278,33437,35522,2013,Andorra,Romania,0,4,FIFA World Cup qualification,Sant Julià de Lòria,Andorra,False,4,-4,Romania
31279,33438,35523,2013,Argentina,Peru,3,1,FIFA World Cup qualification,Buenos Aires,Argentina,False,4,2,Argentina
31280,33439,35524,2013,Armenia,Bulgaria,2,1,FIFA World Cup qualification,Yerevan,Armenia,False,3,1,Armenia
31281,33440,35525,2013,Azerbaijan,Northern Ireland,2,0,FIFA World Cup qualification,Baku,Azerbaijan,False,2,2,Azerbaijan
31282,33441,35526,2013,Bosnia and Herzegovina,Liechtenstein,4,1,FIFA World Cup qualification,Zenica,Bosnia and Herzegovina,False,5,3,Bosnia and Herzegovina
31283,33442,35527,2013,Colombia,Chile,3,3,FIFA World Cup qualification,Barranquilla,Colombia,False,6,0,Draw
31284,33443,35528,2013,Croatia,Belgium,1,2,FIFA World Cup qualification,Zagreb,Croatia,False,3,-1,Belgium
31285,33444,35529,2013,Denmark,Italy,2,2,FIFA World Cup qualification,Copenhagen,Denmark,False,4,0,Draw
31286,33445,35530,2013,Ecuador,Uruguay,1,0,FIFA World Cup qualification,Quito,Ecuador,False,1,1,Ecuador
31287,33446,35531,2013,England,Montenegro,4,1,FIFA World Cup qualification,London,England,False,5,3,England
31288,33447,35532,2013,Estonia,Turkey,0,2,FIFA World Cup qualification,Tallinn,Estonia,False,2,-2,Turkey
31289,33448,35533,2013,Faroe Islands,Kazakhstan,1,1,FIFA World Cup qualification,Tórshavn,Faroe Islands,False,2,0,Draw
31290,33449,35534,2013,France,Australia,6,0,Friendly,Saint-Denis,France,False,6,6,France
31291,33450,35535,2013,Germany,Republic of Ireland,3,0,FIFA World Cup qualification,Cologne,Germany,False,3,3,Germany
31292,33451,35536,2013,Greece,Slovakia,1,0,FIFA World Cup qualification,Piraeus,Greece,False,1,1,Greece
31293,33452,35537,2013,Honduras,Costa Rica,1,0,FIFA World Cup qualification,San Pedro Sula,Honduras,False,1,1,Honduras
31294,33453,35538,2013,Iceland,Cyprus,2,0,FIFA World Cup qualification,Reykjavík,Iceland,False,2,2,Iceland
31295,33454,35539,2013,Lithuania,Latvia,2,0,FIFA World Cup qualification,Vilnius,Lithuania,False,2,2,Lithuania
31296,33455,35540,2013,Luxembourg,Russia,0,4,FIFA World Cup qualification,Luxembourg,Luxembourg,False,4,-4,Russia
31297,33456,35541,2013,Malta,Czech Republic,1,4,FIFA World Cup qualification,Attard,Malta,False,5,-3,Czech Republic
31298,33457,35542,2013,Mexico,Panama,2,1,FIFA World Cup qualification,Mexico City,Mexico,False,3,1,Mexico
31299,33458,35543,2013,Moldova,San Marino,3,0,FIFA World Cup qualification,Chișinău,Moldova,False,3,3,Moldova
31300,33459,35544,2013,Morocco,South Africa,1,1,Friendly,Agadir,Morocco,False,2,0,Draw
31301,33460,35545,2013,Netherlands,Hungary,8,1,FIFA World Cup qualification,Amsterdam,Netherlands,False,9,7,Netherlands
31302,33462,35547,2013,Portugal,Israel,1,1,FIFA World Cup qualification,Lisbon,Portugal,False,2,0,Draw
31303,33463,35548,2013,Serbia,Japan,2,0,Friendly,Novi Sad,Serbia,False,2,2,Serbia
31304,33464,35549,2013,Slovenia,Norway,3,0,FIFA World Cup qualification,Maribor,Slovenia,False,3,3,Slovenia
31305,33465,35550,2013,Spain,Belarus,2,1,FIFA World Cup qualification,Palma de Mallorca,Spain,False,3,1,Spain
31306,33466,35551,2013,Sweden,Austria,2,1,FIFA World Cup qualification,Solna,Sweden,False,3,1,Sweden
31307,33467,35552,2013,Ukraine,Poland,1,0,FIFA World Cup qualification,Kharkiv,Ukraine,False,1,1,Ukraine
31308,33468,35553,2013,United States,Jamaica,2,0,FIFA World Cup qualification,Kansas City,United States,False,2,2,United States
31309,33469,35554,2013,Venezuela,Paraguay,1,1,FIFA World Cup qualification,San Cristóbal,Venezuela,False,2,0,Draw
31310,33471,35556,2013,Burkina Faso,Algeria,3,2,FIFA World Cup qualification,Ouagadougou,Burkina Faso,False,5,1,Burkina Faso
31311,33472,35557,2013,Ivory Coast,Senegal,3,1,FIFA World Cup qualification,Abidjan,Ivory Coast,False,4,2,Ivory Coast
31312,33473,35559,2013,Ethiopia,Nigeria,1,2,FIFA World Cup qualification,Addis Ababa,Ethiopia,False,3,-1,Nigeria
31313,33474,35560,2013,Qatar,Yemen,6,0,AFC Asian Cup qualification,Doha,Qatar,False,6,6,Qatar
31314,33475,35561,2013,Tunisia,Cameroon,0,0,FIFA World Cup qualification,Radès,Tunisia,False,0,0,Draw
31315,33476,35562,2013,Australia,Canada,3,0,Friendly,London,England,True,3,3,Australia
31316,33477,35563,2013,Azerbaijan,Russia,1,1,FIFA World Cup qualification,Baku,Azerbaijan,False,2,0,Draw
31317,33478,35564,2013,Belarus,Japan,1,0,Friendly,Minsk,Belarus,False,1,1,Belarus
31318,33479,35565,2013,Belgium,Wales,1,1,FIFA World Cup qualification,Brussels,Belgium,False,2,0,Draw
31319,33480,35566,2013,Brazil,Zambia,2,0,Friendly,Beijing,China PR,True,2,2,Brazil
31320,33481,35567,2013,Bulgaria,Czech Republic,0,1,FIFA World Cup qualification,Sofia,Bulgaria,False,1,-1,Czech Republic
31321,33482,35568,2013,Chile,Ecuador,2,1,FIFA World Cup qualification,Santiago,Chile,False,3,1,Chile
31322,33483,35569,2013,Costa Rica,Mexico,2,1,FIFA World Cup qualification,San José,Costa Rica,False,3,1,Costa Rica
31323,33484,35570,2013,Cyprus,Albania,0,0,FIFA World Cup qualification,Nicosia,Cyprus,False,0,0,Draw
31324,33485,35571,2013,Denmark,Malta,6,0,FIFA World Cup qualification,Copenhagen,Denmark,False,6,6,Denmark
31325,33486,35572,2013,England,Poland,2,0,FIFA World Cup qualification,London,England,False,2,2,England
31326,33487,35573,2013,Faroe Islands,Austria,0,3,FIFA World Cup qualification,Tórshavn,Faroe Islands,False,3,-3,Austria
31327,33488,35574,2013,France,Finland,3,0,FIFA World Cup qualification,Saint-Denis,France,False,3,3,France
31328,33489,35575,2013,Ghana,Egypt,6,1,FIFA World Cup qualification,Kumasi,Ghana,False,7,5,Ghana
31329,33490,35576,2013,Greece,Liechtenstein,2,0,FIFA World Cup qualification,Piraeus,Greece,False,2,2,Greece
31330,33491,35577,2013,Hong Kong,United Arab Emirates,0,4,AFC Asian Cup qualification,So Kon Po,Hong Kong,False,4,-4,United Arab Emirates
31331,33492,35578,2013,Hungary,Andorra,2,0,FIFA World Cup qualification,Budapest,Hungary,False,2,2,Hungary
31332,33494,35580,2013,Iran,Thailand,2,1,AFC Asian Cup qualification,Teheran,Iran,False,3,1,Iran
31333,33495,35581,2013,Iraq,Saudi Arabia,0,2,AFC Asian Cup qualification,Amman,Jordan,True,2,-2,Saudi Arabia
31334,33496,35582,2013,Republic of Ireland,Kazakhstan,3,1,FIFA World Cup qualification,Dublin,Republic of Ireland,False,4,2,Republic of Ireland
31335,33497,35583,2013,Israel,Northern Ireland,1,1,FIFA World Cup qualification,Ramat-Gan,Israel,False,2,0,Draw
31336,33498,35584,2013,Italy,Armenia,2,2,FIFA World Cup qualification,Naples,Italy,False,4,0,Draw
31337,33499,35585,2013,Jamaica,Honduras,2,2,FIFA World Cup qualification,Kingston,Jamaica,False,4,0,Draw
31338,33500,35586,2013,Jordan,Oman,0,0,AFC Asian Cup qualification,Amman,Jordan,False,0,0,Draw
31339,33501,35588,2013,Kyrgyzstan,Tajikistan,1,4,Friendly,Bishkek,Kyrgyzstan,False,5,-3,Tajikistan
31340,33502,35589,2013,Latvia,Slovakia,2,2,FIFA World Cup qualification,Riga,Latvia,False,4,0,Draw
31341,33503,35590,2013,Lebanon,Kuwait,1,1,AFC Asian Cup qualification,Beirut,Lebanon,False,2,0,Draw
31342,33504,35591,2013,Lithuania,Bosnia and Herzegovina,0,1,FIFA World Cup qualification,Kaunas,Lithuania,False,1,-1,Bosnia and Herzegovina
31343,33505,35592,2013,Malaysia,Bahrain,1,1,AFC Asian Cup qualification,Shah Alam,Malaysia,False,2,0,Draw
31344,33506,35593,2013,Montenegro,Moldova,2,5,FIFA World Cup qualification,Podgorica,Montenegro,False,7,-3,Moldova
31345,33507,35594,2013,Norway,Iceland,1,1,FIFA World Cup qualification,Oslo,Norway,False,2,0,Draw
31346,33508,35595,2013,Panama,United States,2,3,FIFA World Cup qualification,Panama City,Panama,False,5,-1,United States
31347,33509,35596,2013,Paraguay,Colombia,1,2,FIFA World Cup qualification,Asunción,Paraguay,False,3,-1,Colombia
31348,33510,35597,2013,Peru,Bolivia,1,1,FIFA World Cup qualification,Lima,Peru,False,2,0,Draw
31349,33511,35598,2013,Philippines,Pakistan,3,1,Friendly,Bacolod,Philippines,False,4,2,Philippines
31350,33512,35599,2013,Portugal,Luxembourg,3,0,FIFA World Cup qualification,Coimbra,Portugal,False,3,3,Portugal
31351,33513,35600,2013,Romania,Estonia,2,0,FIFA World Cup qualification,Bucharest,Romania,False,2,2,Romania
31352,33514,35601,2013,San Marino,Ukraine,0,8,FIFA World Cup qualification,Serravalle,San Marino,False,8,-8,Ukraine
31353,33515,35602,2013,Scotland,Croatia,2,0,FIFA World Cup qualification,Glasgow,Scotland,False,2,2,Scotland
31354,33517,35604,2013,Singapore,Syria,2,1,AFC Asian Cup qualification,Singapore,Singapore,False,3,1,Singapore
31355,33518,35605,2013,Spain,Georgia,2,0,FIFA World Cup qualification,Albacete,Spain,False,2,2,Spain
31356,33519,35606,2013,Sweden,Germany,3,5,FIFA World Cup qualification,Solna,Sweden,False,8,-2,Germany
31357,33520,35607,2013,Switzerland,Slovenia,1,0,FIFA World Cup qualification,Berne,Switzerland,False,1,1,Switzerland
31358,33521,35608,2013,Trinidad and Tobago,New Zealand,0,0,Friendly,Port of Spain,Trinidad and Tobago,False,0,0,Draw
31359,33522,35609,2013,Turkey,Netherlands,0,2,FIFA World Cup qualification,Istanbul,Turkey,False,2,-2,Netherlands
31360,33523,35610,2013,Uruguay,Argentina,3,2,FIFA World Cup qualification,Montevideo,Uruguay,False,5,1,Uruguay
31361,33524,35611,2013,Uzbekistan,Vietnam,3,1,AFC Asian Cup qualification,Tashkent,Uzbekistan,False,4,2,Uzbekistan
31362,33525,35612,2013,Jordan,Nigeria,1,0,Friendly,Amman,Jordan,False,1,1,Jordan
31363,33526,35613,2013,Indonesia,Kyrgyzstan,4,0,Friendly,Jakarta,Indonesia,False,4,4,Indonesia
31364,33527,35614,2013,Jordan,Zambia,1,0,Friendly,al-Wakrah,Qatar,True,1,1,Jordan
31365,33528,35615,2013,Kuwait,Malaysia,3,0,Friendly,Kuwait City,Kuwait,False,3,3,Kuwait
31366,33529,35616,2013,Bahrain,Lebanon,1,0,Friendly,Riffa,Bahrain,False,1,1,Bahrain
31367,33530,35617,2013,United Arab Emirates,Philippines,4,0,Friendly,Abu Dhabi,United Arab Emirates,False,4,4,United Arab Emirates
31368,33531,35618,2013,Jordan,Uruguay,0,5,FIFA World Cup qualification,Amman,Jordan,False,5,-5,Uruguay
31369,33532,35619,2013,Belgium,Colombia,0,2,Friendly,Brussels,Belgium,False,2,-2,Colombia
31370,33533,35620,2013,Bonaire,Suriname,0,2,ABCS Tournament,Willemstad,Curaçao,True,2,-2,Suriname
31371,33534,35621,2013,Curaçao,Aruba,2,0,ABCS Tournament,Willemstad,Curaçao,False,2,2,Curaçao
31372,33535,35622,2013,Egypt,Zambia,2,0,Friendly,Cairo,Egypt,False,2,2,Egypt
31373,33536,35623,2013,Argentina,Ecuador,0,0,Friendly,East Rutherford,United States,True,0,0,Draw
31374,33537,35624,2013,Bahrain,Malaysia,1,0,AFC Asian Cup qualification,Riffa,Bahrain,False,1,1,Bahrain
31375,33538,35625,2013,Belarus,Albania,0,0,Friendly,Antalya,Turkey,True,0,0,Draw
31376,33539,35627,2013,Czech Republic,Canada,2,0,Friendly,Olomouc,Czech Republic,False,2,2,Czech Republic
31377,33540,35628,2013,Denmark,Norway,2,1,Friendly,Herning,Denmark,False,3,1,Denmark
31378,33541,35629,2013,England,Chile,0,2,Friendly,London,England,False,2,-2,Chile
31379,33542,35630,2013,Estonia,Azerbaijan,2,1,Friendly,Tallinn,Estonia,False,3,1,Estonia
31380,33543,35631,2013,Greece,Romania,3,1,FIFA World Cup qualification,Piraeus,Greece,False,4,2,Greece
31381,33544,35632,2013,Iceland,Croatia,0,0,FIFA World Cup qualification,Reykjavík,Iceland,False,0,0,Draw
31382,33545,35633,2013,India,Philippines,1,1,Friendly,Siliguri,India,False,2,0,Draw
31383,33546,35634,2013,Republic of Ireland,Latvia,3,0,Friendly,Dublin,Republic of Ireland,False,3,3,Republic of Ireland
31384,33547,35635,2013,Italy,Germany,1,1,Friendly,Milan,Italy,False,2,0,Draw
31385,33548,35636,2013,Jamaica,Trinidad and Tobago,0,1,Friendly,Montego Bay,Jamaica,False,1,-1,Trinidad and Tobago
31386,33549,35638,2013,Kuwait,Lebanon,0,0,AFC Asian Cup qualification,Kuwait City,Kuwait,False,0,0,Draw
31387,33550,35639,2013,Libya,Niger,1,1,Friendly,Sousse,Tunisia,True,2,0,Draw
31388,33551,35640,2013,Poland,Slovakia,0,2,Friendly,Wrocław,Poland,False,2,-2,Slovakia
31389,33552,35641,2013,Portugal,Sweden,1,0,FIFA World Cup qualification,Lisbon,Portugal,False,1,1,Portugal
31390,33553,35642,2013,Russia,Serbia,1,1,Friendly,Dubai,United Arab Emirates,True,2,0,Draw
31391,33554,35643,2013,Saudi Arabia,Iraq,2,1,AFC Asian Cup qualification,Dammam,Saudi Arabia,False,3,1,Saudi Arabia
31392,33555,35644,2013,Scotland,United States,0,0,Friendly,Glasgow,Scotland,False,0,0,Draw
31393,33556,35645,2013,Eswatini,South Africa,0,3,Friendly,Lobamba,Eswatini,False,3,-3,South Africa
31394,33557,35646,2013,Syria,Singapore,4,0,AFC Asian Cup qualification,Teheran,Iran,True,4,4,Syria
31395,33558,35647,2013,Thailand,Iran,0,3,AFC Asian Cup qualification,Bangkok,Thailand,False,3,-3,Iran
31396,33559,35648,2013,Turkey,Northern Ireland,1,0,Friendly,Adana,Turkey,False,1,1,Turkey
31397,33560,35649,2013,Ukraine,France,2,0,FIFA World Cup qualification,Kyïv,Ukraine,False,2,2,Ukraine
31398,33561,35650,2013,United Arab Emirates,Hong Kong,4,0,AFC Asian Cup qualification,Abu Dhabi,United Arab Emirates,False,4,4,United Arab Emirates
31399,33562,35651,2013,Vietnam,Uzbekistan,0,3,AFC Asian Cup qualification,Hanoi,Vietnam,False,3,-3,Uzbekistan
31400,33563,35652,2013,Yemen,Qatar,1,4,AFC Asian Cup qualification,al-Ain,United Arab Emirates,True,5,-3,Qatar
31401,33564,35653,2013,Aruba,Bonaire,1,2,ABCS Tournament,Willemstad,Curaçao,True,3,-1,Bonaire
31402,33565,35654,2013,Curaçao,Suriname,1,3,ABCS Tournament,Willemstad,Curaçao,False,4,-2,Suriname
31403,33566,35655,2013,Equatorial Guinea,Spain,1,2,Friendly,Malabo,Equatorial Guinea,False,3,-1,Spain
31404,33567,35656,2013,Honduras,Brazil,0,5,Friendly,Miami Gardens,United States,True,5,-5,Brazil
31405,33568,35657,2013,Netherlands,Japan,2,2,Friendly,Genk,Belgium,True,4,0,Draw
31406,33569,35658,2013,Nigeria,Ethiopia,2,0,FIFA World Cup qualification,Calabar,Nigeria,False,2,2,Nigeria
31407,33570,35659,2013,Senegal,Ivory Coast,1,1,FIFA World Cup qualification,Casablanca,Morocco,True,2,0,Draw
31408,33571,35660,2013,Uganda,Rwanda,0,0,Friendly,Kampala,Uganda,False,0,0,Draw
31409,33572,35661,2013,Wales,Finland,1,1,Friendly,Cardiff,Wales,False,2,0,Draw
31410,33573,35662,2013,Cameroon,Tunisia,4,1,FIFA World Cup qualification,Yaoundé,Cameroon,False,5,3,Cameroon
31411,33574,35663,2013,Luxembourg,Montenegro,1,4,Friendly,Luxembourg,Luxembourg,False,5,-3,Montenegro
31412,33575,35664,2013,Argentina,Bosnia and Herzegovina,2,0,Friendly,St. Louis,United States,True,2,2,Argentina
31413,33576,35665,2013,Italy,Nigeria,2,2,Friendly,London,England,True,4,0,Draw
31414,33577,35666,2013,Moldova,Lithuania,1,1,Friendly,Chișinău,Moldova,False,2,0,Draw
31415,33578,35667,2013,Algeria,Burkina Faso,1,0,FIFA World Cup qualification,Blida,Algeria,False,1,1,Algeria
31416,33579,35668,2013,Australia,Costa Rica,1,0,Friendly,Sydney,Australia,False,1,1,Australia
31417,33580,35669,2013,Austria,United States,1,0,Friendly,Vienna,Austria,False,1,1,Austria
31418,33581,35670,2013,Bahrain,Yemen,2,0,AFC Asian Cup qualification,Riffa,Bahrain,False,2,2,Bahrain
31419,33582,35671,2013,Belgium,Japan,2,3,Friendly,Brussels,Belgium,False,5,-1,Japan
31420,33583,35672,2013,Brazil,Chile,2,1,Friendly,Toronto,Canada,True,3,1,Brazil
31421,33584,35673,2013,Cambodia,Guam,0,2,Friendly,Phnom Penh,Cambodia,False,2,-2,Guam
31422,33585,35675,2013,Croatia,Iceland,2,0,FIFA World Cup qualification,Zagreb,Croatia,False,2,2,Croatia
31423,33586,35676,2013,Egypt,Ghana,2,1,FIFA World Cup qualification,Cairo,Egypt,False,3,1,Egypt
31424,33587,35677,2013,England,Germany,0,1,Friendly,London,England,False,1,-1,Germany
31425,33588,35678,2013,France,Ukraine,3,0,FIFA World Cup qualification,Saint-Denis,France,False,3,3,France
31426,33589,35679,2013,Gibraltar,Slovakia,0,0,Friendly,Faro,Portugal,True,0,0,Draw
31427,33590,35680,2013,Honduras,Ecuador,2,2,Friendly,Houston,United States,True,4,0,Draw
31428,33591,35681,2013,Hong Kong,Uzbekistan,0,2,AFC Asian Cup qualification,So Kon Po,Hong Kong,False,2,-2,Uzbekistan
31429,33592,35682,2013,India,Nepal,2,0,Friendly,Siliguri,India,False,2,2,India
31430,33593,35683,2013,Indonesia,Iraq,0,2,AFC Asian Cup qualification,Jakarta,Indonesia,False,2,-2,Iraq
31431,33594,35684,2013,Kuwait,Thailand,3,1,AFC Asian Cup qualification,Kuwait City,Kuwait,False,4,2,Kuwait
31432,33595,35685,2013,Kyrgyzstan,Azerbaijan,0,0,Friendly,Bishkek,Kyrgyzstan,False,0,0,Draw
31433,33596,35686,2013,Lebanon,Iran,1,4,AFC Asian Cup qualification,Beirut,Lebanon,False,5,-3,Iran
31434,33597,35687,2013,Liechtenstein,Estonia,0,3,Friendly,Vaduz,Liechtenstein,False,3,-3,Estonia
31435,33598,35688,2013,Malaysia,Qatar,0,1,AFC Asian Cup qualification,Shah Alam,Malaysia,False,1,-1,Qatar
31436,33599,35689,2013,Malta,Faroe Islands,3,2,Friendly,Attard,Malta,False,5,1,Malta
31437,33600,35690,2013,Namibia,Mozambique,0,0,Friendly,Windhoek,Namibia,False,0,0,Draw
31438,33601,35691,2013,Netherlands,Colombia,0,0,Friendly,Amsterdam,Netherlands,False,0,0,Draw
31439,33602,35692,2013,Norway,Scotland,0,1,Friendly,Molde,Norway,False,1,-1,Scotland
31440,33603,35693,2013,Poland,Republic of Ireland,0,0,Friendly,Poznań,Poland,False,0,0,Draw
31441,33604,35694,2013,Romania,Greece,1,1,FIFA World Cup qualification,Bucharest,Romania,False,2,0,Draw
31442,33606,35696,2013,Slovenia,Canada,1,0,Friendly,Celje,Slovenia,False,1,1,Slovenia
31443,33607,35697,2013,South Africa,Spain,1,0,Friendly,Johannesburg,South Africa,False,1,1,South Africa
31444,33608,35698,2013,Sweden,Portugal,2,3,FIFA World Cup qualification,Solna,Sweden,False,5,-1,Portugal
31445,33609,35699,2013,Syria,Oman,0,1,AFC Asian Cup qualification,Teheran,Iran,True,1,-1,Oman
31446,33610,35700,2013,Tanzania,Zimbabwe,0,0,Friendly,Dar es Salaam,Tanzania,False,0,0,Draw
31447,33611,35701,2013,Trinidad and Tobago,Jamaica,2,0,Friendly,Port of Spain,Trinidad and Tobago,False,2,2,Trinidad and Tobago
31448,33612,35702,2013,Turkey,Belarus,2,1,Friendly,Mersin,Turkey,False,3,1,Turkey
31449,33613,35703,2013,United Arab Emirates,Vietnam,5,0,AFC Asian Cup qualification,Abu Dhabi,United Arab Emirates,False,5,5,United Arab Emirates
31450,33614,35704,2013,New Zealand,Mexico,2,4,FIFA World Cup qualification,Wellington,New Zealand,False,6,-2,Mexico
31451,33615,35705,2013,Uruguay,Jordan,0,0,FIFA World Cup qualification,Montevideo,Uruguay,False,0,0,Draw
31452,33616,35706,2013,Singapore,Cambodia,1,0,Friendly,Hougang,Singapore,False,1,1,Singapore
31453,33617,35707,2013,Kenya,Ethiopia,0,0,CECAFA Cup,Nairobi,Kenya,False,0,0,Draw
31454,33618,35708,2013,Seychelles,Maldives,3,1,Friendly,Victoria,Seychelles,False,4,2,Seychelles
31455,33619,35710,2013,Burundi,Somalia,2,0,CECAFA Cup,Machakos,Kenya,True,2,2,Burundi
31456,33620,35711,2013,Tanzania,Zambia,1,1,CECAFA Cup,Machakos,Kenya,True,2,0,Draw
31457,33621,35712,2013,Seychelles,Maldives,2,1,Friendly,Victoria,Seychelles,False,3,1,Seychelles
31458,33622,35713,2013,Sudan,Eritrea,3,0,CECAFA Cup,Machakos,Kenya,True,3,3,Sudan
31459,33623,35714,2013,Uganda,Rwanda,1,0,CECAFA Cup,Nairobi,Kenya,True,1,1,Uganda
31460,33624,35715,2013,Dominica,Saint Lucia,0,1,Friendly,Roseau,Dominica,False,1,-1,Saint Lucia
31461,33626,35717,2013,Kenya,South Sudan,3,1,CECAFA Cup,Nairobi,Kenya,False,4,2,Kenya
31462,33627,35718,2013,Dominica,Saint Lucia,1,0,Friendly,Roseau,Dominica,False,1,1,Dominica
31463,33628,35719,2013,Somalia,Tanzania,0,1,CECAFA Cup,Nairobi,Kenya,True,1,-1,Tanzania
31464,33629,35720,2013,Zambia,Burundi,1,0,CECAFA Cup,Nairobi,Kenya,True,1,1,Zambia
31465,33630,35721,2013,Eritrea,Uganda,0,3,CECAFA Cup,Machakos,Kenya,True,3,-3,Uganda
31466,33631,35722,2013,Sudan,Rwanda,1,0,CECAFA Cup,Machakos,Kenya,True,1,1,Sudan
31467,33633,35724,2013,South Sudan,Ethiopia,0,2,CECAFA Cup,Nakuru,Kenya,True,2,-2,Ethiopia
31468,33634,35725,2013,Somalia,Zambia,0,4,CECAFA Cup,Nakuru,Kenya,True,4,-4,Zambia
31469,33635,35726,2013,Tanzania,Burundi,1,0,CECAFA Cup,Nakuru,Kenya,True,1,1,Tanzania
31470,33636,35727,2013,Rwanda,Eritrea,1,0,CECAFA Cup,Nakuru,Kenya,True,1,1,Rwanda
31471,33637,35728,2013,Uganda,Sudan,1,0,CECAFA Cup,Nakuru,Kenya,True,1,1,Uganda
31472,33638,35729,2013,Kenya,Rwanda,1,0,CECAFA Cup,Mombasa,Kenya,False,1,1,Kenya
31473,33639,35730,2013,Uganda,Tanzania,2,2,CECAFA Cup,Mombasa,Kenya,True,4,0,Draw
31474,33640,35731,2013,Ethiopia,Sudan,0,2,CECAFA Cup,Mombasa,Kenya,True,2,-2,Sudan
31475,33641,35732,2013,Zambia,Burundi,4,3,CECAFA Cup,Mombasa,Kenya,True,7,1,Zambia
31476,33642,35733,2013,Kenya,Tanzania,1,0,CECAFA Cup,Nairobi,Kenya,False,1,1,Kenya
31477,33643,35734,2013,Zambia,Sudan,1,2,CECAFA Cup,Mombasa,Kenya,True,3,-1,Sudan
31478,33644,35735,2013,Kenya,Sudan,2,0,CECAFA Cup,Nairobi,Kenya,False,2,2,Kenya
31479,33645,35736,2013,Tanzania,Zambia,1,1,CECAFA Cup,Nairobi,Kenya,True,2,0,Draw
31480,33646,35737,2013,Libya,Mali,1,0,Friendly,el-Jadida,Morocco,True,1,1,Libya
31481,33647,35738,2013,Qatar,Bahrain,1,1,Friendly,Doha,Qatar,False,2,0,Draw
31482,33648,35739,2013,Oman,Bahrain,0,0,WAFF Championship,Doha,Qatar,True,0,0,Draw
31483,33649,35740,2013,Qatar,Palestine,1,0,WAFF Championship,Doha,Qatar,False,1,1,Qatar
31484,33650,35741,2013,Jordan,Lebanon,0,0,WAFF Championship,Doha,Qatar,True,0,0,Draw
31485,33651,35742,2013,Bahrain,Iraq,0,0,WAFF Championship,Doha,Qatar,True,0,0,Draw
31486,33652,35743,2013,Palestine,Saudi Arabia,0,0,WAFF Championship,Doha,Qatar,True,0,0,Draw
31487,33653,35745,2013,Lebanon,Kuwait,0,2,WAFF Championship,Doha,Qatar,True,2,-2,Kuwait
31488,33654,35747,2013,Iraq,Oman,0,0,WAFF Championship,Doha,Qatar,True,0,0,Draw
31489,33655,35748,2013,Qatar,Saudi Arabia,4,1,WAFF Championship,Doha,Qatar,False,5,3,Qatar
31490,33656,35749,2014,Kuwait,Jordan,1,2,WAFF Championship,Doha,Qatar,True,3,-1,Jordan
31491,33657,35750,2014,Bahrain,Jordan,0,1,WAFF Championship,Doha,Qatar,True,1,-1,Jordan
31492,33658,35751,2014,Namibia,Ghana,0,1,Friendly,Windhoek,Namibia,False,1,-1,Ghana
31493,33659,35752,2014,Nigeria,Ethiopia,2,1,Friendly,Abuja,Nigeria,False,3,1,Nigeria
31494,33660,35753,2014,Qatar,Kuwait,3,0,WAFF Championship,Doha,Qatar,False,3,3,Qatar
31495,33661,35754,2014,Bahrain,Kuwait,0,0,WAFF Championship,Doha,Qatar,True,0,0,Draw
31496,33662,35755,2014,Qatar,Jordan,2,0,WAFF Championship,Doha,Qatar,False,2,2,Qatar
31497,33663,35756,2014,Zimbabwe,Gabon,2,0,Friendly,Johannesburg,South Africa,True,2,2,Zimbabwe
31498,33664,35757,2014,Mali,Nigeria,2,1,African Nations Championship,Cape Town,South Africa,True,3,1,Mali
31499,33665,35758,2014,South Africa,Mozambique,3,1,African Nations Championship,Cape Town,South Africa,False,4,2,South Africa
31500,33666,35759,2014,Uganda,Burkina Faso,2,1,African Nations Championship,Cape Town,South Africa,True,3,1,Uganda
31501,33667,35760,2014,Zimbabwe,Morocco,0,0,African Nations Championship,Cape Town,South Africa,True,0,0,Draw
31502,33668,35761,2014,Ghana,Congo,1,0,African Nations Championship,Bloemfontein,South Africa,True,1,1,Ghana
31503,33669,35762,2014,Libya,Ethiopia,2,0,African Nations Championship,Bloemfontein,South Africa,True,2,2,Libya
31504,33670,35763,2014,DR Congo,Mauritania,1,0,African Nations Championship,Polokwane,South Africa,True,1,1,DR Congo
31505,33671,35764,2014,Gabon,Burundi,0,0,African Nations Championship,Polokwane,South Africa,True,0,0,Draw
31506,33672,35765,2014,Moldova,Norway,1,2,Friendly,Abu Dhabi,United Arab Emirates,True,3,-1,Norway
31507,33673,35766,2014,Nigeria,Mozambique,4,2,African Nations Championship,Cape Town,South Africa,True,6,2,Nigeria
31508,33674,35767,2014,South Africa,Mali,1,1,African Nations Championship,Cape Town,South Africa,False,2,0,Draw
31509,33675,35768,2014,Burkina Faso,Morocco,1,1,African Nations Championship,Cape Town,South Africa,True,2,0,Draw
31510,33676,35769,2014,Zimbabwe,Uganda,0,0,African Nations Championship,Cape Town,South Africa,True,0,0,Draw
31511,33677,35770,2014,Ethiopia,Congo,0,1,African Nations Championship,Bloemfontein,South Africa,True,1,-1,Congo
31512,33678,35771,2014,Ghana,Libya,1,1,African Nations Championship,Bloemfontein,South Africa,True,2,0,Draw
31513,33679,35772,2014,Moldova,Sweden,1,2,Friendly,Abu Dhabi,United Arab Emirates,True,3,-1,Sweden
31514,33680,35773,2014,Burundi,Mauritania,3,2,African Nations Championship,Polokwane,South Africa,True,5,1,Burundi
31515,33681,35774,2014,DR Congo,Gabon,0,1,African Nations Championship,Polokwane,South Africa,True,1,-1,Gabon
31516,33682,35775,2014,Norway,Poland,0,3,Friendly,Abu Dhabi,United Arab Emirates,True,3,-3,Poland
31517,33683,35776,2014,Mozambique,Mali,1,2,African Nations Championship,Cape Town,South Africa,True,3,-1,Mali
31518,33684,35777,2014,South Africa,Nigeria,1,3,African Nations Championship,Cape Town,South Africa,False,4,-2,Nigeria
31519,33685,35778,2014,Burkina Faso,Zimbabwe,0,1,African Nations Championship,Cape Town,South Africa,True,1,-1,Zimbabwe
31520,33686,35779,2014,Moldova,Poland,0,1,Friendly,Abu Dhabi,United Arab Emirates,True,1,-1,Poland
31521,33687,35780,2014,Morocco,Uganda,3,1,African Nations Championship,Cape Town,South Africa,True,4,2,Morocco
31522,33688,35781,2014,Congo,Libya,2,2,African Nations Championship,Polokwane,South Africa,True,4,0,Draw
31523,33689,35782,2014,Ethiopia,Ghana,0,1,African Nations Championship,Bloemfontein,South Africa,True,1,-1,Ghana
31524,33690,35783,2014,Iceland,Sweden,0,2,Friendly,Abu Dhabi,United Arab Emirates,True,2,-2,Sweden
31525,33691,35784,2014,Burundi,DR Congo,1,2,African Nations Championship,Polokwane,South Africa,True,3,-1,DR Congo
31526,33692,35785,2014,Chile,Costa Rica,4,0,Friendly,Coquimbo,Chile,False,4,4,Chile
31527,33693,35786,2014,Mauritania,Gabon,2,4,African Nations Championship,Bloemfontein,South Africa,True,6,-2,Gabon
31528,33694,35787,2014,Oman,Finland,0,0,Friendly,Nizwa,Oman,False,0,0,Draw
31529,33696,35789,2014,Mali,Zimbabwe,1,2,African Nations Championship,Cape Town,South Africa,True,3,-1,Zimbabwe
31530,33697,35790,2014,Morocco,Nigeria,3,4,African Nations Championship,Cape Town,South Africa,True,7,-1,Nigeria
31531,33698,35791,2014,Gabon,Libya,1,1,African Nations Championship,Polokwane,South Africa,True,2,0,Draw
31532,33699,35792,2014,Ghana,DR Congo,1,0,African Nations Championship,Bloemfontein,South Africa,True,1,1,Ghana
31533,33701,35794,2014,Nigeria,Ghana,0,0,African Nations Championship,Bloemfontein,South Africa,True,0,0,Draw
31534,33702,35795,2014,Zimbabwe,Libya,0,0,African Nations Championship,Bloemfontein,South Africa,True,0,0,Draw
31535,33703,35796,2014,Oman,Jordan,0,0,AFC Asian Cup qualification,Muscat,Oman,False,0,0,Draw
31536,33704,35797,2014,Libya,Ghana,0,0,African Nations Championship,Cape Town,South Africa,True,0,0,Draw
31537,33706,35799,2014,Zimbabwe,Nigeria,0,1,African Nations Championship,Cape Town,South Africa,True,1,-1,Nigeria
31538,33707,35800,2014,Singapore,Jordan,1,3,AFC Asian Cup qualification,Singapore,Singapore,False,4,-2,Jordan
31539,33708,35801,2014,Lebanon,Pakistan,3,1,Friendly,Beirut,Lebanon,False,4,2,Lebanon
31540,33710,35803,2014,Gibraltar,Faroe Islands,1,4,Friendly,Gibraltar,Gibraltar,False,5,-3,Faroe Islands
31541,33711,35804,2014,Malaysia,Philippines,0,0,Friendly,Selayang,Malaysia,False,0,0,Draw
31542,33712,35805,2014,Iran,Kuwait,3,2,AFC Asian Cup qualification,Karaj,Iran,False,5,1,Iran
31543,33713,35806,2014,Albania,Malta,2,0,Friendly,Durrës,Albania,False,2,2,Albania
31544,33714,35807,2014,Algeria,Slovenia,2,0,Friendly,Blida,Algeria,False,2,2,Algeria
31545,33715,35808,2014,Andorra,Moldova,0,3,Friendly,Sant Julià de Lòria,Andorra,False,3,-3,Moldova
31546,33716,35809,2014,Australia,Ecuador,3,4,Friendly,London,England,True,7,-1,Ecuador
31547,33717,35810,2014,Austria,Uruguay,1,1,Friendly,Klagenfurt,Austria,False,2,0,Draw
31548,33718,35811,2014,Belgium,Ivory Coast,2,2,Friendly,Brussels,Belgium,False,4,0,Draw
31549,33719,35812,2014,Bosnia and Herzegovina,Egypt,0,2,Friendly,Innsbruck,Austria,True,2,-2,Egypt
31550,33720,35813,2014,Botswana,South Sudan,3,0,Friendly,Gaborone,Botswana,False,3,3,Botswana
31551,33721,35814,2014,Bulgaria,Belarus,2,1,Friendly,Sofia,Bulgaria,False,3,1,Bulgaria
31552,33722,35815,2014,Burkina Faso,Comoros,1,1,Friendly,Martigues,France,True,2,0,Draw
31553,33723,35816,2014,Burundi,Rwanda,1,1,Friendly,Bujumbura,Burundi,False,2,0,Draw
31554,33724,35817,2014,Colombia,Tunisia,1,1,Friendly,Barcelona,Spain,True,2,0,Draw
31555,33725,35818,2014,Cyprus,Northern Ireland,0,0,Friendly,Nicosia,Cyprus,False,0,0,Draw
31556,33726,35819,2014,Czech Republic,Norway,2,2,Friendly,Prague,Czech Republic,False,4,0,Draw
31557,33727,35820,2014,England,Denmark,1,0,Friendly,London,England,False,1,1,England
31558,33728,35821,2014,France,Netherlands,2,0,Friendly,Saint-Denis,France,False,2,2,France
31559,33729,35822,2014,Georgia,Liechtenstein,2,0,Friendly,Tbilisi,Georgia,False,2,2,Georgia
31560,33730,35823,2014,Germany,Chile,1,0,Friendly,Stuttgart,Germany,False,1,1,Germany
31561,33731,35824,2014,Gibraltar,Estonia,0,2,Friendly,Gibraltar,Gibraltar,False,2,-2,Estonia
31562,33733,35826,2014,Hungary,Finland,1,2,Friendly,Győr,Hungary,False,3,-1,Finland
31563,33734,35827,2014,India,Bangladesh,2,2,Friendly,Margao,India,False,4,0,Draw
31564,33735,35828,2014,Iran,Guinea,1,2,Friendly,Teheran,Iran,False,3,-1,Guinea
31565,33737,35830,2014,Republic of Ireland,Serbia,1,2,Friendly,Dublin,Republic of Ireland,False,3,-1,Serbia
31566,33738,35831,2014,Israel,Slovakia,1,3,Friendly,Netanya,Israel,False,4,-2,Slovakia
31567,33739,35832,2014,Japan,New Zealand,4,2,Friendly,Tokyo,Japan,False,6,2,Japan
31568,33740,35833,2014,Jordan,Syria,2,1,AFC Asian Cup qualification,Amman,Jordan,False,3,1,Jordan
31569,33741,35834,2014,Kazakhstan,Lithuania,1,1,Friendly,Antalya,Turkey,True,2,0,Draw
31570,33742,35835,2014,Kosovo,Haiti,0,0,Friendly,Mitrovica,Kosovo,False,0,0,Draw
31571,33744,35838,2014,Malawi,Zimbabwe,1,4,Friendly,Blantyre,Malawi,False,5,-3,Zimbabwe
31572,33745,35839,2014,Mali,Senegal,1,1,Friendly,Saint-Leu-la-Forêt,France,True,2,0,Draw
31573,33746,35840,2014,Mauritania,Niger,1,1,Friendly,Nouakchott,Mauritania,False,2,0,Draw
31574,33747,35841,2014,Montenegro,Ghana,1,0,Friendly,Podgorica,Montenegro,False,1,1,Montenegro
31575,33748,35842,2014,Morocco,Gabon,1,1,Friendly,Marrakech,Morocco,False,2,0,Draw
31576,33749,35843,2014,Mozambique,Angola,1,1,Friendly,Maputo,Mozambique,False,2,0,Draw
31577,33750,35844,2014,Namibia,Tanzania,1,1,Friendly,Windhoek,Namibia,False,2,0,Draw
31578,33751,35845,2014,Oman,Singapore,3,1,AFC Asian Cup qualification,Muscat,Oman,False,4,2,Oman
31579,33752,35846,2014,Philippines,Azerbaijan,0,1,Friendly,Dubai,United Arab Emirates,True,1,-1,Azerbaijan
31580,33753,35847,2014,Poland,Scotland,0,1,Friendly,Warsaw,Poland,False,1,-1,Scotland
31581,33754,35848,2014,Portugal,Cameroon,5,1,Friendly,Leiria,Portugal,False,6,4,Portugal
31582,33755,35849,2014,Qatar,Bahrain,0,0,AFC Asian Cup qualification,Doha,Qatar,False,0,0,Draw
31583,33756,35850,2014,Romania,Argentina,0,0,Friendly,Bucharest,Romania,False,0,0,Draw
31584,33757,35851,2014,Russia,Armenia,2,0,Friendly,Krasnodar,Russia,False,2,2,Russia
31585,33758,35852,2014,Saudi Arabia,Indonesia,1,0,AFC Asian Cup qualification,Dammam,Saudi Arabia,False,1,1,Saudi Arabia
31586,33759,35853,2014,South Africa,Brazil,0,5,Friendly,Johannesburg,South Africa,False,5,-5,Brazil
31587,33760,35854,2014,Spain,Italy,1,0,Friendly,Madrid,Spain,False,1,1,Spain
31588,33761,35855,2014,Saint Lucia,Jamaica,0,5,Friendly,Castries,Saint Lucia,False,5,-5,Jamaica
31589,33762,35856,2014,Switzerland,Croatia,2,2,Friendly,St. Gallen,Switzerland,False,4,0,Draw
31590,33763,35857,2014,Thailand,Lebanon,2,5,AFC Asian Cup qualification,Bangkok,Thailand,False,7,-3,Lebanon
31591,33764,35858,2014,Turkey,Sweden,2,1,Friendly,Ankara,Turkey,False,3,1,Turkey
31592,33765,35859,2014,Ukraine,United States,2,0,Friendly,Larnaca,Cyprus,True,2,2,Ukraine
31593,33766,35860,2014,Uzbekistan,United Arab Emirates,1,1,AFC Asian Cup qualification,Tashkent,Uzbekistan,False,2,0,Draw
31594,33767,35861,2014,Vietnam,Hong Kong,3,1,AFC Asian Cup qualification,Hanoi,Vietnam,False,4,2,Vietnam
31595,33768,35862,2014,Wales,Iceland,3,1,Friendly,Cardiff,Wales,False,4,2,Wales
31596,33769,35863,2014,Yemen,Malaysia,1,2,AFC Asian Cup qualification,al-Ain,United Arab Emirates,True,3,-1,Malaysia
31597,33770,35864,2014,Zambia,Uganda,2,1,Friendly,Ndola,Zambia,False,3,1,Zambia
31598,33771,35865,2014,Lesotho,Eswatini,0,1,Friendly,Maseru,Lesotho,False,1,-1,Eswatini
31599,33772,35866,2014,Lesotho,Eswatini,0,0,Friendly,Maseru,Lesotho,False,0,0,Draw
31600,33773,35867,2014,Saint Lucia,Martinique,0,0,Friendly,Gros Islet,Saint Lucia,False,0,0,Draw
31601,33774,35868,2014,Yemen,Nepal,2,0,Friendly,Doha,Qatar,True,2,2,Yemen
31602,33775,35869,2014,Andorra,Indonesia,0,1,Friendly,Alzira,Spain,True,1,-1,Indonesia
31603,33776,35870,2014,Aruba,Guam,2,2,Friendly,Oranjestad,Aruba,False,4,0,Draw
31604,33777,35871,2014,Cuba,Indonesia,1,0,Friendly,Alzira,Spain,True,1,1,Cuba
31605,33778,35872,2014,Aruba,Guam,2,0,Friendly,Oranjestad,Aruba,False,2,2,Aruba
31606,33779,35873,2014,Mauritania,Mauritius,1,0,African Cup of Nations qualification,Nouakchott,Mauritania,False,1,1,Mauritania
31607,33780,35874,2014,Afghanistan,Kyrgyzstan,0,0,Friendly,Dubai,United Arab Emirates,True,0,0,Draw
31608,33781,35875,2014,Yemen,Chad,0,0,Friendly,Doha,Qatar,True,0,0,Draw
31609,33782,35876,2014,Guadeloupe,French Guiana,3,2,Friendly,Les Abymes,Guadeloupe,False,5,1,Guadeloupe
31610,33783,35877,2014,Mauritius,Mauritania,0,2,African Cup of Nations qualification,Curepipe,Mauritius,False,2,-2,Mauritania
31611,33784,35878,2014,Tanzania,Burundi,0,3,Friendly,Dar es Salaam,Tanzania,False,3,-3,Burundi
31612,33785,35879,2014,Philippines,Malaysia,0,0,Friendly,Cebu,Philippines,False,0,0,Draw
31613,33786,35880,2014,Grenada,Saint Lucia,0,1,Windward Islands Tournament,Roseau,Dominica,True,1,-1,Saint Lucia
31614,33787,35881,2014,Dominica,Grenada,3,5,Windward Islands Tournament,Roseau,Dominica,False,8,-2,Grenada
31615,33788,35883,2014,Afghanistan,Kyrgyzstan,1,0,Friendly,Kuwait City,Kuwait,True,1,1,Afghanistan
31616,33789,35884,2014,Germany,Poland,0,0,Friendly,Hamburg,Germany,False,0,0,Draw
31617,33790,35885,2014,Kuwait,Afghanistan,3,2,Friendly,Kuwait City,Kuwait,False,5,1,Kuwait
31618,33791,35886,2014,Kuwait,Kyrgyzstan,2,2,Friendly,Kuwait City,Kuwait,False,4,0,Draw
31619,33792,35887,2014,Malawi,Chad,2,0,African Cup of Nations qualification,Blantyre,Malawi,False,2,2,Malawi
31620,33793,35888,2014,Mauritania,Equatorial Guinea,1,0,African Cup of Nations qualification,Nouakchott,Mauritania,False,1,1,Mauritania
31621,33794,35889,2014,Namibia,Congo,1,0,African Cup of Nations qualification,Windhoek,Namibia,False,1,1,Namibia
31622,33795,35890,2014,Netherlands,Ecuador,1,1,Friendly,Amsterdam,Netherlands,False,2,0,Draw
31623,33796,35891,2014,São Tomé and Príncipe,Benin,0,2,African Cup of Nations qualification,São Tomé,São Tomé and Príncipe,False,2,-2,Benin
31624,33797,35892,2014,Belarus,Iran,0,0,Friendly,Kapfenberg,Austria,True,0,0,Draw
31625,33798,35893,2014,Burundi,Botswana,0,0,African Cup of Nations qualification,Bujumbura,Burundi,False,0,0,Draw
31626,33799,35894,2014,Central African Republic,Guinea-Bissau,0,0,African Cup of Nations qualification,Brazzaville,Congo,True,0,0,Draw
31627,33800,35895,2014,Liberia,Lesotho,1,0,African Cup of Nations qualification,Monrovia,Liberia,False,1,1,Liberia
31628,33801,35896,2014,Libya,Rwanda,0,0,African Cup of Nations qualification,Radès,Tunisia,True,0,0,Draw
31629,33802,35897,2014,Tanzania,Zimbabwe,1,0,African Cup of Nations qualification,Dar es Salaam,Tanzania,False,1,1,Tanzania
31630,33803,35898,2014,Maldives,Burma,2,3,AFC Challenge Cup,Malé,Maldives,False,5,-1,Burma
31631,33804,35899,2014,Palestine,Kyrgyzstan,1,0,AFC Challenge Cup,Malé,Maldives,True,1,1,Palestine
31632,33805,35900,2014,French Guiana,Suriname,0,0,Friendly,Cayenne,French Guiana,False,0,0,Draw
31633,33806,35901,2014,Philippines,Afghanistan,0,0,AFC Challenge Cup,Addu City,Maldives,True,0,0,Draw
31634,33807,35902,2014,Turkmenistan,Laos,5,1,AFC Challenge Cup,Addu City,Maldives,True,6,4,Turkmenistan
31635,33808,35903,2014,Burkina Faso,Senegal,1,1,Friendly,Ouagadougou,Burkina Faso,False,2,0,Draw
31636,33809,35904,2014,Burma,Palestine,0,2,AFC Challenge Cup,Malé,Maldives,True,2,-2,Palestine
31637,33810,35905,2014,Finland,Czech Republic,2,2,Friendly,Helsinki,Finland,False,4,0,Draw
31638,33811,35906,2014,Kosovo,Turkey,1,6,Friendly,Mitrovica,Kosovo,False,7,-5,Turkey
31639,33812,35907,2014,Liechtenstein,Belarus,1,5,Friendly,Vaduz,Liechtenstein,False,6,-4,Belarus
31640,33813,35908,2014,Maldives,Kyrgyzstan,2,0,AFC Challenge Cup,Malé,Maldives,False,2,2,Maldives
31641,33814,35909,2014,Afghanistan,Turkmenistan,3,1,AFC Challenge Cup,Addu City,Maldives,True,4,2,Afghanistan
31642,33815,35910,2014,Hungary,Denmark,2,2,Friendly,Debrecen,Hungary,False,4,0,Draw
31643,33816,35911,2014,Laos,Philippines,0,2,AFC Challenge Cup,Addu City,Maldives,True,2,-2,Philippines
31644,33817,35912,2014,Ukraine,Niger,2,1,Friendly,Kyïv,Ukraine,False,3,1,Ukraine
31645,33818,35913,2014,Bulgaria,Canada,1,1,Friendly,Ritzing,Austria,True,2,0,Draw
31646,33819,35914,2014,Kyrgyzstan,Burma,1,0,AFC Challenge Cup,Addu City,Maldives,True,1,1,Kyrgyzstan
31647,33820,35915,2014,Maldives,Palestine,0,0,AFC Challenge Cup,Malé,Maldives,False,0,0,Draw
31648,33821,35916,2014,Slovakia,Montenegro,2,0,Friendly,Senec,Slovakia,False,2,2,Slovakia
31649,33822,35917,2014,Afghanistan,Laos,0,0,AFC Challenge Cup,Addu City,Maldives,True,0,0,Draw
31650,33823,35918,2014,Moldova,Saudi Arabia,4,0,Friendly,Jerez de la Frontera,Spain,True,4,4,Moldova
31651,33824,35919,2014,Turkmenistan,Philippines,0,2,AFC Challenge Cup,Malé,Maldives,True,2,-2,Philippines
31652,33825,35920,2014,Republic of Ireland,Turkey,1,2,Friendly,Dublin,Republic of Ireland,False,3,-1,Turkey
31653,33826,35921,2014,Kosovo,Senegal,1,3,Friendly,Lancy,Switzerland,True,4,-2,Senegal
31654,33827,35922,2014,Mali,Guinea,1,2,Friendly,Colombes,France,True,3,-1,Guinea
31655,33828,35923,2014,Thailand,Kuwait,1,1,Friendly,Bangkok,Thailand,False,2,0,Draw
31656,33829,35924,2014,Australia,South Africa,1,1,Friendly,Sydney,Australia,False,2,0,Draw
31657,33830,35925,2014,Belgium,Luxembourg,5,1,Friendly,Genk,Belgium,False,6,4,Belgium
31658,33831,35926,2014,Estonia,Gibraltar,1,1,Friendly,Tallinn,Estonia,False,2,0,Draw
31659,33832,35927,2014,Jamaica,Serbia,1,2,Friendly,Harrison,United States,True,3,-1,Serbia
31660,33833,35929,2014,Montenegro,Iran,0,0,Friendly,Hartberg,Austria,True,0,0,Draw
31661,33834,35930,2014,Russia,Slovakia,1,0,Friendly,St. Petersburg,Russia,False,1,1,Russia
31662,33835,35931,2014,Armenia,United Arab Emirates,4,3,Friendly,Carouge,Switzerland,True,7,1,Armenia
31663,33836,35932,2014,France,Norway,4,0,Friendly,Saint-Denis,France,False,4,4,France
31664,33837,35933,2014,Japan,Cyprus,1,0,Friendly,Saitama,Japan,False,1,1,Japan
31665,33838,35934,2014,Maldives,Philippines,2,3,AFC Challenge Cup,Malé,Maldives,False,5,-1,Philippines
31666,33839,35935,2014,Moldova,Canada,1,1,Friendly,Mauer,Austria,True,2,0,Draw
31667,33840,35936,2014,Palestine,Afghanistan,2,0,AFC Challenge Cup,Malé,Maldives,True,2,2,Palestine
31668,33841,35937,2014,Suriname,French Guiana,1,0,Friendly,Paramaribo,Suriname,False,1,1,Suriname
31669,33842,35938,2014,Tanzania,Malawi,1,0,Friendly,Dar es Salaam,Tanzania,False,1,1,Tanzania
31670,33843,35939,2014,Uzbekistan,Oman,0,1,Friendly,Olmaliq,Uzbekistan,False,1,-1,Oman
31671,33844,35940,2014,Angola,Morocco,2,0,Friendly,Faro,Portugal,True,2,2,Angola
31672,33845,35941,2014,Denmark,Sweden,1,0,Friendly,Copenhagen,Denmark,False,1,1,Denmark
31673,33846,35943,2014,Nigeria,Scotland,2,2,Friendly,London,England,True,4,0,Draw
31674,33847,35944,2014,Cameroon,Paraguay,1,2,Friendly,Kufstein,Austria,True,3,-1,Paraguay
31675,33848,35945,2014,Finland,Lithuania,0,1,Baltic Cup,Ventspils,Latvia,True,1,-1,Lithuania
31676,33849,35946,2014,Georgia,Saudi Arabia,2,0,Friendly,Jerez de la Frontera,Spain,True,2,2,Georgia
31677,33850,35947,2014,Latvia,Estonia,0,0,Baltic Cup,Liepāja,Latvia,False,0,0,Draw
31678,33851,35948,2014,Maldives,Afghanistan,1,1,AFC Challenge Cup,Malé,Maldives,False,2,0,Draw
31679,33852,35949,2014,Uzbekistan,Oman,0,1,Friendly,Tashkent,Uzbekistan,False,1,-1,Oman
31680,33853,35950,2014,Angola,Iran,1,1,Friendly,Hartberg,Austria,True,2,0,Draw
31681,33854,35951,2014,Aruba,Turks and Caicos Islands,1,0,CFU Caribbean Cup qualification,Oranjestad,Aruba,False,1,1,Aruba
31682,33855,35952,2014,Austria,Iceland,1,1,Friendly,Innsbruck,Austria,False,2,0,Draw
31683,33856,35953,2014,Bosnia and Herzegovina,Ivory Coast,2,1,Friendly,St. Louis,United States,True,3,1,Bosnia and Herzegovina
31684,33857,35954,2014,Comoros,Kenya,1,1,African Cup of Nations qualification,Mitsamiouli,Comoros,False,2,0,Draw
31685,33858,35955,2014,England,Peru,3,0,Friendly,London,England,False,3,3,England
31686,33860,35958,2014,Montserrat,U.S. Virgin Islands,1,0,CFU Caribbean Cup qualification,Lookout,Montserrat,False,1,1,Montserrat
31687,33861,35959,2014,New Zealand,South Africa,0,0,Friendly,Auckland,New Zealand,False,0,0,Draw
31688,33862,35960,2014,Palestine,Philippines,1,0,AFC Challenge Cup,Malé,Maldives,True,1,1,Palestine
31689,33863,35961,2014,South Sudan,Mozambique,0,0,African Cup of Nations qualification,Khartoum,Sudan,True,0,0,Draw
31690,33864,35962,2014,Spain,Bolivia,2,0,Friendly,Seville,Spain,False,2,2,Spain
31691,33865,35963,2014,Switzerland,Jamaica,1,0,Friendly,Lucerne,Switzerland,False,1,1,Switzerland
31692,33866,35964,2014,Uruguay,Northern Ireland,1,0,Friendly,Montevideo,Uruguay,False,1,1,Uruguay
31693,33867,35965,2014,Albania,Romania,0,1,Friendly,Yverdon-les-Bains,Switzerland,True,1,-1,Romania
31694,33868,35966,2014,Armenia,Algeria,1,3,Friendly,Sion,Switzerland,True,4,-2,Algeria
31695,33869,35967,2014,Chad,Malawi,3,1,African Cup of Nations qualification,N'Djamena,Chad,False,4,2,Chad
31696,33870,35968,2014,Colombia,Senegal,2,2,Friendly,Buenos Aires,Argentina,True,4,0,Draw
31697,33871,35969,2014,Croatia,Mali,2,1,Friendly,Osijek,Croatia,False,3,1,Croatia
31698,33872,35970,2014,Finland,Estonia,2,0,Baltic Cup,Ventspils,Latvia,True,2,2,Finland
31699,33873,35971,2014,Guinea-Bissau,Central African Republic,3,1,African Cup of Nations qualification,Bissau,Guinea-Bissau,False,4,2,Guinea-Bissau
31700,33874,35972,2014,Italy,Republic of Ireland,0,0,Friendly,London,England,True,0,0,Draw
31701,33875,35973,2014,Latvia,Lithuania,1,0,Baltic Cup,Liepāja,Latvia,False,1,1,Latvia
31702,33876,35974,2014,Mexico,Ecuador,3,1,Friendly,Arlington,United States,True,4,2,Mexico
31703,33877,35975,2014,Netherlands,Ghana,1,0,Friendly,Rotterdam,Netherlands,False,1,1,Netherlands
31704,33878,35976,2014,Norway,Russia,1,1,Friendly,Oslo,Norway,False,2,0,Draw
31705,33879,35977,2014,Portugal,Greece,0,0,Friendly,Oeiras,Portugal,False,0,0,Draw
31706,33880,35978,2014,Rwanda,Libya,3,0,African Cup of Nations qualification,Kigali,Rwanda,False,3,3,Rwanda
31707,33881,35979,2014,Sierra Leone,Eswatini,1,0,African Cup of Nations qualification,Freetown,Sierra Leone,False,1,1,Sierra Leone
31708,33882,35980,2014,Uganda,Madagascar,1,0,African Cup of Nations qualification,Kampala,Uganda,False,1,1,Uganda
31709,33884,35982,2014,Benin,São Tomé and Príncipe,2,0,African Cup of Nations qualification,Porto-Novo,Benin,False,2,2,Benin
31710,33885,35983,2014,Botswana,Burundi,1,0,African Cup of Nations qualification,Lobatse,Botswana,False,1,1,Botswana
31711,33886,35984,2014,Congo,Namibia,3,0,African Cup of Nations qualification,Pointe-Noire,Congo,False,3,3,Congo
31712,33887,35985,2014,Equatorial Guinea,Mauritania,3,0,African Cup of Nations qualification,Malabo,Equatorial Guinea,False,3,3,Equatorial Guinea
31713,33888,35986,2014,France,Paraguay,1,1,Friendly,Nice,France,False,2,0,Draw
31714,33889,35987,2014,Germany,Cameroon,2,2,Friendly,Mönchengladbach,Germany,False,4,0,Draw
31715,33890,35988,2014,Honduras,Israel,2,4,Friendly,Houston,United States,True,6,-2,Israel
31716,33891,35989,2014,Lesotho,Liberia,2,0,African Cup of Nations qualification,Maseru,Lesotho,False,2,2,Lesotho
31717,33892,35990,2014,Sweden,Belgium,0,2,Friendly,Solna,Sweden,False,2,-2,Belgium
31718,33893,35991,2014,Turks and Caicos Islands,French Guiana,0,6,CFU Caribbean Cup qualification,Oranjestad,Aruba,True,6,-6,French Guiana
31719,33894,35992,2014,United States,Turkey,2,1,Friendly,Harrison,United States,False,3,1,United States
31720,33895,35993,2014,U.S. Virgin Islands,Bonaire,1,2,CFU Caribbean Cup qualification,Lookout,Montserrat,True,3,-1,Bonaire
31721,33896,35994,2014,Zimbabwe,Tanzania,2,2,African Cup of Nations qualification,Harare,Zimbabwe,False,4,0,Draw
31722,33898,35999,2014,Costa Rica,Japan,1,3,Friendly,Tampa,United States,True,4,-2,Japan
31723,33900,36004,2014,Aruba,French Guiana,0,2,CFU Caribbean Cup qualification,Oranjestad,Aruba,False,2,-2,French Guiana
31724,33901,36005,2014,Brazil,Panama,4,0,Friendly,Goiânia,Brazil,False,4,4,Brazil
31725,33902,36007,2014,Czech Republic,Austria,1,2,Friendly,Olomouc,Czech Republic,False,3,-1,Austria
31726,33903,36008,2014,Georgia,United Arab Emirates,0,1,Friendly,Meyrin,Switzerland,True,1,-1,United Arab Emirates
31727,33904,36009,2014,Greece,Nigeria,0,0,Friendly,Chester,United States,True,0,0,Draw
31728,33905,36010,2014,Mexico,Bosnia and Herzegovina,0,1,Friendly,Chicago,United States,True,1,-1,Bosnia and Herzegovina
31729,33906,36011,2014,Switzerland,Peru,2,0,Friendly,Lucerne,Switzerland,False,2,2,Switzerland
31730,33907,36016,2014,Argentina,Trinidad and Tobago,3,0,Friendly,Buenos Aires,Argentina,False,3,3,Argentina
31731,33908,36017,2014,Ecuador,England,2,2,Friendly,Miami Gardens,United States,True,4,0,Draw
31732,33909,36018,2014,El Salvador,Ivory Coast,1,2,Friendly,Frisco,United States,True,3,-1,Ivory Coast
31733,33910,36019,2014,Gibraltar,Malta,1,0,Friendly,Faro,Portugal,True,1,1,Gibraltar
31734,33911,36020,2014,Hungary,Albania,1,0,Friendly,Budapest,Hungary,False,1,1,Hungary
31735,33912,36021,2014,Iceland,Estonia,1,0,Friendly,Reykjavík,Iceland,False,1,1,Iceland
31736,33913,36022,2014,Italy,Luxembourg,1,1,Friendly,Perugia,Italy,False,2,0,Draw
31737,33914,36023,2014,Jamaica,Egypt,2,2,Friendly,London,England,True,4,0,Draw
31738,33915,36024,2014,Netherlands,Wales,2,0,Friendly,Amsterdam,Netherlands,False,2,2,Netherlands
31739,33916,36025,2014,Romania,Algeria,1,2,Friendly,Lancy,Switzerland,True,3,-1,Algeria
31740,33918,36034,2014,Bolivia,Greece,1,2,Friendly,Harrison,United States,True,3,-1,Greece
31741,33919,36035,2014,Brazil,Serbia,1,0,Friendly,São Paulo,Brazil,False,1,1,Brazil
31742,33920,36036,2014,Colombia,Jordan,3,0,Friendly,Buenos Aires,Argentina,True,3,3,Colombia
31743,33921,36037,2014,Costa Rica,Republic of Ireland,1,1,Friendly,Chester,United States,True,2,0,Draw
31744,33922,36038,2014,Croatia,Australia,1,0,Friendly,Salvador,Brazil,True,1,1,Croatia
31745,33923,36039,2014,Germany,Armenia,6,1,Friendly,Mainz,Germany,False,7,5,Germany
31746,33924,36040,2014,Japan,Zambia,4,3,Friendly,Tampa,United States,True,7,1,Japan
31747,33925,36041,2014,Mexico,Portugal,0,1,Friendly,Foxborough,United States,True,1,-1,Portugal
31748,33926,36042,2014,Poland,Lithuania,2,1,Friendly,Gdańsk,Poland,False,3,1,Poland
31749,33927,36043,2014,Russia,Morocco,2,0,Friendly,Moscow,Russia,False,2,2,Russia
31750,33928,36046,2014,Argentina,Slovenia,2,0,Friendly,La Plata,Argentina,False,2,2,Argentina
31751,33929,36047,2014,Belgium,Tunisia,1,0,Friendly,Brussels,Belgium,False,1,1,Belgium
31752,33930,36048,2014,Cameroon,Moldova,1,0,Friendly,Yaoundé,Cameroon,False,1,1,Cameroon
31753,33931,36049,2014,El Salvador,Spain,0,2,Friendly,Landover,United States,True,2,-2,Spain
31754,33932,36050,2014,Estonia,Tajikistan,2,1,Friendly,Tallinn,Estonia,False,3,1,Estonia
31755,33933,36051,2014,Honduras,England,0,0,Friendly,Miami Gardens,United States,True,0,0,Draw
31756,33934,36052,2014,Hungary,Kazakhstan,3,0,Friendly,Budapest,Hungary,False,3,3,Hungary
31757,33935,36053,2014,United States,Nigeria,2,1,Friendly,Jacksonville,United States,False,3,1,United States
31758,33936,36058,2014,France,Jamaica,8,0,Friendly,Villeneuve-d'Ascq,France,False,8,8,France
31759,33937,36059,2014,Iran,Trinidad and Tobago,2,0,Friendly,São Paulo,Brazil,True,2,2,Iran
31760,33938,36060,2014,San Marino,Albania,0,3,Friendly,Serravalle,San Marino,False,3,-3,Albania
31761,33940,36064,2014,Republic of Ireland,Portugal,1,5,Friendly,East Rutherford,United States,True,6,-4,Portugal
31762,33941,36065,2014,Brazil,Croatia,3,1,FIFA World Cup,São Paulo,Brazil,False,4,2,Brazil
31763,33942,36066,2014,Chile,Australia,3,1,FIFA World Cup,Cuiabá,Brazil,True,4,2,Chile
31764,33943,36067,2014,Mexico,Cameroon,1,0,FIFA World Cup,Natal,Brazil,True,1,1,Mexico
31765,33944,36068,2014,Spain,Netherlands,1,5,FIFA World Cup,Salvador,Brazil,True,6,-4,Netherlands
31766,33945,36069,2014,Colombia,Greece,3,0,FIFA World Cup,Belo Horizonte,Brazil,True,3,3,Colombia
31767,33946,36070,2014,England,Italy,1,2,FIFA World Cup,Manaus,Brazil,True,3,-1,Italy
31768,33947,36071,2014,Ivory Coast,Japan,2,1,FIFA World Cup,Recife,Brazil,True,3,1,Ivory Coast
31769,33948,36072,2014,Uruguay,Costa Rica,1,3,FIFA World Cup,Fortaleza,Brazil,True,4,-2,Costa Rica
31770,33949,36073,2014,Argentina,Bosnia and Herzegovina,2,1,FIFA World Cup,Rio de Janeiro,Brazil,True,3,1,Argentina
31771,33950,36074,2014,France,Honduras,3,0,FIFA World Cup,Porto Alegre,Brazil,True,3,3,France
31772,33951,36075,2014,Switzerland,Ecuador,2,1,FIFA World Cup,Brasília,Brazil,True,3,1,Switzerland
31773,33952,36076,2014,Germany,Portugal,4,0,FIFA World Cup,Salvador,Brazil,True,4,4,Germany
31774,33953,36077,2014,Ghana,United States,1,2,FIFA World Cup,Natal,Brazil,True,3,-1,United States
31775,33954,36078,2014,Iran,Nigeria,0,0,FIFA World Cup,Curitiba,Brazil,True,0,0,Draw
31776,33955,36079,2014,Belgium,Algeria,2,1,FIFA World Cup,Belo Horizonte,Brazil,True,3,1,Belgium
31777,33956,36080,2014,Brazil,Mexico,0,0,FIFA World Cup,Fortaleza,Brazil,False,0,0,Draw
31778,33958,36082,2014,Australia,Netherlands,2,3,FIFA World Cup,Curitiba,Brazil,True,5,-1,Netherlands
31779,33959,36083,2014,Cameroon,Croatia,0,4,FIFA World Cup,Manaus,Brazil,True,4,-4,Croatia
31780,33960,36085,2014,Spain,Chile,0,2,FIFA World Cup,Rio de Janeiro,Brazil,True,2,-2,Chile
31781,33961,36086,2014,Colombia,Ivory Coast,2,1,FIFA World Cup,Brasília,Brazil,True,3,1,Colombia
31782,33962,36087,2014,Japan,Greece,0,0,FIFA World Cup,Natal,Brazil,True,0,0,Draw
31783,33963,36088,2014,Uruguay,England,2,1,FIFA World Cup,São Paulo,Brazil,True,3,1,Uruguay
31784,33964,36089,2014,Honduras,Ecuador,1,2,FIFA World Cup,Curitiba,Brazil,True,3,-1,Ecuador
31785,33965,36090,2014,Italy,Costa Rica,0,1,FIFA World Cup,Recife,Brazil,True,1,-1,Costa Rica
31786,33966,36091,2014,Switzerland,France,2,5,FIFA World Cup,Salvador,Brazil,True,7,-3,France
31787,33967,36092,2014,Argentina,Iran,1,0,FIFA World Cup,Belo Horizonte,Brazil,True,1,1,Argentina
31788,33968,36093,2014,Germany,Ghana,2,2,FIFA World Cup,Fortaleza,Brazil,True,4,0,Draw
31789,33969,36094,2014,Indonesia,Pakistan,4,0,Friendly,Surabaya,Indonesia,False,4,4,Indonesia
31790,33970,36095,2014,Nigeria,Bosnia and Herzegovina,1,0,FIFA World Cup,Cuiabá,Brazil,True,1,1,Nigeria
31791,33971,36096,2014,Belgium,Russia,1,0,FIFA World Cup,Rio de Janeiro,Brazil,True,1,1,Belgium
31792,33972,36099,2014,United States,Portugal,2,2,FIFA World Cup,Manaus,Brazil,True,4,0,Draw
31793,33973,36100,2014,Australia,Spain,0,3,FIFA World Cup,Curitiba,Brazil,True,3,-3,Spain
31794,33974,36101,2014,Brazil,Cameroon,4,1,FIFA World Cup,Brasília,Brazil,False,5,3,Brazil
31795,33975,36102,2014,Croatia,Mexico,1,3,FIFA World Cup,Recife,Brazil,True,4,-2,Mexico
31796,33976,36103,2014,Netherlands,Chile,2,0,FIFA World Cup,São Paulo,Brazil,True,2,2,Netherlands
31797,33977,36104,2014,Costa Rica,England,0,0,FIFA World Cup,Belo Horizonte,Brazil,True,0,0,Draw
31798,33978,36105,2014,Greece,Ivory Coast,2,1,FIFA World Cup,Fortaleza,Brazil,True,3,1,Greece
31799,33979,36106,2014,Italy,Uruguay,0,1,FIFA World Cup,Natal,Brazil,True,1,-1,Uruguay
31800,33980,36107,2014,Japan,Colombia,1,4,FIFA World Cup,Cuiabá,Brazil,True,5,-3,Colombia
31801,33981,36108,2014,Bosnia and Herzegovina,Iran,3,1,FIFA World Cup,Salvador,Brazil,True,4,2,Bosnia and Herzegovina
31802,33982,36109,2014,Ecuador,France,0,0,FIFA World Cup,Rio de Janeiro,Brazil,True,0,0,Draw
31803,33983,36110,2014,Honduras,Switzerland,0,3,FIFA World Cup,Manaus,Brazil,True,3,-3,Switzerland
31804,33984,36111,2014,Indonesia,Nepal,2,0,Friendly,Malang,Indonesia,False,2,2,Indonesia
31805,33985,36112,2014,Nigeria,Argentina,2,3,FIFA World Cup,Porto Alegre,Brazil,True,5,-1,Argentina
31806,33986,36113,2014,Algeria,Russia,1,1,FIFA World Cup,Curitiba,Brazil,True,2,0,Draw
31807,33987,36115,2014,Portugal,Ghana,2,1,FIFA World Cup,Brasília,Brazil,True,3,1,Portugal
31808,33988,36116,2014,United States,Germany,0,1,FIFA World Cup,Recife,Brazil,True,1,-1,Germany
31809,33989,36117,2014,Brazil,Chile,1,1,FIFA World Cup,Belo Horizonte,Brazil,False,2,0,Draw
31810,33990,36118,2014,Colombia,Uruguay,2,0,FIFA World Cup,Rio de Janeiro,Brazil,True,2,2,Colombia
31811,33991,36120,2014,Costa Rica,Greece,1,1,FIFA World Cup,Recife,Brazil,True,2,0,Draw
31812,33992,36121,2014,Netherlands,Mexico,2,1,FIFA World Cup,Fortaleza,Brazil,True,3,1,Netherlands
31813,33993,36122,2014,France,Nigeria,2,0,FIFA World Cup,Brasília,Brazil,True,2,2,France
31814,33994,36123,2014,Germany,Algeria,2,1,FIFA World Cup,Porto Alegre,Brazil,True,3,1,Germany
31815,33995,36124,2014,Argentina,Switzerland,1,0,FIFA World Cup,São Paulo,Brazil,True,1,1,Argentina
31816,33996,36125,2014,Belgium,United States,2,1,FIFA World Cup,Salvador,Brazil,True,3,1,Belgium
31817,33997,36126,2014,Vietnam,Burma,6,0,Friendly,Thủ Dầu Một,Vietnam,False,6,6,Vietnam
31818,33998,36127,2014,Brazil,Colombia,2,1,FIFA World Cup,Fortaleza,Brazil,False,3,1,Brazil
31819,33999,36128,2014,France,Germany,0,1,FIFA World Cup,Rio de Janeiro,Brazil,True,1,-1,Germany
31820,34000,36129,2014,Argentina,Belgium,1,0,FIFA World Cup,Brasília,Brazil,True,1,1,Argentina
31821,34001,36130,2014,Netherlands,Costa Rica,0,0,FIFA World Cup,Salvador,Brazil,True,0,0,Draw
31822,34002,36131,2014,Malawi,Mozambique,1,1,Friendly,Lilongwe,Malawi,False,2,0,Draw
31823,34003,36132,2014,Brazil,Germany,1,7,FIFA World Cup,Belo Horizonte,Brazil,False,8,-6,Germany
31824,34004,36133,2014,Netherlands,Argentina,0,0,FIFA World Cup,São Paulo,Brazil,True,0,0,Draw
31825,34005,36134,2014,Uganda,Seychelles,1,0,Friendly,Kampala,Uganda,False,1,1,Uganda
31826,34006,36135,2014,Brazil,Netherlands,0,3,FIFA World Cup,Brasília,Brazil,False,3,-3,Netherlands
31827,34007,36136,2014,Rwanda,Gabon,1,0,Friendly,Kigali,Rwanda,False,1,1,Rwanda
31828,34008,36137,2014,Germany,Argentina,1,0,FIFA World Cup,Rio de Janeiro,Brazil,True,1,1,Germany
31829,34009,36138,2014,Botswana,Lesotho,2,0,Friendly,Gaborone,Botswana,False,2,2,Botswana
31830,34010,36139,2014,Qatar,Indonesia,2,2,Friendly,al-Wakrah,Qatar,False,4,0,Draw
31831,34011,36140,2014,Kenya,Burundi,0,0,Friendly,Nairobi,Kenya,False,0,0,Draw
31832,34012,36141,2014,Uganda,Malawi,0,0,Friendly,Kampala,Uganda,False,0,0,Draw
31833,34013,36142,2014,Botswana,Guinea-Bissau,2,0,African Cup of Nations qualification,Gaborone,Botswana,False,2,2,Botswana
31834,34014,36143,2014,Sierra Leone,Seychelles,2,0,African Cup of Nations qualification,Freetown,Sierra Leone,False,2,2,Sierra Leone
31835,34015,36144,2014,Uganda,Mauritania,2,0,African Cup of Nations qualification,Kampala,Uganda,False,2,2,Uganda
31836,34016,36145,2014,Benin,Malawi,1,0,African Cup of Nations qualification,Cotonou,Benin,False,1,1,Benin
31837,34017,36146,2014,Congo,Rwanda,2,0,African Cup of Nations qualification,Pointe-Noire,Congo,False,2,2,Congo
31838,34018,36147,2014,Lesotho,Kenya,1,0,African Cup of Nations qualification,Maseru,Lesotho,False,1,1,Lesotho
31839,34019,36148,2014,Tanzania,Mozambique,2,2,African Cup of Nations qualification,Dar es Salaam,Tanzania,False,4,0,Draw
31840,34020,36149,2014,Guam,Macau,0,0,EAFF Championship,Dededo,Guam,False,0,0,Draw
31841,34021,36150,2014,Mongolia,Northern Mariana Islands,4,0,EAFF Championship,Dededo,Guam,True,4,4,Mongolia
31842,34022,36151,2014,Guam,Mongolia,2,0,EAFF Championship,Dededo,Guam,False,2,2,Guam
31843,34023,36152,2014,Northern Mariana Islands,Macau,2,1,EAFF Championship,Dededo,Guam,True,3,1,Northern Mariana Islands
31844,34024,36153,2014,Guam,Northern Mariana Islands,5,0,EAFF Championship,Dededo,Guam,False,5,5,Guam
31845,34025,36154,2014,Macau,Mongolia,3,2,EAFF Championship,Dededo,Guam,True,5,1,Macau
31846,34026,36155,2014,Gabon,Rwanda,0,1,Friendly,Libreville,Gabon,False,1,-1,Rwanda
31847,34027,36156,2014,Guinea-Bissau,Botswana,1,1,African Cup of Nations qualification,Bissau,Guinea-Bissau,False,2,0,Draw
31848,34028,36157,2014,Malawi,Benin,1,0,African Cup of Nations qualification,Blantyre,Malawi,False,1,1,Malawi
31849,34029,36158,2014,Rwanda,Congo,2,0,African Cup of Nations qualification,Kigali,Rwanda,False,2,2,Rwanda
31850,34030,36159,2014,Kenya,Lesotho,0,0,African Cup of Nations qualification,Nairobi,Kenya,False,0,0,Draw
31851,34031,36160,2014,Mauritania,Uganda,0,1,African Cup of Nations qualification,Nouakchott,Mauritania,False,1,-1,Uganda
31852,34032,36161,2014,Mozambique,Tanzania,2,1,African Cup of Nations qualification,Maputo,Mozambique,False,3,1,Mozambique
31853,34033,36162,2014,Tajikistan,Malaysia,4,1,Friendly,Dushanbe,Tajikistan,False,5,3,Tajikistan
31854,34034,36163,2014,Kazakhstan,Tajikistan,2,1,Friendly,Almaty,Kazakhstan,False,3,1,Kazakhstan
31855,34035,36164,2014,Angola,Botswana,0,0,Friendly,Luanda,Angola,False,0,0,Draw
31856,34036,36165,2014,Guatemala,Nicaragua,3,0,Friendly,Antigua Guatemala,Guatemala,False,3,3,Guatemala
31857,34037,36167,2014,Azerbaijan,Uzbekistan,0,0,Friendly,Baku,Azerbaijan,False,0,0,Draw
31858,34038,36168,2014,Panama,Cuba,4,0,Friendly,Panama City,Panama,False,4,4,Panama
31859,34039,36169,2014,Guatemala,Cuba,1,0,Friendly,Guatemala,Guatemala,False,1,1,Guatemala
31860,34040,36170,2014,French Guiana,Suriname,0,1,Friendly,Saint-Laurent-du-Maroni,French Guiana,False,1,-1,Suriname
31861,34041,36171,2014,Seychelles,Sri Lanka,1,2,Friendly,Victoria,Seychelles,False,3,-1,Sri Lanka
31862,34042,36172,2014,Saint Lucia,Martinique,0,2,Friendly,Gros Islet,Saint Lucia,False,2,-2,Martinique
31863,34043,36173,2014,Norway,United Arab Emirates,0,0,Friendly,Stavanger,Norway,False,0,0,Draw
31864,34044,36174,2014,Seychelles,Sri Lanka,3,0,Friendly,Victoria,Seychelles,False,3,3,Seychelles
31865,34045,36175,2014,Saint Lucia,Martinique,0,1,Friendly,Gros Islet,Saint Lucia,False,1,-1,Martinique
31866,34046,36176,2014,Egypt,Kenya,1,0,Friendly,Aswan,Egypt,False,1,1,Egypt
31867,34047,36177,2014,El Salvador,Dominican Republic,2,0,Friendly,San Salvador,El Salvador,False,2,2,El Salvador
31868,34048,36178,2014,Zambia,Sudan,3,1,Friendly,Lusaka,Zambia,False,4,2,Zambia
31869,34049,36179,2014,Niger,Uganda,2,0,Friendly,Niamey,Niger,False,2,2,Niger
31870,34050,36180,2014,Burma,Palestine,4,1,Friendly,Manila,Philippines,True,5,3,Burma
31871,34051,36181,2014,Costa Rica,Nicaragua,3,0,UNCAF Cup,Washington,United States,True,3,3,Costa Rica
31872,34052,36182,2014,Czech Republic,United States,0,1,Friendly,Prague,Czech Republic,False,1,-1,United States
31873,34053,36183,2014,Denmark,Turkey,1,2,Friendly,Odense,Denmark,False,3,-1,Turkey
31874,34054,36184,2014,England,Norway,1,0,Friendly,London,England,False,1,1,England
31875,34055,36185,2014,Germany,Argentina,2,4,Friendly,Düsseldorf,Germany,False,6,-2,Argentina
31876,34056,36186,2014,Grenada,French Guiana,1,1,CFU Caribbean Cup qualification,Bayamón,Puerto Rico,True,2,0,Draw
31877,34057,36187,2014,Guyana,Dominica,0,0,CFU Caribbean Cup qualification,Basseterre,Saint Kitts and Nevis,True,0,0,Draw
31878,34058,36188,2014,Republic of Ireland,Oman,2,0,Friendly,Dublin,Republic of Ireland,False,2,2,Republic of Ireland
31879,34059,36189,2014,Latvia,Armenia,2,0,Friendly,Riga,Latvia,False,2,2,Latvia
31880,34060,36190,2014,Lithuania,United Arab Emirates,1,1,Friendly,Matrei in Osttirol,Austria,True,2,0,Draw
31881,34061,36191,2014,Morocco,Qatar,0,0,Friendly,Rabat,Morocco,False,0,0,Draw
31882,34063,36193,2014,Puerto Rico,Curaçao,2,2,CFU Caribbean Cup qualification,Bayamón,Puerto Rico,False,4,0,Draw
31883,34064,36194,2014,Russia,Azerbaijan,4,0,Friendly,Khimki,Russia,False,4,4,Russia
31884,34065,36195,2014,Ukraine,Moldova,1,0,Friendly,Kyïv,Ukraine,False,1,1,Ukraine
31885,34066,36196,2014,Belarus,Tajikistan,6,1,Friendly,Barysaw,Belarus,False,7,5,Belarus
31886,34067,36197,2014,Belgium,Australia,2,0,Friendly,Liège,Belgium,False,2,2,Belgium
31887,34068,36198,2014,Bosnia and Herzegovina,Liechtenstein,3,0,Friendly,Tuzla,Bosnia and Herzegovina,False,3,3,Bosnia and Herzegovina
31888,34069,36200,2014,Croatia,Cyprus,2,0,Friendly,Pula,Croatia,False,2,2,Croatia
31889,34070,36201,2014,France,Spain,1,0,Friendly,Saint-Denis,France,False,1,1,France
31890,34071,36202,2014,Iraq,Peru,0,2,Friendly,Dubai,United Arab Emirates,True,2,-2,Peru
31891,34072,36203,2014,Italy,Netherlands,2,0,Friendly,Bari,Italy,False,2,2,Italy
31892,34073,36204,2014,Slovakia,Malta,1,0,Friendly,Žilina,Slovakia,False,1,1,Slovakia
31893,34074,36205,2014,Sweden,Estonia,2,0,Friendly,Solna,Sweden,False,2,2,Sweden
31894,34075,36206,2014,Uzbekistan,Jordan,2,0,Friendly,Tashkent,Uzbekistan,False,2,2,Uzbekistan
31895,34076,36207,2014,Curaçao,Grenada,2,1,CFU Caribbean Cup qualification,Bayamón,Puerto Rico,True,3,1,Curaçao
31896,34077,36208,2014,Guinea,Togo,2,1,African Cup of Nations qualification,Casablanca,Morocco,True,3,1,Guinea
31897,34078,36209,2014,Japan,Uruguay,0,2,Friendly,Sapporo,Japan,False,2,-2,Uruguay
31898,34079,36210,2014,Kazakhstan,Kyrgyzstan,7,1,Friendly,Astana,Kazakhstan,False,8,6,Kazakhstan
31899,34080,36212,2014,Puerto Rico,French Guiana,1,2,CFU Caribbean Cup qualification,Bayamón,Puerto Rico,False,3,-1,French Guiana
31900,34081,36213,2014,Senegal,Egypt,2,0,African Cup of Nations qualification,Dakar,Senegal,False,2,2,Senegal
31901,34082,36214,2014,Saint Kitts and Nevis,Dominica,5,0,CFU Caribbean Cup qualification,Basseterre,Saint Kitts and Nevis,False,5,5,Saint Kitts and Nevis
31902,34083,36215,2014,Saint Lucia,Guyana,2,0,CFU Caribbean Cup qualification,Basseterre,Saint Kitts and Nevis,True,2,2,Saint Lucia
31903,34084,36216,2014,Saint Vincent and the Grenadines,Anguilla,4,0,CFU Caribbean Cup qualification,St. John's,Antigua and Barbuda,True,4,4,Saint Vincent and the Grenadines
31904,34085,36217,2014,Sudan,South Africa,0,3,African Cup of Nations qualification,Omdurman,Sudan,False,3,-3,South Africa
31905,34086,36218,2014,Suriname,Bonaire,2,3,CFU Caribbean Cup qualification,Rivière-Pilote,Martinique,True,5,-1,Bonaire
31906,34087,36219,2014,Burkina Faso,Lesotho,2,0,African Cup of Nations qualification,Ouagadougou,Burkina Faso,False,2,2,Burkina Faso
31907,34088,36220,2014,DR Congo,Cameroon,0,2,African Cup of Nations qualification,Lubumbashi,DR Congo,False,2,-2,Cameroon
31908,34089,36221,2014,Ethiopia,Algeria,1,2,African Cup of Nations qualification,Addis Abeba,Ethiopia,False,3,-1,Algeria
31909,34090,36222,2014,Gabon,Angola,1,0,African Cup of Nations qualification,Libreville,Gabon,False,1,1,Gabon
31910,34091,36223,2014,Ghana,Uganda,1,1,African Cup of Nations qualification,Kumasi,Ghana,False,2,0,Draw
31911,34092,36224,2014,Ivory Coast,Sierra Leone,2,1,African Cup of Nations qualification,Abidjan,Ivory Coast,False,3,1,Ivory Coast
31912,34093,36225,2014,Mexico,Chile,0,0,Friendly,Santa Clara,United States,True,0,0,Draw
31913,34095,36227,2014,Nigeria,Congo,2,3,African Cup of Nations qualification,Calabar,Nigeria,False,5,-1,Congo
31914,34097,36229,2014,Philippines,Burma,2,3,Friendly,Manila,Philippines,False,5,-1,Burma
31915,34098,36230,2014,Singapore,Papua New Guinea,2,1,Friendly,Hougang,Singapore,False,3,1,Singapore
31916,34099,36231,2014,Tunisia,Botswana,2,1,African Cup of Nations qualification,Monastir,Tunisia,False,3,1,Tunisia
31917,34100,36232,2014,Vietnam,Hong Kong,3,1,Friendly,Hải Phòng,Vietnam,False,4,2,Vietnam
31918,34101,36233,2014,Zambia,Mozambique,0,0,African Cup of Nations qualification,Ndola,Zambia,False,0,0,Draw
31919,34102,36234,2014,Bonaire,Barbados,1,4,CFU Caribbean Cup qualification,Fort-de-France,Martinique,True,5,-3,Barbados
31920,34103,36235,2014,Burundi,Tanzania,2,0,Friendly,Bujumbura,Burundi,False,2,2,Burundi
31921,34104,36236,2014,Costa Rica,Panama,2,2,UNCAF Cup,Dallas,United States,True,4,0,Draw
31922,34105,36237,2014,Denmark,Armenia,2,1,UEFA Euro qualification,Copenhagen,Denmark,False,3,1,Denmark
31923,34106,36238,2014,Dominica,Saint Lucia,1,2,CFU Caribbean Cup qualification,Basseterre,Saint Kitts and Nevis,True,3,-1,Saint Lucia
31924,34107,36239,2014,Faroe Islands,Finland,1,3,UEFA Euro qualification,Tórshavn,Faroe Islands,False,4,-2,Finland
31925,34108,36240,2014,French Guiana,Curaçao,0,0,CFU Caribbean Cup qualification,Bayamón,Puerto Rico,True,0,0,Draw
31926,34109,36241,2014,Georgia,Republic of Ireland,1,2,UEFA Euro qualification,Tbilisi,Georgia,False,3,-1,Republic of Ireland
31927,34110,36242,2014,Germany,Scotland,2,1,UEFA Euro qualification,Dortmund,Germany,False,3,1,Germany
31928,34111,36243,2014,Gibraltar,Poland,0,7,UEFA Euro qualification,Faro,Portugal,True,7,-7,Poland
31929,34112,36244,2014,Greece,Romania,0,1,UEFA Euro qualification,Piraeus,Greece,False,1,-1,Romania
31930,34113,36245,2014,Hungary,Northern Ireland,1,2,UEFA Euro qualification,Budapest,Hungary,False,3,-1,Northern Ireland
31931,34114,36246,2014,Kosovo,Oman,1,0,Friendly,Prishtina,Kosovo,False,1,1,Kosovo
31932,34115,36247,2014,Mali,Malawi,2,0,African Cup of Nations qualification,Bamako,Mali,False,2,2,Mali
31933,34116,36248,2014,Morocco,Libya,3,0,Friendly,Marrakech,Morocco,False,3,3,Morocco
31934,34117,36249,2014,Paraguay,United Arab Emirates,0,0,Friendly,Villach,Austria,True,0,0,Draw
31935,34118,36250,2014,Portugal,Albania,0,1,UEFA Euro qualification,Aveiro,Portugal,False,1,-1,Albania
31936,34119,36251,2014,Puerto Rico,Grenada,2,2,CFU Caribbean Cup qualification,Bayamón,Puerto Rico,False,4,0,Draw
31937,34120,36252,2014,Serbia,France,1,1,Friendly,Belgrade,Serbia,False,2,0,Draw
31938,34121,36253,2014,Australia,Saudi Arabia,3,2,Friendly,London,England,True,5,1,Australia
31939,34122,36254,2014,Austria,Sweden,1,1,UEFA Euro qualification,Vienna,Austria,False,2,0,Draw
31940,34123,36255,2014,Estonia,Slovenia,1,0,UEFA Euro qualification,Tallinn,Estonia,False,1,1,Estonia
31941,34124,36257,2014,Luxembourg,Belarus,1,1,UEFA Euro qualification,Luxembourg,Luxembourg,False,2,0,Draw
31942,34125,36258,2014,Montenegro,Moldova,2,0,UEFA Euro qualification,Podgorica,Montenegro,False,2,2,Montenegro
31943,34126,36259,2014,Russia,Liechtenstein,4,0,UEFA Euro qualification,Khimki,Russia,False,4,4,Russia
31944,34127,36260,2014,San Marino,Lithuania,0,2,UEFA Euro qualification,Serravalle,San Marino,False,2,-2,Lithuania
31945,34129,36262,2014,Switzerland,England,0,2,UEFA Euro qualification,Basel,Switzerland,False,2,-2,England
31946,34130,36263,2014,Ukraine,Slovakia,0,1,UEFA Euro qualification,Kyïv,Ukraine,False,1,-1,Slovakia
31947,34131,36264,2014,Uzbekistan,New Zealand,3,1,Friendly,Tashkent,Uzbekistan,False,4,2,Uzbekistan
31948,34132,36265,2014,Andorra,Wales,1,2,UEFA Euro qualification,Sant Julià de Lòria,Andorra,False,3,-1,Wales
31949,34133,36266,2014,Azerbaijan,Bulgaria,1,2,UEFA Euro qualification,Baku,Azerbaijan,False,3,-1,Bulgaria
31950,34134,36267,2014,Bosnia and Herzegovina,Cyprus,1,2,UEFA Euro qualification,Zenica,Bosnia and Herzegovina,False,3,-1,Cyprus
31951,34135,36269,2014,Croatia,Malta,2,0,UEFA Euro qualification,Zagreb,Croatia,False,2,2,Croatia
31952,34136,36270,2014,Czech Republic,Netherlands,2,1,UEFA Euro qualification,Prague,Czech Republic,False,3,1,Czech Republic
31953,34137,36271,2014,Haiti,Chile,0,1,Friendly,Fort Lauderdale,United States,True,1,-1,Chile
31954,34138,36272,2014,Iceland,Turkey,3,0,UEFA Euro qualification,Reykjavík,Iceland,False,3,3,Iceland
31955,34139,36273,2014,Indonesia,Yemen,0,0,Friendly,Yogyakarta,Indonesia,False,0,0,Draw
31956,34140,36274,2014,Japan,Venezuela,2,2,Friendly,Yokohama,Japan,False,4,0,Draw
31957,34141,36275,2014,Kazakhstan,Latvia,0,0,UEFA Euro qualification,Astana,Kazakhstan,False,0,0,Draw
31958,34142,36276,2014,Kuwait,Bahrain,0,1,Friendly,al-Farwaniyah,Kuwait,False,1,-1,Bahrain
31959,34143,36277,2014,Mexico,Bolivia,1,0,Friendly,Commerce City,United States,True,1,1,Mexico
31960,34144,36278,2014,Norway,Italy,0,2,UEFA Euro qualification,Oslo,Norway,False,2,-2,Italy
31961,34145,36279,2014,Qatar,Peru,0,2,Friendly,Doha,Qatar,False,2,-2,Peru
31962,34146,36280,2014,Singapore,Hong Kong,0,0,Friendly,Hougang,Singapore,False,0,0,Draw
31963,34147,36281,2014,Algeria,Mali,1,0,African Cup of Nations qualification,Blida,Algeria,False,1,1,Algeria
31964,34148,36282,2014,Angola,Burkina Faso,0,3,African Cup of Nations qualification,Luanda,Angola,False,3,-3,Burkina Faso
31965,34149,36283,2014,Botswana,Senegal,0,2,African Cup of Nations qualification,Gaborone,Botswana,False,2,-2,Senegal
31966,34150,36284,2014,Cameroon,Ivory Coast,4,1,African Cup of Nations qualification,Yaoundé,Cameroon,False,5,3,Cameroon
31967,34151,36286,2014,Congo,Sudan,2,0,African Cup of Nations qualification,Pointe-Noire,Congo,False,2,2,Congo
31968,34152,36287,2014,DR Congo,Sierra Leone,2,0,African Cup of Nations qualification,Lubumbashi,DR Congo,False,2,2,DR Congo
31969,34153,36288,2014,Egypt,Tunisia,0,1,African Cup of Nations qualification,Cairo,Egypt,False,1,-1,Tunisia
31970,34154,36289,2014,Lesotho,Gabon,1,1,African Cup of Nations qualification,Maseru,Lesotho,False,2,0,Draw
31971,34155,36290,2014,Malawi,Ethiopia,3,2,African Cup of Nations qualification,Blantyre,Malawi,False,5,1,Malawi
31972,34156,36291,2014,Mozambique,Niger,1,1,African Cup of Nations qualification,Maputo,Mozambique,False,2,0,Draw
31973,34157,36292,2014,South Africa,Nigeria,0,0,African Cup of Nations qualification,Cape Town,South Africa,False,0,0,Draw
31974,34158,36293,2014,Togo,Ghana,2,3,African Cup of Nations qualification,Lomé,Togo,False,5,-1,Ghana
31975,34159,36294,2014,Uganda,Guinea,2,0,African Cup of Nations qualification,Kampala,Uganda,False,2,2,Uganda
31976,34160,36295,2014,Indonesia,Malaysia,2,0,Friendly,Sidoarjo,Indonesia,False,2,2,Indonesia
31977,34161,36296,2014,Malaysia,Cambodia,4,1,Friendly,Shah Alam,Malaysia,False,5,3,Malaysia
31978,34162,36297,2014,Indonesia,Cambodia,1,0,Friendly,Malang,Indonesia,False,1,1,Indonesia
31979,34163,36298,2014,Botswana,Zimbabwe,1,0,Friendly,Gaborone,Botswana,False,1,1,Botswana
31980,34164,36299,2014,India,Palestine,2,3,Friendly,Siliguri,India,False,5,-1,Palestine
31981,34165,36300,2014,Qatar,Uzbekistan,3,0,Friendly,Doha,Qatar,False,3,3,Qatar
31982,34166,36301,2014,Antigua and Barbuda,Saint Lucia,2,1,CFU Caribbean Cup qualification,Couva,Trinidad and Tobago,True,3,1,Antigua and Barbuda
31983,34167,36302,2014,Curaçao,Martinique,1,1,CFU Caribbean Cup qualification,Les Abymes,Guadeloupe,True,2,0,Draw
31984,34168,36303,2014,Haiti,French Guiana,2,2,CFU Caribbean Cup qualification,Port-au-Prince,Haiti,False,4,0,Draw
31985,34169,36304,2014,Saint Kitts and Nevis,Barbados,2,3,CFU Caribbean Cup qualification,Port-au-Prince,Haiti,True,5,-1,Barbados
31986,34170,36305,2014,Trinidad and Tobago,Dominican Republic,6,1,CFU Caribbean Cup qualification,Couva,Trinidad and Tobago,False,7,5,Trinidad and Tobago
31987,34171,36306,2014,Belarus,Ukraine,0,2,UEFA Euro qualification,Barysaw,Belarus,False,2,-2,Ukraine
31988,34172,36307,2014,England,San Marino,5,0,UEFA Euro qualification,London,England,False,5,5,England
31989,34173,36308,2014,Liechtenstein,Montenegro,0,0,UEFA Euro qualification,Vaduz,Liechtenstein,False,0,0,Draw
31990,34174,36309,2014,Lithuania,Estonia,1,0,UEFA Euro qualification,Vilnius,Lithuania,False,1,1,Lithuania
31991,34175,36311,2014,Moldova,Austria,1,2,UEFA Euro qualification,Chișinău,Moldova,False,3,-1,Austria
31992,34176,36312,2014,Morocco,Central African Republic,4,0,Friendly,Marrakech,Morocco,False,4,4,Morocco
31993,34177,36313,2014,Qatar,Lebanon,5,0,Friendly,Doha,Qatar,False,5,5,Qatar
31994,34178,36314,2014,Slovakia,Spain,2,1,UEFA Euro qualification,Žilina,Slovakia,False,3,1,Slovakia
31995,34179,36315,2014,Slovenia,Switzerland,1,0,UEFA Euro qualification,Maribor,Slovenia,False,1,1,Slovenia
31996,34180,36316,2014,Sweden,Russia,1,1,UEFA Euro qualification,Solna,Sweden,False,2,0,Draw
31997,34181,36317,2014,Belgium,Andorra,6,0,UEFA Euro qualification,Brussels,Belgium,False,6,6,Belgium
31998,34182,36318,2014,Botswana,Egypt,0,2,African Cup of Nations qualification,Gaborone,Botswana,False,2,-2,Egypt
31999,34183,36319,2014,Bulgaria,Croatia,0,1,UEFA Euro qualification,Sofia,Bulgaria,False,1,-1,Croatia
32000,34184,36321,2014,Cyprus,Israel,1,2,UEFA Euro qualification,Nicosia,Cyprus,False,3,-1,Israel
32001,34185,36322,2014,French Guiana,Saint Kitts and Nevis,1,2,CFU Caribbean Cup qualification,Port-au-Prince,Haiti,True,3,-1,Saint Kitts and Nevis
32002,34186,36323,2014,Hong Kong,Singapore,2,1,Friendly,Kowloon,Hong Kong,False,3,1,Hong Kong
32003,34187,36324,2014,Italy,Azerbaijan,2,1,UEFA Euro qualification,Palermo,Italy,False,3,1,Italy
32004,34188,36325,2014,Japan,Jamaica,1,0,Friendly,Niigata,Japan,False,1,1,Japan
32005,34189,36326,2014,Jordan,Kuwait,0,1,Friendly,Amman,Jordan,False,1,-1,Kuwait
32006,34190,36328,2014,Latvia,Iceland,0,3,UEFA Euro qualification,Riga,Latvia,False,3,-3,Iceland
32007,34191,36329,2014,Lesotho,Angola,0,0,African Cup of Nations qualification,Maseru,Lesotho,False,0,0,Draw
32008,34192,36330,2014,Malta,Norway,0,3,UEFA Euro qualification,Attard,Malta,False,3,-3,Norway
32009,34193,36331,2014,Netherlands,Kazakhstan,3,1,UEFA Euro qualification,Amsterdam,Netherlands,False,4,2,Netherlands
32010,34194,36332,2014,Oman,Costa Rica,3,4,Friendly,Muscat,Oman,False,7,-1,Costa Rica
32011,34195,36333,2014,Saudi Arabia,Uruguay,1,1,Friendly,Jeddah,Saudi Arabia,False,2,0,Draw
32012,34196,36334,2014,Senegal,Tunisia,0,0,African Cup of Nations qualification,Dakar,Senegal,False,0,0,Draw
32013,34197,36335,2014,Saint Vincent and the Grenadines,Curaçao,1,0,CFU Caribbean Cup qualification,Les Abymes,Guadeloupe,True,1,1,Saint Vincent and the Grenadines
32014,34198,36336,2014,Trinidad and Tobago,Saint Lucia,2,0,CFU Caribbean Cup qualification,Couva,Trinidad and Tobago,False,2,2,Trinidad and Tobago
32015,34199,36337,2014,Turkey,Czech Republic,1,2,UEFA Euro qualification,Istanbul,Turkey,False,3,-1,Czech Republic
32016,34200,36338,2014,United Arab Emirates,Australia,0,0,Friendly,Abu Dhabi,United Arab Emirates,False,0,0,Draw
32017,34201,36339,2014,Uzbekistan,Bahrain,0,0,Friendly,Dubai,United Arab Emirates,True,0,0,Draw
32018,34202,36340,2014,Wales,Bosnia and Herzegovina,0,0,UEFA Euro qualification,Cardiff,Wales,False,0,0,Draw
32019,34203,36341,2014,Yemen,Iraq,1,1,Friendly,Manama,Bahrain,True,2,0,Draw
32020,34204,36342,2014,Albania,Denmark,1,1,UEFA Euro qualification,Elbasan,Albania,False,2,0,Draw
32021,34205,36343,2014,Argentina,Brazil,0,2,Friendly,Beijing,China PR,True,2,-2,Brazil
32022,34206,36344,2014,Armenia,Serbia,1,1,UEFA Euro qualification,Yerevan,Armenia,False,2,0,Draw
32023,34207,36345,2014,Cameroon,Sierra Leone,0,0,African Cup of Nations qualification,Yaoundé,Cameroon,False,0,0,Draw
32024,34208,36346,2014,Congo,South Africa,0,2,African Cup of Nations qualification,Pointe-Noire,Congo,False,2,-2,South Africa
32025,34209,36347,2014,DR Congo,Ivory Coast,1,2,African Cup of Nations qualification,Kinshasa,DR Congo,False,3,-1,Ivory Coast
32026,34210,36348,2014,Ethiopia,Mali,0,2,African Cup of Nations qualification,Addis Ababa,Ethiopia,False,2,-2,Mali
32027,34211,36349,2014,Finland,Greece,1,1,UEFA Euro qualification,Helsinki,Finland,False,2,0,Draw
32028,34212,36350,2014,France,Portugal,2,1,Friendly,Saint-Denis,France,False,3,1,France
32029,34213,36351,2014,Gabon,Burkina Faso,2,0,African Cup of Nations qualification,Libreville,Gabon,False,2,2,Gabon
32030,34214,36352,2014,Guinea,Ghana,1,1,African Cup of Nations qualification,Casablanca,Morocco,True,2,0,Draw
32031,34215,36353,2014,Republic of Ireland,Gibraltar,7,0,UEFA Euro qualification,Dublin,Republic of Ireland,False,7,7,Republic of Ireland
32032,34216,36354,2014,Malawi,Algeria,0,2,African Cup of Nations qualification,Blantyre,Malawi,False,2,-2,Algeria
32033,34218,36356,2014,Niger,Zambia,0,0,African Cup of Nations qualification,Niamey,Niger,False,0,0,Draw
32034,34219,36357,2014,Northern Ireland,Faroe Islands,2,0,UEFA Euro qualification,Belfast,Northern Ireland,False,2,2,Northern Ireland
32035,34220,36358,2014,Poland,Germany,2,0,UEFA Euro qualification,Warsaw,Poland,False,2,2,Poland
32036,34221,36359,2014,Romania,Hungary,1,1,UEFA Euro qualification,Bucharest,Romania,False,2,0,Draw
32037,34222,36360,2014,Scotland,Georgia,1,0,UEFA Euro qualification,Glasgow,Scotland,False,1,1,Scotland
32038,34223,36361,2014,Sudan,Nigeria,1,0,African Cup of Nations qualification,Khartoum,Sudan,False,1,1,Sudan
32039,34224,36362,2014,Uganda,Togo,0,1,African Cup of Nations qualification,Kampala,Uganda,False,1,-1,Togo
32040,34225,36363,2014,Austria,Montenegro,1,0,UEFA Euro qualification,Vienna,Austria,False,1,1,Austria
32041,34226,36364,2014,Barbados,French Guiana,0,2,CFU Caribbean Cup qualification,Port-au-Prince,Haiti,True,2,-2,French Guiana
32042,34227,36365,2014,Belarus,Slovakia,1,3,UEFA Euro qualification,Barysaw,Belarus,False,4,-2,Slovakia
32043,34228,36366,2014,East Timor,Brunei,4,2,AFF Championship,Vientiane,Laos,True,6,2,East Timor
32044,34229,36367,2014,Estonia,England,0,1,UEFA Euro qualification,Tallinn,Estonia,False,1,-1,England
32045,34230,36368,2014,Guadeloupe,Curaçao,0,1,CFU Caribbean Cup qualification,Les Abymes,Guadeloupe,False,1,-1,Curaçao
32046,34231,36369,2014,Haiti,Saint Kitts and Nevis,0,0,CFU Caribbean Cup qualification,Port-au-Prince,Haiti,False,0,0,Draw
32047,34232,36370,2014,Laos,Cambodia,3,2,AFF Championship,Vientiane,Laos,False,5,1,Laos
32048,34233,36371,2014,Lithuania,Slovenia,0,2,UEFA Euro qualification,Vilnius,Lithuania,False,2,-2,Slovenia
32049,34234,36372,2014,Luxembourg,Spain,0,4,UEFA Euro qualification,Luxembourg,Luxembourg,False,4,-4,Spain
32050,34235,36373,2014,Mexico,Panama,1,0,Friendly,Querétaro,Mexico,False,1,1,Mexico
32051,34236,36374,2014,Pakistan,Palestine,0,2,Friendly,Lahore,Pakistan,False,2,-2,Palestine
32052,34237,36375,2014,Philippines,Papua New Guinea,5,0,Friendly,Manila,Philippines,False,5,5,Philippines
32053,34238,36376,2014,Russia,Moldova,1,1,UEFA Euro qualification,Moscow,Russia,False,2,0,Draw
32054,34239,36377,2014,Saint Lucia,Dominican Republic,2,3,CFU Caribbean Cup qualification,Couva,Trinidad and Tobago,True,5,-1,Dominican Republic
32055,34240,36378,2014,Sweden,Liechtenstein,2,0,UEFA Euro qualification,Solna,Sweden,False,2,2,Sweden
32056,34241,36379,2014,Tanzania,Benin,4,1,Friendly,Dar es Salaam,Tanzania,False,5,3,Tanzania
32057,34242,36380,2014,Trinidad and Tobago,Antigua and Barbuda,1,0,CFU Caribbean Cup qualification,Couva,Trinidad and Tobago,False,1,1,Trinidad and Tobago
32058,34244,36382,2014,Andorra,Israel,1,4,UEFA Euro qualification,Sant Julià de Lòria,Andorra,False,5,-3,Israel
32059,34245,36383,2014,Bosnia and Herzegovina,Belgium,1,1,UEFA Euro qualification,Zenica,Bosnia and Herzegovina,False,2,0,Draw
32060,34246,36384,2014,Croatia,Azerbaijan,6,0,UEFA Euro qualification,Osijek,Croatia,False,6,6,Croatia
32061,34247,36385,2014,Iceland,Netherlands,2,0,UEFA Euro qualification,Reykjavík,Iceland,False,2,2,Iceland
32062,34248,36386,2014,Jordan,Kuwait,1,1,Friendly,Amman,Jordan,False,2,0,Draw
32063,34249,36387,2014,Kazakhstan,Czech Republic,2,4,UEFA Euro qualification,Astana,Kazakhstan,False,6,-2,Czech Republic
32064,34250,36388,2014,Latvia,Turkey,1,1,UEFA Euro qualification,Riga,Latvia,False,2,0,Draw
32065,34251,36389,2014,Malta,Italy,0,1,UEFA Euro qualification,Attard,Malta,False,1,-1,Italy
32066,34252,36390,2014,Morocco,Kenya,3,0,Friendly,Marrakech,Morocco,False,3,3,Morocco
32067,34253,36391,2014,Norway,Bulgaria,2,1,UEFA Euro qualification,Oslo,Norway,False,3,1,Norway
32068,34254,36392,2014,Oman,Uruguay,0,3,Friendly,Muscat,Oman,False,3,-3,Uruguay
32069,34255,36393,2014,Wales,Cyprus,2,1,UEFA Euro qualification,Cardiff,Wales,False,3,1,Wales
32070,34256,36394,2014,Armenia,France,0,3,Friendly,Yerevan,Armenia,False,3,-3,France
32071,34257,36395,2014,Bahrain,Iraq,0,0,Friendly,Riffa,Bahrain,False,0,0,Draw
32072,34258,36396,2014,Burma,East Timor,0,0,AFF Championship,Vientiane,Laos,True,0,0,Draw
32073,34259,36398,2014,Denmark,Portugal,0,1,UEFA Euro qualification,Copenhagen,Denmark,False,1,-1,Portugal
32074,34260,36399,2014,Faroe Islands,Hungary,0,1,UEFA Euro qualification,Tórshavn,Faroe Islands,False,1,-1,Hungary
32075,34261,36400,2014,Finland,Romania,0,2,UEFA Euro qualification,Helsinki,Finland,False,2,-2,Romania
32076,34262,36401,2014,Germany,Republic of Ireland,1,1,UEFA Euro qualification,Gelsenkirchen,Germany,False,2,0,Draw
32077,34263,36402,2014,Gibraltar,Georgia,0,3,UEFA Euro qualification,Faro,Portugal,True,3,-3,Georgia
32078,34264,36403,2014,Greece,Northern Ireland,0,2,UEFA Euro qualification,Piraeus,Greece,False,2,-2,Northern Ireland
32079,34265,36404,2014,Hong Kong,Argentina,0,7,Friendly,So Kon Po,Hong Kong,False,7,-7,Argentina
32080,34266,36405,2014,Japan,Brazil,0,4,Friendly,Kallang,Singapore,True,4,-4,Brazil
32081,34267,36407,2014,Laos,Brunei,4,2,AFF Championship,Vientiane,Laos,False,6,2,Laos
32082,34268,36408,2014,Macau,Singapore,2,2,Friendly,Taipa,Macau,False,4,0,Draw
32083,34269,36409,2014,Poland,Scotland,2,2,UEFA Euro qualification,Warsaw,Poland,False,4,0,Draw
32084,34270,36410,2014,Qatar,Australia,1,0,Friendly,Doha,Qatar,False,1,1,Qatar
32085,34271,36411,2014,San Marino,Switzerland,0,4,UEFA Euro qualification,Serravalle,San Marino,False,4,-4,Switzerland
32086,34272,36412,2014,Saudi Arabia,Lebanon,1,1,Friendly,Jeddah,Saudi Arabia,False,2,0,Draw
32087,34273,36413,2014,Serbia,Albania,0,3,UEFA Euro qualification,Belgrade,Serbia,False,3,-3,Albania
32088,34274,36414,2014,United Arab Emirates,Uzbekistan,0,4,Friendly,Dubai,United Arab Emirates,False,4,-4,Uzbekistan
32089,34275,36415,2014,United States,Honduras,1,1,Friendly,Boca Raton,United States,False,2,0,Draw
32090,34276,36416,2014,Algeria,Malawi,3,0,African Cup of Nations qualification,Blida,Algeria,False,3,3,Algeria
32091,34277,36417,2014,Angola,Lesotho,4,0,African Cup of Nations qualification,Luanda,Angola,False,4,4,Angola
32092,34278,36418,2014,Burkina Faso,Gabon,1,1,African Cup of Nations qualification,Ouagadougou,Burkina Faso,False,2,0,Draw
32093,34279,36419,2014,Cameroon,Sierra Leone,2,0,African Cup of Nations qualification,Yaoundé,Cameroon,False,2,2,Cameroon
32094,34280,36421,2014,Egypt,Botswana,2,0,African Cup of Nations qualification,Cairo,Egypt,False,2,2,Egypt
32095,34281,36422,2014,Ghana,Guinea,3,1,African Cup of Nations qualification,Accra,Ghana,False,4,2,Ghana
32096,34282,36423,2014,Ivory Coast,DR Congo,3,4,African Cup of Nations qualification,Abidjan,Ivory Coast,False,7,-1,DR Congo
32097,34283,36424,2014,Mali,Ethiopia,2,3,African Cup of Nations qualification,Bamako,Mali,False,5,-1,Ethiopia
32098,34284,36425,2014,Nigeria,Sudan,3,1,African Cup of Nations qualification,Abuja,Nigeria,False,4,2,Nigeria
32099,34285,36426,2014,South Africa,Congo,0,0,African Cup of Nations qualification,Polokwane,South Africa,False,0,0,Draw
32100,34286,36427,2014,Eswatini,Zimbabwe,0,2,Friendly,Lobamba,Eswatini,False,2,-2,Zimbabwe
32101,34287,36428,2014,Togo,Uganda,1,0,African Cup of Nations qualification,Lomé,Togo,False,1,1,Togo
32102,34288,36429,2014,Tunisia,Senegal,1,0,African Cup of Nations qualification,Monastir,Tunisia,False,1,1,Tunisia
32103,34289,36430,2014,Zambia,Niger,3,0,African Cup of Nations qualification,Ndola,Zambia,False,3,3,Zambia
32104,34290,36431,2014,Brunei,Burma,1,3,AFF Championship,Vientiane,Laos,True,4,-2,Burma
32105,34291,36432,2014,East Timor,Cambodia,2,3,AFF Championship,Vientiane,Laos,True,5,-1,Cambodia
32106,34292,36433,2014,Cambodia,Burma,0,1,AFF Championship,Vientiane,Laos,True,1,-1,Burma
32107,34293,36434,2014,Laos,East Timor,2,0,AFF Championship,Vientiane,Laos,False,2,2,Laos
32108,34294,36435,2014,Cambodia,Brunei,1,0,AFF Championship,Vientiane,Laos,True,1,1,Cambodia
32109,34295,36436,2014,Laos,Burma,1,2,AFF Championship,Vientiane,Laos,False,3,-1,Burma
32110,34296,36437,2014,Bangladesh,Sri Lanka,1,1,Friendly,Jessore,Bangladesh,False,2,0,Draw
32111,34297,36438,2014,Zambia,Ivory Coast,1,1,Friendly,Lusaka,Zambia,False,2,0,Draw
32112,34298,36439,2014,Bangladesh,Sri Lanka,1,0,Friendly,Rajshahi,Bangladesh,False,1,1,Bangladesh
32113,34299,36441,2014,Philippines,Nepal,3,0,Friendly,Doha,Qatar,True,3,3,Philippines
32114,34301,36443,2014,Kuwait,Yemen,1,1,Friendly,Abu Dhabi,United Arab Emirates,True,2,0,Draw
32115,34303,36445,2014,Saudi Arabia,Palestine,2,0,Friendly,Dammam,Saudi Arabia,False,2,2,Saudi Arabia
32116,34304,36446,2014,United Arab Emirates,Lebanon,3,2,Friendly,al-Hasa,Saudi Arabia,True,5,1,United Arab Emirates
32117,34305,36447,2014,Bahrain,Singapore,2,0,Friendly,Riffa,Bahrain,False,2,2,Bahrain
32118,34306,36448,2014,Oman,Yemen,2,0,Friendly,Muscat,Oman,False,2,2,Oman
32119,34307,36449,2014,Thailand,Philippines,3,0,Friendly,Nakhon Ratchasima,Thailand,False,3,3,Thailand
32120,34308,36450,2014,Uganda,Ethiopia,3,0,Friendly,Kampala,Uganda,False,3,3,Uganda
32121,34309,36451,2014,Vietnam,Palestine,1,3,Friendly,Hanoi,Vietnam,False,4,-2,Palestine
32122,34310,36452,2014,Cuba,French Guiana,1,1,CFU Caribbean Cup,Montego Bay,Jamaica,True,2,0,Draw
32123,34311,36453,2014,Curaçao,Trinidad and Tobago,2,3,CFU Caribbean Cup,Montego Bay,Jamaica,True,5,-1,Trinidad and Tobago
32124,34312,36454,2014,Argentina,Croatia,2,1,Friendly,London,England,True,3,1,Argentina
32125,34313,36455,2014,Belgium,Iceland,3,1,Friendly,Brussels,Belgium,False,4,2,Belgium
32126,34314,36456,2014,Haiti,Antigua and Barbuda,2,2,CFU Caribbean Cup,Montego Bay,Jamaica,True,4,0,Draw
32127,34315,36457,2014,Netherlands,Mexico,2,3,Friendly,Amsterdam,Netherlands,False,5,-1,Mexico
32128,34316,36458,2014,Norway,Estonia,0,1,Friendly,Oslo,Norway,False,1,-1,Estonia
32129,34317,36459,2014,Turkey,Brazil,0,4,Friendly,Istanbul,Turkey,False,4,-4,Brazil
32130,34318,36460,2014,Curaçao,Cuba,2,3,CFU Caribbean Cup,Montego Bay,Jamaica,True,5,-1,Cuba
32131,34319,36462,2014,Morocco,Benin,6,1,Friendly,Agadir,Morocco,False,7,5,Morocco
32132,34320,36463,2014,Saudi Arabia,Qatar,1,1,Gulf Cup,Riyadh,Saudi Arabia,False,2,0,Draw
32133,34321,36464,2014,Singapore,Laos,2,0,Friendly,Yishun,Singapore,False,2,2,Singapore
32134,34322,36465,2014,Trinidad and Tobago,French Guiana,4,2,CFU Caribbean Cup,Montego Bay,Jamaica,True,6,2,Trinidad and Tobago
32135,34323,36466,2014,Uruguay,Costa Rica,3,3,Friendly,Montevideo,Uruguay,False,6,0,Draw
32136,34324,36467,2014,Yemen,Bahrain,0,0,Gulf Cup,Riyadh,Saudi Arabia,True,0,0,Draw
32137,34325,36468,2014,Botswana,Tunisia,0,0,African Cup of Nations qualification,Gaborone,Botswana,False,0,0,Draw
32138,34326,36470,2014,France,Albania,1,1,Friendly,Rennes,France,False,2,0,Draw
32139,34327,36471,2014,Georgia,Poland,0,4,UEFA Euro qualification,Tbilisi,Georgia,False,4,-4,Poland
32140,34328,36472,2014,Germany,Gibraltar,4,0,UEFA Euro qualification,Nuremberg,Germany,False,4,4,Germany
32141,34329,36473,2014,Greece,Faroe Islands,0,1,UEFA Euro qualification,Piraeus,Greece,False,1,-1,Faroe Islands
32142,34330,36474,2014,Hungary,Finland,1,0,UEFA Euro qualification,Budapest,Hungary,False,1,1,Hungary
32143,34331,36475,2014,Iraq,Kuwait,0,1,Gulf Cup,Riyadh,Saudi Arabia,True,1,-1,Kuwait
32144,34332,36476,2014,Ivory Coast,Sierra Leone,5,1,African Cup of Nations qualification,Abidjan,Ivory Coast,False,6,4,Ivory Coast
32145,34333,36477,2014,Japan,Honduras,6,0,Friendly,Toyota,Japan,False,6,6,Japan
32146,34335,36479,2014,Martinique,Haiti,0,3,CFU Caribbean Cup,Montego Bay,Jamaica,True,3,-3,Haiti
32147,34336,36480,2014,Paraguay,Peru,2,1,Friendly,Luque,Paraguay,False,3,1,Paraguay
32148,34337,36481,2014,Philippines,Cambodia,3,0,Friendly,Manila,Philippines,False,3,3,Philippines
32149,34338,36482,2014,Portugal,Armenia,1,0,UEFA Euro qualification,Faro,Portugal,False,1,1,Portugal
32150,34339,36483,2014,Romania,Northern Ireland,2,0,UEFA Euro qualification,Bucharest,Romania,False,2,2,Romania
32151,34340,36484,2014,Scotland,Republic of Ireland,1,0,UEFA Euro qualification,Glasgow,Scotland,False,1,1,Scotland
32152,34341,36485,2014,Serbia,Denmark,1,3,UEFA Euro qualification,Belgrade,Serbia,False,4,-2,Denmark
32153,34342,36486,2014,United Arab Emirates,Oman,0,0,Gulf Cup,Riyadh,Saudi Arabia,True,0,0,Draw
32154,34343,36487,2014,United States,Colombia,1,2,Friendly,London,England,True,3,-1,Colombia
32155,34344,36488,2014,Algeria,Ethiopia,3,1,African Cup of Nations qualification,Blida,Algeria,False,4,2,Algeria
32156,34345,36489,2014,Angola,Gabon,0,0,African Cup of Nations qualification,Luanda,Angola,False,0,0,Draw
32157,34346,36490,2014,Austria,Russia,1,0,UEFA Euro qualification,Vienna,Austria,False,1,1,Austria
32158,34347,36491,2014,Cameroon,DR Congo,1,0,African Cup of Nations qualification,Yaoundé,Cameroon,False,1,1,Cameroon
32159,34348,36493,2014,Congo,Nigeria,0,2,African Cup of Nations qualification,Pointe-Noire,Congo,False,2,-2,Nigeria
32160,34349,36494,2014,Egypt,Senegal,0,1,African Cup of Nations qualification,Cairo,Egypt,False,1,-1,Senegal
32161,34350,36495,2014,England,Slovenia,3,1,UEFA Euro qualification,London,England,False,4,2,England
32162,34351,36496,2014,French Guiana,Curaçao,4,1,CFU Caribbean Cup,Montego Bay,Jamaica,True,5,3,French Guiana
32163,34352,36497,2014,Indonesia,Syria,0,2,Friendly,Jakarta,Indonesia,False,2,-2,Syria
32164,34353,36498,2014,Lesotho,Burkina Faso,0,1,African Cup of Nations qualification,Maseru,Lesotho,False,1,-1,Burkina Faso
32165,34354,36499,2014,Luxembourg,Ukraine,0,3,UEFA Euro qualification,Luxembourg,Luxembourg,False,3,-3,Ukraine
32166,34355,36501,2014,Malawi,Mali,2,0,African Cup of Nations qualification,Blantyre,Malawi,False,2,2,Malawi
32167,34356,36502,2014,Moldova,Liechtenstein,0,1,UEFA Euro qualification,Chișinău,Moldova,False,1,-1,Liechtenstein
32168,34357,36503,2014,Montenegro,Sweden,1,1,UEFA Euro qualification,Podgorica,Montenegro,False,2,0,Draw
32169,34358,36504,2014,Mozambique,Zambia,0,1,African Cup of Nations qualification,Maputo,Mozambique,False,1,-1,Zambia
32170,34359,36505,2014,San Marino,Estonia,0,0,UEFA Euro qualification,Serravalle,San Marino,False,0,0,Draw
32171,34360,36506,2014,South Africa,Sudan,2,1,African Cup of Nations qualification,Nelspruit,South Africa,False,3,1,South Africa
32172,34361,36507,2014,Spain,Belarus,3,0,UEFA Euro qualification,Huelva,Spain,False,3,3,Spain
32173,34362,36508,2014,Switzerland,Lithuania,4,0,UEFA Euro qualification,St. Gallen,Switzerland,False,4,4,Switzerland
32174,34363,36509,2014,Togo,Guinea,1,4,African Cup of Nations qualification,Lomé,Togo,False,5,-3,Guinea
32175,34364,36510,2014,Uganda,Ghana,1,0,African Cup of Nations qualification,Kampala,Uganda,False,1,1,Uganda
32176,34365,36511,2014,Antigua and Barbuda,Martinique,0,2,CFU Caribbean Cup,Montego Bay,Jamaica,True,2,-2,Martinique
32177,34366,36512,2014,Azerbaijan,Norway,0,1,UEFA Euro qualification,Baku,Azerbaijan,False,1,-1,Norway
32178,34367,36513,2014,Belgium,Wales,0,0,UEFA Euro qualification,Brussels,Belgium,False,0,0,Draw
32179,34368,36514,2014,Bulgaria,Malta,1,1,UEFA Euro qualification,Sofia,Bulgaria,False,2,0,Draw
32180,34369,36515,2014,Cyprus,Andorra,5,0,UEFA Euro qualification,Nicosia,Cyprus,False,5,5,Cyprus
32181,34370,36516,2014,Czech Republic,Iceland,2,1,UEFA Euro qualification,Plzeň,Czech Republic,False,3,1,Czech Republic
32182,34372,36518,2014,Israel,Bosnia and Herzegovina,3,0,UEFA Euro qualification,Haifa,Israel,False,3,3,Israel
32183,34373,36519,2014,Italy,Croatia,1,1,UEFA Euro qualification,Milan,Italy,False,2,0,Draw
32184,34374,36520,2014,Morocco,Zimbabwe,2,1,Friendly,Agadir,Morocco,False,3,1,Morocco
32185,34375,36521,2014,Netherlands,Latvia,6,0,UEFA Euro qualification,Amsterdam,Netherlands,False,6,6,Netherlands
32186,34376,36522,2014,Saudi Arabia,Bahrain,3,0,Gulf Cup,Riyadh,Saudi Arabia,False,3,3,Saudi Arabia
32187,34377,36523,2014,Eswatini,Tanzania,1,1,Friendly,Lobamba,Eswatini,False,2,0,Draw
32188,34378,36524,2014,Turkey,Kazakhstan,3,1,UEFA Euro qualification,Istanbul,Turkey,False,4,2,Turkey
32189,34379,36525,2014,Vietnam,Malaysia,3,1,Friendly,Hanoi,Vietnam,False,4,2,Vietnam
32190,34380,36526,2014,Yemen,Qatar,0,0,Gulf Cup,Riyadh,Saudi Arabia,True,0,0,Draw
32191,34381,36527,2014,Iraq,Oman,1,1,Gulf Cup,Riyadh,Saudi Arabia,True,2,0,Draw
32192,34382,36528,2014,Singapore,Cambodia,4,2,Friendly,Yishun,Singapore,False,6,2,Singapore
32193,34383,36529,2014,United Arab Emirates,Kuwait,2,2,Gulf Cup,Riyadh,Saudi Arabia,True,4,0,Draw
32194,34384,36530,2014,Austria,Brazil,1,2,Friendly,Vienna,Austria,False,3,-1,Brazil
32195,34385,36531,2014,Belarus,Mexico,3,2,Friendly,Barysaw,Belarus,False,5,1,Belarus
32196,34386,36532,2014,Bolivia,Venezuela,3,2,Friendly,La Paz,Bolivia,False,5,1,Bolivia
32197,34387,36533,2014,Chile,Uruguay,1,2,Friendly,Santiago,Chile,False,3,-1,Uruguay
32198,34388,36535,2014,Cuba,Haiti,1,2,CFU Caribbean Cup,Montego Bay,Jamaica,True,3,-1,Haiti
32199,34389,36536,2014,Estonia,Jordan,1,0,Friendly,Tallinn,Estonia,False,1,1,Estonia
32200,34390,36537,2014,France,Sweden,1,0,Friendly,Marseille,France,False,1,1,France
32201,34391,36538,2014,Greece,Serbia,0,2,Friendly,Perivólia,Greece,False,2,-2,Serbia
32202,34392,36539,2014,Hungary,Russia,1,2,Friendly,Budapest,Hungary,False,3,-1,Russia
32203,34394,36541,2014,Republic of Ireland,United States,4,1,Friendly,Dublin,Republic of Ireland,False,5,3,Republic of Ireland
32204,34395,36542,2014,Italy,Albania,1,0,Friendly,Genoa,Italy,False,1,1,Italy
32205,34396,36543,2014,Jamaica,Trinidad and Tobago,0,0,CFU Caribbean Cup,Montego Bay,Jamaica,False,0,0,Draw
32206,34397,36544,2014,Japan,Australia,2,1,Friendly,Osaka,Japan,False,3,1,Japan
32207,34398,36545,2014,Nicaragua,El Salvador,0,2,Friendly,Managua,Nicaragua,False,2,-2,El Salvador
32208,34399,36546,2014,Panama,Canada,0,0,Friendly,Panama City,Panama,False,0,0,Draw
32209,34400,36547,2014,Peru,Paraguay,2,1,Friendly,Lima,Peru,False,3,1,Peru
32210,34401,36548,2014,Portugal,Argentina,1,0,Friendly,Manchester,England,True,1,1,Portugal
32211,34402,36549,2014,Romania,Denmark,2,0,Friendly,Bucharest,Romania,False,2,2,Romania
32212,34403,36550,2014,Scotland,England,1,3,Friendly,Glasgow,Scotland,False,4,-2,England
32213,34404,36551,2014,Slovakia,Finland,2,1,Friendly,Žilina,Slovakia,False,3,1,Slovakia
32214,34405,36552,2014,Slovenia,Colombia,0,1,Friendly,Ljubljana,Slovenia,False,1,-1,Colombia
32215,34406,36553,2014,Spain,Germany,0,1,Friendly,Vigo,Spain,False,1,-1,Germany
32216,34407,36554,2014,Thailand,New Zealand,2,0,Friendly,Nakhon Ratchasima,Thailand,False,2,2,Thailand
32217,34408,36555,2014,Ukraine,Lithuania,0,0,Friendly,Kyïv,Ukraine,False,0,0,Draw
32218,34409,36556,2014,Bahrain,Qatar,0,0,Gulf Cup,Riyadh,Saudi Arabia,True,0,0,Draw
32219,34410,36557,2014,Burkina Faso,Angola,1,1,African Cup of Nations qualification,Ouagadougou,Burkina Faso,False,2,0,Draw
32220,34411,36558,2014,DR Congo,Sierra Leone,3,1,African Cup of Nations qualification,Kinshasa,DR Congo,False,4,2,DR Congo
32221,34412,36559,2014,Ethiopia,Malawi,0,0,African Cup of Nations qualification,Addis Ababa,Ethiopia,False,0,0,Draw
32222,34413,36560,2014,Gabon,Lesotho,4,2,African Cup of Nations qualification,Libreville,Gabon,False,6,2,Gabon
32223,34414,36561,2014,Ghana,Togo,3,1,African Cup of Nations qualification,Tamale,Ghana,False,4,2,Ghana
32224,34415,36562,2014,Guam,Hong Kong,0,0,EAFF Championship,Taipei,Chinese Taipei,True,0,0,Draw
32225,34416,36563,2014,Guinea,Uganda,2,0,African Cup of Nations qualification,Casablanca,Morocco,True,2,2,Guinea
32226,34417,36564,2014,Ivory Coast,Cameroon,0,0,African Cup of Nations qualification,Abidjan,Ivory Coast,False,0,0,Draw
32227,34418,36565,2014,Mali,Algeria,2,0,African Cup of Nations qualification,Bamako,Mali,False,2,2,Mali
32228,34419,36566,2014,Niger,Mozambique,1,1,African Cup of Nations qualification,Niamey,Niger,False,2,0,Draw
32229,34420,36567,2014,Nigeria,South Africa,2,2,African Cup of Nations qualification,Uyo,Nigeria,False,4,0,Draw
32230,34421,36568,2014,Saudi Arabia,Yemen,1,0,Gulf Cup,Riyadh,Saudi Arabia,False,1,1,Saudi Arabia
32231,34422,36569,2014,Senegal,Botswana,3,0,African Cup of Nations qualification,Dakar,Senegal,False,3,3,Senegal
32232,34423,36570,2014,Sudan,Congo,0,1,African Cup of Nations qualification,Khartoum,Sudan,False,1,-1,Congo
32233,34424,36571,2014,Tunisia,Egypt,2,1,African Cup of Nations qualification,Monastir,Tunisia,False,3,1,Tunisia
32234,34426,36573,2014,Kuwait,Oman,0,5,Gulf Cup,Riyadh,Saudi Arabia,True,5,-5,Oman
32235,34427,36574,2014,United Arab Emirates,Iraq,2,0,Gulf Cup,Riyadh,Saudi Arabia,True,2,2,United Arab Emirates
32236,34428,36575,2014,Philippines,Laos,4,1,AFF Championship,Hanoi,Vietnam,True,5,3,Philippines
32237,34429,36576,2014,Vietnam,Indonesia,2,2,AFF Championship,Hanoi,Vietnam,False,4,0,Draw
32238,34430,36577,2014,Malaysia,Burma,0,0,AFF Championship,Kallang,Singapore,True,0,0,Draw
32239,34431,36578,2014,Oman,Qatar,1,3,Gulf Cup,Riyadh,Saudi Arabia,True,4,-2,Qatar
32240,34432,36579,2014,Saudi Arabia,United Arab Emirates,3,2,Gulf Cup,Riyadh,Saudi Arabia,False,5,1,Saudi Arabia
32241,34433,36580,2014,Singapore,Thailand,1,2,AFF Championship,Kallang,Singapore,False,3,-1,Thailand
32242,34434,36581,2014,Philippines,Indonesia,4,0,AFF Championship,Hanoi,Vietnam,True,4,4,Philippines
32243,34435,36582,2014,Vietnam,Laos,3,0,AFF Championship,Hanoi,Vietnam,False,3,3,Vietnam
32244,34436,36583,2014,Malaysia,Thailand,2,3,AFF Championship,Kallang,Singapore,True,5,-1,Thailand
32245,34437,36584,2014,Saudi Arabia,Qatar,1,2,Gulf Cup,Riyadh,Saudi Arabia,False,3,-1,Qatar
32246,34438,36585,2014,Singapore,Burma,4,2,AFF Championship,Kallang,Singapore,False,6,2,Singapore
32247,34439,36586,2014,Indonesia,Laos,5,1,AFF Championship,Hanoi,Vietnam,True,6,4,Indonesia
32248,34440,36587,2014,Vietnam,Philippines,3,1,AFF Championship,Hanoi,Vietnam,False,4,2,Vietnam
32249,34441,36588,2014,Singapore,Malaysia,1,3,AFF Championship,Kallang,Singapore,False,4,-2,Malaysia
32250,34442,36589,2014,Thailand,Burma,2,0,AFF Championship,Kallang,Singapore,True,2,2,Thailand
32251,34443,36590,2014,South Africa,Ivory Coast,2,0,Friendly,Nelspruit,South Africa,False,2,2,South Africa
32252,34444,36591,2014,Philippines,Thailand,0,0,AFF Championship,Manila,Philippines,False,0,0,Draw
32253,34445,36592,2014,Malaysia,Vietnam,1,2,AFF Championship,Shah Alam,Malaysia,False,3,-1,Vietnam
32254,34446,36593,2014,Thailand,Philippines,3,0,AFF Championship,Bangkok,Thailand,False,3,3,Thailand
32255,34447,36594,2014,Vietnam,Malaysia,2,4,AFF Championship,Hanoi,Vietnam,False,6,-2,Malaysia
32256,34448,36595,2014,Uzbekistan,Palestine,1,0,Friendly,Dubai,United Arab Emirates,True,1,1,Uzbekistan
32257,34449,36596,2014,Thailand,Malaysia,2,0,AFF Championship,Bangkok,Thailand,False,2,2,Thailand
32258,34450,36597,2014,Malaysia,Thailand,3,2,AFF Championship,Shah Alam,Malaysia,False,5,1,Malaysia
32259,34451,36599,2014,Uzbekistan,Jordan,2,1,Friendly,Dubai,United Arab Emirates,True,3,1,Uzbekistan
32260,34452,36600,2014,Iraq,Kuwait,1,1,Friendly,al-Hamriyah,United Arab Emirates,True,2,0,Draw
32261,34453,36601,2014,Uzbekistan,Iraq,0,1,Friendly,Sharjah,United Arab Emirates,True,1,-1,Iraq
32262,34454,36602,2014,Qatar,Estonia,3,0,Friendly,Doha,Qatar,False,3,3,Qatar
32263,34455,36603,2014,Uzbekistan,Iraq,0,0,Friendly,Sharjah,United Arab Emirates,True,0,0,Draw
32264,34456,36605,2014,Bahrain,Saudi Arabia,4,1,Friendly,South Geelong,Australia,True,5,3,Bahrain
32265,34457,36606,2014,United Arab Emirates,Jordan,1,0,Friendly,Robina,Australia,True,1,1,United Arab Emirates
32266,34458,36607,2014,Qatar,Oman,2,2,Friendly,Canberra,Australia,True,4,0,Draw
32267,34459,36608,2015,Bahrain,Jordan,1,0,Friendly,Ballarat,Australia,True,1,1,Bahrain
32268,34460,36609,2015,Iran,Iraq,1,0,Friendly,Wollongong,Australia,True,1,1,Iran
32269,34461,36611,2015,South Africa,Zambia,1,0,Friendly,Johannesburg,South Africa,False,1,1,South Africa
32270,34462,36613,2015,Cameroon,DR Congo,1,1,Friendly,Yaoundé,Cameroon,False,2,0,Draw
32271,34463,36614,2015,Australia,Kuwait,4,1,AFC Asian Cup,Melbourne,Australia,False,5,3,Australia
32272,34464,36615,2015,Senegal,Gabon,1,0,Friendly,Casablanca,Morocco,True,1,1,Senegal
32273,34465,36616,2015,Burkina Faso,Eswatini,5,1,Friendly,Nelspruit,South Africa,True,6,4,Burkina Faso
32274,34466,36617,2015,Cameroon,South Africa,1,1,Friendly,Libreville,Gabon,True,2,0,Draw
32275,34469,36622,2015,Iran,Bahrain,2,0,AFC Asian Cup,Melbourne,Australia,True,2,2,Iran
32276,34470,36623,2015,Nigeria,Ivory Coast,0,1,Friendly,Abu Dhabi,United Arab Emirates,True,1,-1,Ivory Coast
32277,34471,36624,2015,Tunisia,Algeria,1,1,Friendly,Radès,Tunisia,False,2,0,Draw
32278,34472,36625,2015,United Arab Emirates,Qatar,4,1,AFC Asian Cup,Canberra,Australia,True,5,3,United Arab Emirates
32279,34473,36626,2015,Japan,Palestine,4,0,AFC Asian Cup,Newcastle,Australia,True,4,4,Japan
32280,34474,36627,2015,Jordan,Iraq,0,1,AFC Asian Cup,Brisbane,Australia,True,1,-1,Iraq
32281,34475,36628,2015,Australia,Oman,4,0,AFC Asian Cup,Sydney,Australia,False,4,4,Australia
32282,34476,36629,2015,Botswana,Burkina Faso,0,2,Friendly,Nelspruit,South Africa,True,2,-2,Burkina Faso
32283,34478,36631,2015,Senegal,Guinea,5,2,Friendly,Casablanca,Morocco,True,7,3,Senegal
32284,34479,36634,2015,Mali,South Africa,0,3,Friendly,Libreville,Gabon,True,3,-3,South Africa
32285,34480,36635,2015,Bahrain,United Arab Emirates,1,2,AFC Asian Cup,Canberra,Australia,True,3,-1,United Arab Emirates
32286,34481,36636,2015,Qatar,Iran,0,1,AFC Asian Cup,Sydney,Australia,True,1,-1,Iran
32287,34482,36637,2015,Sweden,Ivory Coast,2,0,Friendly,Abu Dhabi,United Arab Emirates,True,2,2,Sweden
32288,34483,36638,2015,Canada,Iceland,1,2,Friendly,Orlando,United States,True,3,-1,Iceland
32289,34484,36639,2015,Iraq,Japan,0,1,AFC Asian Cup,Brisbane,Australia,True,1,-1,Japan
32290,34485,36640,2015,Palestine,Jordan,1,5,AFC Asian Cup,Melbourne,Australia,True,6,-4,Jordan
32291,34487,36642,2015,Burkina Faso,Gabon,0,2,African Cup of Nations,Bata,Equatorial Guinea,True,2,-2,Gabon
32292,34488,36643,2015,Equatorial Guinea,Congo,1,1,African Cup of Nations,Bata,Equatorial Guinea,False,2,0,Draw
32293,34489,36644,2015,Oman,Kuwait,1,0,AFC Asian Cup,Newcastle,Australia,True,1,1,Oman
32294,34490,36645,2015,Yemen,Nigeria,0,2,Friendly,Dubai,United Arab Emirates,True,2,-2,Nigeria
32295,34492,36648,2015,Uzbekistan,Saudi Arabia,3,1,AFC Asian Cup,Melbourne,Australia,True,4,2,Uzbekistan
32296,34493,36649,2015,Zambia,DR Congo,1,1,African Cup of Nations,Ebebiyín,Equatorial Guinea,True,2,0,Draw
32297,34494,36650,2015,Algeria,South Africa,3,1,African Cup of Nations,Mongomo,Equatorial Guinea,True,4,2,Algeria
32298,34495,36651,2015,Canada,Iceland,1,1,Friendly,Orlando,United States,True,2,0,Draw
32299,34496,36652,2015,Finland,Sweden,1,0,Friendly,Abu Dhabi,United Arab Emirates,True,1,1,Finland
32300,34497,36653,2015,Ghana,Senegal,1,2,African Cup of Nations,Mongomo,Equatorial Guinea,True,3,-1,Senegal
32301,34498,36654,2015,Iran,United Arab Emirates,1,0,AFC Asian Cup,Brisbane,Australia,True,1,1,Iran
32302,34499,36655,2015,Qatar,Bahrain,1,2,AFC Asian Cup,Sydney,Australia,True,3,-1,Bahrain
32303,34500,36656,2015,Iraq,Palestine,2,0,AFC Asian Cup,Canberra,Australia,True,2,2,Iraq
32304,34501,36657,2015,Ivory Coast,Guinea,1,1,African Cup of Nations,Malabo,Equatorial Guinea,True,2,0,Draw
32305,34502,36658,2015,Japan,Jordan,2,0,AFC Asian Cup,Melbourne,Australia,True,2,2,Japan
32306,34503,36659,2015,Mali,Cameroon,1,1,African Cup of Nations,Malabo,Equatorial Guinea,True,2,0,Draw
32307,34504,36660,2015,Equatorial Guinea,Burkina Faso,0,0,African Cup of Nations,Bata,Equatorial Guinea,False,0,0,Draw
32308,34505,36661,2015,Gabon,Congo,0,1,African Cup of Nations,Bata,Equatorial Guinea,True,1,-1,Congo
32309,34507,36665,2015,Yemen,Finland,0,0,Friendly,Dubai,United Arab Emirates,True,0,0,Draw
32310,34508,36666,2015,Zambia,Tunisia,1,2,African Cup of Nations,Ebebiyín,Equatorial Guinea,True,3,-1,Tunisia
32311,34509,36667,2015,Ghana,Algeria,1,0,African Cup of Nations,Mongomo,Equatorial Guinea,True,1,1,Ghana
32312,34510,36668,2015,Iran,Iraq,3,3,AFC Asian Cup,Canberra,Australia,True,6,0,Draw
32313,34511,36669,2015,Japan,United Arab Emirates,1,1,AFC Asian Cup,Sydney,Australia,True,2,0,Draw
32314,34512,36670,2015,South Africa,Senegal,1,1,African Cup of Nations,Mongomo,Equatorial Guinea,True,2,0,Draw
32315,34513,36671,2015,Cameroon,Guinea,1,1,African Cup of Nations,Malabo,Equatorial Guinea,True,2,0,Draw
32316,34514,36672,2015,Ivory Coast,Mali,1,1,African Cup of Nations,Malabo,Equatorial Guinea,True,2,0,Draw
32317,34515,36673,2015,Congo,Burkina Faso,2,1,African Cup of Nations,Ebebiyín,Equatorial Guinea,True,3,1,Congo
32318,34516,36674,2015,Equatorial Guinea,Gabon,2,0,African Cup of Nations,Bata,Equatorial Guinea,False,2,2,Equatorial Guinea
32319,34517,36676,2015,DR Congo,Tunisia,1,1,African Cup of Nations,Bata,Equatorial Guinea,True,2,0,Draw
32320,34518,36678,2015,Australia,United Arab Emirates,2,0,AFC Asian Cup,Newcastle,Australia,False,2,2,Australia
32321,34519,36679,2015,Senegal,Algeria,0,2,African Cup of Nations,Malabo,Equatorial Guinea,True,2,-2,Algeria
32322,34520,36680,2015,South Africa,Ghana,1,2,African Cup of Nations,Mongomo,Equatorial Guinea,True,3,-1,Ghana
32323,34521,36681,2015,Cameroon,Ivory Coast,0,1,African Cup of Nations,Malabo,Equatorial Guinea,True,1,-1,Ivory Coast
32324,34522,36682,2015,Chile,United States,3,2,Friendly,Rancagua,Chile,False,5,1,Chile
32325,34523,36683,2015,Guinea,Mali,1,1,African Cup of Nations,Mongomo,Equatorial Guinea,True,2,0,Draw
32326,34524,36684,2015,Curaçao,Aruba,0,0,ABCS Tournament,Paramaribo,Suriname,True,0,0,Draw
32327,34525,36685,2015,Iraq,United Arab Emirates,2,3,AFC Asian Cup,Newcastle,Australia,True,5,-1,United Arab Emirates
32328,34526,36686,2015,Suriname,Bonaire,3,0,ABCS Tournament,Paramaribo,Suriname,False,3,3,Suriname
32329,34528,36688,2015,Congo,DR Congo,2,4,African Cup of Nations,Bata,Equatorial Guinea,True,6,-2,DR Congo
32330,34529,36689,2015,Equatorial Guinea,Tunisia,2,1,African Cup of Nations,Bata,Equatorial Guinea,False,3,1,Equatorial Guinea
32331,34530,36690,2015,Curaçao,Bonaire,4,1,ABCS Tournament,Paramaribo,Suriname,True,5,3,Curaçao
32332,34531,36691,2015,Ghana,Guinea,3,0,African Cup of Nations,Malabo,Equatorial Guinea,True,3,3,Ghana
32333,34532,36692,2015,Ivory Coast,Algeria,3,1,African Cup of Nations,Malabo,Equatorial Guinea,True,4,2,Ivory Coast
32334,34533,36693,2015,Suriname,Aruba,1,0,ABCS Tournament,Paramaribo,Suriname,False,1,1,Suriname
32335,34534,36694,2015,Bangladesh,Sri Lanka,1,0,Friendly,Dhaka,Bangladesh,False,1,1,Bangladesh
32336,34535,36695,2015,DR Congo,Ivory Coast,1,3,African Cup of Nations,Bata,Equatorial Guinea,True,4,-2,Ivory Coast
32337,34536,36696,2015,Honduras,Venezuela,2,3,Friendly,San Pedro Sula,Honduras,False,5,-1,Venezuela
32338,34537,36697,2015,Equatorial Guinea,Ghana,0,3,African Cup of Nations,Malabo,Equatorial Guinea,False,3,-3,Ghana
32339,34538,36698,2015,Pakistan,Afghanistan,2,1,Friendly,Lahore,Pakistan,False,3,1,Pakistan
32340,34539,36699,2015,Equatorial Guinea,DR Congo,0,0,African Cup of Nations,Malabo,Equatorial Guinea,False,0,0,Draw
32341,34540,36700,2015,Ivory Coast,Ghana,0,0,African Cup of Nations,Bata,Equatorial Guinea,True,0,0,Draw
32342,34541,36701,2015,United States,Panama,2,0,Friendly,Carson,United States,False,2,2,United States
32343,34542,36702,2015,Kazakhstan,Moldova,1,1,Friendly,Antalya,Turkey,True,2,0,Draw
32344,34543,36703,2015,Antigua and Barbuda,U.S. Virgin Islands,2,0,Friendly,St. John's,Antigua and Barbuda,False,2,2,Antigua and Barbuda
32345,34544,36704,2015,Bermuda,Grenada,2,0,Friendly,Hamilton,Bermuda,False,2,2,Bermuda
32346,34545,36705,2015,Cambodia,Macau,3,0,FIFA World Cup qualification,Phnom Penh,Cambodia,False,3,3,Cambodia
32347,34546,36706,2015,East Timor,Mongolia,0,3,FIFA World Cup qualification,Dili,East Timor,False,3,-3,Mongolia
32348,34547,36707,2015,India,Nepal,2,0,FIFA World Cup qualification,Guwahati,India,False,2,2,India
32349,34548,36708,2015,Sri Lanka,Bhutan,0,1,FIFA World Cup qualification,Colombo,Sri Lanka,False,1,-1,Bhutan
32350,34549,36709,2015,Yemen,Pakistan,3,1,FIFA World Cup qualification,Doha,Qatar,True,4,2,Yemen
32351,34550,36710,2015,Antigua and Barbuda,Dominica,1,0,Friendly,St. John's,Antigua and Barbuda,False,1,1,Antigua and Barbuda
32352,34551,36711,2015,Bhutan,Sri Lanka,2,1,FIFA World Cup qualification,Thimphu,Bhutan,False,3,1,Bhutan
32353,34553,36713,2015,Macau,Cambodia,1,1,FIFA World Cup qualification,Taipa,Macau,False,2,0,Draw
32354,34554,36714,2015,Mongolia,East Timor,3,0,FIFA World Cup qualification,Ulan Bator,Mongolia,False,3,3,Mongolia
32355,34555,36715,2015,Nepal,India,0,0,FIFA World Cup qualification,Kathmandu,Nepal,False,0,0,Draw
32356,34557,36717,2015,Barbados,U.S. Virgin Islands,0,1,FIFA World Cup qualification,Bridgetown,Barbados,False,1,-1,U.S. Virgin Islands
32357,34558,36718,2015,Pakistan,Yemen,0,0,FIFA World Cup qualification,Isa Town,Bahrain,True,0,0,Draw
32358,34559,36719,2015,Botswana,Lesotho,2,0,Friendly,Gaborone,Botswana,False,2,2,Botswana
32359,34560,36720,2015,Denmark,United States,3,2,Friendly,Århus,Denmark,False,5,1,Denmark
32360,34561,36721,2015,Dominican Republic,Cuba,0,3,Friendly,Santiago de los Caballeros,Dominican Republic,False,3,-3,Cuba
32361,34562,36722,2015,French Guiana,Honduras,3,1,Gold Cup qualification,Cayenne,French Guiana,False,4,2,French Guiana
32362,34563,36723,2015,Gabon,Mali,4,3,Friendly,Beauvais,France,True,7,1,Gabon
32363,34564,36724,2015,Georgia,Malta,2,0,Friendly,Tbilisi,Georgia,False,2,2,Georgia
32364,34565,36725,2015,Germany,Australia,2,2,Friendly,Kaiserslautern,Germany,False,4,0,Draw
32365,34566,36726,2015,Indonesia,Cameroon,0,1,Friendly,Sidoarjo,Indonesia,False,1,-1,Cameroon
32366,34567,36727,2015,Mauritius,Burundi,2,2,Friendly,Curepipe,Mauritius,False,4,0,Draw
32367,34568,36728,2015,Nigeria,Uganda,0,1,Friendly,Uyo,Nigeria,False,1,-1,Uganda
32368,34569,36729,2015,Scotland,Northern Ireland,1,0,Friendly,Glasgow,Scotland,False,1,1,Scotland
32369,34570,36730,2015,Eswatini,South Africa,1,3,Friendly,Lobamba,Eswatini,False,4,-2,South Africa
32370,34571,36731,2015,Bahrain,Colombia,0,6,Friendly,Riffa,Bahrain,False,6,-6,Colombia
32371,34572,36732,2015,Chile,Iran,0,2,Friendly,Sankt Pölten,Austria,True,2,-2,Iran
32372,34573,36733,2015,Egypt,Equatorial Guinea,2,0,Friendly,Cairo,Egypt,False,2,2,Egypt
32373,34574,36734,2015,France,Brazil,1,3,Friendly,Saint-Denis,France,False,4,-2,Brazil
32374,34575,36735,2015,Ivory Coast,Angola,2,0,Friendly,Abidjan,Ivory Coast,False,2,2,Ivory Coast
32375,34576,36736,2015,Jordan,Syria,0,1,Friendly,Amman,Jordan,False,1,-1,Syria
32376,34577,36737,2015,Maldives,Tajikistan,0,2,Friendly,Malé,Maldives,False,2,-2,Tajikistan
32377,34578,36738,2015,Oman,Malaysia,6,0,Friendly,Seeb,Oman,False,6,6,Oman
32378,34579,36739,2015,Qatar,Algeria,1,0,Friendly,Doha,Qatar,False,1,1,Qatar
32379,34580,36740,2015,Thailand,Singapore,2,0,Friendly,Nakhon Ratchasima,Thailand,False,2,2,Thailand
32380,34581,36741,2015,U.S. Virgin Islands,Barbados,0,4,FIFA World Cup qualification,Charlotte Amalie,U.S. Virgin Islands,False,4,-4,Barbados
32381,34582,36742,2015,Canada,Guatemala,1,0,Friendly,Fort Lauderdale,United States,True,1,1,Canada
32382,34583,36744,2015,Curaçao,Montserrat,2,1,FIFA World Cup qualification,Willemstad,Curaçao,False,3,1,Curaçao
32383,34584,36745,2015,England,Lithuania,4,0,UEFA Euro qualification,London,England,False,4,4,England
32384,34585,36746,2015,Gambia,Mauritania,1,0,Friendly,Bakau,Gambia,False,1,1,Gambia
32385,34586,36747,2015,Japan,Tunisia,2,0,Friendly,Ōita,Japan,False,2,2,Japan
32386,34587,36749,2015,Liechtenstein,Austria,0,5,UEFA Euro qualification,Vaduz,Liechtenstein,False,5,-5,Austria
32387,34588,36751,2015,Moldova,Sweden,0,2,UEFA Euro qualification,Chișinău,Moldova,False,2,-2,Sweden
32388,34589,36752,2015,Montenegro,Russia,0,3,UEFA Euro qualification,Podgorica,Montenegro,False,3,-3,Russia
32389,34590,36753,2015,Slovakia,Luxembourg,3,0,UEFA Euro qualification,Žilina,Slovakia,False,3,3,Slovakia
32390,34591,36754,2015,Slovenia,San Marino,6,0,UEFA Euro qualification,Ljubljana,Slovenia,False,6,6,Slovenia
32391,34592,36755,2015,Spain,Ukraine,1,0,UEFA Euro qualification,Seville,Spain,False,1,1,Spain
32392,34593,36756,2015,Switzerland,Estonia,3,0,UEFA Euro qualification,Lucerne,Switzerland,False,3,3,Switzerland
32393,34594,36757,2015,Trinidad and Tobago,Panama,0,1,Friendly,Couva,Trinidad and Tobago,False,1,-1,Panama
32394,34595,36758,2015,Andorra,Bosnia and Herzegovina,0,3,UEFA Euro qualification,Sant Julià de Lòria,Andorra,False,3,-3,Bosnia and Herzegovina
32395,34596,36759,2015,Azerbaijan,Malta,2,0,UEFA Euro qualification,Baku,Azerbaijan,False,2,2,Azerbaijan
32396,34597,36760,2015,Belgium,Cyprus,5,0,UEFA Euro qualification,Brussels,Belgium,False,5,5,Belgium
32397,34598,36761,2015,Bulgaria,Italy,2,2,UEFA Euro qualification,Sofia,Bulgaria,False,4,0,Draw
32398,34599,36762,2015,Croatia,Norway,5,1,UEFA Euro qualification,Zagreb,Croatia,False,6,4,Croatia
32399,34600,36763,2015,Czech Republic,Latvia,1,1,UEFA Euro qualification,Prague,Czech Republic,False,2,0,Draw
32400,34601,36764,2015,Ghana,Senegal,1,2,Friendly,Le Havre,France,True,3,-1,Senegal
32401,34602,36765,2015,Hong Kong,Guam,1,0,Friendly,Kowloon,Hong Kong,False,1,1,Hong Kong
32402,34603,36766,2015,Iraq,DR Congo,2,1,Friendly,Sharjah,United Arab Emirates,True,3,1,Iraq
32403,34604,36767,2015,Israel,Wales,0,3,UEFA Euro qualification,Haifa,Israel,False,3,-3,Wales
32404,34605,36768,2015,Kazakhstan,Iceland,0,3,UEFA Euro qualification,Astana,Kazakhstan,False,3,-3,Iceland
32405,34606,36769,2015,Mauritius,Togo,1,1,Friendly,Mapou,Mauritius,False,2,0,Draw
32406,34607,36770,2015,Morocco,Uruguay,0,1,Friendly,Agadir,Morocco,False,1,-1,Uruguay
32407,34608,36771,2015,Netherlands,Turkey,1,1,UEFA Euro qualification,Amsterdam,Netherlands,False,2,0,Draw
32408,34609,36772,2015,Albania,Armenia,2,1,UEFA Euro qualification,Elbasan,Albania,False,3,1,Albania
32409,34610,36773,2015,Anguilla,Nicaragua,0,3,FIFA World Cup qualification,The Valley,Anguilla,False,3,-3,Nicaragua
32410,34611,36774,2015,Bermuda,Bahamas,3,0,FIFA World Cup qualification,Hamilton,Bermuda,False,3,3,Bermuda
32411,34612,36775,2015,Botswana,Mozambique,1,2,Friendly,Lobatse,Botswana,False,3,-1,Mozambique
32412,34613,36776,2015,Brazil,Chile,1,0,Friendly,London,England,True,1,1,Brazil
32413,34615,36778,2015,France,Denmark,2,0,Friendly,Saint-Étienne,France,False,2,2,France
32414,34616,36779,2015,Georgia,Germany,0,2,UEFA Euro qualification,Tbilisi,Georgia,False,2,-2,Germany
32415,34617,36780,2015,Guyana,Grenada,2,0,Friendly,Providence,Guyana,False,2,2,Guyana
32416,34618,36781,2015,Honduras,French Guiana,3,0,Gold Cup qualification,San Pedro Sula,Honduras,False,3,3,Honduras
32417,34619,36782,2015,Hungary,Greece,0,0,UEFA Euro qualification,Budapest,Hungary,False,0,0,Draw
32418,34620,36783,2015,Republic of Ireland,Poland,1,1,UEFA Euro qualification,Dublin,Republic of Ireland,False,2,0,Draw
32419,34621,36784,2015,Ivory Coast,Equatorial Guinea,1,1,Friendly,Abidjan,Ivory Coast,False,2,0,Draw
32420,34622,36785,2015,Northern Ireland,Finland,2,1,UEFA Euro qualification,Belfast,Northern Ireland,False,3,1,Northern Ireland
32421,34623,36786,2015,Portugal,Serbia,2,1,UEFA Euro qualification,Lisbon,Portugal,False,3,1,Portugal
32422,34624,36787,2015,Romania,Faroe Islands,1,0,UEFA Euro qualification,Ploieşti,Romania,False,1,1,Romania
32423,34625,36788,2015,Scotland,Gibraltar,6,1,UEFA Euro qualification,Glasgow,Scotland,False,7,5,Scotland
32424,34626,36789,2015,South Africa,Nigeria,1,1,Friendly,Nelspruit,South Africa,False,2,0,Draw
32425,34627,36790,2015,Tanzania,Malawi,1,1,Friendly,Mwanza,Tanzania,False,2,0,Draw
32426,34628,36791,2015,Zambia,Rwanda,2,0,Friendly,Lusaka,Zambia,False,2,2,Zambia
32427,34629,36792,2015,Bahrain,Philippines,2,1,Friendly,Riffa,Bahrain,False,3,1,Bahrain
32428,34630,36793,2015,Belarus,Gabon,0,0,Friendly,Belek,Turkey,True,0,0,Draw
32429,34631,36794,2015,Indonesia,Burma,2,1,Friendly,Sidoarjo,Indonesia,False,3,1,Indonesia
32430,34632,36795,2015,Jamaica,Cuba,3,0,Friendly,Montego Bay,Jamaica,False,3,3,Jamaica
32431,34633,36796,2015,Kuwait,Colombia,1,3,Friendly,Abu Dhabi,United Arab Emirates,True,4,-2,Colombia
32432,34634,36798,2015,Oman,Algeria,1,4,Friendly,Doha,Qatar,True,5,-3,Algeria
32433,34635,36799,2015,Qatar,Slovenia,1,0,Friendly,Doha,Qatar,False,1,1,Qatar
32434,34636,36800,2015,Saudi Arabia,Jordan,2,1,Friendly,Dammam,Saudi Arabia,False,3,1,Saudi Arabia
32435,34637,36801,2015,Thailand,Cameroon,2,3,Friendly,Nonthaburi,Thailand,False,5,-1,Cameroon
32436,34638,36802,2015,Austria,Bosnia and Herzegovina,1,1,Friendly,Vienna,Austria,False,2,0,Draw
32437,34639,36804,2015,Estonia,Iceland,1,1,Friendly,Tallinn,Estonia,False,2,0,Draw
32438,34640,36805,2015,Ghana,Mali,1,1,Friendly,Paris,France,True,2,0,Draw
32439,34641,36806,2015,Iraq,DR Congo,1,0,Friendly,Sharjah,United Arab Emirates,True,1,1,Iraq
32440,34642,36807,2015,Israel,Belgium,0,1,UEFA Euro qualification,Jerusalem,Israel,False,1,-1,Belgium
32441,34643,36808,2015,Italy,England,1,1,Friendly,Turin,Italy,False,2,0,Draw
32442,34644,36809,2015,Japan,Uzbekistan,5,1,Friendly,Chōfu,Japan,False,6,4,Japan
32443,34645,36811,2015,Liechtenstein,San Marino,1,0,Friendly,Eschen,Liechtenstein,False,1,1,Liechtenstein
32444,34646,36812,2015,Luxembourg,Turkey,1,2,Friendly,Luxembourg,Luxembourg,False,3,-1,Turkey
32445,34647,36813,2015,Mauritania,Niger,2,0,Friendly,Nouakchott,Mauritania,False,2,2,Mauritania
32446,34648,36814,2015,Montserrat,Curaçao,2,2,FIFA World Cup qualification,Lookout,Montserrat,False,4,0,Draw
32447,34649,36815,2015,Netherlands,Spain,2,0,Friendly,Amsterdam,Netherlands,False,2,2,Netherlands
32448,34650,36816,2015,Panama,Costa Rica,2,1,Friendly,Panama City,Panama,False,3,1,Panama
32449,34651,36817,2015,Peru,Venezuela,0,1,Friendly,Fort Lauderdale,United States,True,1,-1,Venezuela
32450,34653,36819,2015,Russia,Kazakhstan,0,0,Friendly,Khimki,Russia,False,0,0,Draw
32451,34654,36820,2015,Singapore,Guam,2,2,Friendly,Kallang,Singapore,False,4,0,Draw
32452,34655,36821,2015,Slovakia,Czech Republic,1,0,Friendly,Žilina,Slovakia,False,1,1,Slovakia
32453,34656,36822,2015,Sweden,Iran,3,1,Friendly,Solna,Sweden,False,4,2,Sweden
32454,34657,36823,2015,Switzerland,United States,1,1,Friendly,Zürich,Switzerland,False,2,0,Draw
32455,34658,36824,2015,Tajikistan,Syria,2,3,Friendly,Dushanbe,Tajikistan,False,5,-1,Syria
32456,34659,36825,2015,Ukraine,Latvia,1,1,Friendly,L'viv,Ukraine,False,2,0,Draw
32457,34660,36826,2015,United States,Mexico,2,0,Friendly,San Antonio,United States,False,2,2,United States
32458,34661,36827,2015,Barbados,Saint Kitts and Nevis,1,3,Friendly,Bridgetown,Barbados,False,4,-2,Saint Kitts and Nevis
32459,34662,36828,2015,Zambia,Malawi,2,0,Friendly,Lusaka,Zambia,False,2,2,Zambia
32460,34663,36829,2015,Kazakhstan,Burkina Faso,0,0,Friendly,Almaty,Kazakhstan,False,0,0,Draw
32461,34664,36830,2015,Dominican Republic,Cayman Islands,6,0,Friendly,Santiago de los Caballeros,Dominican Republic,False,6,6,Dominican Republic
32462,34665,36831,2015,Grenada,Dominica,1,2,Windward Islands Tournament,Vieux Fort,Saint Lucia,True,3,-1,Dominica
32463,34666,36832,2015,Lesotho,South Africa,0,0,Friendly,Maseru,Lesotho,False,0,0,Draw
32464,34667,36833,2015,Saint Lucia,Saint Vincent and the Grenadines,1,2,Windward Islands Tournament,Vieux Fort,Saint Lucia,False,3,-1,Saint Vincent and the Grenadines
32465,34668,36834,2015,Lesotho,South Africa,1,1,Friendly,Maseru,Lesotho,False,2,0,Draw
32466,34669,36835,2015,Saint Lucia,Grenada,0,2,Windward Islands Tournament,Vieux Fort,Saint Lucia,False,2,-2,Grenada
32467,34670,36836,2015,Namibia,Seychelles,0,0,COSAFA Cup,Moruleng-Saulspoort,South Africa,True,0,0,Draw
32468,34672,36838,2015,Zimbabwe,Mauritius,2,0,COSAFA Cup,Moruleng-Saulspoort,South Africa,True,2,2,Zimbabwe
32469,34673,36839,2015,Lesotho,Madagascar,1,2,COSAFA Cup,Phokeng,South Africa,True,3,-1,Madagascar
32470,34674,36840,2015,Tanzania,Eswatini,0,1,COSAFA Cup,Phokeng,South Africa,True,1,-1,Eswatini
32471,34675,36841,2015,Namibia,Mauritius,2,0,COSAFA Cup,Moruleng-Saulspoort,South Africa,True,2,2,Namibia
32472,34676,36842,2015,Seychelles,Zimbabwe,0,1,COSAFA Cup,Moruleng-Saulspoort,South Africa,True,1,-1,Zimbabwe
32473,34677,36843,2015,Lesotho,Eswatini,0,2,COSAFA Cup,Phokeng,South Africa,True,2,-2,Eswatini
32474,34678,36844,2015,Madagascar,Tanzania,2,0,COSAFA Cup,Phokeng,South Africa,True,2,2,Madagascar
32475,34680,36846,2015,Namibia,Zimbabwe,4,1,COSAFA Cup,Moruleng-Saulspoort,South Africa,True,5,3,Namibia
32476,34681,36847,2015,Seychelles,Mauritius,0,1,COSAFA Cup,Phokeng,South Africa,True,1,-1,Mauritius
32477,34682,36848,2015,Lesotho,Tanzania,1,0,COSAFA Cup,Moruleng-Saulspoort,South Africa,True,1,1,Lesotho
32478,34683,36849,2015,Madagascar,Eswatini,1,1,COSAFA Cup,Phokeng,South Africa,True,2,0,Draw
32479,34684,36850,2015,Lebanon,Syria,2,2,Friendly,Sidon,Lebanon,False,4,0,Draw
32480,34685,36851,2015,South Africa,Botswana,0,0,COSAFA Cup,Moruleng-Saulspoort,South Africa,False,0,0,Draw
32481,34686,36852,2015,Thailand,Vietnam,1,0,FIFA World Cup qualification,Bangkok,Thailand,False,1,1,Thailand
32482,34687,36853,2015,Zambia,Namibia,0,0,COSAFA Cup,Moruleng-Saulspoort,South Africa,True,0,0,Draw
32483,34688,36854,2015,Ghana,Madagascar,1,2,COSAFA Cup,Phokeng,South Africa,True,3,-1,Madagascar
32484,34689,36855,2015,Mozambique,Malawi,2,2,COSAFA Cup,Phokeng,South Africa,True,4,0,Draw
32485,34690,36856,2015,South Africa,Malawi,0,0,COSAFA Cup,Moruleng-Saulspoort,South Africa,False,0,0,Draw
32486,34691,36857,2015,Zambia,Ghana,3,0,COSAFA Cup,Moruleng-Saulspoort,South Africa,True,3,3,Zambia
32487,34692,36858,2015,Botswana,Mozambique,1,2,COSAFA Cup,Moruleng-Saulspoort,South Africa,True,3,-1,Mozambique
32488,34693,36859,2015,Namibia,Madagascar,3,2,COSAFA Cup,Moruleng-Saulspoort,South Africa,True,5,1,Namibia
32489,34694,36860,2015,Laos,Afghanistan,0,2,Friendly,Vientiane,Laos,False,2,-2,Afghanistan
32490,34695,36861,2015,Zambia,Malawi,0,1,COSAFA Cup,Phokeng,South Africa,True,1,-1,Malawi
32491,34696,36863,2015,Bahrain,Oman,0,0,Friendly,Riffa,Bahrain,False,0,0,Draw
32492,34697,36864,2015,Bangladesh,Singapore,1,2,Friendly,Dhaka,Bangladesh,False,3,-1,Singapore
32493,34698,36865,2015,Jordan,Lebanon,0,0,Friendly,Irbid,Jordan,False,0,0,Draw
32494,34699,36866,2015,Madagascar,Botswana,2,1,COSAFA Cup,Moruleng-Saulspoort,South Africa,True,3,1,Madagascar
32495,34700,36867,2015,Mexico,Guatemala,3,0,Friendly,Tuxtla Gutiérrez,Mexico,False,3,3,Mexico
32496,34701,36868,2015,Namibia,Mozambique,2,0,COSAFA Cup,Moruleng-Saulspoort,South Africa,True,2,2,Namibia
32497,34702,36869,2015,El Salvador,Honduras,0,2,Friendly,Washington,United States,True,2,-2,Honduras
32498,34703,36870,2015,Northern Ireland,Qatar,1,1,Friendly,Crewe,England,True,2,0,Draw
32499,34704,36871,2015,Bangladesh,Afghanistan,1,1,Friendly,Dhaka,Bangladesh,False,2,0,Draw
32500,34705,36872,2015,Cambodia,Laos,1,1,Friendly,Phnom Penh,Cambodia,False,2,0,Draw
32501,34706,36873,2015,Panama,Ecuador,1,1,Friendly,Panama City,Panama,False,2,0,Draw
32502,34707,36874,2015,Cambodia,Burma,1,0,Friendly,Samut Sakhon,Thailand,True,1,1,Cambodia
32503,34708,36875,2015,Curaçao,Trinidad and Tobago,1,0,Friendly,Willemstad,Curaçao,False,1,1,Curaçao
32504,34709,36876,2015,Hungary,Lithuania,4,0,Friendly,Debrecen,Hungary,False,4,4,Hungary
32505,34710,36877,2015,Jordan,Kuwait,2,2,Friendly,Istanbul,Turkey,True,4,0,Draw
32506,34711,36878,2015,Netherlands,United States,3,4,Friendly,Amsterdam,Netherlands,False,7,-1,United States
32507,34712,36879,2015,Oman,Syria,1,2,Friendly,Muscat,Oman,False,3,-1,Syria
32508,34713,36880,2015,Scotland,Qatar,1,0,Friendly,Edinburgh,Scotland,False,1,1,Scotland
32509,34714,36881,2015,Thailand,Bahrain,1,1,Friendly,Bangkok,Thailand,False,2,0,Draw
32510,34715,36882,2015,Andorra,Equatorial Guinea,0,1,Friendly,Sant Julià de Lòria,Andorra,False,1,-1,Equatorial Guinea
32511,34716,36883,2015,Burkina Faso,Cameroon,2,3,Friendly,Colombes,France,True,5,-1,Cameroon
32512,34717,36884,2015,Colombia,Costa Rica,1,0,Friendly,Buenos Aires,Argentina,True,1,1,Colombia
32513,34718,36885,2015,Ecuador,Panama,4,0,Friendly,Portoviejo,Ecuador,False,4,4,Ecuador
32514,34719,36886,2015,Guinea,Chad,2,1,Friendly,Saint-Leu-la-Forêt,France,True,3,1,Guinea
32515,34720,36887,2015,Malaysia,Hong Kong,0,0,Friendly,Shah Alam,Malaysia,False,0,0,Draw
32516,34721,36888,2015,Niger,Gabon,2,1,Friendly,Niamey,Niger,False,3,1,Niger
32517,34722,36889,2015,Paraguay,Honduras,2,2,Friendly,Asunción,Paraguay,False,4,0,Draw
32518,34723,36890,2015,Rwanda,Kenya,0,0,Friendly,Kigali,Rwanda,False,0,0,Draw
32519,34724,36891,2015,Singapore,Brunei,5,1,Friendly,Jurong West,Singapore,False,6,4,Singapore
32520,34725,36892,2015,Uruguay,Guatemala,5,1,Friendly,Montevideo,Uruguay,False,6,4,Uruguay
32521,34726,36893,2015,Brazil,Mexico,2,0,Friendly,São Paulo,Brazil,False,2,2,Brazil
32522,34727,36894,2015,Croatia,Gibraltar,4,0,Friendly,Varaždin,Croatia,False,4,4,Croatia
32523,34728,36895,2015,Ethiopia,Zambia,0,1,Friendly,Addis Abeba,Ethiopia,False,1,-1,Zambia
32524,34729,36896,2015,France,Belgium,3,4,Friendly,Saint-Denis,France,False,7,-1,Belgium
32525,34730,36897,2015,Republic of Ireland,England,0,0,Friendly,Dublin,Republic of Ireland,False,0,0,Draw
32526,34731,36898,2015,Kenya,South Sudan,2,0,Friendly,Kigali,Rwanda,True,2,2,Kenya
32527,34732,36899,2015,Russia,Belarus,4,2,Friendly,Khimki,Russia,False,6,2,Russia
32528,34733,36900,2015,Rwanda,Tanzania,2,0,Friendly,Kigali,Rwanda,False,2,2,Rwanda
32529,34734,36901,2015,Serbia,Azerbaijan,4,1,Friendly,Sankt Pölten,Austria,True,5,3,Serbia
32530,34735,36902,2015,Denmark,Montenegro,2,1,Friendly,Viborg,Denmark,False,3,1,Denmark
32531,34736,36903,2015,Egypt,Malawi,2,1,Friendly,Alexandria,Egypt,False,3,1,Egypt
32532,34737,36904,2015,Ghana,Togo,1,0,Friendly,Accra,Ghana,False,1,1,Ghana
32533,34738,36905,2015,Malta,Lithuania,2,0,Friendly,Attard,Malta,False,2,2,Malta
32534,34739,36906,2015,Norway,Sweden,0,0,Friendly,Oslo,Norway,False,0,0,Draw
32535,34740,36907,2015,Turkey,Bulgaria,4,0,Friendly,Istanbul,Turkey,False,4,4,Turkey
32536,34741,36908,2015,DR Congo,Cameroon,1,1,Friendly,Mons,Belgium,True,2,0,Draw
32537,34742,36909,2015,Finland,Estonia,0,2,Friendly,Turku,Finland,False,2,-2,Estonia
32538,34743,36910,2015,Georgia,Ukraine,1,2,Friendly,Linz,Austria,True,3,-1,Ukraine
32539,34744,36911,2015,Luxembourg,Moldova,0,0,Friendly,Luxembourg,Luxembourg,False,0,0,Draw
32540,34745,36912,2015,Uganda,Gambia,1,1,Friendly,Kampala,Uganda,False,2,0,Draw
32541,34746,36913,2015,Brazil,Honduras,1,0,Friendly,Porto Alegre,Brazil,False,1,1,Brazil
32542,34747,36914,2015,Curaçao,Cuba,0,0,FIFA World Cup qualification,Willemstad,Curaçao,False,0,0,Draw
32543,34748,36915,2015,Germany,United States,1,2,Friendly,Cologne,Germany,False,3,-1,United States
32544,34749,36916,2015,Switzerland,Liechtenstein,3,0,Friendly,Thun,Switzerland,False,3,3,Switzerland
32545,34750,36917,2015,Afghanistan,Syria,0,6,FIFA World Cup qualification,Mashhad,Iran,True,6,-6,Syria
32546,34751,36918,2015,Bangladesh,Kyrgyzstan,1,3,FIFA World Cup qualification,Dhaka,Bangladesh,False,4,-2,Kyrgyzstan
32547,34752,36919,2015,Cambodia,Singapore,0,4,FIFA World Cup qualification,Phnom Penh,Cambodia,False,4,-4,Singapore
32548,34753,36920,2015,Chile,Ecuador,2,0,Copa América,Santiago,Chile,False,2,2,Chile
32549,34754,36921,2015,Dominican Republic,Belize,1,2,FIFA World Cup qualification,Santo Domingo,Dominican Republic,False,3,-1,Belize
32550,34755,36922,2015,Guam,Turkmenistan,1,0,FIFA World Cup qualification,Dededo,Guam,False,1,1,Guam
32551,34756,36923,2015,Hong Kong,Bhutan,7,0,FIFA World Cup qualification,Kowloon,Hong Kong,False,7,7,Hong Kong
32552,34757,36924,2015,India,Oman,1,2,FIFA World Cup qualification,Bangalore,India,False,3,-1,Oman
32553,34758,36925,2015,Japan,Iraq,4,0,Friendly,Yokohama,Japan,False,4,4,Japan
32554,34759,36927,2015,Laos,Burma,2,2,FIFA World Cup qualification,Vientiane,Laos,False,4,0,Draw
32555,34760,36928,2015,Lebanon,Kuwait,0,1,FIFA World Cup qualification,Sidon,Lebanon,False,1,-1,Kuwait
32556,34761,36929,2015,Malaysia,East Timor,3,0,FIFA World Cup qualification,Kuala Lumpur,Malaysia,False,3,3,Malaysia
32557,34762,36930,2015,Maldives,Qatar,0,1,FIFA World Cup qualification,Malé,Maldives,False,1,-1,Qatar
32558,34763,36931,2015,Philippines,Bahrain,2,1,FIFA World Cup qualification,Bocaue,Philippines,False,3,1,Philippines
32559,34764,36932,2015,Saudi Arabia,Palestine,3,2,FIFA World Cup qualification,Dammam,Saudi Arabia,False,5,1,Saudi Arabia
32560,34765,36933,2015,Spain,Costa Rica,2,1,Friendly,León,Spain,False,3,1,Spain
32561,34766,36934,2015,Tajikistan,Jordan,1,3,FIFA World Cup qualification,Dushanbe,Tajikistan,False,4,-2,Jordan
32562,34767,36935,2015,Uzbekistan,Iran,0,1,Friendly,Tashkent,Uzbekistan,False,1,-1,Iran
32563,34769,36937,2015,Andorra,Cyprus,1,3,UEFA Euro qualification,Sant Julià de Lòria,Andorra,False,4,-2,Cyprus
32564,34770,36938,2015,Bosnia and Herzegovina,Israel,3,1,UEFA Euro qualification,Zenica,Bosnia and Herzegovina,False,4,2,Bosnia and Herzegovina
32565,34771,36939,2015,Croatia,Italy,1,1,UEFA Euro qualification,Split,Croatia,False,2,0,Draw
32566,34772,36940,2015,Guinea,Eswatini,1,2,African Cup of Nations qualification,Casablanca,Morocco,True,3,-1,Eswatini
32567,34773,36941,2015,Iceland,Czech Republic,2,1,UEFA Euro qualification,Reykjavík,Iceland,False,3,1,Iceland
32568,34774,36942,2015,Kazakhstan,Turkey,0,1,UEFA Euro qualification,Almaty,Kazakhstan,False,1,-1,Turkey
32569,34775,36943,2015,Latvia,Netherlands,0,2,UEFA Euro qualification,Riga,Latvia,False,2,-2,Netherlands
32570,34776,36944,2015,Malta,Bulgaria,0,1,UEFA Euro qualification,Attard,Malta,False,1,-1,Bulgaria
32571,34777,36945,2015,Mexico,Bolivia,0,0,Copa América,Viña del Mar,Chile,True,0,0,Draw
32572,34778,36946,2015,Morocco,Libya,1,0,African Cup of Nations qualification,Agadir,Morocco,False,1,1,Morocco
32573,34779,36947,2015,Norway,Azerbaijan,0,0,UEFA Euro qualification,Oslo,Norway,False,0,0,Draw
32574,34780,36948,2015,Tunisia,Djibouti,8,1,African Cup of Nations qualification,Radès,Tunisia,False,9,7,Tunisia
32575,34781,36949,2015,Wales,Belgium,1,0,UEFA Euro qualification,Cardiff,Wales,False,1,1,Wales
32576,34782,36950,2015,Albania,France,1,0,Friendly,Elbasan,Albania,False,1,1,Albania
32577,34783,36951,2015,Algeria,Seychelles,4,0,African Cup of Nations qualification,Blida,Algeria,False,4,4,Algeria
32578,34784,36952,2015,Angola,Central African Republic,4,0,African Cup of Nations qualification,Lubango,Angola,False,4,4,Angola
32579,34785,36953,2015,Argentina,Paraguay,2,2,Copa América,La Serena,Chile,True,4,0,Draw
32580,34786,36954,2015,Armenia,Portugal,2,3,UEFA Euro qualification,Yerevan,Armenia,False,5,-1,Portugal
32581,34787,36955,2015,Burkina Faso,Comoros,2,0,African Cup of Nations qualification,Ouagadougou,Burkina Faso,False,2,2,Burkina Faso
32582,34788,36957,2015,Denmark,Serbia,2,0,UEFA Euro qualification,Copenhagen,Denmark,False,2,2,Denmark
32583,34789,36958,2015,Faroe Islands,Greece,2,1,UEFA Euro qualification,Tórshavn,Faroe Islands,False,3,1,Faroe Islands
32584,34790,36959,2015,Finland,Hungary,0,1,UEFA Euro qualification,Helsinki,Finland,False,1,-1,Hungary
32585,34791,36960,2015,Gibraltar,Germany,0,7,UEFA Euro qualification,Faro,Portugal,True,7,-7,Germany
32586,34792,36961,2015,Republic of Ireland,Scotland,1,1,UEFA Euro qualification,Dublin,Republic of Ireland,False,2,0,Draw
32587,34793,36962,2015,Malawi,Zimbabwe,1,2,African Cup of Nations qualification,Blantyre,Malawi,False,3,-1,Zimbabwe
32588,34794,36963,2015,Mali,South Sudan,2,0,African Cup of Nations qualification,Bamako,Mali,False,2,2,Mali
32589,34795,36964,2015,Nigeria,Chad,2,0,African Cup of Nations qualification,Kaduna,Nigeria,False,2,2,Nigeria
32590,34796,36965,2015,Northern Ireland,Romania,0,0,UEFA Euro qualification,Belfast,Northern Ireland,False,0,0,Draw
32591,34797,36966,2015,Poland,Georgia,4,0,UEFA Euro qualification,Warsaw,Poland,False,4,4,Poland
32592,34798,36967,2015,Senegal,Burundi,3,1,African Cup of Nations qualification,Dakar,Senegal,False,4,2,Senegal
32593,34799,36968,2015,South Africa,Gambia,0,0,African Cup of Nations qualification,Durban,South Africa,False,0,0,Draw
32594,34800,36969,2015,Uganda,Botswana,2,0,African Cup of Nations qualification,Kampala,Uganda,False,2,2,Uganda
32595,34801,36970,2015,Uruguay,Jamaica,1,0,Copa América,Antofagasta,Chile,True,1,1,Uruguay
32596,34802,36971,2015,Zambia,Guinea-Bissau,0,0,African Cup of Nations qualification,Ndola,Zambia,False,0,0,Draw
32597,34803,36972,2015,Barbados,Aruba,0,3,FIFA World Cup qualification,Bridgetown,Barbados,False,3,-3,Aruba
32598,34804,36973,2015,Belarus,Spain,0,1,UEFA Euro qualification,Barysaw,Belarus,False,1,-1,Spain
32599,34805,36974,2015,Brazil,Peru,2,1,Copa América,Temuco,Chile,True,3,1,Brazil
32600,34806,36975,2015,Cameroon,Mauritania,1,0,African Cup of Nations qualification,Yaoundé,Cameroon,False,1,1,Cameroon
32601,34807,36976,2015,Colombia,Venezuela,0,1,Copa América,Rancagua,Chile,True,1,-1,Venezuela
32602,34808,36977,2015,Congo,Kenya,1,1,African Cup of Nations qualification,Owando,Congo,False,2,0,Draw
32603,34809,36978,2015,DR Congo,Madagascar,2,1,African Cup of Nations qualification,Kinshasa,DR Congo,False,3,1,DR Congo
32604,34810,36979,2015,Cuba,Curaçao,1,1,FIFA World Cup qualification,Havana,Cuba,False,2,0,Draw
32605,34811,36980,2015,Egypt,Tanzania,3,0,African Cup of Nations qualification,Alexandria,Egypt,False,3,3,Egypt
32606,34812,36981,2015,Equatorial Guinea,Benin,1,1,African Cup of Nations qualification,Bata,Equatorial Guinea,False,2,0,Draw
32607,34813,36982,2015,Estonia,San Marino,2,0,UEFA Euro qualification,Tallinn,Estonia,False,2,2,Estonia
32608,34814,36983,2015,Ethiopia,Lesotho,2,1,African Cup of Nations qualification,Addis Abeba,Ethiopia,False,3,1,Ethiopia
32609,34815,36984,2015,Gabon,Ivory Coast,0,0,Friendly,Libreville,Gabon,False,0,0,Draw
32610,34816,36985,2015,Ghana,Mauritius,7,1,African Cup of Nations qualification,Accra,Ghana,False,8,6,Ghana
32611,34817,36986,2015,Liechtenstein,Moldova,1,1,UEFA Euro qualification,Vaduz,Liechtenstein,False,2,0,Draw
32612,34818,36987,2015,Lithuania,Switzerland,1,2,UEFA Euro qualification,Vilnius,Lithuania,False,3,-1,Switzerland
32613,34819,36988,2015,Mozambique,Rwanda,0,1,African Cup of Nations qualification,Maputo,Mozambique,False,1,-1,Rwanda
32614,34820,36989,2015,Niger,Namibia,1,0,African Cup of Nations qualification,Niamey,Niger,False,1,1,Niger
32615,34821,36990,2015,Russia,Austria,0,1,UEFA Euro qualification,Moscow,Russia,False,1,-1,Austria
32616,34823,36992,2015,Slovenia,England,2,3,UEFA Euro qualification,Ljubljana,Slovenia,False,5,-1,England
32617,34824,36993,2015,Sudan,Sierra Leone,1,0,African Cup of Nations qualification,Khartoum,Sudan,False,1,1,Sudan
32618,34825,36994,2015,Sweden,Montenegro,3,1,UEFA Euro qualification,Solna,Sweden,False,4,2,Sweden
32619,34826,36995,2015,Togo,Liberia,2,1,African Cup of Nations qualification,Lomé,Togo,False,3,1,Togo
32620,34827,36996,2015,Ukraine,Luxembourg,3,0,UEFA Euro qualification,L'viv,Ukraine,False,3,3,Ukraine
32621,34828,36997,2015,Chile,Mexico,3,3,Copa América,Santiago,Chile,False,6,0,Draw
32622,34829,36998,2015,Ecuador,Bolivia,2,3,Copa América,Valparaíso,Chile,True,5,-1,Bolivia
32623,34830,36999,2015,Morocco,Tunisia,1,1,African Nations Championship,Casablanca,Morocco,False,2,0,Draw
32624,34831,37000,2015,Argentina,Uruguay,1,0,Copa América,La Serena,Chile,True,1,1,Argentina
32625,34832,37001,2015,Bangladesh,Tajikistan,1,1,FIFA World Cup qualification,Dhaka,Bangladesh,False,2,0,Draw
32626,34835,37004,2015,Cambodia,Afghanistan,0,1,FIFA World Cup qualification,Phnom Penh,Cambodia,False,1,-1,Afghanistan
32627,34836,37005,2015,East Timor,United Arab Emirates,0,3,FIFA World Cup qualification,Shah Alam,Malaysia,True,3,-3,United Arab Emirates
32628,34837,37006,2015,Grenada,Puerto Rico,2,0,FIFA World Cup qualification,St. George's,Grenada,False,2,2,Grenada
32629,34838,37007,2015,Guam,India,2,1,FIFA World Cup qualification,Dededo,Guam,False,3,1,Guam
32630,34839,37008,2015,Hong Kong,Maldives,2,0,FIFA World Cup qualification,Kowloon,Hong Kong,False,2,2,Hong Kong
32631,34840,37009,2015,Italy,Portugal,0,1,Friendly,Geneva,Switzerland,True,1,-1,Portugal
32632,34841,37010,2015,Japan,Singapore,0,0,FIFA World Cup qualification,Saitama,Japan,False,0,0,Draw
32633,34842,37011,2015,Jordan,Trinidad and Tobago,3,0,Friendly,Irbid,Jordan,False,3,3,Jordan
32634,34843,37013,2015,Kyrgyzstan,Australia,1,2,FIFA World Cup qualification,Bishkek,Kyrgyzstan,False,3,-1,Australia
32635,34844,37014,2015,Laos,Lebanon,0,2,FIFA World Cup qualification,Vientiane,Laos,False,2,-2,Lebanon
32636,34845,37015,2015,Malaysia,Palestine,0,6,FIFA World Cup qualification,Kuala Lumpur,Malaysia,False,6,-6,Palestine
32637,34846,37016,2015,Paraguay,Jamaica,1,0,Copa América,Antofagasta,Chile,True,1,1,Paraguay
32638,34847,37017,2015,Poland,Greece,0,0,Friendly,Gdańsk,Poland,False,0,0,Draw
32639,34848,37018,2015,South Africa,Angola,2,1,Friendly,Cape Town,South Africa,False,3,1,South Africa
32640,34849,37019,2015,Suriname,Nicaragua,1,3,FIFA World Cup qualification,Paramaribo,Suriname,False,4,-2,Nicaragua
32641,34850,37020,2015,Turkmenistan,Iran,1,1,FIFA World Cup qualification,Daşoguz,Turkmenistan,False,2,0,Draw
32642,34851,37021,2015,Yemen,Philippines,0,2,FIFA World Cup qualification,Doha,Qatar,True,2,-2,Philippines
32643,34852,37022,2015,Brazil,Colombia,0,1,Copa América,Santiago,Chile,True,1,-1,Colombia
32644,34853,37025,2015,Peru,Venezuela,1,0,Copa América,Valparaíso,Chile,True,1,1,Peru
32645,34854,37028,2015,Chile,Bolivia,5,0,Copa América,Santiago,Chile,False,5,5,Chile
32646,34855,37029,2015,Mexico,Ecuador,1,2,Copa América,Rancagua,Chile,True,3,-1,Ecuador
32647,34856,37033,2015,Argentina,Jamaica,1,0,Copa América,Viña del Mar,Chile,True,1,1,Argentina
32648,34857,37034,2015,Mozambique,Seychelles,5,1,African Nations Championship,Beira,Mozambique,False,6,4,Mozambique
32649,34858,37035,2015,Senegal,Gambia,3,1,African Nations Championship,Dakar,Senegal,False,4,2,Senegal
32650,34859,37036,2015,South Africa,Mauritius,3,0,African Nations Championship,Johannesburg,South Africa,False,3,3,South Africa
32651,34860,37037,2015,Tanzania,Uganda,0,3,African Nations Championship,Zanzibar,Tanzania,False,3,-3,Uganda
32652,34861,37038,2015,Uruguay,Paraguay,1,1,Copa América,La Serena,Chile,True,2,0,Draw
32653,34862,37041,2015,Brazil,Venezuela,2,1,Copa América,Santiago,Chile,True,3,1,Brazil
32654,34863,37042,2015,Colombia,Peru,0,0,Copa América,Temuco,Chile,True,0,0,Draw
32655,34864,37043,2015,Djibouti,Burundi,1,2,African Nations Championship,Djibouti,Djibouti,False,3,-1,Burundi
32656,34865,37044,2015,Ethiopia,Kenya,2,0,African Nations Championship,Bahir Dar,Ethiopia,False,2,2,Ethiopia
32657,34866,37045,2015,Lesotho,Botswana,0,0,African Nations Championship,Maseru,Lesotho,False,0,0,Draw
32658,34867,37046,2015,Mauritania,Sierra Leone,2,1,African Nations Championship,Nouakchott,Mauritania,False,3,1,Mauritania
32659,34868,37047,2015,Morocco,Libya,3,0,African Nations Championship,Casablanca,Morocco,False,3,3,Morocco
32660,34869,37048,2015,Namibia,Zambia,2,1,African Nations Championship,Windhoek,Namibia,False,3,1,Namibia
32661,34870,37049,2015,Eswatini,Angola,2,2,African Nations Championship,Lobamba,Eswatini,False,4,0,Draw
32662,34871,37050,2015,Zimbabwe,Comoros,2,0,African Nations Championship,Harare,Zimbabwe,False,2,2,Zimbabwe
32663,34873,37053,2015,Guinea,Liberia,3,1,African Nations Championship,Bamako,Mali,True,4,2,Guinea
32664,34874,37054,2015,Chile,Uruguay,1,0,Copa América,Santiago,Chile,False,1,1,Chile
32665,34875,37055,2015,Bolivia,Peru,1,3,Copa América,Temuco,Chile,True,4,-2,Peru
32666,34876,37056,2015,Argentina,Colombia,0,0,Copa América,Viña del Mar,Chile,True,0,0,Draw
32667,34877,37057,2015,Brazil,Paraguay,1,1,Copa América,Concepción,Chile,True,2,0,Draw
32668,34878,37058,2015,Mexico,Costa Rica,2,2,Friendly,Orlando,United States,True,4,0,Draw
32669,34883,37067,2015,Chile,Peru,2,1,Copa América,Santiago,Chile,False,3,1,Chile
32670,34886,37070,2015,Åland Islands,Greenland,0,2,Island Games,St. Clement,Jersey,True,2,-2,Greenland
32671,34889,37076,2015,Argentina,Paraguay,6,1,Copa América,Concepción,Chile,True,7,5,Argentina
32672,34892,37080,2015,Gibraltar,Guernsey,0,4,Island Games,St. Helier,Jersey,True,4,-4,Guernsey
32673,34894,37083,2015,Jersey,Isle of Man,1,2,Island Games,St. John,Jersey,False,3,-1,Isle of Man
32674,34895,37085,2015,Honduras,Mexico,0,0,Friendly,Houston,United States,True,0,0,Draw
32675,34897,37089,2015,Gibraltar,Åland Islands,0,0,Island Games,St. Brelade,Jersey,True,0,0,Draw
32676,34899,37094,2015,Peru,Paraguay,2,0,Copa América,Concepción,Chile,True,2,2,Peru
32677,34900,37096,2015,Guernsey,Isle of Man,3,0,Island Games,St. Helier,Jersey,True,3,3,Guernsey
32678,34901,37097,2015,Angola,Eswatini,2,0,African Nations Championship,Luanda,Angola,False,2,2,Angola
32679,34902,37098,2015,Chile,Argentina,0,0,Copa América,Santiago,Chile,False,0,0,Draw
32680,34903,37099,2015,Zambia,Namibia,2,1,African Nations Championship,Lusaka,Zambia,False,3,1,Zambia
32681,34904,37100,2015,Malawi,Uganda,1,0,Friendly,Blantyre,Malawi,False,1,1,Malawi
32682,34905,37101,2015,Panama,Haiti,1,1,Gold Cup,Frisco,United States,True,2,0,Draw
32683,34906,37102,2015,United States,Honduras,2,1,Gold Cup,Frisco,United States,False,3,1,United States
32684,34907,37103,2015,Costa Rica,Jamaica,2,2,Gold Cup,Carson,United States,True,4,0,Draw
32685,34908,37104,2015,El Salvador,Canada,0,0,Gold Cup,Carson,United States,True,0,0,Draw
32686,34909,37105,2015,Mexico,Cuba,6,0,Gold Cup,Chicago,United States,True,6,6,Mexico
32687,34910,37106,2015,Trinidad and Tobago,Guatemala,3,1,Gold Cup,Chicago,United States,True,4,2,Trinidad and Tobago
32688,34911,37107,2015,Honduras,Panama,1,1,Gold Cup,Foxborough,United States,True,2,0,Draw
32689,34912,37108,2015,United States,Haiti,1,0,Gold Cup,Foxborough,United States,False,1,1,United States
32690,34913,37109,2015,Costa Rica,El Salvador,1,1,Gold Cup,Houston,United States,True,2,0,Draw
32691,34914,37110,2015,Jamaica,Canada,1,0,Gold Cup,Houston,United States,True,1,1,Jamaica
32692,34915,37111,2015,Guatemala,Mexico,0,0,Gold Cup,Glendale,United States,True,0,0,Draw
32693,34916,37112,2015,Trinidad and Tobago,Cuba,2,0,Gold Cup,Glendale,United States,True,2,2,Trinidad and Tobago
32694,34917,37113,2015,Honduras,Haiti,0,1,Gold Cup,Kansas City,United States,True,1,-1,Haiti
32695,34918,37114,2015,United States,Panama,1,1,Gold Cup,Kansas City,United States,False,2,0,Draw
32696,34919,37115,2015,Canada,Costa Rica,0,0,Gold Cup,Toronto,Canada,False,0,0,Draw
32697,34920,37116,2015,Jamaica,El Salvador,1,0,Gold Cup,Toronto,Canada,True,1,1,Jamaica
32698,34921,37117,2015,Guatemala,Cuba,0,1,Gold Cup,Charlotte,United States,True,1,-1,Cuba
32699,34922,37118,2015,Trinidad and Tobago,Mexico,4,4,Gold Cup,Charlotte,United States,True,8,0,Draw
32700,34923,37119,2015,Haiti,Jamaica,0,1,Gold Cup,Baltimore,United States,True,1,-1,Jamaica
32701,34924,37120,2015,United States,Cuba,6,0,Gold Cup,Baltimore,United States,False,6,6,United States
32702,34925,37121,2015,Mexico,Costa Rica,1,0,Gold Cup,East Rutherford,United States,True,1,1,Mexico
32703,34926,37122,2015,Trinidad and Tobago,Panama,1,1,Gold Cup,East Rutherford,United States,True,2,0,Draw
32704,34927,37123,2015,Panama,Mexico,1,2,Gold Cup,Atlanta,United States,True,3,-1,Mexico
32705,34928,37124,2015,United States,Jamaica,1,2,Gold Cup,Atlanta,United States,False,3,-1,Jamaica
32706,34929,37125,2015,United States,Panama,1,1,Gold Cup,Chester,United States,False,2,0,Draw
32707,34930,37126,2015,Jamaica,Mexico,1,3,Gold Cup,Philadelphia,United States,True,4,-2,Mexico
32708,34932,37133,2015,Fiji,Tonga,5,0,Friendly,Ba,Fiji,False,5,5,Fiji
32709,34933,37134,2015,Cambodia,Bhutan,2,0,Friendly,Phnom Penh,Cambodia,False,2,2,Cambodia
32710,34934,37135,2015,Lebanon,Iraq,2,3,Friendly,Sidon,Lebanon,False,5,-1,Iraq
32711,34935,37136,2015,Fiji,American Samoa,6,0,Friendly,Nadi,Fiji,False,6,6,Fiji
32712,34936,37137,2015,Oman,Yemen,1,0,Friendly,Seeb,Oman,False,1,1,Oman
32713,34937,37138,2015,Qatar,Singapore,4,0,Friendly,Doha,Qatar,False,4,4,Qatar
32714,34938,37139,2015,Rwanda,Ethiopia,3,1,Friendly,Kigali,Rwanda,False,4,2,Rwanda
32715,34939,37140,2015,Tanzania,Libya,1,2,Friendly,Kertepe,Turkey,True,3,-1,Libya
32716,34940,37141,2015,United Arab Emirates,Burma,1,0,Friendly,Abu Dhabi,United Arab Emirates,False,1,1,United Arab Emirates
32717,34941,37142,2015,Laos,Cambodia,2,1,Friendly,Bangkok,Thailand,True,3,1,Laos
32718,34942,37143,2015,Malaysia,Bangladesh,0,0,Friendly,Shah Alam,Malaysia,False,0,0,Draw
32719,34943,37144,2015,Niger,Burkina Faso,0,0,Friendly,Niamey,Niger,False,0,0,Draw
32720,34944,37145,2015,India,Nepal,0,0,Friendly,Pune,India,False,0,0,Draw
32721,34945,37146,2015,Lebanon,Palestine,0,0,Friendly,Sidon,Lebanon,False,0,0,Draw
32722,34946,37147,2015,Samoa,American Samoa,3,2,Oceania Nations Cup qualification,‘Atele,Tonga,True,5,1,Samoa
32723,34947,37148,2015,Tonga,Cook Islands,0,3,Oceania Nations Cup qualification,‘Atele,Tonga,False,3,-3,Cook Islands
32724,34948,37149,2015,Congo,Ghana,2,3,Friendly,Brazzaville,Congo,False,5,-1,Ghana
32725,34949,37150,2015,Cook Islands,Samoa,1,0,Oceania Nations Cup qualification,‘Atele,Tonga,True,1,1,Cook Islands
32726,34950,37151,2015,Tonga,American Samoa,1,2,Oceania Nations Cup qualification,‘Atele,Tonga,False,3,-1,American Samoa
32727,34951,37152,2015,Australia,Bangladesh,5,0,FIFA World Cup qualification,Perth,Australia,False,5,5,Australia
32728,34952,37153,2015,Azerbaijan,Croatia,0,0,UEFA Euro qualification,Baku,Azerbaijan,False,0,0,Draw
32729,34954,37155,2015,Belgium,Bosnia and Herzegovina,3,1,UEFA Euro qualification,Brussels,Belgium,False,4,2,Belgium
32730,34955,37156,2015,Bulgaria,Norway,0,1,UEFA Euro qualification,Sofia,Bulgaria,False,1,-1,Norway
32731,34956,37158,2015,Cyprus,Wales,0,1,UEFA Euro qualification,Nicosia,Cyprus,False,1,-1,Wales
32732,34957,37159,2015,Czech Republic,Kazakhstan,2,1,UEFA Euro qualification,Plzeň,Czech Republic,False,3,1,Czech Republic
32733,34958,37160,2015,Iran,Guam,6,0,FIFA World Cup qualification,Teheran,Iran,False,6,6,Iran
32734,34960,37162,2015,Israel,Andorra,4,0,UEFA Euro qualification,Haifa,Israel,False,4,4,Israel
32735,34961,37163,2015,Italy,Malta,1,0,UEFA Euro qualification,Florence,Italy,False,1,1,Italy
32736,34962,37164,2015,Japan,Cambodia,3,0,FIFA World Cup qualification,Saitama,Japan,False,3,3,Japan
32737,34963,37165,2015,Jordan,Kyrgyzstan,0,0,FIFA World Cup qualification,Irbid,Jordan,False,0,0,Draw
32738,34964,37167,2015,Kuwait,Burma,9,0,FIFA World Cup qualification,Doha,Qatar,True,9,9,Kuwait
32739,34965,37168,2015,Netherlands,Iceland,0,1,UEFA Euro qualification,Amsterdam,Netherlands,False,1,-1,Iceland
32740,34966,37169,2015,Oman,Turkmenistan,3,1,FIFA World Cup qualification,Seeb,Oman,False,4,2,Oman
32741,34967,37170,2015,Philippines,Maldives,2,0,Friendly,Manila,Philippines,False,2,2,Philippines
32742,34968,37171,2015,Qatar,Bhutan,15,0,FIFA World Cup qualification,Doha,Qatar,False,15,15,Qatar
32743,34969,37172,2015,Saudi Arabia,East Timor,7,0,FIFA World Cup qualification,Jeddah,Saudi Arabia,False,7,7,Saudi Arabia
32744,34970,37173,2015,Syria,Singapore,1,0,FIFA World Cup qualification,Muscat,Oman,True,1,1,Syria
32745,34971,37174,2015,Thailand,Afghanistan,2,0,Friendly,Bangkok,Thailand,False,2,2,Thailand
32746,34972,37175,2015,Turkey,Latvia,1,1,UEFA Euro qualification,Konya,Turkey,False,2,0,Draw
32747,34973,37176,2015,United Arab Emirates,Malaysia,10,0,FIFA World Cup qualification,Abu Dhabi,United Arab Emirates,False,10,10,United Arab Emirates
32748,34974,37177,2015,Uzbekistan,Yemen,1,0,FIFA World Cup qualification,Tashkent,Uzbekistan,False,1,1,Uzbekistan
32749,34975,37178,2015,American Samoa,Cook Islands,2,0,Oceania Nations Cup qualification,‘Atele,Tonga,True,2,2,American Samoa
32750,34976,37179,2015,Curaçao,El Salvador,0,1,FIFA World Cup qualification,Willemstad,Curaçao,False,1,-1,El Salvador
32751,34977,37180,2015,Denmark,Albania,0,0,UEFA Euro qualification,Copenhagen,Denmark,False,0,0,Draw
32752,34978,37181,2015,Djibouti,Togo,0,2,African Cup of Nations qualification,Djibouti,Djibouti,False,2,-2,Togo
32753,34979,37182,2015,Faroe Islands,Northern Ireland,1,3,UEFA Euro qualification,Tórshavn,Faroe Islands,False,4,-2,Northern Ireland
32754,34980,37183,2015,Georgia,Scotland,1,0,UEFA Euro qualification,Tbilisi,Georgia,False,1,1,Georgia
32755,34981,37184,2015,Germany,Poland,3,1,UEFA Euro qualification,Frankfurt am Main,Germany,False,4,2,Germany
32756,34982,37185,2015,Gibraltar,Republic of Ireland,0,4,UEFA Euro qualification,Faro,Portugal,True,4,-4,Republic of Ireland
32757,34983,37186,2015,Greece,Finland,0,1,UEFA Euro qualification,Piraeus,Greece,False,1,-1,Finland
32758,34984,37187,2015,Grenada,Haiti,1,3,FIFA World Cup qualification,St. George's,Grenada,False,4,-2,Haiti
32759,34985,37188,2015,Hungary,Romania,0,0,UEFA Euro qualification,Budapest,Hungary,False,0,0,Draw
32760,34986,37189,2015,Portugal,France,0,1,Friendly,Lisbon,Portugal,False,1,-1,France
32761,34987,37190,2015,Serbia,Armenia,2,0,UEFA Euro qualification,Novi Sad,Serbia,False,2,2,Serbia
32762,34988,37191,2015,Tonga,Samoa,0,3,Oceania Nations Cup qualification,‘Atele,Tonga,False,3,-3,Samoa
32763,34989,37192,2015,Venezuela,Honduras,0,3,Friendly,Puerto Ordaz,Venezuela,False,3,-3,Honduras
32764,34990,37193,2015,Austria,Moldova,1,0,UEFA Euro qualification,Vienna,Austria,False,1,1,Austria
32765,34991,37194,2015,Botswana,Burkina Faso,1,0,African Cup of Nations qualification,Francistown,Botswana,False,1,1,Botswana
32766,34992,37195,2015,Chile,Paraguay,3,2,Friendly,Santiago,Chile,False,5,1,Chile
32767,34993,37196,2015,Comoros,Uganda,0,1,African Cup of Nations qualification,Mitsamiouli,Comoros,False,1,-1,Uganda
32768,34994,37197,2015,Costa Rica,Brazil,0,1,Friendly,Harrison,United States,True,1,-1,Brazil
32769,34995,37198,2015,Estonia,Lithuania,1,0,UEFA Euro qualification,Tallinn,Estonia,False,1,1,Estonia
32770,34996,37199,2015,Gabon,Sudan,4,0,Friendly,Libreville,Gabon,False,4,4,Gabon
32771,34997,37200,2015,Guinea-Bissau,Congo,2,4,African Cup of Nations qualification,Bissau,Guinea-Bissau,False,6,-2,Congo
32772,34998,37201,2015,Liberia,Tunisia,1,0,African Cup of Nations qualification,Monrovia,Liberia,False,1,1,Liberia
32773,35000,37203,2015,Mauritania,South Africa,3,1,African Cup of Nations qualification,Nouakchott,Mauritania,False,4,2,Mauritania
32774,35001,37204,2015,Montenegro,Liechtenstein,2,0,UEFA Euro qualification,Podgorica,Montenegro,False,2,2,Montenegro
32775,35002,37205,2015,Namibia,Senegal,0,2,African Cup of Nations qualification,Windhoek,Namibia,False,2,-2,Senegal
32776,35003,37206,2015,Russia,Sweden,1,0,UEFA Euro qualification,Moscow,Russia,False,1,1,Russia
32777,35004,37207,2015,Rwanda,Ghana,0,1,African Cup of Nations qualification,Kigali,Rwanda,False,1,-1,Ghana
32778,35005,37208,2015,San Marino,England,0,6,UEFA Euro qualification,Serravalle,San Marino,False,6,-6,England
32779,35006,37209,2015,São Tomé and Príncipe,Morocco,0,3,African Cup of Nations qualification,São Tomé,São Tomé and Príncipe,False,3,-3,Morocco
32780,35007,37210,2015,Seychelles,Ethiopia,1,1,African Cup of Nations qualification,Victoria,Seychelles,False,2,0,Draw
32781,35008,37211,2015,South Sudan,Equatorial Guinea,1,0,African Cup of Nations qualification,Juba,South Sudan,False,1,1,South Sudan
32782,35009,37212,2015,Spain,Slovakia,2,0,UEFA Euro qualification,Oviedo,Spain,False,2,2,Spain
32783,35010,37213,2015,Switzerland,Slovenia,3,2,UEFA Euro qualification,Basel,Switzerland,False,5,1,Switzerland
32784,35011,37214,2015,Tanzania,Nigeria,0,0,African Cup of Nations qualification,Dar es Salaam,Tanzania,False,0,0,Draw
32785,35012,37215,2015,Ukraine,Belarus,3,1,UEFA Euro qualification,L'viv,Ukraine,False,4,2,Ukraine
32786,35013,37216,2015,Bosnia and Herzegovina,Andorra,3,0,UEFA Euro qualification,Zenica,Bosnia and Herzegovina,False,3,3,Bosnia and Herzegovina
32787,35014,37217,2015,Central African Republic,DR Congo,2,0,African Cup of Nations qualification,Bangui,Central African Republic,False,2,2,Central African Republic
32788,35015,37218,2015,Chad,Egypt,1,5,African Cup of Nations qualification,N'Djamena,Chad,False,6,-4,Egypt
32789,35016,37219,2015,Cyprus,Belgium,0,1,UEFA Euro qualification,Nicosia,Cyprus,False,1,-1,Belgium
32790,35017,37220,2015,Iceland,Kazakhstan,0,0,UEFA Euro qualification,Reykjavík,Iceland,False,0,0,Draw
32791,35018,37221,2015,Italy,Bulgaria,1,0,UEFA Euro qualification,Palermo,Italy,False,1,1,Italy
32792,35019,37222,2015,Latvia,Czech Republic,1,2,UEFA Euro qualification,Riga,Latvia,False,3,-1,Czech Republic
32793,35020,37223,2015,Lesotho,Algeria,1,3,African Cup of Nations qualification,Maseru,Lesotho,False,4,-2,Algeria
32794,35022,37225,2015,Madagascar,Angola,0,0,African Cup of Nations qualification,Antananarivo,Madagascar,False,0,0,Draw
32795,35023,37226,2015,Malta,Azerbaijan,2,2,UEFA Euro qualification,Attard,Malta,False,4,0,Draw
32796,35024,37227,2015,Mauritius,Mozambique,1,0,African Cup of Nations qualification,Curepipe,Mauritius,False,1,1,Mauritius
32797,35025,37228,2015,Norway,Croatia,2,0,UEFA Euro qualification,Oslo,Norway,False,2,2,Norway
32798,35026,37229,2015,Sierra Leone,Ivory Coast,0,0,African Cup of Nations qualification,Port Harcourt,Nigeria,True,0,0,Draw
32799,35027,37230,2015,Eswatini,Malawi,2,2,African Cup of Nations qualification,Lobamba,Eswatini,False,4,0,Draw
32800,35028,37231,2015,Turkey,Netherlands,3,0,UEFA Euro qualification,Konya,Turkey,False,3,3,Turkey
32801,35029,37232,2015,Wales,Israel,0,0,UEFA Euro qualification,Cardiff,Wales,False,0,0,Draw
32802,35030,37233,2015,Albania,Portugal,0,1,UEFA Euro qualification,Elbasan,Albania,False,1,-1,Portugal
32803,35031,37234,2015,Armenia,Denmark,0,0,UEFA Euro qualification,Yerevan,Armenia,False,0,0,Draw
32804,35032,37235,2015,Burma,New Zealand,1,1,Friendly,Rangoon,Burma,False,2,0,Draw
32805,35033,37236,2015,Finland,Faroe Islands,1,0,UEFA Euro qualification,Helsinki,Finland,False,1,1,Finland
32806,35034,37237,2015,France,Serbia,2,1,Friendly,Bordeaux,France,False,3,1,France
32807,35035,37238,2015,Republic of Ireland,Georgia,1,0,UEFA Euro qualification,Dublin,Republic of Ireland,False,1,1,Republic of Ireland
32808,35036,37239,2015,Northern Ireland,Hungary,1,1,UEFA Euro qualification,Belfast,Northern Ireland,False,2,0,Draw
32809,35037,37240,2015,Poland,Gibraltar,8,1,UEFA Euro qualification,Warsaw,Poland,False,9,7,Poland
32810,35038,37241,2015,Romania,Greece,0,0,UEFA Euro qualification,Bucharest,Romania,False,0,0,Draw
32811,35039,37242,2015,Scotland,Germany,2,3,UEFA Euro qualification,Glasgow,Scotland,False,5,-1,Germany
32812,35040,37243,2015,Afghanistan,Japan,0,6,FIFA World Cup qualification,Teheran,Iran,True,6,-6,Japan
32813,35041,37244,2015,Bangladesh,Jordan,0,4,FIFA World Cup qualification,Dhaka,Bangladesh,False,4,-4,Jordan
32814,35042,37245,2015,Belarus,Luxembourg,2,0,UEFA Euro qualification,Barysaw,Belarus,False,2,2,Belarus
32815,35043,37246,2015,Cambodia,Syria,0,6,FIFA World Cup qualification,Phnom Penh,Cambodia,False,6,-6,Syria
32816,35044,37248,2015,Ecuador,Honduras,2,0,Friendly,Quito,Ecuador,False,2,2,Ecuador
32817,35045,37249,2015,El Salvador,Curaçao,1,0,FIFA World Cup qualification,San Salvador,El Salvador,False,1,1,El Salvador
32818,35046,37250,2015,England,Switzerland,2,0,UEFA Euro qualification,London,England,False,2,2,England
32819,35047,37251,2015,Guam,Oman,0,0,FIFA World Cup qualification,Dededo,Guam,False,0,0,Draw
32820,35048,37252,2015,Hong Kong,Qatar,2,3,FIFA World Cup qualification,Kowloon,Hong Kong,False,5,-1,Qatar
32821,35049,37253,2015,India,Iran,0,3,FIFA World Cup qualification,Bangalore,India,False,3,-3,Iran
32822,35050,37254,2015,Laos,Kuwait,0,2,FIFA World Cup qualification,Vientiane,Laos,False,2,-2,Kuwait
32823,35052,37256,2015,Liechtenstein,Russia,0,7,UEFA Euro qualification,Vaduz,Liechtenstein,False,7,-7,Russia
32824,35053,37257,2015,Lithuania,San Marino,2,1,UEFA Euro qualification,Vilnius,Lithuania,False,3,1,Lithuania
32825,35054,37259,2015,Malaysia,Saudi Arabia,0,3,FIFA World Cup qualification,Shah Alam,Malaysia,False,3,-3,Saudi Arabia
32826,35055,37260,2015,Mexico,Argentina,2,2,Friendly,Arlington,United States,True,4,0,Draw
32827,35056,37261,2015,Moldova,Montenegro,0,2,UEFA Euro qualification,Chișinău,Moldova,False,2,-2,Montenegro
32828,35057,37262,2015,Nigeria,Niger,2,0,Friendly,Port Harcourt,Nigeria,False,2,2,Nigeria
32829,35058,37263,2015,Palestine,United Arab Emirates,0,0,FIFA World Cup qualification,al-Ramm,Palestine,False,0,0,Draw
32830,35059,37264,2015,Philippines,Uzbekistan,1,5,FIFA World Cup qualification,Bocaue,Philippines,False,6,-4,Uzbekistan
32831,35060,37265,2015,Slovakia,Ukraine,0,0,UEFA Euro qualification,Žilina,Slovakia,False,0,0,Draw
32832,35061,37266,2015,Slovenia,Estonia,1,0,UEFA Euro qualification,Maribor,Slovenia,False,1,1,Slovenia
32833,35062,37267,2015,South Africa,Senegal,1,0,Friendly,Johannesburg,South Africa,False,1,1,South Africa
32834,35063,37268,2015,Sweden,Austria,1,4,UEFA Euro qualification,Solna,Sweden,False,5,-3,Austria
32835,35064,37269,2015,Tajikistan,Australia,0,3,FIFA World Cup qualification,Dushanbe,Tajikistan,False,3,-3,Australia
32836,35065,37270,2015,Thailand,Iraq,2,2,FIFA World Cup qualification,Bangkok,Thailand,False,4,0,Draw
32837,35066,37271,2015,Venezuela,Panama,1,1,Friendly,Puerto Ordaz,Venezuela,False,2,0,Draw
32838,35067,37272,2015,Yemen,Bahrain,0,4,FIFA World Cup qualification,Doha,Qatar,True,4,-4,Bahrain
32839,35068,37273,2015,Zambia,Gabon,1,1,Friendly,Lusaka,Zambia,False,2,0,Draw
32840,35069,37274,2015,Rwanda,Gabon,0,1,Friendly,Kigali,Rwanda,False,1,-1,Gabon
32841,35070,37275,2015,Botswana,Ethiopia,2,3,Friendly,Gaborone,Botswana,False,5,-1,Ethiopia
32842,35071,37276,2015,Oman,Syria,2,1,Friendly,Muscat,Oman,False,3,1,Oman
32843,35072,37277,2015,Jordan,Iraq,3,0,Friendly,Amman,Jordan,False,3,3,Jordan
32844,35073,37278,2015,Comoros,Lesotho,0,0,FIFA World Cup qualification,Moroni,Comoros,False,0,0,Draw
32845,35074,37279,2015,Mauritius,Kenya,2,5,FIFA World Cup qualification,Mapou,Mauritius,False,7,-3,Kenya
32846,35075,37280,2015,Seychelles,Burundi,0,1,FIFA World Cup qualification,Roche Caiman,Seychelles,False,1,-1,Burundi
32847,35076,37281,2015,South Sudan,Mauritania,1,1,FIFA World Cup qualification,Juba,South Sudan,False,2,0,Draw
32848,35077,37282,2015,Tanzania,Malawi,2,0,FIFA World Cup qualification,Dar es Salaam,Tanzania,False,2,2,Tanzania
32849,35078,37283,2015,Albania,Serbia,0,2,UEFA Euro qualification,Elbasan,Albania,False,2,-2,Serbia
32850,35079,37284,2015,Argentina,Ecuador,0,2,FIFA World Cup qualification,Buenos Aires,Argentina,False,2,-2,Ecuador
32851,35080,37285,2015,Bahrain,Uzbekistan,0,4,FIFA World Cup qualification,Riffa,Bahrain,False,4,-4,Uzbekistan
32852,35081,37286,2015,Bhutan,Maldives,3,4,FIFA World Cup qualification,Thimphu,Bhutan,False,7,-1,Maldives
32853,35082,37287,2015,Bolivia,Uruguay,0,0,FIFA World Cup qualification,La Paz,Bolivia,False,0,0,Draw
32854,35083,37288,2015,Burma,Lebanon,0,2,FIFA World Cup qualification,Bangkok,Thailand,True,2,-2,Lebanon
32855,35084,37289,2015,Chile,Brazil,2,0,FIFA World Cup qualification,Santiago,Chile,False,2,2,Chile
32856,35085,37290,2015,Colombia,Peru,2,0,FIFA World Cup qualification,Barranquilla,Colombia,False,2,2,Colombia
32857,35086,37291,2015,East Timor,Palestine,0,3,FIFA World Cup qualification,Dili,East Timor,False,3,-3,Palestine
32858,35087,37292,2015,France,Armenia,4,0,Friendly,Nice,France,False,4,4,France
32859,35088,37293,2015,Georgia,Gibraltar,4,0,UEFA Euro qualification,Tbilisi,Georgia,False,4,4,Georgia
32860,35089,37294,2015,Hungary,Faroe Islands,2,1,UEFA Euro qualification,Budapest,Hungary,False,3,1,Hungary
32861,35090,37295,2015,Republic of Ireland,Germany,1,0,UEFA Euro qualification,Dublin,Republic of Ireland,False,1,1,Republic of Ireland
32862,35091,37296,2015,Jordan,Australia,2,0,FIFA World Cup qualification,Amman,Jordan,False,2,2,Jordan
32863,35093,37299,2015,Kyrgyzstan,Tajikistan,2,2,FIFA World Cup qualification,Bishkek,Kyrgyzstan,False,4,0,Draw
32864,35094,37300,2015,Laos,Malaysia,1,3,Friendly,Pathum Thani,Thailand,True,4,-2,Malaysia
32865,35095,37301,2015,Liberia,Guinea-Bissau,1,1,FIFA World Cup qualification,Monrovia,Liberia,False,2,0,Draw
32866,35096,37302,2015,Nigeria,DR Congo,0,2,Friendly,Visé,Belgium,True,2,-2,DR Congo
32867,35097,37303,2015,Northern Ireland,Greece,3,1,UEFA Euro qualification,Belfast,Northern Ireland,False,4,2,Northern Ireland
32868,35098,37304,2015,Oman,Iran,1,1,FIFA World Cup qualification,Muscat,Oman,False,2,0,Draw
32869,35099,37305,2015,Portugal,Denmark,1,0,UEFA Euro qualification,Braga,Portugal,False,1,1,Portugal
32870,35101,37307,2015,Romania,Finland,1,1,UEFA Euro qualification,Bucharest,Romania,False,2,0,Draw
32871,35102,37308,2015,São Tomé and Príncipe,Ethiopia,1,0,FIFA World Cup qualification,São Tomé,São Tomé and Príncipe,False,1,1,São Tomé and Príncipe
32872,35103,37309,2015,Saudi Arabia,United Arab Emirates,2,1,FIFA World Cup qualification,Jeddah,Saudi Arabia,False,3,1,Saudi Arabia
32873,35104,37310,2015,Scotland,Poland,2,2,UEFA Euro qualification,Glasgow,Scotland,False,4,0,Draw
32874,35105,37311,2015,Singapore,Afghanistan,1,0,FIFA World Cup qualification,Kallang,Singapore,False,1,1,Singapore
32875,35106,37312,2015,Syria,Japan,0,3,FIFA World Cup qualification,Seeb,Oman,True,3,-3,Japan
32876,35107,37313,2015,Turkmenistan,India,2,1,FIFA World Cup qualification,Ashgabat,Turkmenistan,False,3,1,Turkmenistan
32877,35108,37314,2015,Venezuela,Paraguay,0,1,FIFA World Cup qualification,Ciudad Guayana,Venezuela,False,1,-1,Paraguay
32878,35109,37315,2015,Vietnam,Iraq,1,1,FIFA World Cup qualification,Hanoi,Vietnam,False,2,0,Draw
32879,35110,37316,2015,Algeria,Guinea,1,2,Friendly,Algiers,Algeria,False,3,-1,Guinea
32880,35111,37317,2015,Burkina Faso,Mali,1,4,Friendly,Troyes,France,True,5,-3,Mali
32881,35112,37318,2015,Djibouti,Eswatini,0,6,FIFA World Cup qualification,Djibouti,Djibouti,False,6,-6,Eswatini
32882,35113,37319,2015,England,Estonia,2,0,UEFA Euro qualification,London,England,False,2,2,England
32883,35114,37320,2015,Gambia,Namibia,1,1,FIFA World Cup qualification,Bakau,Gambia,False,2,0,Draw
32884,35115,37321,2015,Liechtenstein,Sweden,0,2,UEFA Euro qualification,Vaduz,Liechtenstein,False,2,-2,Sweden
32885,35116,37323,2015,Moldova,Russia,1,2,UEFA Euro qualification,Chișinău,Moldova,False,3,-1,Russia
32886,35117,37324,2015,Montenegro,Austria,2,3,UEFA Euro qualification,Podgorica,Montenegro,False,5,-1,Austria
32887,35118,37325,2015,Morocco,Ivory Coast,0,1,Friendly,Agadir,Morocco,False,1,-1,Ivory Coast
32888,35119,37326,2015,Slovakia,Belarus,0,1,UEFA Euro qualification,Žilina,Slovakia,False,1,-1,Belarus
32889,35120,37327,2015,Slovenia,Lithuania,1,1,UEFA Euro qualification,Ljubljana,Slovenia,False,2,0,Draw
32890,35121,37328,2015,Somalia,Niger,0,2,FIFA World Cup qualification,Addis Abeba,Ethiopia,True,2,-2,Niger
32891,35122,37329,2015,Spain,Luxembourg,4,0,UEFA Euro qualification,Logroño,Spain,False,4,4,Spain
32892,35123,37330,2015,Switzerland,San Marino,7,0,UEFA Euro qualification,St. Gallen,Switzerland,False,7,7,Switzerland
32893,35124,37331,2015,Thailand,Hong Kong,1,0,Friendly,Bangkok,Thailand,False,1,1,Thailand
32894,35125,37332,2015,Tunisia,Gabon,3,3,Friendly,Radès,Tunisia,False,6,0,Draw
32895,35126,37333,2015,Andorra,Belgium,1,4,UEFA Euro qualification,Sant Julià de Lòria,Andorra,False,5,-3,Belgium
32896,35127,37334,2015,Azerbaijan,Italy,1,3,UEFA Euro qualification,Baku,Azerbaijan,False,4,-2,Italy
32897,35128,37335,2015,Bosnia and Herzegovina,Wales,2,0,UEFA Euro qualification,Zenica,Bosnia and Herzegovina,False,2,2,Bosnia and Herzegovina
32898,35129,37336,2015,Chad,Sierra Leone,1,0,FIFA World Cup qualification,N'Djamena,Chad,False,1,1,Chad
32899,35130,37337,2015,Croatia,Bulgaria,3,0,UEFA Euro qualification,Zagreb,Croatia,False,3,3,Croatia
32900,35131,37338,2015,Czech Republic,Turkey,0,2,UEFA Euro qualification,Prague,Czech Republic,False,2,-2,Turkey
32901,35132,37339,2015,Eritrea,Botswana,0,2,FIFA World Cup qualification,Asmara,Eritrea,False,2,-2,Botswana
32902,35133,37340,2015,Iceland,Latvia,2,2,UEFA Euro qualification,Reykjavík,Iceland,False,4,0,Draw
32903,35134,37341,2015,Israel,Cyprus,1,2,UEFA Euro qualification,Jerusalem,Israel,False,3,-1,Cyprus
32904,35135,37342,2015,Kazakhstan,Netherlands,1,2,UEFA Euro qualification,Astana,Kazakhstan,False,3,-1,Netherlands
32905,35136,37343,2015,Kosovo,Equatorial Guinea,2,0,Friendly,Prishtina,Kosovo,False,2,2,Kosovo
32906,35137,37344,2015,Madagascar,Central African Republic,3,0,FIFA World Cup qualification,Antananarivo,Madagascar,False,3,3,Madagascar
32907,35138,37345,2015,Norway,Malta,2,0,UEFA Euro qualification,Oslo,Norway,False,2,2,Norway
32908,35139,37346,2015,United States,Mexico,2,3,Friendly,Pasadena,United States,False,5,-1,Mexico
32909,35140,37347,2015,Armenia,Albania,0,3,UEFA Euro qualification,Yerevan,Armenia,False,3,-3,Albania
32910,35141,37348,2015,Denmark,France,1,2,Friendly,Copenhagen,Denmark,False,3,-1,France
32911,35142,37349,2015,Egypt,Zambia,3,0,Friendly,Abu Dhabi,United Arab Emirates,True,3,3,Egypt
32912,35143,37350,2015,Ethiopia,São Tomé and Príncipe,3,0,FIFA World Cup qualification,Addis Abeba,Ethiopia,False,3,3,Ethiopia
32913,35144,37351,2015,Faroe Islands,Romania,0,3,UEFA Euro qualification,Tórshavn,Faroe Islands,False,3,-3,Romania
32914,35145,37352,2015,Finland,Northern Ireland,1,1,UEFA Euro qualification,Helsinki,Finland,False,2,0,Draw
32915,35146,37353,2015,Germany,Georgia,2,1,UEFA Euro qualification,Leipzig,Germany,False,3,1,Germany
32916,35147,37354,2015,Gibraltar,Scotland,0,6,UEFA Euro qualification,Faro,Portugal,True,6,-6,Scotland
32917,35148,37355,2015,Greece,Hungary,4,3,UEFA Euro qualification,Piraeus,Greece,False,7,1,Greece
32918,35149,37356,2015,Kenya,Mauritius,0,0,FIFA World Cup qualification,Nairobi,Kenya,False,0,0,Draw
32919,35150,37357,2015,Malawi,Tanzania,1,0,FIFA World Cup qualification,Blantyre,Malawi,False,1,1,Malawi
32920,35151,37358,2015,Nigeria,Cameroon,3,0,Friendly,Brussels,Belgium,True,3,3,Nigeria
32921,35152,37359,2015,Poland,Republic of Ireland,2,1,UEFA Euro qualification,Warsaw,Poland,False,3,1,Poland
32922,35153,37360,2015,Serbia,Portugal,1,2,UEFA Euro qualification,Belgrade,Serbia,False,3,-1,Portugal
32923,35154,37361,2015,Austria,Liechtenstein,3,0,UEFA Euro qualification,Vienna,Austria,False,3,3,Austria
32924,35156,37363,2015,Estonia,Switzerland,0,1,UEFA Euro qualification,Tallinn,Estonia,False,1,-1,Switzerland
32925,35157,37364,2015,Gabon,DR Congo,1,2,Friendly,Mons,Belgium,True,3,-1,DR Congo
32926,35158,37365,2015,Lithuania,England,0,3,UEFA Euro qualification,Vilnius,Lithuania,False,3,-3,England
32927,35159,37366,2015,Luxembourg,Slovakia,2,4,UEFA Euro qualification,Luxembourg,Luxembourg,False,6,-2,Slovakia
32928,35160,37367,2015,Morocco,Guinea,1,1,Friendly,Agadir,Morocco,False,2,0,Draw
32929,35161,37368,2015,Russia,Montenegro,2,0,UEFA Euro qualification,Moscow,Russia,False,2,2,Russia
32930,35162,37369,2015,San Marino,Slovenia,0,2,UEFA Euro qualification,Serravalle,San Marino,False,2,-2,Slovenia
32931,35163,37370,2015,Sweden,Moldova,2,0,UEFA Euro qualification,Solna,Sweden,False,2,2,Sweden
32932,35164,37371,2015,Ukraine,Spain,0,1,UEFA Euro qualification,Kyïv,Ukraine,False,1,-1,Spain
32933,35165,37372,2015,Algeria,Senegal,1,0,Friendly,Algiers,Algeria,False,1,1,Algeria
32934,35166,37373,2015,Bahrain,Philippines,2,0,FIFA World Cup qualification,Riffa,Bahrain,False,2,2,Bahrain
32935,35167,37374,2015,Belgium,Israel,3,1,UEFA Euro qualification,Brussels,Belgium,False,4,2,Belgium
32936,35168,37375,2015,Bhutan,Hong Kong,0,1,FIFA World Cup qualification,Thimphu,Bhutan,False,1,-1,Hong Kong
32937,35169,37376,2015,Botswana,Eritrea,3,1,FIFA World Cup qualification,Francistown,Botswana,False,4,2,Botswana
32938,35170,37377,2015,Brazil,Venezuela,3,1,FIFA World Cup qualification,Fortaleza,Brazil,False,4,2,Brazil
32939,35171,37378,2015,Bulgaria,Azerbaijan,2,0,UEFA Euro qualification,Sofia,Bulgaria,False,2,2,Bulgaria
32940,35172,37379,2015,Burma,Laos,3,1,FIFA World Cup qualification,Bangkok,Thailand,True,4,2,Burma
32941,35173,37380,2015,Burundi,Seychelles,2,0,FIFA World Cup qualification,Bujumbura,Burundi,False,2,2,Burundi
32942,35174,37381,2015,Congo,Benin,2,1,Friendly,Brazzaville,Congo,False,3,1,Congo
32943,35175,37382,2015,Cyprus,Bosnia and Herzegovina,2,3,UEFA Euro qualification,Nicosia,Cyprus,False,5,-1,Bosnia and Herzegovina
32944,35176,37383,2015,East Timor,Malaysia,0,3,FIFA World Cup qualification,Dili,East Timor,False,3,-3,Malaysia
32945,35177,37384,2015,Ecuador,Bolivia,2,0,FIFA World Cup qualification,Quito,Ecuador,False,2,2,Ecuador
32946,35178,37385,2015,El Salvador,Guatemala,1,1,Friendly,Carson,United States,True,2,0,Draw
32947,35179,37386,2015,Guinea-Bissau,Liberia,1,3,FIFA World Cup qualification,Bissau,Guinea-Bissau,False,4,-2,Liberia
32948,35180,37387,2015,Iran,Japan,1,1,Friendly,Teheran,Iran,False,2,0,Draw
32949,35181,37388,2015,Italy,Norway,2,1,UEFA Euro qualification,Rome,Italy,False,3,1,Italy
32950,35182,37389,2015,Jordan,Tajikistan,3,0,FIFA World Cup qualification,Irbid,Jordan,False,3,3,Jordan
32951,35183,37392,2015,Kuwait,Lebanon,0,0,FIFA World Cup qualification,Kuwait City,Kuwait,False,0,0,Draw
32952,35184,37393,2015,Kyrgyzstan,Bangladesh,2,0,FIFA World Cup qualification,Bishkek,Kyrgyzstan,False,2,2,Kyrgyzstan
32953,35185,37394,2015,Latvia,Kazakhstan,0,1,UEFA Euro qualification,Riga,Latvia,False,1,-1,Kazakhstan
32954,35186,37395,2015,Lesotho,Comoros,1,1,FIFA World Cup qualification,Maseru,Lesotho,False,2,0,Draw
32955,35187,37396,2015,Madagascar,Central African Republic,2,2,FIFA World Cup qualification,Antananarivo,Madagascar,False,4,0,Draw
32956,35188,37397,2015,Malta,Croatia,0,1,UEFA Euro qualification,Attard,Malta,False,1,-1,Croatia
32957,35189,37398,2015,Mauritania,South Sudan,4,0,FIFA World Cup qualification,Nouakchott,Mauritania,False,4,4,Mauritania
32958,35190,37399,2015,Namibia,Gambia,2,1,FIFA World Cup qualification,Windhoek,Namibia,False,3,1,Namibia
32959,35191,37400,2015,Netherlands,Czech Republic,2,3,UEFA Euro qualification,Amsterdam,Netherlands,False,5,-1,Czech Republic
32960,35192,37401,2015,Niger,Somalia,4,0,FIFA World Cup qualification,Niamey,Niger,False,4,4,Niger
32961,35193,37402,2015,Oman,India,3,0,FIFA World Cup qualification,Muscat,Oman,False,3,3,Oman
32962,35194,37403,2015,Paraguay,Argentina,0,0,FIFA World Cup qualification,Asunción,Paraguay,False,0,0,Draw
32963,35195,37404,2015,Peru,Chile,3,4,FIFA World Cup qualification,Lima,Peru,False,7,-1,Chile
32964,35196,37405,2015,Qatar,Maldives,4,0,FIFA World Cup qualification,Doha,Qatar,False,4,4,Qatar
32965,35197,37406,2015,Sierra Leone,Chad,2,1,FIFA World Cup qualification,Port Harcourt,Nigeria,True,3,1,Sierra Leone
32966,35198,37407,2015,Singapore,Cambodia,2,1,FIFA World Cup qualification,Kallang,Singapore,False,3,1,Singapore
32967,35199,37408,2015,Syria,Afghanistan,5,2,FIFA World Cup qualification,Seeb,Oman,True,7,3,Syria
32968,35200,37409,2015,Turkey,Iceland,1,0,UEFA Euro qualification,Konya,Turkey,False,1,1,Turkey
32969,35201,37410,2015,Turkmenistan,Guam,1,0,FIFA World Cup qualification,Ashgabat,Turkmenistan,False,1,1,Turkmenistan
32970,35202,37411,2015,Uruguay,Colombia,3,0,FIFA World Cup qualification,Montevideo,Uruguay,False,3,3,Uruguay
32971,35203,37412,2015,Vietnam,Thailand,0,3,FIFA World Cup qualification,Hanoi,Vietnam,False,3,-3,Thailand
32972,35204,37413,2015,Wales,Andorra,2,0,UEFA Euro qualification,Cardiff,Wales,False,2,2,Wales
32973,35205,37414,2015,Niger,Togo,2,0,African Nations Championship,Niamey,Niger,False,2,2,Niger
32974,35206,37415,2015,Nigeria,Burkina Faso,2,0,African Nations Championship,Port Harcourt,Nigeria,False,2,2,Nigeria
32975,35207,37416,2015,South Africa,Angola,0,2,African Nations Championship,Johannesburg,South Africa,False,2,-2,Angola
32976,35208,37417,2015,Eswatini,Djibouti,2,1,FIFA World Cup qualification,Lobamba,Eswatini,False,3,1,Eswatini
32977,35209,37418,2015,Uganda,Sudan,2,0,African Nations Championship,Kampala,Uganda,False,2,2,Uganda
32978,35210,37419,2015,Zambia,Mozambique,3,0,African Nations Championship,Ndola,Zambia,False,3,3,Zambia
32979,35211,37420,2015,Cameroon,Congo,0,0,African Nations Championship,Yaoundé,Cameroon,False,0,0,Draw
32980,35212,37421,2015,Ghana,Ivory Coast,2,1,African Nations Championship,Kumasi,Ghana,False,3,1,Ghana
32981,35213,37422,2015,Mali,Mauritania,2,1,African Nations Championship,Bamako,Mali,False,3,1,Mali
32982,35214,37423,2015,Zimbabwe,Lesotho,3,1,African Nations Championship,Bulawayo,Zimbabwe,False,4,2,Zimbabwe
32983,35215,37424,2015,Tunisia,Libya,1,0,African Nations Championship,Radès,Tunisia,False,1,1,Tunisia
32984,35216,37425,2015,Libya,Morocco,0,4,African Nations Championship,Radès,Tunisia,True,4,-4,Morocco
32985,35217,37426,2015,Angola,South Africa,1,2,African Nations Championship,Luanda,Angola,False,3,-1,South Africa
32986,35218,37427,2015,Gabon,Chad,0,1,African Nations Championship,Libreville,Gabon,False,1,-1,Chad
32987,35219,37428,2015,Mauritania,Mali,1,1,African Nations Championship,Nouakchott,Mauritania,False,2,0,Draw
32988,35220,37429,2015,Senegal,Guinea,3,1,African Nations Championship,Dakar,Senegal,False,4,2,Senegal
32989,35221,37430,2015,Burkina Faso,Nigeria,0,0,African Nations Championship,Ouagadougou,Burkina Faso,False,0,0,Draw
32990,35222,37431,2015,Ethiopia,Burundi,3,0,African Nations Championship,Addis Abeba,Ethiopia,False,3,3,Ethiopia
32991,35223,37432,2015,Lesotho,Zimbabwe,1,1,African Nations Championship,Maseru,Lesotho,False,2,0,Draw
32992,35224,37433,2015,Mozambique,Zambia,1,1,African Nations Championship,Maputo,Mozambique,False,2,0,Draw
32993,35225,37434,2015,Sudan,Uganda,0,2,African Nations Championship,Khartoum,Sudan,False,2,-2,Uganda
32994,35226,37435,2015,Togo,Niger,1,1,African Nations Championship,Lomé,Togo,False,2,0,Draw
32995,35227,37436,2015,Tunisia,Morocco,2,3,African Nations Championship,Radès,Tunisia,False,5,-1,Morocco
32996,35228,37437,2015,Ivory Coast,Ghana,1,0,African Nations Championship,Abidjan,Ivory Coast,False,1,1,Ivory Coast
32997,35229,37438,2015,Congo,Cameroon,0,1,African Nations Championship,Brazzaville,Congo,False,1,-1,Cameroon
32998,35230,37439,2015,Cambodia,Brunei,6,1,Friendly,Phnom Penh,Cambodia,False,7,5,Cambodia
32999,35231,37440,2015,United Arab Emirates,Turkmenistan,5,1,Friendly,Abu Dhabi,United Arab Emirates,False,6,4,United Arab Emirates
33000,35232,37441,2015,Angola,Namibia,1,0,Friendly,Luanda,Angola,False,1,1,Angola
33001,35233,37442,2015,DR Congo,Zambia,3,0,Friendly,Luanda,Angola,True,3,3,DR Congo
33002,35234,37443,2015,Angola,DR Congo,1,0,Friendly,Luanda,Angola,False,1,1,Angola
33003,35235,37444,2015,Hong Kong,Burma,5,0,Friendly,Kowloon,Hong Kong,False,5,5,Hong Kong
33004,35236,37445,2015,Namibia,Zambia,0,0,Friendly,Luanda,Angola,True,0,0,Draw
33005,35237,37446,2015,Vanuatu,Fiji,1,1,Friendly,Port Vila,Vanuatu,False,2,0,Draw
33006,35238,37447,2015,Palestine,Saudi Arabia,0,0,FIFA World Cup qualification,Amman,Jordan,True,0,0,Draw
33007,35239,37448,2015,Vanuatu,Fiji,2,1,Friendly,Port Vila,Vanuatu,False,3,1,Vanuatu
33008,35240,37449,2015,Estonia,Georgia,3,0,Friendly,Tallinn,Estonia,False,3,3,Estonia
33009,35241,37450,2015,Jordan,Malta,2,0,Friendly,Istanbul,Turkey,True,2,2,Jordan
33010,35242,37451,2015,Mozambique,Gabon,1,0,FIFA World Cup qualification,Maputo,Mozambique,False,1,1,Mozambique
33011,35243,37452,2015,Sudan,Zambia,0,1,FIFA World Cup qualification,Khartoum,Sudan,False,1,-1,Zambia
33012,35244,37453,2015,Afghanistan,Cambodia,3,0,FIFA World Cup qualification,Teheran,Iran,True,3,3,Afghanistan
33013,35245,37454,2015,Andorra,Saint Kitts and Nevis,0,1,Friendly,Sant Julià de Lòria,Andorra,False,1,-1,Saint Kitts and Nevis
33014,35246,37455,2015,Australia,Kyrgyzstan,3,0,FIFA World Cup qualification,Canberra,Australia,False,3,3,Australia
33015,35247,37456,2015,Benin,Burkina Faso,2,1,FIFA World Cup qualification,Cotonou,Benin,False,3,1,Benin
33016,35248,37457,2015,Bolivia,Venezuela,4,2,FIFA World Cup qualification,La Paz,Bolivia,False,6,2,Bolivia
33017,35249,37458,2015,Burundi,DR Congo,2,3,FIFA World Cup qualification,Bujumbura,Burundi,False,5,-1,DR Congo
33018,35250,37459,2015,Chile,Colombia,1,1,FIFA World Cup qualification,Santiago,Chile,False,2,0,Draw
33019,35251,37461,2015,Ecuador,Uruguay,2,1,FIFA World Cup qualification,Quito,Ecuador,False,3,1,Ecuador
33020,35252,37462,2015,India,Guam,1,0,FIFA World Cup qualification,Bangalore,India,False,1,1,India
33021,35253,37463,2015,Iran,Turkmenistan,3,1,FIFA World Cup qualification,Teheran,Iran,False,4,2,Iran
33022,35254,37465,2015,Lebanon,Laos,7,0,FIFA World Cup qualification,Sidon,Lebanon,False,7,7,Lebanon
33023,35255,37467,2015,Maldives,Hong Kong,0,1,FIFA World Cup qualification,Malé,Maldives,False,1,-1,Hong Kong
33024,35256,37468,2015,Morocco,Equatorial Guinea,2,0,FIFA World Cup qualification,Agadir,Morocco,False,2,2,Morocco
33025,35257,37469,2015,Namibia,Guinea,0,1,FIFA World Cup qualification,Windhoek,Namibia,False,1,-1,Guinea
33026,35258,37470,2015,Norway,Hungary,0,1,UEFA Euro qualification,Oslo,Norway,False,1,-1,Hungary
33027,35259,37471,2015,Oman,New Zealand,0,1,Friendly,Seeb,Oman,False,1,-1,New Zealand
33028,35260,37472,2015,Palestine,Malaysia,6,0,FIFA World Cup qualification,Amman,Jordan,True,6,6,Palestine
33029,35261,37473,2015,Philippines,Yemen,0,1,FIFA World Cup qualification,Manila,Philippines,False,1,-1,Yemen
33030,35262,37474,2015,Singapore,Japan,0,3,FIFA World Cup qualification,Kallang,Singapore,False,3,-3,Japan
33031,35263,37475,2015,Tajikistan,Bangladesh,5,0,FIFA World Cup qualification,Dushanbe,Tajikistan,False,5,5,Tajikistan
33032,35265,37477,2015,Togo,Uganda,0,1,FIFA World Cup qualification,Lomé,Togo,False,1,-1,Uganda
33033,35266,37478,2015,United Arab Emirates,East Timor,8,0,FIFA World Cup qualification,Abu Dhabi,United Arab Emirates,False,8,8,United Arab Emirates
33034,35268,37480,2015,Angola,South Africa,1,3,FIFA World Cup qualification,Benguela,Angola,False,4,-2,South Africa
33035,35269,37481,2015,Argentina,Brazil,1,1,FIFA World Cup qualification,Buenos Aires,Argentina,False,2,0,Draw
33036,35270,37482,2015,Belgium,Italy,3,1,Friendly,Brussels,Belgium,False,4,2,Belgium
33037,35271,37483,2015,Bosnia and Herzegovina,Republic of Ireland,1,1,UEFA Euro qualification,Zenica,Bosnia and Herzegovina,False,2,0,Draw
33038,35272,37484,2015,Comoros,Ghana,0,0,FIFA World Cup qualification,Mitsamiouli,Comoros,False,0,0,Draw
33039,35273,37485,2015,Costa Rica,Haiti,1,0,FIFA World Cup qualification,San José,Costa Rica,False,1,1,Costa Rica
33040,35274,37486,2015,Czech Republic,Serbia,4,1,Friendly,Ostrava,Czech Republic,False,5,3,Czech Republic
33041,35275,37487,2015,France,Germany,2,0,Friendly,Saint-Denis,France,False,2,2,France
33042,35277,37489,2015,Kosovo,Albania,2,2,Friendly,Prishtina,Kosovo,False,4,0,Draw
33043,35278,37490,2015,Liberia,Ivory Coast,0,1,FIFA World Cup qualification,Monrovia,Liberia,False,1,-1,Ivory Coast
33044,35279,37491,2015,Libya,Rwanda,1,0,FIFA World Cup qualification,Sfax,Tunisia,True,1,1,Libya
33045,35280,37492,2015,Luxembourg,Greece,1,0,Friendly,Luxembourg,Luxembourg,False,1,1,Luxembourg
33046,35281,37493,2015,Madagascar,Senegal,2,2,FIFA World Cup qualification,Antananarivo,Madagascar,False,4,0,Draw
33047,35282,37494,2015,Mauritania,Tunisia,1,2,FIFA World Cup qualification,Nouakchott,Mauritania,False,3,-1,Tunisia
33048,35283,37495,2015,Niger,Cameroon,0,3,FIFA World Cup qualification,Niamey,Niger,False,3,-3,Cameroon
33049,35284,37496,2015,Northern Ireland,Latvia,1,0,Friendly,Belfast,Northern Ireland,False,1,1,Northern Ireland
33050,35285,37497,2015,Peru,Paraguay,1,0,FIFA World Cup qualification,Lima,Peru,False,1,1,Peru
33051,35286,37498,2015,Poland,Iceland,4,2,Friendly,Warsaw,Poland,False,6,2,Poland
33052,35287,37499,2015,Qatar,Turkey,1,2,Friendly,Doha,Qatar,False,3,-1,Turkey
33053,35288,37500,2015,Slovakia,Switzerland,3,2,Friendly,Trnava,Slovakia,False,5,1,Slovakia
33054,35289,37501,2015,Spain,England,2,0,Friendly,Alicante,Spain,False,2,2,Spain
33055,35290,37502,2015,Eswatini,Nigeria,0,0,FIFA World Cup qualification,Lobamba,Eswatini,False,0,0,Draw
33056,35291,37503,2015,Wales,Netherlands,2,3,Friendly,Cardiff,Wales,False,5,-1,Netherlands
33057,35292,37504,2015,Botswana,Mali,2,1,FIFA World Cup qualification,Francistown,Botswana,False,3,1,Botswana
33058,35293,37505,2015,Chad,Egypt,1,0,FIFA World Cup qualification,N'Djamena,Chad,False,1,1,Chad
33059,35294,37506,2015,Ethiopia,Congo,3,4,FIFA World Cup qualification,Addis Abeba,Ethiopia,False,7,-1,Congo
33060,35295,37507,2015,Gabon,Mozambique,1,0,FIFA World Cup qualification,Libreville,Gabon,False,1,1,Gabon
33061,35296,37508,2015,Hong Kong,Macau,2,0,Friendly,Siu Sai Wan,Hong Kong,False,2,2,Hong Kong
33062,35297,37509,2015,Russia,Portugal,1,0,Friendly,Krasnodar,Russia,False,1,1,Russia
33063,35298,37510,2015,Sweden,Denmark,2,1,UEFA Euro qualification,Solna,Sweden,False,3,1,Sweden
33064,35299,37511,2015,Tanzania,Algeria,2,2,FIFA World Cup qualification,Dar es Salaam,Tanzania,False,4,0,Draw
33065,35300,37512,2015,Ukraine,Slovenia,2,0,UEFA Euro qualification,L'viv,Ukraine,False,2,2,Ukraine
33066,35301,37513,2015,DR Congo,Burundi,3,0,FIFA World Cup qualification,Kinshasa,DR Congo,False,3,3,DR Congo
33067,35302,37514,2015,Equatorial Guinea,Morocco,1,0,FIFA World Cup qualification,Bata,Equatorial Guinea,False,1,1,Equatorial Guinea
33068,35303,37515,2015,Guinea,Namibia,2,0,FIFA World Cup qualification,Casablanca,Morocco,True,2,2,Guinea
33069,35304,37516,2015,Hungary,Norway,2,1,UEFA Euro qualification,Budapest,Hungary,False,3,1,Hungary
33070,35305,37517,2015,Uganda,Togo,3,0,FIFA World Cup qualification,Kampala,Uganda,False,3,3,Uganda
33071,35306,37518,2015,Zambia,Sudan,2,0,FIFA World Cup qualification,Ndola,Zambia,False,2,2,Zambia
33072,35307,37519,2015,Albania,Georgia,2,2,Friendly,Tirana,Albania,False,4,0,Draw
33073,35308,37520,2015,Republic of Ireland,Bosnia and Herzegovina,2,0,UEFA Euro qualification,Dublin,Republic of Ireland,False,2,2,Republic of Ireland
33074,35309,37521,2015,Algeria,Tanzania,7,0,FIFA World Cup qualification,Blida,Algeria,False,7,7,Algeria
33075,35310,37522,2015,Austria,Switzerland,1,2,Friendly,Vienna,Austria,False,3,-1,Switzerland
33076,35311,37523,2015,Azerbaijan,Moldova,2,1,Friendly,Baku,Azerbaijan,False,3,1,Azerbaijan
33077,35312,37524,2015,Bangladesh,Australia,0,4,FIFA World Cup qualification,Dhaka,Bangladesh,False,4,-4,Australia
33078,35313,37525,2015,Bhutan,Qatar,0,3,FIFA World Cup qualification,Thimphu,Bhutan,False,3,-3,Qatar
33079,35314,37526,2015,Brazil,Peru,3,0,FIFA World Cup qualification,Salvador,Brazil,False,3,3,Brazil
33080,35315,37527,2015,Burkina Faso,Benin,2,0,FIFA World Cup qualification,Ouagadougou,Burkina Faso,False,2,2,Burkina Faso
33081,35316,37528,2015,Burma,Kuwait,3,0,FIFA World Cup qualification,Bangkok,Thailand,True,3,3,Burma
33082,35317,37529,2015,Cambodia,Japan,0,2,FIFA World Cup qualification,Phnom Penh,Cambodia,False,2,-2,Japan
33083,35318,37530,2015,Cameroon,Niger,0,0,FIFA World Cup qualification,Yaoundé,Cameroon,False,0,0,Draw
33084,35319,37532,2015,Colombia,Argentina,0,1,FIFA World Cup qualification,Barranquilla,Colombia,False,1,-1,Argentina
33085,35320,37533,2015,Congo,Ethiopia,2,1,FIFA World Cup qualification,Brazzaville,Congo,False,3,1,Congo
33086,35321,37534,2015,Denmark,Sweden,2,2,UEFA Euro qualification,Copenhagen,Denmark,False,4,0,Draw
33087,35322,37535,2015,East Timor,Saudi Arabia,0,10,FIFA World Cup qualification,Dili,East Timor,False,10,-10,Saudi Arabia
33088,35323,37536,2015,Egypt,Chad,4,0,FIFA World Cup qualification,Alexandria,Egypt,False,4,4,Egypt
33089,35324,37537,2015,England,France,2,0,Friendly,London,England,False,2,2,England
33090,35325,37538,2015,Estonia,Saint Kitts and Nevis,3,0,Friendly,Tallinn,Estonia,False,3,3,Estonia
33091,35326,37539,2015,Ghana,Comoros,2,0,FIFA World Cup qualification,Kumasi,Ghana,False,2,2,Ghana
33092,35327,37540,2015,Guam,Iran,0,6,FIFA World Cup qualification,Dededo,Guam,False,6,-6,Iran
33093,35328,37541,2015,Honduras,Mexico,0,2,FIFA World Cup qualification,San Pedro Sula,Honduras,False,2,-2,Mexico
33094,35330,37543,2015,Italy,Romania,2,2,Friendly,Bologna,Italy,False,4,0,Draw
33095,35331,37544,2015,Ivory Coast,Liberia,3,0,FIFA World Cup qualification,Abidjan,Ivory Coast,False,3,3,Ivory Coast
33096,35332,37546,2015,Kyrgyzstan,Jordan,1,0,FIFA World Cup qualification,Bishkek,Kyrgyzstan,False,1,1,Kyrgyzstan
33097,35334,37548,2015,Luxembourg,Portugal,0,2,Friendly,Luxembourg,Luxembourg,False,2,-2,Portugal
33098,35335,37550,2015,Malaysia,United Arab Emirates,1,2,FIFA World Cup qualification,Shah Alam,Malaysia,False,3,-1,United Arab Emirates
33099,35336,37551,2015,Mali,Botswana,2,0,FIFA World Cup qualification,Bamako,Mali,False,2,2,Mali
33100,35337,37552,2015,Nigeria,Eswatini,2,0,FIFA World Cup qualification,Port Harcourt,Nigeria,False,2,2,Nigeria
33101,35338,37553,2015,Paraguay,Bolivia,2,1,FIFA World Cup qualification,Asunción,Paraguay,False,3,1,Paraguay
33102,35339,37554,2015,Poland,Czech Republic,3,1,Friendly,Wrocław,Poland,False,4,2,Poland
33103,35340,37555,2015,Russia,Croatia,1,3,Friendly,Rostov-on-Don,Russia,False,4,-2,Croatia
33104,35341,37556,2015,Rwanda,Libya,1,3,FIFA World Cup qualification,Kigali,Rwanda,False,4,-2,Libya
33105,35342,37557,2015,Senegal,Madagascar,3,0,FIFA World Cup qualification,Dakar,Senegal,False,3,3,Senegal
33106,35343,37558,2015,Singapore,Syria,1,2,FIFA World Cup qualification,Kallang,Singapore,False,3,-1,Syria
33107,35344,37559,2015,Slovakia,Iceland,3,1,Friendly,Žilina,Slovakia,False,4,2,Slovakia
33108,35345,37560,2015,Slovenia,Ukraine,1,1,UEFA Euro qualification,Maribor,Slovenia,False,2,0,Draw
33109,35346,37561,2015,South Africa,Angola,1,0,FIFA World Cup qualification,Durban,South Africa,False,1,1,South Africa
33110,35347,37562,2015,Tunisia,Mauritania,2,1,FIFA World Cup qualification,Radès,Tunisia,False,3,1,Tunisia
33111,35348,37563,2015,Turkey,Greece,0,0,Friendly,Istanbul,Turkey,False,0,0,Draw
33112,35349,37564,2015,Turkmenistan,Oman,2,1,FIFA World Cup qualification,Ashgabat,Turkmenistan,False,3,1,Turkmenistan
33113,35350,37565,2015,Uruguay,Chile,3,0,FIFA World Cup qualification,Montevideo,Uruguay,False,3,3,Uruguay
33114,35351,37566,2015,Venezuela,Ecuador,1,3,FIFA World Cup qualification,Ciudad Guayana,Venezuela,False,4,-2,Ecuador
33115,35352,37567,2015,Yemen,Uzbekistan,1,3,FIFA World Cup qualification,Doha,Qatar,True,4,-2,Uzbekistan
33116,35354,37569,2015,Ethiopia,Rwanda,0,1,CECAFA Cup,Addis Abeba,Ethiopia,False,1,-1,Rwanda
33117,35355,37570,2015,Kenya,Uganda,2,0,CECAFA Cup,Addis Abeba,Ethiopia,True,2,2,Kenya
33118,35356,37571,2015,Somalia,Tanzania,0,4,CECAFA Cup,Addis Abeba,Ethiopia,True,4,-4,Tanzania
33119,35357,37572,2015,South Sudan,Djibouti,2,0,CECAFA Cup,Bahir Dar,Ethiopia,True,2,2,South Sudan
33120,35358,37573,2015,Sudan,Malawi,1,2,CECAFA Cup,Bahir Dar,Ethiopia,True,3,-1,Malawi
33121,35359,37574,2015,Rwanda,Tanzania,1,2,CECAFA Cup,Hawassa,Ethiopia,True,3,-1,Tanzania
33122,35360,37576,2015,Ethiopia,Somalia,2,0,CECAFA Cup,Hawassa,Ethiopia,False,2,2,Ethiopia
33123,35361,37577,2015,Kenya,Burundi,1,1,CECAFA Cup,Hawassa,Ethiopia,True,2,0,Draw
33124,35362,37578,2015,Malawi,Djibouti,3,0,CECAFA Cup,Bahir Dar,Ethiopia,True,3,3,Malawi
33125,35363,37579,2015,South Sudan,Sudan,0,0,CECAFA Cup,Bahir Dar,Ethiopia,True,0,0,Draw
33126,35364,37580,2015,Djibouti,Sudan,0,4,CECAFA Cup,Bahir Dar,Ethiopia,True,4,-4,Sudan
33127,35365,37581,2015,Rwanda,Somalia,3,0,CECAFA Cup,Hawassa,Ethiopia,True,3,3,Rwanda
33128,35366,37582,2015,South Sudan,Malawi,2,0,CECAFA Cup,Bahir Dar,Ethiopia,True,2,2,South Sudan
33129,35367,37584,2015,Ethiopia,Tanzania,1,1,CECAFA Cup,Hawassa,Ethiopia,False,2,0,Draw
33130,35368,37585,2015,Uganda,Burundi,1,0,CECAFA Cup,Hawassa,Ethiopia,True,1,1,Uganda
33131,35369,37586,2015,Ethiopia,Tanzania,1,1,CECAFA Cup,Addis Abeba,Ethiopia,False,2,0,Draw
33132,35370,37587,2015,Uganda,Malawi,2,0,CECAFA Cup,Addis Abeba,Ethiopia,True,2,2,Uganda
33133,35371,37588,2015,Rwanda,Kenya,0,0,CECAFA Cup,Addis Abeba,Ethiopia,True,0,0,Draw
33134,35372,37589,2015,South Sudan,Sudan,0,0,CECAFA Cup,Addis Abeba,Ethiopia,True,0,0,Draw
33135,35373,37590,2015,Ethiopia,Uganda,0,0,CECAFA Cup,Addis Abeba,Ethiopia,False,0,0,Draw
33136,35374,37591,2015,Rwanda,Sudan,1,1,CECAFA Cup,Addis Abeba,Ethiopia,True,2,0,Draw
33137,35375,37592,2015,Ethiopia,Sudan,1,1,CECAFA Cup,Addis Abeba,Ethiopia,False,2,0,Draw
33138,35376,37593,2015,Uganda,Rwanda,1,0,CECAFA Cup,Addis Abeba,Ethiopia,True,1,1,Uganda
33139,35377,37594,2015,Nicaragua,Cuba,5,0,Friendly,Managua,Nicaragua,False,5,5,Nicaragua
33140,35378,37595,2015,Nicaragua,Cuba,1,0,Friendly,Estelí,Nicaragua,False,1,1,Nicaragua
33141,35379,37596,2015,Honduras,Cuba,2,0,Friendly,Juticalpa,Honduras,False,2,2,Honduras
33142,35380,37597,2015,Bangladesh,Nepal,1,0,Friendly,Dhaka,Bangladesh,False,1,1,Bangladesh
33143,35381,37598,2015,Nepal,Sri Lanka,0,1,SAFF Cup,Thiruvananthapuram,India,True,1,-1,Sri Lanka
33144,35382,37599,2015,Afghanistan,Bangladesh,4,0,SAFF Cup,Thiruvananthapuram,India,True,4,4,Afghanistan
33145,35383,37600,2015,Maldives,Bhutan,3,1,SAFF Cup,Thiruvananthapuram,India,True,4,2,Maldives
33146,35384,37601,2015,India,Sri Lanka,2,0,SAFF Cup,Thiruvananthapuram,India,False,2,2,India
33147,35385,37602,2015,Bangladesh,Maldives,1,3,SAFF Cup,Thiruvananthapuram,India,True,4,-2,Maldives
33148,35386,37603,2015,Bhutan,Afghanistan,0,3,SAFF Cup,Thiruvananthapuram,India,True,3,-3,Afghanistan
33149,35387,37604,2015,Martinique,Guadeloupe,2,0,Friendly,Le Lamentin,Martinique,False,2,2,Martinique
33150,35388,37606,2015,India,Nepal,4,1,SAFF Cup,Thiruvananthapuram,India,False,5,3,India
33151,35389,37607,2015,Afghanistan,Maldives,4,1,SAFF Cup,Thiruvananthapuram,India,True,5,3,Afghanistan
33152,35390,37608,2015,Bhutan,Bangladesh,0,3,SAFF Cup,Thiruvananthapuram,India,True,3,-3,Bangladesh
33153,35391,37609,2015,Afghanistan,Sri Lanka,5,0,SAFF Cup,Thiruvananthapuram,India,True,5,5,Afghanistan
33154,35392,37610,2015,India,Maldives,3,2,SAFF Cup,Thiruvananthapuram,India,False,5,1,India
33155,35393,37611,2016,India,Afghanistan,2,1,SAFF Cup,Thiruvananthapuram,India,False,3,1,India
33156,35394,37612,2016,Rwanda,Cameroon,1,1,Friendly,Gisenyi,Rwanda,False,2,0,Draw
33157,35395,37613,2016,Sweden,Estonia,1,1,Friendly,Abu Dhabi,United Arab Emirates,True,2,0,Draw
33158,35396,37614,2016,Bangladesh,Sri Lanka,4,2,Friendly,Jessore,Bangladesh,False,6,2,Bangladesh
33159,35397,37615,2016,Trinidad and Tobago,Haiti,0,1,Copa América qualification,Panama City,Panama,True,1,-1,Haiti
33160,35398,37616,2016,Panama,Cuba,4,0,Copa América qualification,Panama City,Panama,False,4,4,Panama
33161,35399,37617,2016,Rwanda,DR Congo,1,0,Friendly,Gisenyi,Rwanda,False,1,1,Rwanda
33162,35400,37618,2016,Sweden,Finland,3,0,Friendly,Abu Dhabi,United Arab Emirates,True,3,3,Sweden
33163,35401,37619,2016,Maldives,Cambodia,3,2,Friendly,Jessore,Bangladesh,True,5,1,Maldives
33164,35402,37620,2016,Finland,Iceland,0,1,Friendly,Abu Dhabi,United Arab Emirates,True,1,-1,Iceland
33165,35403,37621,2016,Nepal,Sri Lanka,1,0,Friendly,Dhaka,Bangladesh,True,1,1,Nepal
33166,35404,37622,2016,Uganda,Cameroon,0,0,Friendly,Njeru,Uganda,False,0,0,Draw
33167,35405,37623,2016,Bangladesh,Nepal,0,0,Friendly,Dhaka,Bangladesh,False,0,0,Draw
33168,35406,37624,2016,Gabon,Morocco,0,0,African Nations Championship,Kigali,Rwanda,True,0,0,Draw
33169,35407,37625,2016,Rwanda,Ivory Coast,1,0,African Nations Championship,Kigali,Rwanda,False,1,1,Rwanda
33170,35408,37626,2016,United Arab Emirates,Iceland,2,1,Friendly,Dubai,United Arab Emirates,False,3,1,United Arab Emirates
33171,35409,37627,2016,Angola,Cameroon,0,1,African Nations Championship,Butare,Rwanda,True,1,-1,Cameroon
33172,35410,37628,2016,DR Congo,Ethiopia,3,0,African Nations Championship,Butare,Rwanda,True,3,3,DR Congo
33173,35411,37629,2016,Nigeria,Niger,4,1,African Nations Championship,Kigali,Rwanda,True,5,3,Nigeria
33174,35412,37630,2016,Tunisia,Guinea,2,2,African Nations Championship,Kigali,Rwanda,True,4,0,Draw
33175,35413,37631,2016,Maldives,Nepal,1,4,Friendly,Dhaka,Bangladesh,True,5,-3,Nepal
33176,35414,37632,2016,Mali,Uganda,2,2,African Nations Championship,Gisenyi,Rwanda,True,4,0,Draw
33177,35415,37633,2016,Zimbabwe,Zambia,0,1,African Nations Championship,Gisenyi,Rwanda,True,1,-1,Zambia
33178,35416,37634,2016,Morocco,Ivory Coast,0,1,African Nations Championship,Kigali,Rwanda,True,1,-1,Ivory Coast
33179,35417,37635,2016,Rwanda,Gabon,2,1,African Nations Championship,Kigali,Rwanda,False,3,1,Rwanda
33180,35418,37636,2016,Cameroon,Ethiopia,0,0,African Nations Championship,Butare,Rwanda,True,0,0,Draw
33181,35419,37637,2016,DR Congo,Angola,4,2,African Nations Championship,Butare,Rwanda,True,6,2,DR Congo
33182,35420,37638,2016,Niger,Guinea,2,2,African Nations Championship,Kigali,Rwanda,True,4,0,Draw
33183,35421,37639,2016,Tunisia,Nigeria,1,1,African Nations Championship,Kigali,Rwanda,True,2,0,Draw
33184,35422,37640,2016,Uganda,Zambia,0,1,African Nations Championship,Gisenyi,Rwanda,True,1,-1,Zambia
33185,35423,37641,2016,Zimbabwe,Mali,0,1,African Nations Championship,Gisenyi,Rwanda,True,1,-1,Mali
33186,35424,37642,2016,Ivory Coast,Gabon,4,1,African Nations Championship,Butare,Rwanda,True,5,3,Ivory Coast
33187,35425,37643,2016,Rwanda,Morocco,1,4,African Nations Championship,Kigali,Rwanda,False,5,-3,Morocco
33188,35426,37644,2016,Cameroon,DR Congo,3,1,African Nations Championship,Butare,Rwanda,True,4,2,Cameroon
33189,35427,37645,2016,Ethiopia,Angola,1,2,African Nations Championship,Kigali,Rwanda,True,3,-1,Angola
33190,35428,37646,2016,Guinea,Nigeria,1,0,African Nations Championship,Gisenyi,Rwanda,True,1,1,Guinea
33191,35429,37647,2016,Niger,Tunisia,0,5,African Nations Championship,Kigali,Rwanda,True,5,-5,Tunisia
33192,35430,37648,2016,Egypt,Jordan,0,1,Friendly,Aswan,Egypt,False,1,-1,Jordan
33193,35431,37649,2016,Uganda,Zimbabwe,1,1,African Nations Championship,Gisenyi,Rwanda,True,2,0,Draw
33194,35432,37650,2016,Zambia,Mali,0,0,African Nations Championship,Kigali,Rwanda,True,0,0,Draw
33195,35433,37651,2016,Egypt,Libya,2,0,Friendly,Aswan,Egypt,False,2,2,Egypt
33196,35434,37652,2016,Cameroon,Ivory Coast,0,3,African Nations Championship,Butare,Rwanda,True,3,-3,Ivory Coast
33197,35435,37653,2016,Rwanda,DR Congo,1,2,African Nations Championship,Kigali,Rwanda,False,3,-1,DR Congo
33198,35436,37654,2016,Tunisia,Mali,1,2,African Nations Championship,Kigali,Rwanda,True,3,-1,Mali
33199,35437,37655,2016,United States,Iceland,3,2,Friendly,Carson,United States,False,5,1,United States
33200,35438,37656,2016,Zambia,Guinea,0,0,African Nations Championship,Gisenyi,Rwanda,True,0,0,Draw
33201,35439,37657,2016,DR Congo,Guinea,1,1,African Nations Championship,Kigali,Rwanda,True,2,0,Draw
33202,35440,37658,2016,Mali,Ivory Coast,1,0,African Nations Championship,Kigali,Rwanda,True,1,1,Mali
33203,35441,37659,2016,Bahrain,Lebanon,2,0,Friendly,Riffa,Bahrain,False,2,2,Bahrain
33204,35442,37660,2016,Guadeloupe,Martinique,1,1,Friendly,Vieux-Habitants,Guadeloupe,False,2,0,Draw
33205,35443,37661,2016,DR Congo,Mali,3,0,African Nations Championship,Kigali,Rwanda,True,3,3,DR Congo
33206,35444,37662,2016,Guinea,Ivory Coast,1,2,African Nations Championship,Kigali,Rwanda,True,3,-1,Ivory Coast
33207,35445,37663,2016,Uzbekistan,Lebanon,2,0,Friendly,Dubai,United Arab Emirates,True,2,2,Uzbekistan
33208,35446,37664,2016,Guyana,Suriname,2,0,Friendly,Providence,Guyana,False,2,2,Guyana
33209,35447,37665,2016,French Guiana,Suriname,2,3,Friendly,Cayenne,French Guiana,False,5,-1,Suriname
33210,35448,37666,2016,Egypt,Burkina Faso,2,0,Friendly,Alexandria,Egypt,False,2,2,Egypt
33211,35449,37667,2016,Sint Maarten,Anguilla,2,0,Friendly,Philipsburg,Sint Maarten,False,2,2,Sint Maarten
33212,35450,37668,2016,Iraq,Syria,0,1,Friendly,Teheran,Iran,True,1,-1,Syria
33213,35451,37669,2016,United Arab Emirates,Bangladesh,6,1,Friendly,Abu Dhabi,United Arab Emirates,False,7,5,United Arab Emirates
33214,35452,37670,2016,Cuba,Bermuda,2,1,CFU Caribbean Cup qualification,Havana,Cuba,False,3,1,Cuba
33215,35453,37671,2016,Antigua and Barbuda,Aruba,2,1,CFU Caribbean Cup qualification,St. John's,Antigua and Barbuda,False,3,1,Antigua and Barbuda
33216,35454,37672,2016,Barbados,Curaçao,1,0,CFU Caribbean Cup qualification,Bridgetown,Barbados,False,1,1,Barbados
33217,35455,37673,2016,Chad,Tanzania,0,1,African Cup of Nations qualification,N'Djamena,Chad,False,1,-1,Tanzania
33218,35456,37674,2016,Croatia,Israel,2,0,Friendly,Osijek,Croatia,False,2,2,Croatia
33219,35457,37675,2016,Gibraltar,Liechtenstein,0,0,Friendly,Gibraltar,Gibraltar,False,0,0,Draw
33220,35458,37676,2016,Guadeloupe,Suriname,0,0,CFU Caribbean Cup qualification,Les Abymes,Guadeloupe,False,0,0,Draw
33221,35459,37677,2016,Guinea-Bissau,Kenya,1,0,African Cup of Nations qualification,Bissau,Guinea-Bissau,False,1,1,Guinea-Bissau
33222,35461,37679,2016,Poland,Serbia,1,0,Friendly,Poznań,Poland,False,1,1,Poland
33223,35462,37680,2016,Romania,Lithuania,1,0,Friendly,Giurgiu,Romania,False,1,1,Romania
33224,35463,37681,2016,São Tomé and Príncipe,Libya,2,1,African Cup of Nations qualification,São Tomé,São Tomé and Príncipe,False,3,1,São Tomé and Príncipe
33225,35465,37683,2016,South Sudan,Benin,1,2,African Cup of Nations qualification,Juba,South Sudan,False,3,-1,Benin
33226,35466,37684,2016,Zambia,Congo,1,1,African Cup of Nations qualification,Ndola,Zambia,False,2,0,Draw
33227,35467,37685,2016,Australia,Tajikistan,7,0,FIFA World Cup qualification,Adelaide,Australia,False,7,7,Australia
33228,35468,37686,2016,Bahrain,Yemen,3,0,FIFA World Cup qualification,Riffa,Bahrain,False,3,3,Bahrain
33229,35469,37687,2016,Bolivia,Colombia,2,3,FIFA World Cup qualification,La Paz,Bolivia,False,5,-1,Colombia
33230,35470,37688,2016,Chile,Argentina,1,2,FIFA World Cup qualification,Santiago,Chile,False,3,-1,Argentina
33231,35471,37690,2016,Comoros,Botswana,1,0,African Cup of Nations qualification,Mitsamiouli,Comoros,False,1,1,Comoros
33232,35472,37691,2016,Czech Republic,Scotland,0,1,Friendly,Prague,Czech Republic,False,1,-1,Scotland
33233,35473,37692,2016,Denmark,Iceland,2,1,Friendly,Herning,Denmark,False,3,1,Denmark
33234,35474,37693,2016,Djibouti,Liberia,0,1,African Cup of Nations qualification,Djibouti,Djibouti,False,1,-1,Liberia
33235,35475,37694,2016,Ecuador,Paraguay,2,2,FIFA World Cup qualification,Quito,Ecuador,False,4,0,Draw
33236,35476,37695,2016,Estonia,Norway,0,0,Friendly,Tallinn,Estonia,False,0,0,Draw
33237,35477,37696,2016,Ghana,Mozambique,3,1,African Cup of Nations qualification,Accra,Ghana,False,4,2,Ghana
33238,35478,37697,2016,Greece,Montenegro,2,1,Friendly,Piraeus,Greece,False,3,1,Greece
33239,35479,37698,2016,Iran,India,4,0,FIFA World Cup qualification,Teheran,Iran,False,4,4,Iran
33240,35480,37699,2016,Iraq,Thailand,2,2,FIFA World Cup qualification,Teheran,Iran,True,4,0,Draw
33241,35481,37700,2016,Italy,Spain,1,1,Friendly,Udine,Italy,False,2,0,Draw
33242,35482,37701,2016,Japan,Afghanistan,5,0,FIFA World Cup qualification,Saitama,Japan,False,5,5,Japan
33243,35483,37702,2016,Jordan,Bangladesh,8,0,FIFA World Cup qualification,Amman,Jordan,False,8,8,Jordan
33244,35484,37704,2016,Madagascar,Central African Republic,1,1,African Cup of Nations qualification,Antananarivo,Madagascar,False,2,0,Draw
33245,35485,37705,2016,Malta,Moldova,0,0,Friendly,Attard,Malta,False,0,0,Draw
33246,35486,37706,2016,Oman,Guam,1,0,FIFA World Cup qualification,Muscat,Oman,False,1,1,Oman
33247,35487,37707,2016,Peru,Venezuela,2,2,FIFA World Cup qualification,Lima,Peru,False,4,0,Draw
33248,35488,37708,2016,Qatar,Hong Kong,2,0,FIFA World Cup qualification,Doha,Qatar,False,2,2,Qatar
33249,35489,37709,2016,Saudi Arabia,Malaysia,2,0,FIFA World Cup qualification,Jeddah,Saudi Arabia,False,2,2,Saudi Arabia
33250,35490,37710,2016,Singapore,Burma,2,1,Friendly,Kallang,Singapore,False,3,1,Singapore
33251,35491,37711,2016,Solomon Islands,Papua New Guinea,2,0,Friendly,Honiara,Solomon Islands,False,2,2,Solomon Islands
33252,35492,37712,2016,Syria,Cambodia,6,0,FIFA World Cup qualification,Seeb,Oman,True,6,6,Syria
33253,35493,37713,2016,Turkey,Sweden,2,1,Friendly,Antalya,Turkey,False,3,1,Turkey
33254,35494,37714,2016,Ukraine,Cyprus,1,0,Friendly,Odesa,Ukraine,False,1,1,Ukraine
33255,35495,37715,2016,United Arab Emirates,Palestine,2,0,FIFA World Cup qualification,Abu Dhabi,United Arab Emirates,False,2,2,United Arab Emirates
33256,35496,37716,2016,Uzbekistan,Philippines,1,0,FIFA World Cup qualification,Tashkent,Uzbekistan,False,1,1,Uzbekistan
33257,35498,37718,2016,Wales,Northern Ireland,1,1,Friendly,Cardiff,Wales,False,2,0,Draw
33258,35499,37719,2016,Algeria,Ethiopia,7,1,African Cup of Nations qualification,Blida,Algeria,False,8,6,Algeria
33259,35500,37720,2016,Armenia,Belarus,0,0,Friendly,Yerevan,Armenia,False,0,0,Draw
33260,35501,37721,2016,Brazil,Uruguay,2,2,FIFA World Cup qualification,Recife,Brazil,False,4,0,Draw
33261,35502,37722,2016,Canada,Mexico,0,3,FIFA World Cup qualification,Vancouver,Canada,False,3,-3,Mexico
33262,35503,37723,2016,El Salvador,Honduras,2,2,FIFA World Cup qualification,San Salvador,El Salvador,False,4,0,Draw
33263,35504,37724,2016,Gabon,Sierra Leone,2,1,Friendly,Franceville,Gabon,False,3,1,Gabon
33264,35505,37725,2016,Guatemala,United States,2,0,FIFA World Cup qualification,Guatemala,Guatemala,False,2,2,Guatemala
33265,35506,37726,2016,Guinea,Malawi,0,0,African Cup of Nations qualification,Conakry,Guinea,False,0,0,Draw
33266,35507,37727,2016,Haiti,Panama,0,0,FIFA World Cup qualification,Port-au-Prince,Haiti,False,0,0,Draw
33267,35508,37728,2016,Republic of Ireland,Switzerland,1,0,Friendly,Dublin,Republic of Ireland,False,1,1,Republic of Ireland
33268,35509,37729,2016,Ivory Coast,Sudan,1,0,African Cup of Nations qualification,Abidjan,Ivory Coast,False,1,1,Ivory Coast
33269,35510,37730,2016,Jamaica,Costa Rica,1,1,FIFA World Cup qualification,Kingston,Jamaica,False,2,0,Draw
33270,35511,37731,2016,Luxembourg,Bosnia and Herzegovina,0,3,Friendly,Luxembourg,Luxembourg,False,3,-3,Bosnia and Herzegovina
33271,35512,37732,2016,Mali,Equatorial Guinea,1,0,African Cup of Nations qualification,Bamako,Mali,False,1,1,Mali
33272,35513,37733,2016,Mauritania,Gambia,2,1,African Cup of Nations qualification,Nouakchott,Mauritania,False,3,1,Mauritania
33273,35514,37734,2016,Netherlands,France,2,3,Friendly,Amsterdam,Netherlands,False,5,-1,France
33274,35515,37735,2016,Nigeria,Egypt,1,1,African Cup of Nations qualification,Kaduna,Nigeria,False,2,0,Draw
33275,35516,37736,2016,Portugal,Bulgaria,0,1,Friendly,Leiria,Portugal,False,1,-1,Bulgaria
33276,35517,37737,2016,Slovakia,Latvia,0,0,Friendly,Trnava,Slovakia,False,0,0,Draw
33277,35518,37738,2016,Eswatini,Zimbabwe,1,1,African Cup of Nations qualification,Lobamba,Eswatini,False,2,0,Draw
33278,35519,37739,2016,Tunisia,Togo,1,0,African Cup of Nations qualification,Monastir,Tunisia,False,1,1,Tunisia
33279,35520,37740,2016,Anguilla,Puerto Rico,0,4,CFU Caribbean Cup qualification,The Valley,Anguilla,False,4,-4,Puerto Rico
33280,35521,37741,2016,Aruba,Saint Kitts and Nevis,0,2,CFU Caribbean Cup qualification,Oranjestad,Aruba,False,2,-2,Saint Kitts and Nevis
33281,35522,37742,2016,Austria,Albania,2,1,Friendly,Vienna,Austria,False,3,1,Austria
33282,35523,37743,2016,Azerbaijan,Kazakhstan,0,1,Friendly,Belek,Turkey,True,1,-1,Kazakhstan
33283,35524,37744,2016,Bermuda,French Guiana,2,1,CFU Caribbean Cup qualification,Hamilton,Bermuda,False,3,1,Bermuda
33284,35525,37746,2016,Burkina Faso,Uganda,1,0,African Cup of Nations qualification,Ouagadougou,Burkina Faso,False,1,1,Burkina Faso
33285,35526,37747,2016,Burundi,Namibia,1,3,African Cup of Nations qualification,Bujumbura,Burundi,False,4,-2,Namibia
33286,35527,37748,2016,Cameroon,South Africa,2,2,African Cup of Nations qualification,Limbe,Cameroon,False,4,0,Draw
33287,35528,37750,2016,DR Congo,Angola,2,1,African Cup of Nations qualification,Kinshasa,DR Congo,False,3,1,DR Congo
33288,35529,37751,2016,Curaçao,Dominican Republic,2,1,CFU Caribbean Cup qualification,Willemstad,Curaçao,False,3,1,Curaçao
33289,35530,37752,2016,Germany,England,2,3,Friendly,Berlin,Germany,False,5,-1,England
33290,35531,37753,2016,Hungary,Croatia,1,1,Friendly,Budapest,Hungary,False,2,0,Draw
33291,35532,37754,2016,Mauritius,Rwanda,1,0,African Cup of Nations qualification,Mapou,Mauritius,False,1,1,Mauritius
33292,35533,37755,2016,Poland,Finland,5,0,Friendly,Wrocław,Poland,False,5,5,Poland
33293,35534,37756,2016,Russia,Lithuania,3,0,Friendly,Moscow,Russia,False,3,3,Russia
33294,35535,37757,2016,Senegal,Niger,2,0,African Cup of Nations qualification,Dakar,Senegal,False,2,2,Senegal
33295,35536,37758,2016,Seychelles,Lesotho,2,0,African Cup of Nations qualification,Victoria,Seychelles,False,2,2,Seychelles
33296,35537,37759,2016,Sint Maarten,U.S. Virgin Islands,1,2,CFU Caribbean Cup qualification,Philipsburg,Sint Maarten,False,3,-1,U.S. Virgin Islands
33297,35538,37760,2016,Benin,South Sudan,4,1,African Cup of Nations qualification,Cotonou,Benin,False,5,3,Benin
33298,35539,37761,2016,Botswana,Comoros,2,1,African Cup of Nations qualification,Francistown,Botswana,False,3,1,Botswana
33299,35540,37762,2016,Congo,Zambia,1,1,African Cup of Nations qualification,Brazzaville,Congo,False,2,0,Draw
33300,35541,37763,2016,Kenya,Guinea-Bissau,0,1,African Cup of Nations qualification,Nairobi,Kenya,False,1,-1,Guinea-Bissau
33301,35542,37764,2016,Mozambique,Ghana,0,0,African Cup of Nations qualification,Maputo,Mozambique,False,0,0,Draw
33302,35543,37765,2016,Romania,Spain,0,0,Friendly,Cluj,Romania,False,0,0,Draw
33303,35545,37767,2016,Andorra,Moldova,0,1,Friendly,Paola,Malta,True,1,-1,Moldova
33304,35546,37768,2016,Central African Republic,Madagascar,2,1,African Cup of Nations qualification,Bangui,Central African Republic,False,3,1,Central African Republic
33305,35547,37769,2016,Equatorial Guinea,Mali,0,1,African Cup of Nations qualification,Malabo,Equatorial Guinea,False,1,-1,Mali
33306,35548,37770,2016,Libya,São Tomé and Príncipe,4,0,African Cup of Nations qualification,Cairo,Egypt,True,4,4,Libya
33307,35549,37771,2016,Liechtenstein,Faroe Islands,2,3,Friendly,Marbella,Spain,True,5,-1,Faroe Islands
33308,35550,37772,2016,Northern Ireland,Slovenia,1,0,Friendly,Belfast,Northern Ireland,False,1,1,Northern Ireland
33309,35551,37773,2016,Sierra Leone,Gabon,1,0,Friendly,Freetown,Sierra Leone,False,1,1,Sierra Leone
33310,35552,37774,2016,Ukraine,Wales,1,0,Friendly,Kyïv,Ukraine,False,1,1,Ukraine
33311,35553,37775,2016,Afghanistan,Singapore,2,1,FIFA World Cup qualification,Teheran,Iran,True,3,1,Afghanistan
33312,35554,37776,2016,Angola,DR Congo,0,2,African Cup of Nations qualification,Luanda,Angola,False,2,-2,DR Congo
33313,35555,37777,2016,Argentina,Bolivia,2,0,FIFA World Cup qualification,Córdoba,Argentina,False,2,2,Argentina
33314,35556,37778,2016,Australia,Jordan,5,1,FIFA World Cup qualification,Sydney,Australia,False,6,4,Australia
33315,35557,37779,2016,Austria,Turkey,1,2,Friendly,Vienna,Austria,False,3,-1,Turkey
33316,35558,37781,2016,Colombia,Ecuador,3,0,FIFA World Cup qualification,Barranquilla,Colombia,False,3,3,Colombia
33317,35559,37782,2016,Costa Rica,Jamaica,3,0,FIFA World Cup qualification,San José,Costa Rica,False,3,3,Costa Rica
33318,35560,37783,2016,Dominica,Martinique,1,4,CFU Caribbean Cup qualification,Roseau,Dominica,False,5,-3,Martinique
33319,35561,37784,2016,Dominican Republic,Barbados,2,0,CFU Caribbean Cup qualification,Santo Domingo,Dominican Republic,False,2,2,Dominican Republic
33320,35562,37785,2016,Egypt,Nigeria,1,0,African Cup of Nations qualification,Alexandria,Egypt,False,1,1,Egypt
33321,35563,37786,2016,England,Netherlands,1,2,Friendly,London,England,False,3,-1,Netherlands
33322,35564,37787,2016,Estonia,Serbia,0,1,Friendly,Tallinn,Estonia,False,1,-1,Serbia
33323,35565,37788,2016,Ethiopia,Algeria,3,3,African Cup of Nations qualification,Addis Abeba,Ethiopia,False,6,0,Draw
33324,35566,37789,2016,France,Russia,4,2,Friendly,Saint-Denis,France,False,6,2,France
33325,35567,37790,2016,French Guiana,Cuba,3,0,CFU Caribbean Cup qualification,Cayenne,French Guiana,False,3,3,French Guiana
33326,35568,37791,2016,Gambia,Mauritania,0,0,African Cup of Nations qualification,Bakau,Gambia,False,0,0,Draw
33327,35569,37792,2016,Georgia,Kazakhstan,1,1,Friendly,Tbilisi,Georgia,False,2,0,Draw
33328,35570,37793,2016,Germany,Italy,4,1,Friendly,Munich,Germany,False,5,3,Germany
33329,35571,37794,2016,Gibraltar,Latvia,0,5,Friendly,Gibraltar,Gibraltar,False,5,-5,Latvia
33330,35572,37795,2016,Greece,Iceland,2,3,Friendly,Piraeus,Greece,False,5,-1,Iceland
33331,35573,37796,2016,Honduras,El Salvador,2,0,FIFA World Cup qualification,San Pedro Sula,Honduras,False,2,2,Honduras
33332,35574,37797,2016,India,Turkmenistan,1,2,FIFA World Cup qualification,Kochi,India,False,3,-1,Turkmenistan
33333,35575,37798,2016,Iran,Oman,2,0,FIFA World Cup qualification,Teheran,Iran,False,2,2,Iran
33334,35576,37799,2016,Iraq,Vietnam,1,0,FIFA World Cup qualification,Teheran,Iran,True,1,1,Iraq
33335,35577,37800,2016,Republic of Ireland,Slovakia,2,2,Friendly,Dublin,Republic of Ireland,False,4,0,Draw
33336,35578,37801,2016,Japan,Syria,5,0,FIFA World Cup qualification,Saitama,Japan,False,5,5,Japan
33337,35579,37802,2016,Lebanon,Burma,1,1,FIFA World Cup qualification,Sidon,Lebanon,False,2,0,Draw
33338,35580,37803,2016,Lesotho,Seychelles,2,1,African Cup of Nations qualification,Maseru,Lesotho,False,3,1,Lesotho
33339,35581,37804,2016,Liberia,Djibouti,5,0,African Cup of Nations qualification,Monrovia,Liberia,False,5,5,Liberia
33340,35582,37805,2016,Luxembourg,Albania,0,2,Friendly,Luxembourg,Luxembourg,False,2,-2,Albania
33341,35583,37807,2016,Malawi,Guinea,1,2,African Cup of Nations qualification,Blantyre,Malawi,False,3,-1,Guinea
33342,35584,37808,2016,Malaysia,Macau,0,0,Friendly,Krubong,Malaysia,False,0,0,Draw
33343,35585,37809,2016,Maldives,Bhutan,4,2,FIFA World Cup qualification,Malé,Maldives,False,6,2,Maldives
33344,35586,37810,2016,Mexico,Canada,2,0,FIFA World Cup qualification,Mexico City,Mexico,False,2,2,Mexico
33345,35587,37811,2016,Montenegro,Belarus,0,0,Friendly,Podgorica,Montenegro,False,0,0,Draw
33346,35589,37813,2016,Namibia,Burundi,1,3,African Cup of Nations qualification,Windhoek,Namibia,False,4,-2,Burundi
33347,35590,37814,2016,Niger,Senegal,1,2,African Cup of Nations qualification,Niamey,Niger,False,3,-1,Senegal
33348,35591,37815,2016,Norway,Finland,2,0,Friendly,Oslo,Norway,False,2,2,Norway
33349,35592,37816,2016,Palestine,East Timor,7,0,FIFA World Cup qualification,Hebron,Palestine,False,7,7,Palestine
33350,35593,37817,2016,Panama,Haiti,1,0,FIFA World Cup qualification,Panama City,Panama,False,1,1,Panama
33351,35594,37818,2016,Paraguay,Brazil,2,2,FIFA World Cup qualification,Asunción,Paraguay,False,4,0,Draw
33352,35596,37820,2016,Portugal,Belgium,2,1,Friendly,Leiria,Portugal,False,3,1,Portugal
33353,35597,37821,2016,Rwanda,Mauritius,5,0,African Cup of Nations qualification,Kigali,Rwanda,False,5,5,Rwanda
33354,35598,37822,2016,Scotland,Denmark,1,0,Friendly,Glasgow,Scotland,False,1,1,Scotland
33355,35599,37823,2016,South Africa,Cameroon,0,0,African Cup of Nations qualification,Durban,South Africa,False,0,0,Draw
33356,35600,37824,2016,Saint Kitts and Nevis,Antigua and Barbuda,1,0,CFU Caribbean Cup qualification,Basseterre,Saint Kitts and Nevis,False,1,1,Saint Kitts and Nevis
33357,35601,37825,2016,Sudan,Ivory Coast,1,1,African Cup of Nations qualification,Omdurman,Sudan,False,2,0,Draw
33358,35602,37826,2016,Suriname,Guadeloupe,3,2,CFU Caribbean Cup qualification,Paramaribo,Suriname,False,5,1,Suriname
33359,35603,37827,2016,Sweden,Czech Republic,1,1,Friendly,Solna,Sweden,False,2,0,Draw
33360,35604,37828,2016,Switzerland,Bosnia and Herzegovina,0,2,Friendly,Zürich,Switzerland,False,2,-2,Bosnia and Herzegovina
33361,35605,37829,2016,Tajikistan,Kyrgyzstan,0,1,FIFA World Cup qualification,Dushanbe,Tajikistan,False,1,-1,Kyrgyzstan
33362,35606,37830,2016,Togo,Tunisia,0,0,African Cup of Nations qualification,Lomé,Togo,False,0,0,Draw
33363,35607,37831,2016,Uganda,Burkina Faso,0,0,African Cup of Nations qualification,Kampala,Uganda,False,0,0,Draw
33364,35608,37832,2016,United Arab Emirates,Saudi Arabia,1,1,FIFA World Cup qualification,Abu Dhabi,United Arab Emirates,False,2,0,Draw
33365,35609,37833,2016,Uruguay,Peru,1,0,FIFA World Cup qualification,Montevideo,Uruguay,False,1,1,Uruguay
33366,35610,37834,2016,United States,Guatemala,4,0,FIFA World Cup qualification,Columbus,United States,False,4,4,United States
33367,35611,37835,2016,Uzbekistan,Bahrain,1,0,FIFA World Cup qualification,Tashkent,Uzbekistan,False,1,1,Uzbekistan
33368,35612,37836,2016,Venezuela,Chile,1,4,FIFA World Cup qualification,Barinas,Venezuela,False,5,-3,Chile
33369,35613,37837,2016,U.S. Virgin Islands,Grenada,1,2,CFU Caribbean Cup qualification,Charlotte Amalie,U.S. Virgin Islands,False,3,-1,Grenada
33370,35614,37838,2016,Martinique,Panama,0,2,Friendly,Fort-de-France,Martinique,False,2,-2,Panama
33371,35615,37839,2016,Hungary,Ivory Coast,0,0,Friendly,Budapest,Hungary,False,0,0,Draw
33372,35616,37841,2016,Botswana,Lesotho,2,1,Friendly,Serowe,Botswana,False,3,1,Botswana
33373,35617,37842,2016,England,Turkey,2,1,Friendly,Manchester,England,False,3,1,England
33374,35618,37843,2016,Puerto Rico,United States,1,3,Friendly,Bayamón,Puerto Rico,False,4,-2,United States
33375,35619,37844,2016,Romania,DR Congo,1,1,Friendly,Como,Italy,True,2,0,Draw
33376,35620,37845,2016,Serbia,Cyprus,2,1,Friendly,Užice,Serbia,False,3,1,Serbia
33377,35621,37846,2016,Azerbaijan,Andorra,0,0,Friendly,Bad Erlach,Austria,True,0,0,Draw
33378,35622,37847,2016,Croatia,Moldova,1,0,Friendly,Koprivnica,Croatia,False,1,1,Croatia
33379,35623,37848,2016,Czech Republic,Malta,6,0,Friendly,Kufstein,Austria,True,6,6,Czech Republic
33380,35624,37849,2016,England,Australia,2,1,Friendly,Sunderland,England,False,3,1,England
33381,35625,37850,2016,Republic of Ireland,Netherlands,1,1,Friendly,Dublin,Republic of Ireland,False,2,0,Draw
33382,35626,37851,2016,Morocco,Congo,2,0,Friendly,Tangier,Morocco,False,2,2,Morocco
33383,35627,37852,2016,Nigeria,Mali,1,0,Friendly,Le Petit-Quevilly,France,True,1,1,Nigeria
33384,35628,37853,2016,Northern Ireland,Belarus,3,0,Friendly,Belfast,Northern Ireland,False,3,3,Northern Ireland
33385,35629,37854,2016,Slovakia,Georgia,3,1,Friendly,Wels,Austria,True,4,2,Slovakia
33386,35630,37855,2016,Togo,Zambia,1,0,Friendly,Lomé,Togo,False,1,1,Togo
33387,35631,37857,2016,Burma,Malaysia,0,0,Friendly,Rangoon,Burma,False,0,0,Draw
33388,35632,37858,2016,Costa Rica,Venezuela,2,1,Friendly,San José,Costa Rica,False,3,1,Costa Rica
33389,35633,37859,2016,El Salvador,Peru,1,3,Friendly,Seattle,United States,True,4,-2,Peru
33390,35634,37860,2016,Gabon,Mauritania,0,2,Friendly,Cornellà de Llobregat,Spain,True,2,-2,Mauritania
33391,35635,37861,2016,Guatemala,Armenia,1,7,Friendly,Carson,United States,True,8,-6,Armenia
33392,35636,37862,2016,Mexico,Paraguay,1,0,Friendly,Atlanta,United States,True,1,1,Mexico
33393,35637,37863,2016,New Zealand,Fiji,3,1,Oceania Nations Cup,Port Morseby,Papua New Guinea,True,4,2,New Zealand
33394,35638,37864,2016,Rwanda,Senegal,0,2,Friendly,Kigali,Rwanda,False,2,-2,Senegal
33395,35639,37865,2016,Switzerland,Belgium,1,2,Friendly,Geneva,Switzerland,False,3,-1,Belgium
33396,35640,37866,2016,Vanuatu,Solomon Islands,0,1,Oceania Nations Cup,Port Morseby,Papua New Guinea,True,1,-1,Solomon Islands
33397,35641,37867,2016,Albania,Qatar,3,1,Friendly,Hartberg,Austria,True,4,2,Albania
33398,35643,37869,2016,Bosnia and Herzegovina,Spain,1,3,Friendly,St. Gallen,Switzerland,True,4,-2,Spain
33399,35644,37870,2016,Cambodia,East Timor,2,0,Friendly,Phnom Penh,Cambodia,False,2,2,Cambodia
33400,35645,37871,2016,Germany,Slovakia,1,3,Friendly,Augsburg,Germany,False,4,-2,Slovakia
33401,35646,37872,2016,Italy,Scotland,1,0,Friendly,Attard,Malta,True,1,1,Italy
33402,35647,37873,2016,Kenya,Tanzania,1,1,Friendly,Nairobi,Kenya,False,2,0,Draw
33403,35648,37874,2016,Laos,Nepal,1,1,Friendly,Vientiane,Laos,False,2,0,Draw
33404,35649,37875,2016,Lithuania,Estonia,2,0,Baltic Cup,Klaipėda,Lithuania,False,2,2,Lithuania
33405,35650,37876,2016,Papua New Guinea,New Caledonia,1,1,Oceania Nations Cup,Port Morseby,Papua New Guinea,False,2,0,Draw
33406,35651,37877,2016,Portugal,Norway,3,0,Friendly,Porto,Portugal,False,3,3,Portugal
33407,35652,37878,2016,Romania,Ukraine,3,4,Friendly,Turin,Italy,True,7,-1,Ukraine
33408,35653,37880,2016,Turkey,Montenegro,1,0,Friendly,Antalya,Turkey,False,1,1,Turkey
33409,35654,37885,2016,France,Cameroon,3,2,Friendly,Nantes,France,False,5,1,France
33410,35655,37886,2016,Gambia,Zambia,0,0,Friendly,Bakau,Gambia,False,0,0,Draw
33411,35656,37887,2016,Sweden,Slovenia,0,0,Friendly,Malmö,Sweden,False,0,0,Draw
33412,35657,37892,2016,Austria,Malta,2,1,Friendly,Klagenfurt,Austria,False,3,1,Austria
33413,35658,37893,2016,Republic of Ireland,Belarus,1,2,Friendly,Cork,Republic of Ireland,False,3,-1,Belarus
33414,35659,37894,2016,Kenya,Sudan,1,1,Friendly,Nairobi,Kenya,False,2,0,Draw
33415,35660,37895,2016,Luxembourg,Nigeria,1,3,Friendly,Luxembourg,Luxembourg,False,4,-2,Nigeria
33416,35661,37896,2016,Serbia,Israel,3,1,Friendly,Novi Sad,Serbia,False,4,2,Serbia
33417,35662,37897,2016,Solomon Islands,Fiji,0,1,Oceania Nations Cup,Port Moresby,Papua New Guinea,True,1,-1,Fiji
33418,35663,37898,2016,Vanuatu,New Zealand,0,5,Oceania Nations Cup,Port Moresby,Papua New Guinea,True,5,-5,New Zealand
33419,35664,37899,2016,Vietnam,Syria,2,0,Friendly,Thanh Hóa,Vietnam,False,2,2,Vietnam
33420,35665,37900,2016,Zimbabwe,Uganda,2,0,Friendly,Harare,Zimbabwe,False,2,2,Zimbabwe
33421,35666,37905,2016,Belgium,Finland,1,1,Friendly,Brussels,Belgium,False,2,0,Draw
33422,35667,37906,2016,Curaçao,Guyana,5,2,CFU Caribbean Cup qualification,Willemstad,Curaçao,False,7,3,Curaçao
33423,35668,37907,2016,Czech Republic,Russia,2,1,Friendly,Innsbruck,Austria,True,3,1,Czech Republic
33424,35669,37908,2016,El Salvador,Armenia,0,4,Friendly,Carson,United States,True,4,-4,Armenia
33425,35670,37909,2016,Estonia,Andorra,2,0,Friendly,Tallinn,Estonia,False,2,2,Estonia
33426,35671,37910,2016,Grenada,Puerto Rico,3,3,CFU Caribbean Cup qualification,St. George's,Grenada,False,6,0,Draw
33427,35672,37911,2016,Latvia,Lithuania,2,1,Baltic Cup,Liepāja,Latvia,False,3,1,Latvia
33428,35673,37912,2016,Martinique,Guadeloupe,2,0,CFU Caribbean Cup qualification,Fort-de-France,Martinique,False,2,2,Martinique
33429,35674,37913,2016,New Caledonia,Samoa,7,0,Oceania Nations Cup,Port Moresby,Papua New Guinea,True,7,7,New Caledonia
33430,35675,37914,2016,Norway,Iceland,3,2,Friendly,Oslo,Norway,False,5,1,Norway
33431,35677,37916,2016,Poland,Netherlands,1,2,Friendly,Gdańsk,Poland,False,3,-1,Netherlands
33432,35679,37918,2016,Saint Kitts and Nevis,Suriname,1,0,CFU Caribbean Cup qualification,Basseterre,Saint Kitts and Nevis,False,1,1,Saint Kitts and Nevis
33433,35680,37921,2016,England,Portugal,1,0,Friendly,London,England,False,1,1,England
33434,35681,37922,2016,Laos,India,0,1,AFC Asian Cup qualification,Vientiane,Laos,False,1,-1,India
33435,35682,37924,2016,Malaysia,East Timor,3,0,AFC Asian Cup qualification,Johor Bahru,Malaysia,False,3,3,Malaysia
33436,35683,37925,2016,Maldives,Yemen,0,2,AFC Asian Cup qualification,Malé,Maldives,False,2,-2,Yemen
33437,35684,37926,2016,Seychelles,Algeria,0,2,African Cup of Nations qualification,Victoria,Seychelles,False,2,-2,Algeria
33438,35685,37927,2016,Tajikistan,Bangladesh,5,0,AFC Asian Cup qualification,Dushanbe,Tajikistan,False,5,5,Tajikistan
33439,35686,37932,2016,Albania,Ukraine,1,3,Friendly,Bergamo,Italy,True,4,-2,Ukraine
33440,35687,37933,2016,Azerbaijan,Canada,1,1,Friendly,Rohrbach an der Lafnitz,Austria,True,2,0,Draw
33441,35688,37934,2016,Bosnia and Herzegovina,Denmark,2,2,Kirin Cup,Toyota,Japan,True,4,0,Draw
33442,35689,37935,2016,Burma,Singapore,0,1,Friendly,Rangoon,Burma,False,1,-1,Singapore
33443,35690,37937,2016,Djibouti,Tunisia,0,3,African Cup of Nations qualification,Djibouti,Djibouti,False,3,-3,Tunisia
33444,35691,37938,2016,Faroe Islands,Kosovo,0,2,Friendly,Frankfurt am Main,Germany,True,2,-2,Kosovo
33445,35692,37939,2016,Japan,Bulgaria,7,2,Kirin Cup,Toyota,Japan,False,9,5,Japan
33446,35693,37940,2016,Libya,Morocco,1,1,African Cup of Nations qualification,Radès,Tunisia,True,2,0,Draw
33447,35694,37941,2016,Mauritania,Cameroon,0,1,African Cup of Nations qualification,Nouakchott,Mauritania,False,1,-1,Cameroon
33448,35695,37942,2016,Romania,Georgia,5,1,Friendly,Bucharest,Romania,False,6,4,Romania
33449,35696,37943,2016,Sierra Leone,Sudan,1,0,African Cup of Nations qualification,Freetown,Sierra Leone,False,1,1,Sierra Leone
33450,35697,37944,2016,Switzerland,Moldova,2,1,Friendly,Lugano,Switzerland,False,3,1,Switzerland
33451,35698,37945,2016,Thailand,Syria,2,2,King's Cup,Bangkok,Thailand,False,4,0,Draw
33452,35699,37946,2016,United Arab Emirates,Jordan,1,3,King's Cup,Bangkok,Thailand,True,4,-2,Jordan
33453,35700,37947,2016,United States,Colombia,0,2,Copa América,Santa Clara,United States,False,2,-2,Colombia
33454,35701,37948,2016,Vietnam,Hong Kong,2,2,Friendly,Rangoon,Burma,True,4,0,Draw
33455,35702,37953,2016,Australia,Greece,1,0,Friendly,Sydney,Australia,False,1,1,Australia
33456,35703,37954,2016,Austria,Netherlands,0,2,Friendly,Vienna,Austria,False,2,-2,Netherlands
33457,35704,37955,2016,Botswana,Uganda,1,2,African Cup of Nations qualification,Francistown,Botswana,False,3,-1,Uganda
33458,35705,37956,2016,Brazil,Ecuador,0,0,Copa América,Pasadena,United States,True,0,0,Draw
33459,35706,37957,2016,Costa Rica,Paraguay,0,0,Copa América,Orlando,United States,True,0,0,Draw
33460,35707,37958,2016,Croatia,San Marino,10,0,Friendly,Rijeka,Croatia,False,10,10,Croatia
33461,35708,37959,2016,Estonia,Latvia,0,0,Baltic Cup,Tallinn,Estonia,False,0,0,Draw
33462,35709,37960,2016,Fiji,Vanuatu,2,3,Oceania Nations Cup,Port Moresby,Papua New Guinea,True,5,-1,Vanuatu
33463,35710,37961,2016,France,Scotland,3,0,Friendly,Metz,France,False,3,3,France
33464,35711,37962,2016,Gambia,South Africa,0,4,African Cup of Nations qualification,Bakau,Gambia,False,4,-4,South Africa
33465,35712,37963,2016,Germany,Hungary,2,0,Friendly,Gelsenkirchen,Germany,False,2,2,Germany
33466,35713,37964,2016,Guadeloupe,Dominica,2,1,CFU Caribbean Cup qualification,Les Abymes,Guadeloupe,False,3,1,Guadeloupe
33467,35714,37965,2016,Haiti,Peru,0,1,Copa América,Seattle,United States,True,1,-1,Peru
33468,35715,37966,2016,Ivory Coast,Gabon,2,1,Friendly,Bouaké,Ivory Coast,False,3,1,Ivory Coast
33469,35716,37967,2016,New Zealand,Solomon Islands,1,0,Oceania Nations Cup,Port Moresby,Papua New Guinea,True,1,1,New Zealand
33470,35717,37968,2016,Rwanda,Mozambique,2,3,African Cup of Nations qualification,Kigali,Rwanda,False,5,-1,Mozambique
33471,35718,37969,2016,Slovakia,Northern Ireland,0,0,Friendly,Trnava,Slovakia,False,0,0,Draw
33472,35719,37970,2016,South Sudan,Mali,0,3,African Cup of Nations qualification,Juba,South Sudan,False,3,-3,Mali
33473,35720,37971,2016,Tanzania,Egypt,0,2,African Cup of Nations qualification,Dar es Salaam,Tanzania,False,2,-2,Egypt
33474,35721,37972,2016,U.S. Virgin Islands,Guyana,0,7,CFU Caribbean Cup qualification,Charlotte Amalie,U.S. Virgin Islands,False,7,-7,Guyana
33475,35722,37977,2016,Belgium,Norway,3,2,Friendly,Brussels,Belgium,False,5,1,Belgium
33476,35723,37978,2016,Central African Republic,Angola,3,0,African Cup of Nations qualification,Bangui,Central African Republic,False,3,3,Central African Republic
33477,35724,37979,2016,Comoros,Burkina Faso,0,1,African Cup of Nations qualification,Moroni,Comoros,False,1,-1,Burkina Faso
33478,35726,37981,2016,Jamaica,Venezuela,0,1,Copa América,Chicago,United States,True,1,-1,Venezuela
33479,35727,37982,2016,Kenya,Congo,2,1,African Cup of Nations qualification,Nairobi,Kenya,False,3,1,Kenya
33480,35728,37983,2016,Lesotho,Ethiopia,1,2,African Cup of Nations qualification,Maseru,Lesotho,False,3,-1,Ethiopia
33481,35729,37984,2016,Liberia,Togo,2,2,African Cup of Nations qualification,Monrovia,Liberia,False,4,0,Draw
33482,35730,37985,2016,Madagascar,DR Congo,1,6,African Cup of Nations qualification,Mahajanga,Madagascar,False,7,-5,DR Congo
33483,35731,37986,2016,Mauritius,Ghana,0,2,African Cup of Nations qualification,Mapou,Mauritius,False,2,-2,Ghana
33484,35732,37987,2016,Mexico,Uruguay,3,1,Copa América,Glendale,United States,True,4,2,Mexico
33485,35733,37988,2016,Papua New Guinea,Samoa,8,0,Oceania Nations Cup,Port Moresby,Papua New Guinea,False,8,8,Papua New Guinea
33486,35734,37989,2016,Russia,Serbia,1,1,Friendly,Monaco,Monaco,True,2,0,Draw
33487,35735,37990,2016,Slovenia,Turkey,0,1,Friendly,Ljubljana,Slovenia,False,1,-1,Turkey
33488,35736,37991,2016,Eswatini,Guinea,1,0,African Cup of Nations qualification,Lobamba,Eswatini,False,1,1,Eswatini
33489,35737,37992,2016,Sweden,Wales,3,0,Friendly,Solna,Sweden,False,3,3,Sweden
33490,35738,37994,2016,Thailand,Jordan,2,0,King's Cup,Bangkok,Thailand,False,2,2,Thailand
33491,35739,37995,2016,United Arab Emirates,Syria,0,1,King's Cup,Bangkok,Thailand,True,1,-1,Syria
33492,35740,37996,2016,Zimbabwe,Malawi,3,0,African Cup of Nations qualification,Harare,Zimbabwe,False,3,3,Zimbabwe
33493,35741,37999,2016,Argentina,Chile,2,1,Copa América,Santa Clara,United States,True,3,1,Argentina
33494,35742,38000,2016,Burma,Hong Kong,3,0,Friendly,Rangoon,Burma,False,3,3,Burma
33495,35743,38001,2016,Iceland,Liechtenstein,4,0,Friendly,Reykjavík,Iceland,False,4,4,Iceland
33496,35744,38002,2016,Italy,Finland,2,0,Friendly,Verona,Italy,False,2,2,Italy
33497,35745,38003,2016,Malaysia,East Timor,3,0,AFC Asian Cup qualification,Johor Bahru,Malaysia,False,3,3,Malaysia
33498,35746,38004,2016,Panama,Bolivia,2,1,Copa América,Orlando,United States,True,3,1,Panama
33499,35747,38005,2016,Poland,Lithuania,0,0,Friendly,Cracow,Poland,False,0,0,Draw
33500,35748,38006,2016,Singapore,Vietnam,0,3,Friendly,Rangoon,Burma,True,3,-3,Vietnam
33501,35749,38007,2016,Australia,Greece,1,2,Friendly,Melbourne,Australia,False,3,-1,Greece
33502,35750,38008,2016,Bangladesh,Tajikistan,0,1,AFC Asian Cup qualification,Dhaka,Bangladesh,False,1,-1,Tajikistan
33503,35751,38009,2016,Bulgaria,Denmark,0,4,Kirin Cup,Suita,Japan,True,4,-4,Denmark
33504,35753,38011,2016,Canada,Uzbekistan,2,1,Friendly,Bad Waltersdorf,Austria,True,3,1,Canada
33505,35754,38013,2016,Colombia,Paraguay,2,1,Copa América,Pasadena,United States,True,3,1,Colombia
33506,35755,38014,2016,Curaçao,U.S. Virgin Islands,7,0,CFU Caribbean Cup qualification,Willemstad,Curaçao,False,7,7,Curaçao
33507,35756,38015,2016,Dominican Republic,French Guiana,2,1,CFU Caribbean Cup qualification,Santo Domingo,Dominican Republic,False,3,1,Dominican Republic
33508,35757,38016,2016,India,Laos,6,1,AFC Asian Cup qualification,Guwahati,India,False,7,5,India
33509,35758,38017,2016,Iran,Kyrgyzstan,6,0,Friendly,Teheran,Iran,False,6,6,Iran
33510,35759,38018,2016,Japan,Bosnia and Herzegovina,1,2,Kirin Cup,Suita,Japan,False,3,-1,Bosnia and Herzegovina
33511,35760,38019,2016,Spain,Georgia,0,1,Friendly,Getafe,Spain,False,1,-1,Georgia
33512,35761,38020,2016,Saint Vincent and the Grenadines,Saint Kitts and Nevis,0,1,CFU Caribbean Cup qualification,Kingstown,Saint Vincent and the Grenadines,False,1,-1,Saint Kitts and Nevis
33513,35762,38021,2016,United States,Costa Rica,4,0,Copa América,Chicago,United States,False,4,4,United States
33514,35763,38022,2016,Yemen,Maldives,2,0,AFC Asian Cup qualification,Doha,Qatar,True,2,2,Yemen
33515,35764,38023,2016,Brazil,Haiti,7,1,Copa América,Orlando,United States,True,8,6,Brazil
33516,35765,38024,2016,Ecuador,Peru,2,2,Copa América,Glendale,United States,True,4,0,Draw
33517,35766,38025,2016,New Zealand,New Caledonia,1,0,Oceania Nations Cup,Port Moresby,Papua New Guinea,True,1,1,New Zealand
33518,35767,38026,2016,Papua New Guinea,Solomon Islands,2,1,Oceania Nations Cup,Port Moresby,Papua New Guinea,False,3,1,Papua New Guinea
33519,35768,38027,2016,Portugal,Estonia,7,0,Friendly,Lisbon,Portugal,False,7,7,Portugal
33520,35769,38028,2016,Mexico,Jamaica,2,0,Copa América,Pasadena,United States,True,2,2,Mexico
33521,35770,38029,2016,Uruguay,Venezuela,0,1,Copa América,Philadelphia,United States,True,1,-1,Venezuela
33522,35771,38030,2016,Argentina,Panama,5,0,Copa América,Chicago,United States,True,5,5,Argentina
33523,35772,38031,2016,Chile,Bolivia,2,1,Copa América,Foxborough,United States,True,3,1,Chile
33524,35773,38032,2016,France,Romania,2,1,UEFA Euro,Saint-Denis,France,False,3,1,France
33525,35774,38033,2016,Albania,Switzerland,0,1,UEFA Euro,Lens,France,True,1,-1,Switzerland
33526,35775,38034,2016,Colombia,Costa Rica,2,3,Copa América,Houston,United States,True,5,-1,Costa Rica
33527,35776,38035,2016,England,Russia,1,1,UEFA Euro,Marseille,France,True,2,0,Draw
33528,35777,38036,2016,Papua New Guinea,New Zealand,0,0,Oceania Nations Cup,Port Moresby,Papua New Guinea,False,0,0,Draw
33529,35778,38037,2016,Seychelles,Madagascar,0,1,COSAFA Cup,Windhoek,Namibia,True,1,-1,Madagascar
33530,35779,38038,2016,United States,Paraguay,1,0,Copa América,Philadelphia,United States,False,1,1,United States
33531,35780,38039,2016,Wales,Slovakia,2,1,UEFA Euro,Bordeaux,France,True,3,1,Wales
33532,35781,38040,2016,Zimbabwe,Eswatini,2,2,COSAFA Cup,Windhoek,Namibia,True,4,0,Draw
33533,35782,38041,2016,Benin,Equatorial Guinea,2,1,African Cup of Nations qualification,Cotonou,Benin,False,3,1,Benin
33534,35783,38042,2016,Brazil,Peru,0,1,Copa América,Foxborough,United States,True,1,-1,Peru
33535,35784,38043,2016,Ecuador,Haiti,4,0,Copa América,East Rutherford,United States,True,4,4,Ecuador
33536,35785,38044,2016,Germany,Ukraine,2,0,UEFA Euro,Villeneuve-d'Ascq,France,True,2,2,Germany
33537,35786,38045,2016,Lesotho,Mauritius,3,0,COSAFA Cup,Windhoek,Namibia,True,3,3,Lesotho
33538,35787,38046,2016,Malawi,Angola,3,0,COSAFA Cup,Windhoek,Namibia,True,3,3,Malawi
33539,35788,38047,2016,Poland,Northern Ireland,1,0,UEFA Euro,Nice,France,True,1,1,Poland
33540,35789,38048,2016,Turkey,Croatia,0,1,UEFA Euro,Paris,France,True,1,-1,Croatia
33541,35790,38049,2016,Belgium,Italy,0,2,UEFA Euro,Lyon,France,True,2,-2,Italy
33542,35791,38050,2016,Republic of Ireland,Sweden,1,1,UEFA Euro,Saint-Denis,France,True,2,0,Draw
33543,35792,38051,2016,Madagascar,Zimbabwe,0,0,COSAFA Cup,Windhoek,Namibia,True,0,0,Draw
33544,35793,38052,2016,Mexico,Venezuela,1,1,Copa América,Houston,United States,True,2,0,Draw
33545,35794,38053,2016,Spain,Czech Republic,1,0,UEFA Euro,Toulouse,France,True,1,1,Spain
33546,35795,38054,2016,Eswatini,Seychelles,4,0,COSAFA Cup,Windhoek,Namibia,True,4,4,Eswatini
33547,35796,38055,2016,Uruguay,Jamaica,3,0,Copa América,Santa Clara,United States,True,3,3,Uruguay
33548,35797,38056,2016,Angola,Lesotho,0,2,COSAFA Cup,Windhoek,Namibia,True,2,-2,Lesotho
33549,35798,38057,2016,Argentina,Bolivia,3,0,Copa América,Seattle,United States,True,3,3,Argentina
33550,35799,38058,2016,Austria,Hungary,0,2,UEFA Euro,Bordeaux,France,True,2,-2,Hungary
33551,35800,38059,2016,Chile,Panama,4,2,Copa América,Philadelphia,United States,True,6,2,Chile
33552,35801,38060,2016,Mauritius,Malawi,0,1,COSAFA Cup,Windhoek,Namibia,True,1,-1,Malawi
33553,35802,38061,2016,Portugal,Iceland,1,1,UEFA Euro,Saint-Étienne,France,True,2,0,Draw
33554,35803,38062,2016,France,Albania,2,0,UEFA Euro,Marseille,France,False,2,2,France
33555,35804,38063,2016,Romania,Switzerland,1,1,UEFA Euro,Paris,France,True,2,0,Draw
33556,35805,38064,2016,Russia,Slovakia,1,2,UEFA Euro,Villeneuve-d'Ascq,France,True,3,-1,Slovakia
33557,35806,38065,2016,Eswatini,Madagascar,1,0,COSAFA Cup,Windhoek,Namibia,True,1,1,Eswatini
33558,35807,38066,2016,Zimbabwe,Seychelles,5,0,COSAFA Cup,Windhoek,Namibia,True,5,5,Zimbabwe
33559,35808,38067,2016,Angola,Mauritius,0,2,COSAFA Cup,Windhoek,Namibia,True,2,-2,Mauritius
33560,35809,38068,2016,England,Wales,2,1,UEFA Euro,Lens,France,True,3,1,England
33561,35810,38069,2016,Germany,Poland,0,0,UEFA Euro,Saint-Denis,France,True,0,0,Draw
33562,35811,38070,2016,Malawi,Lesotho,0,1,COSAFA Cup,Windhoek,Namibia,True,1,-1,Lesotho
33563,35812,38071,2016,Ukraine,Northern Ireland,0,2,UEFA Euro,Lyon,France,True,2,-2,Northern Ireland
33564,35813,38072,2016,United States,Ecuador,2,1,Copa América,Seattle,United States,False,3,1,United States
33565,35814,38073,2016,Czech Republic,Croatia,2,2,UEFA Euro,Saint-Étienne,France,True,4,0,Draw
33566,35815,38074,2016,Italy,Sweden,1,0,UEFA Euro,Toulouse,France,True,1,1,Italy
33567,35816,38075,2016,Peru,Colombia,0,0,Copa América,East Rutherford,United States,True,0,0,Draw
33568,35817,38076,2016,Spain,Turkey,3,0,UEFA Euro,Nice,France,True,3,3,Spain
33569,35818,38077,2016,Argentina,Venezuela,4,1,Copa América,Foxborough,United States,True,5,3,Argentina
33570,35819,38078,2016,Belgium,Republic of Ireland,3,0,UEFA Euro,Bordeaux,France,True,3,3,Belgium
33571,35820,38079,2016,Iceland,Hungary,1,1,UEFA Euro,Marseille,France,True,2,0,Draw
33572,35821,38080,2016,Mexico,Chile,0,7,Copa América,Santa Clara,United States,True,7,-7,Chile
33573,35822,38081,2016,Namibia,Botswana,1,1,COSAFA Cup,Windhoek,Namibia,False,2,0,Draw
33574,35823,38082,2016,Portugal,Austria,0,0,UEFA Euro,Lyon,France,True,0,0,Draw
33575,35824,38083,2016,South Africa,Lesotho,1,1,COSAFA Cup,Windhoek,Namibia,True,2,0,Draw
33576,35825,38084,2016,DR Congo,Mozambique,1,0,COSAFA Cup,Windhoek,Namibia,True,1,1,DR Congo
33577,35826,38085,2016,France,Switzerland,0,0,UEFA Euro,Villeneuve-d'Ascq,France,False,0,0,Draw
33578,35827,38086,2016,French Guiana,Bermuda,3,0,CFU Caribbean Cup qualification,Cayenne,French Guiana,False,3,3,French Guiana
33579,35828,38087,2016,Romania,Albania,0,1,UEFA Euro,Lyon,France,True,1,-1,Albania
33580,35829,38088,2016,Zambia,Eswatini,0,0,COSAFA Cup,Windhoek,Namibia,True,0,0,Draw
33581,35830,38089,2016,Russia,Wales,0,3,UEFA Euro,Toulouse,France,True,3,-3,Wales
33582,35831,38090,2016,Slovakia,England,0,0,UEFA Euro,Saint-Étienne,France,True,0,0,Draw
33583,35832,38091,2016,Croatia,Spain,2,1,UEFA Euro,Bordeaux,France,True,3,1,Croatia
33584,35833,38092,2016,Czech Republic,Turkey,0,2,UEFA Euro,Lens,France,True,2,-2,Turkey
33585,35834,38093,2016,Lesotho,Zambia,2,3,COSAFA Cup,Windhoek,Namibia,True,5,-1,Zambia
33586,35835,38094,2016,Namibia,Mozambique,3,0,COSAFA Cup,Windhoek,Namibia,False,3,3,Namibia
33587,35836,38095,2016,Northern Ireland,Germany,0,1,UEFA Euro,Paris,France,True,1,-1,Germany
33588,35837,38096,2016,Ukraine,Poland,0,1,UEFA Euro,Marseille,France,True,1,-1,Poland
33589,35838,38097,2016,United States,Argentina,0,4,Copa América,Houston,United States,False,4,-4,Argentina
33590,35839,38098,2016,Botswana,DR Congo,0,0,COSAFA Cup,Windhoek,Namibia,True,0,0,Draw
33591,35840,38099,2016,Colombia,Chile,0,2,Copa América,Chicago,United States,True,2,-2,Chile
33592,35841,38100,2016,Hungary,Portugal,3,3,UEFA Euro,Lyon,France,True,6,0,Draw
33593,35842,38101,2016,Iceland,Austria,2,1,UEFA Euro,Saint-Denis,France,True,3,1,Iceland
33594,35843,38102,2016,Italy,Republic of Ireland,0,1,UEFA Euro,Villeneuve-d'Ascq,France,True,1,-1,Republic of Ireland
33595,35844,38103,2016,New Caledonia,Malaysia,1,2,Friendly,Nouméa,New Caledonia,False,3,-1,Malaysia
33596,35845,38104,2016,South Africa,Eswatini,5,1,COSAFA Cup,Windhoek,Namibia,True,6,4,South Africa
33597,35846,38105,2016,Sweden,Belgium,0,1,UEFA Euro,Nice,France,True,1,-1,Belgium
33598,35847,38106,2016,Namibia,Zambia,1,0,COSAFA Cup,Windhoek,Namibia,False,1,1,Namibia
33599,35848,38107,2016,Croatia,Portugal,0,1,UEFA Euro,Lens,France,True,1,-1,Portugal
33600,35849,38108,2016,South Africa,Botswana,3,2,COSAFA Cup,Windhoek,Namibia,True,5,1,South Africa
33601,35850,38109,2016,Eswatini,DR Congo,1,0,COSAFA Cup,Windhoek,Namibia,True,1,1,Eswatini
33602,35851,38110,2016,Switzerland,Poland,1,1,UEFA Euro,Saint-Étienne,France,True,2,0,Draw
33603,35852,38111,2016,United States,Colombia,0,1,Copa América,Glendale,United States,False,1,-1,Colombia
33604,35853,38112,2016,Wales,Northern Ireland,1,0,UEFA Euro,Paris,France,True,1,1,Wales
33605,35854,38113,2016,Argentina,Chile,0,0,Copa América,East Rutherford,United States,True,0,0,Draw
33606,35855,38114,2016,Fiji,Malaysia,1,1,Friendly,Nadi,Fiji,False,2,0,Draw
33607,35856,38115,2016,France,Republic of Ireland,2,1,UEFA Euro,Lyon,France,False,3,1,France
33608,35857,38116,2016,Germany,Slovakia,3,0,UEFA Euro,Villeneuve-d'Ascq,France,True,3,3,Germany
33609,35858,38117,2016,Hungary,Belgium,0,4,UEFA Euro,Toulouse,France,True,4,-4,Belgium
33610,35859,38118,2016,England,Iceland,1,2,UEFA Euro,Nice,France,True,3,-1,Iceland
33611,35860,38119,2016,Italy,Spain,2,0,UEFA Euro,Saint-Denis,France,True,2,2,Italy
33612,35861,38120,2016,Macau,Mongolia,2,2,EAFF Championship,Dededo,Guam,True,4,0,Draw
33613,35862,38121,2016,Poland,Portugal,1,1,UEFA Euro,Marseille,France,True,2,0,Draw
33614,35863,38122,2016,Wales,Belgium,3,1,UEFA Euro,Villeneuve-d'Ascq,France,True,4,2,Wales
33615,35864,38123,2016,Germany,Italy,1,1,UEFA Euro,Bordeaux,France,True,2,0,Draw
33616,35866,38125,2016,Northern Mariana Islands,Macau,1,3,EAFF Championship,Dededo,Guam,True,4,-2,Macau
33617,35867,38126,2016,France,Iceland,5,2,UEFA Euro,Saint-Denis,France,False,7,3,France
33618,35868,38127,2016,Northern Mariana Islands,Mongolia,0,8,EAFF Championship,Dededo,Guam,True,8,-8,Mongolia
33619,35869,38128,2016,Portugal,Wales,2,0,UEFA Euro,Lyon,France,True,2,2,Portugal
33620,35870,38129,2016,France,Germany,2,0,UEFA Euro,Marseille,France,False,2,2,France
33621,35871,38130,2016,France,Portugal,0,1,UEFA Euro,Saint-Denis,France,False,1,-1,Portugal
33622,35872,38131,2016,Uzbekistan,Iraq,2,1,Friendly,Tashkent,Uzbekistan,False,3,1,Uzbekistan
33623,35873,38132,2016,Cambodia,Singapore,2,1,Friendly,Phnom Penh,Cambodia,False,3,1,Cambodia
33624,35874,38133,2016,Oman,Turkmenistan,1,0,Friendly,Muscat,Oman,False,1,1,Oman
33625,35875,38134,2016,Qatar,Iraq,2,1,Friendly,Doha,Qatar,False,3,1,Qatar
33626,35876,38135,2016,Bhutan,India,0,3,Friendly,Thimphu,Bhutan,False,3,-3,India
33627,35877,38136,2016,Jordan,Qatar,2,3,Friendly,Lucerne,Switzerland,True,5,-1,Qatar
33628,35879,38138,2016,Honduras,Nicaragua,1,0,Friendly,San Pedro Sula,Honduras,False,1,1,Honduras
33629,35880,38140,2016,Saudi Arabia,Laos,4,0,Friendly,Doha,Qatar,True,4,4,Saudi Arabia
33630,35881,38141,2016,Uzbekistan,Burkina Faso,1,0,Friendly,Tashkent,Uzbekistan,False,1,1,Uzbekistan
33631,35882,38144,2016,Tajikistan,Syria,0,0,Friendly,Khujand,Tajikistan,False,0,0,Draw
33632,35883,38146,2016,Dominican Republic,Puerto Rico,5,0,Friendly,San Cristóbal,Dominican Republic,False,5,5,Dominican Republic
33633,35884,38148,2016,Egypt,Guinea,1,1,Friendly,Alexandria,Egypt,False,2,0,Draw
33634,35885,38149,2016,Kyrgyzstan,Kazakhstan,2,0,Friendly,Bishkek,Kyrgyzstan,False,2,2,Kyrgyzstan
33635,35886,38150,2016,Uganda,Kenya,0,0,Friendly,Kampala,Uganda,False,0,0,Draw
33636,35887,38151,2016,Albania,Morocco,0,0,Friendly,Shkodër,Albania,False,0,0,Draw
33637,35888,38152,2016,Czech Republic,Armenia,3,0,Friendly,Mladá Boleslav,Czech Republic,False,3,3,Czech Republic
33638,35889,38153,2016,Denmark,Liechtenstein,5,0,Friendly,Horsens,Denmark,False,5,5,Denmark
33639,35890,38154,2016,Estonia,Malta,1,1,Friendly,Pärnu,Estonia,False,2,0,Draw
33640,35891,38155,2016,Germany,Finland,2,0,Friendly,Mönchengladbach,Germany,False,2,2,Germany
33641,35892,38156,2016,Republic of Ireland,Oman,4,0,Friendly,Dublin,Republic of Ireland,False,4,4,Republic of Ireland
33642,35893,38157,2016,Lebanon,Jordan,1,1,Friendly,Beirut,Lebanon,False,2,0,Draw
33643,35894,38158,2016,Norway,Belarus,0,1,Friendly,Oslo,Norway,False,1,-1,Belarus
33644,35895,38159,2016,Turkey,Russia,0,0,Friendly,Antalya,Turkey,False,0,0,Draw
33645,35896,38160,2016,Argentina,Uruguay,1,0,FIFA World Cup qualification,Mendoza,Argentina,False,1,1,Argentina
33646,35897,38161,2016,Australia,Iraq,2,0,FIFA World Cup qualification,Perth,Australia,False,2,2,Australia
33647,35898,38162,2016,Bahrain,Singapore,3,1,Friendly,Riffa,Bahrain,False,4,2,Bahrain
33648,35899,38163,2016,Belgium,Spain,0,2,Friendly,Brussels,Belgium,False,2,-2,Spain
33649,35900,38164,2016,Bolivia,Peru,0,3,FIFA World Cup qualification,La Paz,Bolivia,False,3,-3,Peru
33650,35901,38165,2016,Colombia,Venezuela,2,0,FIFA World Cup qualification,Barranquilla,Colombia,False,2,2,Colombia
33651,35902,38166,2016,Ecuador,Brazil,0,3,FIFA World Cup qualification,Quito,Ecuador,False,3,-3,Brazil
33652,35903,38167,2016,Hong Kong,Cambodia,4,2,Friendly,Kowloon,Hong Kong,False,6,2,Hong Kong
33653,35904,38168,2016,Iran,Qatar,2,0,FIFA World Cup qualification,Teheran,Iran,False,2,2,Iran
33654,35905,38169,2016,Italy,France,1,3,Friendly,Bari,Italy,False,4,-2,France
33655,35906,38170,2016,Japan,United Arab Emirates,1,2,FIFA World Cup qualification,Saitama,Japan,False,3,-1,United Arab Emirates
33656,35907,38172,2016,Maldives,Bangladesh,5,0,Friendly,Malé,Maldives,False,5,5,Maldives
33657,35908,38173,2016,Netherlands,Greece,1,2,Friendly,Eindhoven,Netherlands,False,3,-1,Greece
33658,35909,38174,2016,Paraguay,Chile,2,1,FIFA World Cup qualification,Asunción,Paraguay,False,3,1,Paraguay
33659,35910,38175,2016,Portugal,Gibraltar,5,0,Friendly,Porto,Portugal,False,5,5,Portugal
33660,35911,38176,2016,Saudi Arabia,Thailand,1,0,FIFA World Cup qualification,Riyadh,Saudi Arabia,False,1,1,Saudi Arabia
33661,35912,38177,2016,Uzbekistan,Syria,1,0,FIFA World Cup qualification,Tashkent,Uzbekistan,False,1,1,Uzbekistan
33662,35913,38178,2016,El Salvador,Mexico,1,3,FIFA World Cup qualification,San Salvador,El Salvador,False,4,-2,Mexico
33663,35914,38179,2016,Haiti,Costa Rica,0,1,FIFA World Cup qualification,Port-au-Prince,Haiti,False,1,-1,Costa Rica
33664,35915,38180,2016,Honduras,Canada,2,1,FIFA World Cup qualification,San Pedro Sula,Honduras,False,3,1,Honduras
33665,35916,38181,2016,Latvia,Luxembourg,3,1,Friendly,Riga,Latvia,False,4,2,Latvia
33666,35917,38182,2016,Panama,Jamaica,2,0,FIFA World Cup qualification,Panama City,Panama,False,2,2,Panama
33667,35918,38183,2016,South Africa,Mauritania,1,1,African Cup of Nations qualification,Nelspruit,South Africa,False,2,0,Draw
33668,35919,38184,2016,Saint Vincent and the Grenadines,United States,0,6,FIFA World Cup qualification,Kingstown,Saint Vincent and the Grenadines,False,6,-6,United States
33669,35920,38185,2016,Sudan,Gabon,1,2,Friendly,Khartoum,Sudan,False,3,-1,Gabon
33670,35921,38186,2016,Trinidad and Tobago,Guatemala,2,2,FIFA World Cup qualification,Port of Spain,Trinidad and Tobago,False,4,0,Draw
33671,35922,38187,2016,Angola,Madagascar,1,1,African Cup of Nations qualification,Luanda,Angola,False,2,0,Draw
33672,35923,38188,2016,Cameroon,Gambia,2,0,African Cup of Nations qualification,Limbe,Cameroon,False,2,2,Cameroon
33673,35924,38190,2016,Ethiopia,Seychelles,2,1,African Cup of Nations qualification,Hawassa,Ethiopia,False,3,1,Ethiopia
33674,35925,38191,2016,Ghana,Rwanda,1,1,African Cup of Nations qualification,Accra,Ghana,False,2,0,Draw
33675,35926,38192,2016,India,Puerto Rico,4,1,Friendly,Bombay,India,False,5,3,India
33676,35927,38193,2016,Ivory Coast,Sierra Leone,1,1,African Cup of Nations qualification,Bouaké,Ivory Coast,False,2,0,Draw
33677,35928,38194,2016,Mozambique,Mauritius,1,0,African Cup of Nations qualification,Maputo,Mozambique,False,1,1,Mozambique
33678,35929,38195,2016,Nigeria,Tanzania,1,0,African Cup of Nations qualification,Uyo,Nigeria,False,1,1,Nigeria
33679,35930,38196,2016,Senegal,Namibia,2,0,African Cup of Nations qualification,Dakar,Senegal,False,2,2,Senegal
33680,35931,38197,2016,Algeria,Lesotho,6,0,African Cup of Nations qualification,Blida,Algeria,False,6,6,Algeria
33681,35932,38198,2016,Bahrain,Jordan,0,0,Friendly,Isa Town,Bahrain,False,0,0,Draw
33682,35933,38199,2016,Burkina Faso,Botswana,2,1,African Cup of Nations qualification,Ouagadougou,Burkina Faso,False,3,1,Burkina Faso
33683,35934,38200,2016,Congo,Guinea-Bissau,1,0,African Cup of Nations qualification,Brazzaville,Congo,False,1,1,Congo
33684,35935,38201,2016,DR Congo,Central African Republic,4,1,African Cup of Nations qualification,Kinshasa,DR Congo,False,5,3,DR Congo
33685,35936,38202,2016,Czech Republic,Northern Ireland,0,0,FIFA World Cup qualification,Prague,Czech Republic,False,0,0,Draw
33686,35937,38203,2016,Denmark,Armenia,1,0,FIFA World Cup qualification,Copenhagen,Denmark,False,1,1,Denmark
33687,35938,38204,2016,Equatorial Guinea,South Sudan,4,0,African Cup of Nations qualification,Malabo,Equatorial Guinea,False,4,4,Equatorial Guinea
33688,35939,38205,2016,Kazakhstan,Poland,2,2,FIFA World Cup qualification,Astana,Kazakhstan,False,4,0,Draw
33689,35940,38206,2016,Lithuania,Slovenia,2,2,FIFA World Cup qualification,Vilnius,Lithuania,False,4,0,Draw
33690,35941,38207,2016,Malawi,Eswatini,1,0,African Cup of Nations qualification,Blantyre,Malawi,False,1,1,Malawi
33691,35942,38208,2016,Malta,Scotland,1,5,FIFA World Cup qualification,Attard,Malta,False,6,-4,Scotland
33692,35943,38209,2016,Norway,Germany,0,3,FIFA World Cup qualification,Oslo,Norway,False,3,-3,Germany
33693,35944,38210,2016,Romania,Montenegro,1,1,FIFA World Cup qualification,Cluj,Romania,False,2,0,Draw
33694,35945,38211,2016,San Marino,Azerbaijan,0,1,FIFA World Cup qualification,Serravalle,San Marino,False,1,-1,Azerbaijan
33695,35946,38212,2016,Slovakia,England,0,1,FIFA World Cup qualification,Trnava,Slovakia,False,1,-1,England
33696,35947,38213,2016,Tunisia,Liberia,4,1,African Cup of Nations qualification,Monastir,Tunisia,False,5,3,Tunisia
33697,35948,38214,2016,Uganda,Comoros,1,0,African Cup of Nations qualification,Kampala,Uganda,False,1,1,Uganda
33698,35949,38215,2016,Zambia,Kenya,1,1,African Cup of Nations qualification,Ndola,Zambia,False,2,0,Draw
33699,35951,38217,2016,Croatia,Turkey,1,1,FIFA World Cup qualification,Zagreb,Croatia,False,2,0,Draw
33700,35952,38218,2016,Finland,Kosovo,1,1,FIFA World Cup qualification,Turku,Finland,False,2,0,Draw
33701,35953,38219,2016,Georgia,Austria,1,2,FIFA World Cup qualification,Tbilisi,Georgia,False,3,-1,Austria
33702,35954,38220,2016,Israel,Italy,1,3,FIFA World Cup qualification,Haifa,Israel,False,4,-2,Italy
33703,35955,38221,2016,Lebanon,Afghanistan,2,0,Friendly,Beirut,Lebanon,False,2,2,Lebanon
33704,35956,38222,2016,Serbia,Republic of Ireland,2,2,FIFA World Cup qualification,Belgrade,Serbia,False,4,0,Draw
33705,35957,38223,2016,Spain,Liechtenstein,8,0,FIFA World Cup qualification,León,Spain,False,8,8,Spain
33706,35958,38224,2016,Ukraine,Iceland,1,1,FIFA World Cup qualification,Kyïv,Ukraine,False,2,0,Draw
33707,35959,38225,2016,Wales,Moldova,4,0,FIFA World Cup qualification,Cardiff,Wales,False,4,4,Wales
33708,35960,38226,2016,Andorra,Latvia,0,1,FIFA World Cup qualification,Sant Julià de Lòria,Andorra,False,1,-1,Latvia
33709,35961,38227,2016,Bangladesh,Bhutan,0,0,AFC Asian Cup qualification,Dhaka,Bangladesh,False,0,0,Draw
33710,35962,38228,2016,Belarus,France,0,0,FIFA World Cup qualification,Barysaw,Belarus,False,0,0,Draw
33711,35963,38229,2016,Bosnia and Herzegovina,Estonia,5,0,FIFA World Cup qualification,Zenica,Bosnia and Herzegovina,False,5,5,Bosnia and Herzegovina
33712,35964,38230,2016,Brazil,Colombia,2,1,FIFA World Cup qualification,Manaus,Brazil,False,3,1,Brazil
33713,35965,38231,2016,Bulgaria,Luxembourg,4,3,FIFA World Cup qualification,Sofia,Bulgaria,False,7,1,Bulgaria
33714,35966,38232,2016,Cameroon,Gabon,2,1,Friendly,Limbe,Cameroon,False,3,1,Cameroon
33715,35967,38233,2016,Canada,El Salvador,3,1,FIFA World Cup qualification,Vancouver,Canada,False,4,2,Canada
33716,35968,38234,2016,Chile,Bolivia,3,0,FIFA World Cup qualification,Santiago,Chile,False,3,3,Chile
33717,35969,38236,2016,Costa Rica,Panama,3,1,FIFA World Cup qualification,San José,Costa Rica,False,4,2,Costa Rica
33718,35970,38237,2016,Cyprus,Belgium,0,3,FIFA World Cup qualification,Nicosia,Cyprus,False,3,-3,Belgium
33719,35971,38238,2016,Faroe Islands,Hungary,0,0,FIFA World Cup qualification,Tórshavn,Faroe Islands,False,0,0,Draw
33720,35972,38239,2016,Gibraltar,Greece,1,4,FIFA World Cup qualification,Faro,Portugal,True,5,-3,Greece
33721,35973,38240,2016,Indonesia,Malaysia,3,0,Friendly,Surakarta,Indonesia,False,3,3,Indonesia
33722,35974,38241,2016,Iraq,Saudi Arabia,1,2,FIFA World Cup qualification,Shah Alam,Malaysia,True,3,-1,Saudi Arabia
33723,35975,38242,2016,Jamaica,Haiti,0,2,FIFA World Cup qualification,Kingston,Jamaica,False,2,-2,Haiti
33724,35976,38243,2016,Kyrgyzstan,Philippines,1,2,Friendly,Bishkek,Kyrgyzstan,False,3,-1,Philippines
33725,35977,38244,2016,Maldives,Laos,4,0,AFC Asian Cup qualification,Malé,Maldives,False,4,4,Maldives
33726,35978,38245,2016,Mexico,Honduras,0,0,FIFA World Cup qualification,Mexico City,Mexico,False,0,0,Draw
33727,35979,38246,2016,Palestine,Tajikistan,1,1,Friendly,Hebron,Palestine,False,2,0,Draw
33728,35980,38247,2016,Peru,Ecuador,2,1,FIFA World Cup qualification,Lima,Peru,False,3,1,Peru
33729,35981,38248,2016,Qatar,Uzbekistan,0,1,FIFA World Cup qualification,Doha,Qatar,False,1,-1,Uzbekistan
33730,35982,38249,2016,Russia,Ghana,1,0,Friendly,Moscow,Russia,False,1,1,Russia
33731,35983,38250,2016,South Africa,Egypt,1,0,Friendly,Johannesburg,South Africa,False,1,1,South Africa
33732,35984,38251,2016,Sweden,Netherlands,1,1,FIFA World Cup qualification,Solna,Sweden,False,2,0,Draw
33733,35985,38252,2016,Switzerland,Portugal,2,0,FIFA World Cup qualification,Basel,Switzerland,False,2,2,Switzerland
33734,35987,38254,2016,Thailand,Japan,0,2,FIFA World Cup qualification,Bangkok,Thailand,False,2,-2,Japan
33735,35988,38255,2016,United Arab Emirates,Australia,0,1,FIFA World Cup qualification,Abu Dhabi,United Arab Emirates,False,1,-1,Australia
33736,35989,38256,2016,Uruguay,Paraguay,4,0,FIFA World Cup qualification,Montevideo,Uruguay,False,4,4,Uruguay
33737,35990,38257,2016,United States,Trinidad and Tobago,4,0,FIFA World Cup qualification,Jacksonville,United States,False,4,4,United States
33738,35991,38258,2016,Venezuela,Argentina,2,2,FIFA World Cup qualification,Mérida,Venezuela,False,4,0,Draw
33739,35992,38259,2016,Qatar,Serbia,3,0,Friendly,Doha,Qatar,False,3,3,Qatar
33740,35993,38260,2016,Botswana,Angola,1,1,Friendly,Gaborone,Botswana,False,2,0,Draw
33741,35994,38261,2016,DR Congo,Kenya,0,1,Friendly,Kinshasa,DR Congo,False,1,-1,Kenya
33742,35995,38262,2016,Togo,Uganda,1,0,Friendly,Lomé,Togo,False,1,1,Togo
33743,35996,38263,2016,Curaçao,Antigua and Barbuda,3,0,CFU Caribbean Cup qualification,Willemstad,Curaçao,False,3,3,Curaçao
33744,35997,38264,2016,Solomon Islands,New Caledonia,0,3,Friendly,Honiara,Solomon Islands,False,3,-3,New Caledonia
33745,35998,38265,2016,Tajikistan,Palestine,3,3,Friendly,Dushanbe,Tajikistan,False,6,0,Draw
33746,35999,38266,2016,Trinidad and Tobago,Dominican Republic,4,0,CFU Caribbean Cup qualification,Couva,Trinidad and Tobago,False,4,4,Trinidad and Tobago
33747,36000,38267,2016,Austria,Wales,2,2,FIFA World Cup qualification,Vienna,Austria,False,4,0,Draw
33748,36001,38268,2016,Brazil,Bolivia,5,0,FIFA World Cup qualification,Natal,Brazil,False,5,5,Brazil
33749,36002,38269,2016,Cambodia,Hong Kong,0,2,Friendly,Phnom Penh,Cambodia,False,2,-2,Hong Kong
33750,36003,38271,2016,Ecuador,Chile,3,0,FIFA World Cup qualification,Quito,Ecuador,False,3,3,Ecuador
33751,36004,38272,2016,Iceland,Finland,3,2,FIFA World Cup qualification,Reykjavík,Iceland,False,5,1,Iceland
33752,36005,38273,2016,Republic of Ireland,Georgia,1,0,FIFA World Cup qualification,Dublin,Republic of Ireland,False,1,1,Republic of Ireland
33753,36006,38274,2016,Italy,Spain,1,1,FIFA World Cup qualification,Turin,Italy,False,2,0,Draw
33754,36007,38275,2016,Japan,Iraq,2,1,FIFA World Cup qualification,Saitama,Japan,False,3,1,Japan
33755,36008,38277,2016,Kosovo,Croatia,0,6,FIFA World Cup qualification,Shkodër,Albania,True,6,-6,Croatia
33756,36009,38278,2016,Kyrgyzstan,Lebanon,0,0,Friendly,Bishkek,Kyrgyzstan,False,0,0,Draw
33757,36010,38279,2016,Liechtenstein,Albania,0,2,FIFA World Cup qualification,Vaduz,Liechtenstein,False,2,-2,Albania
33758,36011,38281,2016,Mauritania,Canada,0,4,Friendly,Marrakech,Morocco,True,4,-4,Canada
33759,36012,38282,2016,Moldova,Serbia,0,3,FIFA World Cup qualification,Chișinău,Moldova,False,3,-3,Serbia
33760,36013,38283,2016,Paraguay,Colombia,0,1,FIFA World Cup qualification,Asunción,Paraguay,False,1,-1,Colombia
33761,36014,38284,2016,Peru,Argentina,2,2,FIFA World Cup qualification,Lima,Peru,False,4,0,Draw
33762,36015,38285,2016,Saudi Arabia,Australia,2,2,FIFA World Cup qualification,Jeddah,Saudi Arabia,False,4,0,Draw
33763,36016,38286,2016,Turkey,Ukraine,2,2,FIFA World Cup qualification,Konya,Turkey,False,4,0,Draw
33764,36017,38287,2016,United Arab Emirates,Thailand,3,1,FIFA World Cup qualification,Abu Dhabi,United Arab Emirates,False,4,2,United Arab Emirates
33765,36018,38288,2016,Uruguay,Venezuela,3,0,FIFA World Cup qualification,Montevideo,Uruguay,False,3,3,Uruguay
33766,36019,38289,2016,Uzbekistan,Iran,0,1,FIFA World Cup qualification,Tashkent,Uzbekistan,False,1,-1,Iran
33767,36021,38291,2016,Belgium,Bosnia and Herzegovina,4,0,FIFA World Cup qualification,Brussels,Belgium,False,4,4,Belgium
33768,36022,38292,2016,Cuba,United States,0,2,Friendly,Havana,Cuba,False,2,-2,United States
33769,36023,38293,2016,Estonia,Gibraltar,4,0,FIFA World Cup qualification,Tallinn,Estonia,False,4,4,Estonia
33770,36024,38294,2016,France,Bulgaria,4,1,FIFA World Cup qualification,Saint-Denis,France,False,5,3,France
33771,36025,38295,2016,Ghana,Uganda,0,0,FIFA World Cup qualification,Tamale,Ghana,False,0,0,Draw
33772,36026,38296,2016,Greece,Cyprus,2,0,FIFA World Cup qualification,Piraeus,Greece,False,2,2,Greece
33773,36027,38297,2016,Hungary,Switzerland,2,3,FIFA World Cup qualification,Budapest,Hungary,False,5,-1,Switzerland
33774,36028,38298,2016,Latvia,Faroe Islands,0,2,FIFA World Cup qualification,Riga,Latvia,False,2,-2,Faroe Islands
33775,36029,38299,2016,Luxembourg,Sweden,0,1,FIFA World Cup qualification,Luxembourg,Luxembourg,False,1,-1,Sweden
33776,36030,38300,2016,Netherlands,Belarus,4,1,FIFA World Cup qualification,Rotterdam,Netherlands,False,5,3,Netherlands
33777,36031,38301,2016,Oman,Jordan,1,1,Friendly,Muscat,Oman,False,2,0,Draw
33778,36032,38302,2016,Philippines,Bahrain,1,3,Friendly,Manila,Philippines,False,4,-2,Bahrain
33779,36033,38303,2016,Portugal,Andorra,6,0,FIFA World Cup qualification,Aveiro,Portugal,False,6,6,Portugal
33780,36034,38304,2016,Singapore,Malaysia,0,0,Friendly,Kallang,Singapore,False,0,0,Draw
33781,36035,38305,2016,Armenia,Romania,0,5,FIFA World Cup qualification,Yerevan,Armenia,False,5,-5,Romania
33782,36036,38306,2016,Azerbaijan,Norway,1,0,FIFA World Cup qualification,Baku,Azerbaijan,False,1,1,Azerbaijan
33783,36037,38307,2016,Belize,Honduras,1,2,Friendly,Belmopan,Belize,False,3,-1,Honduras
33784,36038,38308,2016,Burkina Faso,South Africa,1,1,FIFA World Cup qualification,Ouagadougou,Burkina Faso,False,2,0,Draw
33785,36039,38309,2016,DR Congo,Libya,4,0,FIFA World Cup qualification,Kinshasa,DR Congo,False,4,4,DR Congo
33786,36040,38310,2016,Dominican Republic,Martinique,1,2,CFU Caribbean Cup qualification,San Cristóbal,Dominican Republic,False,3,-1,Martinique
33787,36041,38311,2016,England,Malta,2,0,FIFA World Cup qualification,London,England,False,2,2,England
33788,36042,38312,2016,French Guiana,Saint Kitts and Nevis,1,0,CFU Caribbean Cup qualification,Cayenne,French Guiana,False,1,1,French Guiana
33789,36043,38313,2016,Gabon,Morocco,0,0,FIFA World Cup qualification,Franceville,Gabon,False,0,0,Draw
33790,36044,38314,2016,Germany,Czech Republic,3,0,FIFA World Cup qualification,Hamburg,Germany,False,3,3,Germany
33791,36045,38315,2016,Ivory Coast,Mali,3,1,FIFA World Cup qualification,Bouaké,Ivory Coast,False,4,2,Ivory Coast
33792,36046,38316,2016,Mexico,New Zealand,2,1,Friendly,Nashville,United States,True,3,1,Mexico
33793,36047,38317,2016,Montenegro,Kazakhstan,5,0,FIFA World Cup qualification,Podgorica,Montenegro,False,5,5,Montenegro
33794,36048,38318,2016,Northern Ireland,San Marino,4,0,FIFA World Cup qualification,Belfast,Northern Ireland,False,4,4,Northern Ireland
33795,36049,38319,2016,Poland,Denmark,3,2,FIFA World Cup qualification,Warsaw,Poland,False,5,1,Poland
33796,36050,38320,2016,Scotland,Lithuania,1,1,FIFA World Cup qualification,Glasgow,Scotland,False,2,0,Draw
33797,36052,38322,2016,Slovenia,Slovakia,1,0,FIFA World Cup qualification,Ljubljana,Slovenia,False,1,1,Slovenia
33798,36053,38323,2016,Solomon Islands,New Caledonia,0,1,Friendly,Honiara,Solomon Islands,False,1,-1,New Caledonia
33799,36054,38324,2016,Suriname,Guyana,3,2,CFU Caribbean Cup qualification,Paramaribo,Suriname,False,5,1,Suriname
33800,36055,38326,2016,Albania,Spain,0,2,FIFA World Cup qualification,Shkodër,Albania,False,2,-2,Spain
33801,36056,38327,2016,Algeria,Cameroon,1,1,FIFA World Cup qualification,Blida,Algeria,False,2,0,Draw
33802,36057,38328,2016,Cambodia,Sri Lanka,4,0,Friendly,Phnom Penh,Cambodia,False,4,4,Cambodia
33803,36058,38329,2016,Congo,Egypt,1,2,FIFA World Cup qualification,Brazzaville,Congo,False,3,-1,Egypt
33804,36059,38330,2016,Finland,Croatia,0,1,FIFA World Cup qualification,Tampere,Finland,False,1,-1,Croatia
33805,36060,38331,2016,Iceland,Turkey,2,0,FIFA World Cup qualification,Reykjavík,Iceland,False,2,2,Iceland
33806,36061,38332,2016,Indonesia,Vietnam,2,2,Friendly,Sleman,Indonesia,False,4,0,Draw
33807,36062,38333,2016,Israel,Liechtenstein,2,1,FIFA World Cup qualification,Jerusalem,Israel,False,3,1,Israel
33808,36063,38335,2016,Moldova,Republic of Ireland,1,3,FIFA World Cup qualification,Chișinău,Moldova,False,4,-2,Republic of Ireland
33809,36064,38336,2016,Russia,Costa Rica,3,4,Friendly,Krasnodar,Russia,False,7,-1,Costa Rica
33810,36065,38337,2016,Serbia,Austria,3,2,FIFA World Cup qualification,Belgrade,Serbia,False,5,1,Serbia
33811,36066,38338,2016,Togo,Mozambique,2,0,Friendly,Lomé,Togo,False,2,2,Togo
33812,36067,38339,2016,Tunisia,Guinea,2,0,FIFA World Cup qualification,Monastir,Tunisia,False,2,2,Tunisia
33813,36068,38340,2016,Ukraine,Kosovo,3,0,FIFA World Cup qualification,Cracow,Poland,True,3,3,Ukraine
33814,36069,38341,2016,Wales,Georgia,1,1,FIFA World Cup qualification,Cardiff,Wales,False,2,0,Draw
33815,36070,38342,2016,Zambia,Nigeria,1,2,FIFA World Cup qualification,Ndola,Zambia,False,3,-1,Nigeria
33816,36071,38343,2016,Andorra,Switzerland,1,2,FIFA World Cup qualification,Sant Julià de Lòria,Andorra,False,3,-1,Switzerland
33817,36072,38344,2016,Belarus,Luxembourg,1,1,FIFA World Cup qualification,Barysaw,Belarus,False,2,0,Draw
33818,36073,38345,2016,Bhutan,Bangladesh,3,1,AFC Asian Cup qualification,Thimphu,Bhutan,False,4,2,Bhutan
33819,36074,38346,2016,Bosnia and Herzegovina,Cyprus,2,0,FIFA World Cup qualification,Zenica,Bosnia and Herzegovina,False,2,2,Bosnia and Herzegovina
33820,36075,38347,2016,Estonia,Greece,0,2,FIFA World Cup qualification,Tallinn,Estonia,False,2,-2,Greece
33821,36076,38348,2016,Faroe Islands,Portugal,0,6,FIFA World Cup qualification,Tórshavn,Faroe Islands,False,6,-6,Portugal
33822,36077,38349,2016,Gibraltar,Belgium,0,6,FIFA World Cup qualification,Faro,Portugal,True,6,-6,Belgium
33823,36078,38350,2016,Latvia,Hungary,0,2,FIFA World Cup qualification,Riga,Latvia,False,2,-2,Hungary
33824,36079,38351,2016,Netherlands,France,0,1,FIFA World Cup qualification,Amsterdam,Netherlands,False,1,-1,France
33825,36081,38353,2016,Sweden,Bulgaria,3,0,FIFA World Cup qualification,Solna,Sweden,False,3,3,Sweden
33826,36082,38354,2016,Argentina,Paraguay,0,1,FIFA World Cup qualification,Córdoba,Argentina,False,1,-1,Paraguay
33827,36083,38355,2016,Australia,Japan,1,1,FIFA World Cup qualification,Melbourne,Australia,False,2,0,Draw
33828,36084,38356,2016,Bolivia,Ecuador,2,2,FIFA World Cup qualification,La Paz,Bolivia,False,4,0,Draw
33829,36085,38357,2016,Chile,Peru,2,1,FIFA World Cup qualification,Santiago,Chile,False,3,1,Chile
33830,36086,38358,2016,Colombia,Uruguay,2,2,FIFA World Cup qualification,Barranquilla,Colombia,False,4,0,Draw
33831,36087,38359,2016,Czech Republic,Azerbaijan,0,0,FIFA World Cup qualification,Ostrava,Czech Republic,False,0,0,Draw
33832,36088,38360,2016,Denmark,Montenegro,0,1,FIFA World Cup qualification,Copenhagen,Denmark,False,1,-1,Montenegro
33833,36089,38361,2016,Germany,Northern Ireland,2,0,FIFA World Cup qualification,Hanover,Germany,False,2,2,Germany
33834,36090,38362,2016,Hong Kong,Singapore,2,0,Friendly,Kowloon,Hong Kong,False,2,2,Hong Kong
33835,36092,38364,2016,Iraq,Thailand,4,0,FIFA World Cup qualification,Teheran,Iran,True,4,4,Iraq
33836,36093,38365,2016,Kazakhstan,Romania,0,0,FIFA World Cup qualification,Astana,Kazakhstan,False,0,0,Draw
33837,36094,38366,2016,Kyrgyzstan,Turkmenistan,1,0,Friendly,Bishkek,Kyrgyzstan,False,1,1,Kyrgyzstan
33838,36095,38367,2016,Laos,Maldives,1,1,AFC Asian Cup qualification,Vientiane,Laos,False,2,0,Draw
33839,36096,38368,2016,Lebanon,Equatorial Guinea,1,1,Friendly,Beirut,Lebanon,False,2,0,Draw
33840,36097,38369,2016,Lithuania,Malta,2,0,FIFA World Cup qualification,Vilnius,Lithuania,False,2,2,Lithuania
33841,36098,38370,2016,Malaysia,Afghanistan,1,1,Friendly,Shah Alam,Malaysia,False,2,0,Draw
33842,36099,38371,2016,Mexico,Panama,1,0,Friendly,Bridgeview,United States,True,1,1,Mexico
33843,36100,38372,2016,Morocco,Canada,4,0,Friendly,Marrakech,Morocco,False,4,4,Morocco
33844,36101,38373,2016,Norway,San Marino,4,1,FIFA World Cup qualification,Oslo,Norway,False,5,3,Norway
33845,36102,38374,2016,Oman,Bahrain,2,2,Friendly,Muscat,Oman,False,4,0,Draw
33846,36103,38375,2016,Poland,Armenia,2,1,FIFA World Cup qualification,Warsaw,Poland,False,3,1,Poland
33847,36104,38376,2016,Puerto Rico,Curaçao,2,4,CFU Caribbean Cup qualification,Bayamón,Puerto Rico,False,6,-2,Curaçao
33848,36105,38377,2016,Qatar,Syria,1,0,FIFA World Cup qualification,Doha,Qatar,False,1,1,Qatar
33849,36106,38378,2016,Saudi Arabia,United Arab Emirates,3,0,FIFA World Cup qualification,Jeddah,Saudi Arabia,False,3,3,Saudi Arabia
33850,36107,38379,2016,Slovakia,Scotland,3,0,FIFA World Cup qualification,Trnava,Slovakia,False,3,3,Slovakia
33851,36108,38380,2016,Slovenia,England,0,0,FIFA World Cup qualification,Ljubljana,Slovenia,False,0,0,Draw
33852,36109,38381,2016,South Africa,Ghana,1,1,Friendly,Durban,South Africa,False,2,0,Draw
33853,36111,38383,2016,Venezuela,Brazil,0,2,FIFA World Cup qualification,Mérida,Venezuela,False,2,-2,Brazil
33854,36112,38384,2016,Brunei,East Timor,2,1,AFF Championship,Phnom Penh,Cambodia,True,3,1,Brunei
33855,36113,38385,2016,Cambodia,Laos,2,1,AFF Championship,Phnom Penh,Cambodia,False,3,1,Cambodia
33856,36114,38386,2016,Cambodia,Brunei,3,0,AFF Championship,Phnom Penh,Cambodia,False,3,3,Cambodia
33857,36115,38387,2016,East Timor,Laos,1,2,AFF Championship,Phnom Penh,Cambodia,True,3,-1,Laos
33858,36116,38388,2016,Cambodia,East Timor,3,2,AFF Championship,Phnom Penh,Cambodia,False,5,1,Cambodia
33859,36117,38389,2016,Laos,Brunei,4,3,AFF Championship,Phnom Penh,Cambodia,True,7,1,Laos
33860,36118,38390,2016,Brunei,East Timor,4,0,AFC Challenge Cup,Kuching,Malaysia,True,4,4,Brunei
33861,36119,38391,2016,Macau,Mongolia,2,1,AFC Challenge Cup,Kuching,Malaysia,True,3,1,Macau
33862,36120,38392,2016,Sri Lanka,Laos,1,2,AFC Challenge Cup,Kuching,Malaysia,True,3,-1,Laos
33863,36121,38393,2016,Burma,Indonesia,0,0,Friendly,Rangoon,Burma,False,0,0,Draw
33864,36122,38394,2016,East Timor,Nepal,0,0,AFC Challenge Cup,Kuching,Malaysia,True,0,0,Draw
33865,36123,38395,2016,Zimbabwe,Zambia,1,0,Friendly,Harare,Zimbabwe,False,1,1,Zimbabwe
33866,36124,38396,2016,Hong Kong,Guam,3,2,EAFF Championship,Kowloon,Hong Kong,False,5,1,Hong Kong
33867,36125,38397,2016,Jordan,Iraq,0,0,Friendly,Amman,Jordan,False,0,0,Draw
33868,36126,38399,2016,Laos,Macau,1,4,AFC Challenge Cup,Kuching,Malaysia,True,5,-3,Macau
33869,36127,38400,2016,Mongolia,Sri Lanka,2,0,AFC Challenge Cup,Kuching,Malaysia,True,2,2,Mongolia
33870,36128,38402,2016,Nepal,Brunei,3,0,AFC Challenge Cup,Kuching,Malaysia,True,3,3,Nepal
33871,36129,38403,2016,Uganda,Zambia,0,1,Friendly,Kampala,Uganda,False,1,-1,Zambia
33872,36130,38404,2016,Vietnam,Indonesia,3,2,Friendly,Hanoi,Vietnam,False,5,1,Vietnam
33873,36131,38405,2016,Greece,Belarus,0,1,Friendly,Piraeus,Greece,False,1,-1,Belarus
33874,36133,38407,2016,Haiti,French Guiana,2,5,CFU Caribbean Cup qualification,Port-au-Prince,Haiti,False,7,-3,French Guiana
33875,36135,38409,2016,Mongolia,Laos,0,3,AFC Challenge Cup,Kuching,Malaysia,True,3,-3,Laos
33876,36136,38410,2016,Netherlands,Belgium,1,1,Friendly,Amsterdam,Netherlands,False,2,0,Draw
33877,36137,38411,2016,Philippines,Kyrgyzstan,1,0,Friendly,Manila,Philippines,False,1,1,Philippines
33878,36138,38412,2016,Sri Lanka,Macau,1,1,AFC Challenge Cup,Kuching,Malaysia,True,2,0,Draw
33879,36139,38413,2016,Syria,Singapore,2,0,Friendly,Paroi,Malaysia,True,2,2,Syria
33880,36140,38414,2016,Tajikistan,Turkmenistan,3,0,Friendly,Dushanbe,Tajikistan,False,3,3,Tajikistan
33881,36141,38415,2016,United Arab Emirates,Bahrain,2,0,Friendly,al-Ain,United Arab Emirates,False,2,2,United Arab Emirates
33882,36142,38416,2016,Brazil,Argentina,3,0,FIFA World Cup qualification,Belo Horizonte,Brazil,False,3,3,Brazil
33883,36143,38417,2016,Colombia,Chile,0,0,FIFA World Cup qualification,Barranquilla,Colombia,False,0,0,Draw
33884,36144,38418,2016,Iran,Papua New Guinea,8,1,Friendly,Shah Alam,Malaysia,True,9,7,Iran
33885,36145,38419,2016,Lebanon,Palestine,1,1,Friendly,Beirut,Lebanon,False,2,0,Draw
33886,36146,38420,2016,Paraguay,Peru,1,4,FIFA World Cup qualification,Asunción,Paraguay,False,5,-3,Peru
33887,36147,38421,2016,Qatar,Russia,2,1,Friendly,Doha,Qatar,False,3,1,Qatar
33888,36148,38422,2016,Uruguay,Ecuador,2,1,FIFA World Cup qualification,Montevideo,Uruguay,False,3,1,Uruguay
33889,36149,38423,2016,Uzbekistan,Jordan,1,0,Friendly,Tashkent,Uzbekistan,False,1,1,Uzbekistan
33890,36150,38424,2016,Venezuela,Bolivia,5,0,FIFA World Cup qualification,Maturín,Venezuela,False,5,5,Venezuela
33891,36151,38425,2016,Armenia,Montenegro,3,2,FIFA World Cup qualification,Yerevan,Armenia,False,5,1,Armenia
33892,36152,38426,2016,Czech Republic,Norway,2,1,FIFA World Cup qualification,Prague,Czech Republic,False,3,1,Czech Republic
33893,36153,38427,2016,Denmark,Kazakhstan,4,1,FIFA World Cup qualification,Copenhagen,Denmark,False,5,3,Denmark
33894,36154,38428,2016,England,Scotland,3,0,FIFA World Cup qualification,London,England,False,3,3,England
33895,36155,38429,2016,France,Sweden,2,1,FIFA World Cup qualification,Saint-Denis,France,False,3,1,France
33896,36156,38430,2016,Honduras,Panama,0,1,FIFA World Cup qualification,San Pedro Sula,Honduras,False,1,-1,Panama
33897,36157,38431,2016,Japan,Oman,4,0,Friendly,Kashima,Japan,False,4,4,Japan
33898,36158,38433,2016,Libya,Tunisia,0,1,FIFA World Cup qualification,Algiers,Algeria,True,1,-1,Tunisia
33899,36159,38434,2016,Malta,Slovenia,0,1,FIFA World Cup qualification,Attard,Malta,False,1,-1,Slovenia
33900,36160,38435,2016,Northern Ireland,Azerbaijan,4,0,FIFA World Cup qualification,Belfast,Northern Ireland,False,4,4,Northern Ireland
33901,36161,38436,2016,Romania,Poland,0,3,FIFA World Cup qualification,Bucharest,Romania,False,3,-3,Poland
33902,36162,38437,2016,San Marino,Germany,0,8,FIFA World Cup qualification,Serravalle,San Marino,False,8,-8,Germany
33903,36163,38438,2016,Slovakia,Lithuania,4,0,FIFA World Cup qualification,Trnava,Slovakia,False,4,4,Slovakia
33904,36164,38439,2016,Togo,Comoros,2,2,Friendly,Tunis,Tunisia,True,4,0,Draw
33905,36165,38440,2016,Albania,Israel,0,3,FIFA World Cup qualification,Elbasan,Albania,False,3,-3,Israel
33906,36166,38441,2016,Austria,Republic of Ireland,0,1,FIFA World Cup qualification,Vienna,Austria,False,1,-1,Republic of Ireland
33907,36167,38442,2016,Cameroon,Zambia,1,1,FIFA World Cup qualification,Limbe,Cameroon,False,2,0,Draw
33908,36168,38444,2016,Croatia,Iceland,2,0,FIFA World Cup qualification,Zagreb,Croatia,False,2,2,Croatia
33909,36169,38445,2016,Georgia,Moldova,1,1,FIFA World Cup qualification,Tbilisi,Georgia,False,2,0,Draw
33910,36171,38447,2016,Kenya,Mozambique,1,0,Friendly,Nairobi,Kenya,False,1,1,Kenya
33911,36172,38448,2016,Liechtenstein,Italy,0,4,FIFA World Cup qualification,Vaduz,Liechtenstein,False,4,-4,Italy
33912,36173,38449,2016,Macau,Brunei,1,1,AFC Challenge Cup,Kuching,Malaysia,True,2,0,Draw
33913,36174,38450,2016,Mali,Gabon,0,0,FIFA World Cup qualification,Bamako,Mali,False,0,0,Draw
33914,36175,38451,2016,Morocco,Ivory Coast,0,0,FIFA World Cup qualification,Marrakech,Morocco,False,0,0,Draw
33915,36176,38452,2016,Nepal,Laos,2,2,AFC Challenge Cup,Kuching,Malaysia,True,4,0,Draw
33916,36177,38453,2016,New Zealand,New Caledonia,2,0,FIFA World Cup qualification,Auckland,New Zealand,False,2,2,New Zealand
33917,36178,38454,2016,Nigeria,Algeria,3,1,FIFA World Cup qualification,Uyo,Nigeria,False,4,2,Nigeria
33918,36180,38456,2016,Turkey,Kosovo,2,0,FIFA World Cup qualification,Antalya,Turkey,False,2,2,Turkey
33919,36181,38457,2016,Uganda,Congo,1,0,FIFA World Cup qualification,Kampala,Uganda,False,1,1,Uganda
33920,36182,38458,2016,Ukraine,Finland,1,0,FIFA World Cup qualification,Odesa,Ukraine,False,1,1,Ukraine
33921,36183,38459,2016,Wales,Serbia,1,1,FIFA World Cup qualification,Cardiff,Wales,False,2,0,Draw
33922,36184,38460,2016,Belgium,Estonia,8,1,FIFA World Cup qualification,Brussels,Belgium,False,9,7,Belgium
33923,36185,38461,2016,Bulgaria,Belarus,1,0,FIFA World Cup qualification,Sofia,Bulgaria,False,1,1,Bulgaria
33924,36186,38462,2016,Cyprus,Gibraltar,3,1,FIFA World Cup qualification,Nicosia,Cyprus,False,4,2,Cyprus
33925,36187,38463,2016,Egypt,Ghana,2,0,FIFA World Cup qualification,Alexandria,Egypt,False,2,2,Egypt
33926,36188,38464,2016,Greece,Bosnia and Herzegovina,1,1,FIFA World Cup qualification,Piraeus,Greece,False,2,0,Draw
33927,36189,38465,2016,Guinea,DR Congo,1,2,FIFA World Cup qualification,Conakry,Guinea,False,3,-1,DR Congo
33928,36190,38466,2016,Hungary,Andorra,4,0,FIFA World Cup qualification,Budapest,Hungary,False,4,4,Hungary
33929,36191,38467,2016,Jamaica,Suriname,1,0,CFU Caribbean Cup qualification,Kingston,Jamaica,False,1,1,Jamaica
33930,36192,38468,2016,Luxembourg,Netherlands,1,3,FIFA World Cup qualification,Luxembourg,Luxembourg,False,4,-2,Netherlands
33931,36193,38469,2016,Portugal,Latvia,4,1,FIFA World Cup qualification,Faro,Portugal,False,5,3,Portugal
33932,36194,38470,2016,Singapore,Cambodia,1,0,Friendly,Bishan,Singapore,False,1,1,Singapore
33933,36196,38472,2016,Saint Kitts and Nevis,Haiti,0,2,CFU Caribbean Cup qualification,Basseterre,Saint Kitts and Nevis,False,2,-2,Haiti
33934,36197,38473,2016,Switzerland,Faroe Islands,2,0,FIFA World Cup qualification,Lucerne,Switzerland,False,2,2,Switzerland
33935,36198,38474,2016,Tajikistan,Afghanistan,1,0,Friendly,Dushanbe,Tajikistan,False,1,1,Tajikistan
33936,36199,38475,2016,Zimbabwe,Tanzania,3,0,Friendly,Harare,Zimbabwe,False,3,3,Zimbabwe
33937,36200,38476,2016,Burma,Oman,0,3,Friendly,Rangoon,Burma,False,3,-3,Oman
33938,36201,38477,2016,Laos,Brunei,3,2,AFC Challenge Cup,Kuching,Malaysia,True,5,1,Laos
33939,36202,38478,2016,Malaysia,Papua New Guinea,2,1,Friendly,Shah Alam,Malaysia,False,3,1,Malaysia
33940,36203,38479,2016,Poland,Slovenia,1,1,Friendly,Wrocław,Poland,False,2,0,Draw
33941,36204,38480,2016,Argentina,Colombia,3,0,FIFA World Cup qualification,San Juan,Argentina,False,3,3,Argentina
33942,36205,38481,2016,Austria,Slovakia,0,0,Friendly,Vienna,Austria,False,0,0,Draw
33943,36206,38482,2016,Bahrain,Kyrgyzstan,0,0,Friendly,Riffa,Bahrain,False,0,0,Draw
33944,36207,38483,2016,Bolivia,Paraguay,1,0,FIFA World Cup qualification,La Paz,Bolivia,False,1,1,Bolivia
33945,36208,38484,2016,Chile,Uruguay,3,1,FIFA World Cup qualification,Santiago,Chile,False,4,2,Chile
33946,36209,38486,2016,Costa Rica,United States,4,0,FIFA World Cup qualification,San José,Costa Rica,False,4,4,Costa Rica
33947,36210,38487,2016,Czech Republic,Denmark,1,1,Friendly,Mladá Boleslav,Czech Republic,False,2,0,Draw
33948,36211,38488,2016,Ecuador,Venezuela,3,0,FIFA World Cup qualification,Quito,Ecuador,False,3,3,Ecuador
33949,36212,38489,2016,England,Spain,2,2,Friendly,London,England,False,4,0,Draw
33950,36213,38490,2016,France,Ivory Coast,0,0,Friendly,Lens,France,False,0,0,Draw
33951,36214,38491,2016,Gabon,Comoros,1,1,Friendly,Tunis,Tunisia,True,2,0,Draw
33952,36215,38492,2016,Honduras,Trinidad and Tobago,3,1,FIFA World Cup qualification,San Pedro Sula,Honduras,False,4,2,Honduras
33953,36216,38493,2016,Italy,Germany,0,0,Friendly,Milan,Italy,False,0,0,Draw
33954,36217,38494,2016,Japan,Saudi Arabia,2,1,FIFA World Cup qualification,Saitama,Japan,False,3,1,Japan
33955,36218,38495,2016,Jordan,Lebanon,0,0,Friendly,Amman,Jordan,False,0,0,Draw
33956,36219,38496,2016,Kenya,Liberia,1,0,Friendly,Nairobi,Kenya,False,1,1,Kenya
33957,36220,38498,2016,Malta,Iceland,0,2,Friendly,Attard,Malta,False,2,-2,Iceland
33958,36221,38499,2016,Morocco,Togo,2,1,Friendly,Marrakech,Morocco,False,3,1,Morocco
33959,36222,38500,2016,Mozambique,South Africa,1,1,Friendly,Maputo,Mozambique,False,2,0,Draw
33960,36223,38501,2016,Nepal,Macau,1,0,AFC Challenge Cup,Kuching,Malaysia,True,1,1,Nepal
33961,36224,38502,2016,New Caledonia,New Zealand,0,0,FIFA World Cup qualification,Koné,New Caledonia,False,0,0,Draw
33962,36225,38503,2016,Northern Ireland,Croatia,0,3,Friendly,Belfast,Northern Ireland,False,3,-3,Croatia
33963,36226,38504,2016,Panama,Mexico,0,0,FIFA World Cup qualification,Panama City,Panama,False,0,0,Draw
33964,36227,38505,2016,Peru,Brazil,0,2,FIFA World Cup qualification,Lima,Peru,False,2,-2,Brazil
33965,36228,38506,2016,Russia,Romania,1,0,Friendly,Groznyy,Russia,False,1,1,Russia
33966,36229,38507,2016,Syria,Iran,0,0,FIFA World Cup qualification,Paroi,Malaysia,True,0,0,Draw
33967,36230,38508,2016,Thailand,Australia,2,2,FIFA World Cup qualification,Bangkok,Thailand,False,4,0,Draw
33968,36231,38509,2016,Tunisia,Mauritania,0,0,Friendly,Gabès,Tunisia,False,0,0,Draw
33969,36232,38510,2016,Ukraine,Serbia,2,0,Friendly,Kharkiv,Ukraine,False,2,2,Ukraine
33970,36233,38511,2016,United Arab Emirates,Iraq,2,0,FIFA World Cup qualification,Abu Dhabi,United Arab Emirates,False,2,2,United Arab Emirates
33971,36234,38512,2016,Philippines,Singapore,0,0,AFF Championship,Bocaue,Philippines,False,0,0,Draw
33972,36235,38513,2016,Saint Kitts and Nevis,Estonia,1,1,Friendly,Basseterre,Saint Kitts and Nevis,False,2,0,Draw
33973,36236,38514,2016,Thailand,Indonesia,4,2,AFF Championship,Bocaue,Philippines,True,6,2,Thailand
33974,36237,38515,2016,Burma,Vietnam,1,2,AFF Championship,Rangoon,Burma,False,3,-1,Vietnam
33975,36238,38516,2016,Malaysia,Cambodia,3,2,AFF Championship,Rangoon,Burma,True,5,1,Malaysia
33976,36239,38517,2016,Antigua and Barbuda,Estonia,0,1,Friendly,St. John's,Antigua and Barbuda,False,1,-1,Estonia
33977,36240,38518,2016,Philippines,Indonesia,2,2,AFF Championship,Bocaue,Philippines,False,4,0,Draw
33978,36241,38519,2016,Thailand,Singapore,1,0,AFF Championship,Bocaue,Philippines,True,1,1,Thailand
33979,36242,38520,2016,Burma,Cambodia,3,1,AFF Championship,Rangoon,Burma,False,4,2,Burma
33980,36243,38521,2016,Malaysia,Vietnam,0,1,AFF Championship,Rangoon,Burma,True,1,-1,Vietnam
33981,36244,38522,2016,Philippines,Thailand,0,1,AFF Championship,Bocaue,Philippines,False,1,-1,Thailand
33982,36245,38523,2016,Singapore,Indonesia,1,2,AFF Championship,Manila,Philippines,True,3,-1,Indonesia
33983,36246,38524,2016,Burma,Malaysia,1,0,AFF Championship,Rangoon,Burma,False,1,1,Burma
33984,36247,38525,2016,Vietnam,Cambodia,2,1,AFF Championship,Naypyidaw,Burma,True,3,1,Vietnam
33985,36248,38526,2016,Indonesia,Vietnam,2,1,AFF Championship,Bogor,Indonesia,False,3,1,Indonesia
33986,36249,38527,2016,Burma,Thailand,0,2,AFF Championship,Rangoon,Burma,False,2,-2,Thailand
33987,36250,38528,2016,Vietnam,Indonesia,2,2,AFF Championship,Hanoi,Vietnam,False,4,0,Draw
33988,36251,38529,2016,Thailand,Burma,4,0,AFF Championship,Bangkok,Thailand,False,4,4,Thailand
33989,36252,38530,2016,Indonesia,Thailand,2,1,AFF Championship,Bogor,Indonesia,False,3,1,Indonesia
33990,36253,38531,2016,Thailand,Indonesia,2,0,AFF Championship,Bangkok,Thailand,False,2,2,Thailand
33991,36254,38532,2016,Ivory Coast,Zimbabwe,0,0,Friendly,Abidjan,Ivory Coast,False,0,0,Draw
33992,36255,38533,2016,Nicaragua,Trinidad and Tobago,2,1,Friendly,Managua,Nicaragua,False,3,1,Nicaragua
33993,36256,38535,2016,Nicaragua,Trinidad and Tobago,1,3,Friendly,Managua,Nicaragua,False,4,-2,Trinidad and Tobago
33994,36257,38537,2017,Trinidad and Tobago,Suriname,1,2,CFU Caribbean Cup qualification,Couva,Trinidad and Tobago,False,3,-1,Suriname
33995,36258,38538,2017,Tunisia,Uganda,2,0,Friendly,Tunis,Tunisia,False,2,2,Tunisia
33996,36259,38539,2017,Cameroon,DR Congo,2,0,Friendly,Yaoundé,Cameroon,False,2,2,Cameroon
33997,36260,38540,2017,Suriname,Haiti,2,4,CFU Caribbean Cup qualification,Couva,Trinidad and Tobago,True,6,-2,Haiti
33998,36261,38541,2017,Algeria,Mauritania,3,1,Friendly,Blida,Algeria,False,4,2,Algeria
33999,36262,38542,2017,Burkina Faso,Mali,2,1,Friendly,Marrakech,Morocco,True,3,1,Burkina Faso
34000,36263,38543,2017,Egypt,Tunisia,1,0,Friendly,Cairo,Egypt,False,1,1,Egypt
34001,36264,38544,2017,Ivory Coast,Sweden,2,1,Friendly,Abu Dhabi,United Arab Emirates,True,3,1,Ivory Coast
34002,36265,38545,2017,Libya,Senegal,1,2,Friendly,Brazzaville,Congo,True,3,-1,Senegal
34003,36266,38546,2017,Trinidad and Tobago,Haiti,3,4,CFU Caribbean Cup qualification,Couva,Trinidad and Tobago,False,7,-1,Haiti
34004,36267,38547,2017,Morocco,Finland,0,1,Friendly,al-Ain,United Arab Emirates,True,1,-1,Finland
34005,36268,38548,2017,Algeria,Mauritania,6,0,Friendly,Sidi Moussa,Algeria,False,6,6,Algeria
34006,36269,38549,2017,Cameroon,Zimbabwe,1,1,Friendly,Yaoundé,Cameroon,False,2,0,Draw
34007,36270,38551,2017,Chile,Croatia,1,1,Friendly,Nanning,China PR,True,2,0,Draw
34008,36271,38552,2017,Congo,Senegal,0,2,Friendly,Brazzaville,Congo,False,2,-2,Senegal
34009,36272,38553,2017,Ivory Coast,Uganda,3,0,Friendly,Abu Dhabi,United Arab Emirates,True,3,3,Ivory Coast
34010,36273,38554,2017,Honduras,Nicaragua,2,1,UNCAF Cup,Panama City,Panama,True,3,1,Honduras
34011,36274,38555,2017,Burkina Faso,Cameroon,1,1,African Cup of Nations,Libreville,Gabon,True,2,0,Draw
34012,36275,38556,2017,Cambodia,Saudi Arabia,2,7,Friendly,Abu Dhabi,United Arab Emirates,True,9,-5,Saudi Arabia
34013,36276,38558,2017,Gabon,Guinea-Bissau,1,1,African Cup of Nations,Libreville,Gabon,False,2,0,Draw
34014,36277,38559,2017,Algeria,Zimbabwe,2,2,African Cup of Nations,Franceville,Gabon,True,4,0,Draw
34015,36278,38560,2017,Belize,Costa Rica,0,3,UNCAF Cup,Panama City,Panama,True,3,-3,Costa Rica
34016,36279,38561,2017,El Salvador,Honduras,1,2,UNCAF Cup,Panama City,Panama,True,3,-1,Honduras
34017,36280,38562,2017,Iceland,Chile,0,1,Friendly,Nanning,China PR,True,1,-1,Chile
34018,36281,38563,2017,Tunisia,Senegal,0,2,African Cup of Nations,Franceville,Gabon,True,2,-2,Senegal
34019,36282,38564,2017,DR Congo,Morocco,1,0,African Cup of Nations,Oyem,Gabon,True,1,1,DR Congo
34020,36283,38565,2017,Ivory Coast,Togo,0,0,African Cup of Nations,Oyem,Gabon,True,0,0,Draw
34021,36284,38566,2017,El Salvador,Belize,3,1,UNCAF Cup,Panama City,Panama,True,4,2,El Salvador
34022,36285,38567,2017,Ghana,Uganda,1,0,African Cup of Nations,Port-Gentil,Gabon,True,1,1,Ghana
34023,36286,38568,2017,Mali,Egypt,0,0,African Cup of Nations,Port-Gentil,Gabon,True,0,0,Draw
34024,36287,38569,2017,Qatar,Moldova,1,1,Friendly,Doha,Qatar,False,2,0,Draw
34025,36288,38570,2017,Cameroon,Guinea-Bissau,2,1,African Cup of Nations,Libreville,Gabon,True,3,1,Cameroon
34026,36289,38571,2017,Gabon,Burkina Faso,1,1,African Cup of Nations,Libreville,Gabon,False,2,0,Draw
34027,36290,38572,2017,Algeria,Tunisia,1,2,African Cup of Nations,Franceville,Gabon,True,3,-1,Tunisia
34028,36291,38573,2017,Senegal,Zimbabwe,2,0,African Cup of Nations,Franceville,Gabon,True,2,2,Senegal
34029,36292,38574,2017,Ivory Coast,DR Congo,2,2,African Cup of Nations,Oyem,Gabon,True,4,0,Draw
34030,36293,38575,2017,Morocco,Togo,3,1,African Cup of Nations,Oyem,Gabon,True,4,2,Morocco
34031,36294,38576,2017,Nicaragua,Belize,3,1,UNCAF Cup,Panama City,Panama,True,4,2,Nicaragua
34032,36295,38577,2017,Egypt,Uganda,1,0,African Cup of Nations,Port-Gentil,Gabon,True,1,1,Egypt
34033,36296,38578,2017,Ghana,Mali,1,0,African Cup of Nations,Port-Gentil,Gabon,True,1,1,Ghana
34034,36297,38579,2017,Belize,Honduras,0,1,UNCAF Cup,Panama City,Panama,True,1,-1,Honduras
34035,36298,38580,2017,Bermuda,Canada,2,4,Friendly,Hamilton,Bermuda,False,6,-2,Canada
34036,36299,38581,2017,El Salvador,Nicaragua,1,0,UNCAF Cup,Panama City,Panama,True,1,1,El Salvador
34037,36300,38582,2017,Gabon,Cameroon,0,0,African Cup of Nations,Libreville,Gabon,False,0,0,Draw
34038,36301,38583,2017,Guinea-Bissau,Burkina Faso,0,2,African Cup of Nations,Franceville,Gabon,True,2,-2,Burkina Faso
34039,36302,38584,2017,Panama,Costa Rica,1,0,UNCAF Cup,Panama City,Panama,False,1,1,Panama
34040,36303,38585,2017,Senegal,Algeria,2,2,African Cup of Nations,Franceville,Gabon,True,4,0,Draw
34041,36304,38586,2017,Uzbekistan,Georgia,2,2,Friendly,Dubai,United Arab Emirates,True,4,0,Draw
34042,36305,38587,2017,Zimbabwe,Tunisia,2,4,African Cup of Nations,Libreville,Gabon,True,6,-2,Tunisia
34043,36306,38588,2017,Morocco,Ivory Coast,1,0,African Cup of Nations,Oyem,Gabon,True,1,1,Morocco
34044,36307,38589,2017,Togo,DR Congo,1,3,African Cup of Nations,Port-Gentil,Gabon,True,4,-2,DR Congo
34045,36308,38590,2017,Egypt,Ghana,1,0,African Cup of Nations,Port-Gentil,Gabon,True,1,1,Egypt
34046,36309,38591,2017,Jordan,Georgia,1,0,Friendly,Dubai,United Arab Emirates,True,1,1,Jordan
34047,36310,38592,2017,Uganda,Mali,1,1,African Cup of Nations,Oyem,Gabon,True,2,0,Draw
34048,36311,38593,2017,Brazil,Colombia,1,0,Friendly,Rio de Janeiro,Brazil,False,1,1,Brazil
34049,36312,38594,2017,Burkina Faso,Tunisia,2,0,African Cup of Nations,Libreville,Gabon,True,2,2,Burkina Faso
34050,36313,38595,2017,Senegal,Cameroon,0,0,African Cup of Nations,Franceville,Gabon,True,0,0,Draw
34051,36314,38596,2017,DR Congo,Ghana,1,2,African Cup of Nations,Oyem,Gabon,True,3,-1,Ghana
34052,36315,38597,2017,Egypt,Morocco,1,0,African Cup of Nations,Port-Gentil,Gabon,True,1,1,Egypt
34053,36316,38598,2017,United States,Serbia,0,0,Friendly,San Diego,United States,False,0,0,Draw
34054,36317,38599,2017,Burkina Faso,Egypt,1,1,African Cup of Nations,Libreville,Gabon,True,2,0,Draw
34055,36318,38600,2017,Cameroon,Ghana,2,0,African Cup of Nations,Franceville,Gabon,True,2,2,Cameroon
34056,36319,38601,2017,Burkina Faso,Ghana,1,0,African Cup of Nations,Port-Gentil,Gabon,True,1,1,Burkina Faso
34057,36320,38602,2017,Egypt,Cameroon,1,2,African Cup of Nations,Libreville,Gabon,True,3,-1,Cameroon
34058,36321,38603,2017,Mexico,Iceland,1,0,Friendly,Las Vegas,United States,True,1,1,Mexico
34059,36322,38604,2017,Ecuador,Honduras,3,1,Friendly,Guayaquil,Ecuador,False,4,2,Ecuador
34060,36323,38605,2017,Qatar,Azerbaijan,1,2,Friendly,Doha,Qatar,False,3,-1,Azerbaijan
34061,36324,38606,2017,Trinidad and Tobago,Barbados,2,0,Friendly,Couva,Trinidad and Tobago,False,2,2,Trinidad and Tobago
34062,36325,38607,2017,Burundi,Djibouti,7,0,Friendly,Bujumbura,Burundi,False,7,7,Burundi
34063,36326,38608,2017,Burundi,Djibouti,1,0,Friendly,Bujumbura,Burundi,False,1,1,Burundi
34064,36327,38609,2017,Honduras,Nicaragua,2,0,Friendly,San Pedro Sula,Honduras,False,2,2,Honduras
34065,36328,38610,2017,Iran,Iraq,0,1,Friendly,Teheran,Iran,False,1,-1,Iraq
34066,36329,38611,2017,San Marino,Moldova,0,2,Friendly,Serravalle,San Marino,False,2,-2,Moldova
34067,36330,38612,2017,Indonesia,Burma,1,3,Friendly,Cibinong,Indonesia,False,4,-2,Burma
34068,36331,38613,2017,Cambodia,India,2,3,Friendly,Phnom Penh,Cambodia,False,5,-1,India
34069,36332,38614,2017,Curaçao,El Salvador,1,1,Friendly,Willemstad,Curaçao,False,2,0,Draw
34070,36333,38615,2017,Cyprus,Kazakhstan,3,1,Friendly,Larnaca,Cyprus,False,4,2,Cyprus
34071,36334,38616,2017,Czech Republic,Lithuania,3,0,Friendly,Ústí nad Labem,Czech Republic,False,3,3,Czech Republic
34072,36335,38617,2017,Djibouti,South Sudan,2,0,African Cup of Nations qualification,Djibouti,Djibouti,False,2,2,Djibouti
34073,36336,38618,2017,Germany,England,1,0,Friendly,Dortmund,Germany,False,1,1,Germany
34074,36337,38619,2017,Philippines,Malaysia,0,0,Friendly,Manila,Philippines,False,0,0,Draw
34075,36338,38620,2017,São Tomé and Príncipe,Madagascar,0,1,African Cup of Nations qualification,São Tomé,São Tomé and Príncipe,False,1,-1,Madagascar
34076,36339,38621,2017,Scotland,Canada,1,1,Friendly,Edinburgh,Scotland,False,2,0,Draw
34077,36341,38623,2017,Yemen,Palestine,0,1,Friendly,al-Wakrah,Qatar,True,1,-1,Palestine
34078,36342,38624,2017,Afghanistan,Singapore,2,1,Friendly,al-Wakrah,Qatar,True,3,1,Afghanistan
34079,36343,38625,2017,Argentina,Chile,1,0,FIFA World Cup qualification,Buenos Aires,Argentina,False,1,1,Argentina
34080,36344,38626,2017,Bahrain,Tajikistan,1,1,Friendly,Riffa,Bahrain,False,2,0,Draw
34081,36345,38628,2017,Colombia,Bolivia,1,0,FIFA World Cup qualification,Barranquilla,Colombia,False,1,1,Colombia
34082,36346,38629,2017,Iraq,Australia,1,1,FIFA World Cup qualification,Teheran,Iran,True,2,0,Draw
34083,36347,38630,2017,Jordan,Hong Kong,4,0,Friendly,Amman,Jordan,False,4,4,Jordan
34084,36348,38631,2017,Kenya,Uganda,1,1,Friendly,Machakos,Kenya,False,2,0,Draw
34085,36349,38632,2017,Nigeria,Senegal,1,1,Friendly,London,England,True,2,0,Draw
34086,36351,38634,2017,Paraguay,Ecuador,2,1,FIFA World Cup qualification,Asunción,Paraguay,False,3,1,Paraguay
34087,36352,38635,2017,Qatar,Iran,0,1,FIFA World Cup qualification,Doha,Qatar,False,1,-1,Iran
34088,36353,38636,2017,Syria,Uzbekistan,1,0,FIFA World Cup qualification,Paya Rumput,Malaysia,True,1,1,Syria
34089,36354,38637,2017,Thailand,Saudi Arabia,0,3,FIFA World Cup qualification,Bangkok,Thailand,False,3,-3,Saudi Arabia
34090,36355,38638,2017,United Arab Emirates,Japan,0,2,FIFA World Cup qualification,al-Ain,United Arab Emirates,False,2,-2,Japan
34091,36356,38639,2017,Uruguay,Brazil,1,4,FIFA World Cup qualification,Montevideo,Uruguay,False,5,-3,Brazil
34092,36357,38640,2017,Venezuela,Peru,2,2,FIFA World Cup qualification,Maturín,Venezuela,False,4,0,Draw
34093,36358,38641,2017,Austria,Moldova,2,0,FIFA World Cup qualification,Vienna,Austria,False,2,2,Austria
34094,36359,38642,2017,Comoros,Mauritius,2,0,African Cup of Nations qualification,Mitsamiouli,Comoros,False,2,2,Comoros
34095,36360,38643,2017,Croatia,Ukraine,1,0,FIFA World Cup qualification,Zagreb,Croatia,False,1,1,Croatia
34096,36361,38644,2017,Georgia,Serbia,1,2,FIFA World Cup qualification,Tbilisi,Georgia,False,3,-1,Serbia
34097,36362,38645,2017,Guinea,Gabon,2,2,Friendly,Le Havre,France,True,4,0,Draw
34098,36363,38646,2017,Republic of Ireland,Wales,0,0,FIFA World Cup qualification,Dublin,Republic of Ireland,False,0,0,Draw
34099,36364,38647,2017,Italy,Albania,2,0,FIFA World Cup qualification,Palermo,Italy,False,2,2,Italy
34100,36365,38648,2017,Kosovo,Iceland,1,2,FIFA World Cup qualification,Shkodër,Albania,True,3,-1,Iceland
34101,36366,38649,2017,Libya,Togo,0,0,Friendly,Alexandria,Egypt,True,0,0,Draw
34102,36368,38651,2017,Mauritania,Benin,1,0,Friendly,Nouakchott,Mauritania,False,1,1,Mauritania
34103,36369,38652,2017,Mexico,Costa Rica,2,0,FIFA World Cup qualification,Mexico City,Mexico,False,2,2,Mexico
34104,36370,38653,2017,Morocco,Burkina Faso,2,0,Friendly,Marrakech,Morocco,False,2,2,Morocco
34105,36371,38654,2017,Russia,Ivory Coast,0,2,Friendly,Krasnodar,Russia,False,2,-2,Ivory Coast
34106,36372,38655,2017,Spain,Israel,4,1,FIFA World Cup qualification,Gijón,Spain,False,5,3,Spain
34107,36373,38656,2017,Trinidad and Tobago,Panama,1,0,FIFA World Cup qualification,Port of Spain,Trinidad and Tobago,False,1,1,Trinidad and Tobago
34108,36374,38657,2017,Tunisia,Cameroon,0,1,Friendly,Monastir,Tunisia,False,1,-1,Cameroon
34109,36375,38658,2017,Turkey,Finland,2,0,FIFA World Cup qualification,Antalya,Turkey,False,2,2,Turkey
34110,36376,38659,2017,United States,Honduras,6,0,FIFA World Cup qualification,San Jose,United States,False,6,6,United States
34111,36377,38660,2017,Andorra,Faroe Islands,0,0,FIFA World Cup qualification,Sant Julià de Lòria,Andorra,False,0,0,Draw
34112,36378,38661,2017,Belgium,Greece,1,1,FIFA World Cup qualification,Brussels,Belgium,False,2,0,Draw
34113,36379,38662,2017,Bosnia and Herzegovina,Gibraltar,5,0,FIFA World Cup qualification,Zenica,Bosnia and Herzegovina,False,5,5,Bosnia and Herzegovina
34114,36380,38663,2017,Bulgaria,Netherlands,2,0,FIFA World Cup qualification,Sofia,Bulgaria,False,2,2,Bulgaria
34115,36381,38664,2017,Cyprus,Estonia,0,0,FIFA World Cup qualification,Nicosia,Cyprus,False,0,0,Draw
34116,36382,38665,2017,Fiji,New Zealand,0,2,FIFA World Cup qualification,Lautoka,Fiji,False,2,-2,New Zealand
34117,36383,38666,2017,Luxembourg,France,1,3,FIFA World Cup qualification,Luxembourg,Luxembourg,False,4,-2,France
34118,36384,38667,2017,Mozambique,Angola,2,0,Friendly,Maputo,Mozambique,False,2,2,Mozambique
34119,36385,38668,2017,Portugal,Hungary,3,0,FIFA World Cup qualification,Lisbon,Portugal,False,3,3,Portugal
34120,36386,38669,2017,South Africa,Guinea-Bissau,3,1,Friendly,Durban,South Africa,False,4,2,South Africa
34121,36387,38670,2017,Sweden,Belarus,4,0,FIFA World Cup qualification,Solna,Sweden,False,4,4,Sweden
34122,36388,38671,2017,Switzerland,Latvia,1,0,FIFA World Cup qualification,Geneva,Switzerland,False,1,1,Switzerland
34123,36389,38672,2017,Tanzania,Botswana,2,0,Friendly,Dar es Salaam,Tanzania,False,2,2,Tanzania
34124,36390,38673,2017,Armenia,Kazakhstan,2,0,FIFA World Cup qualification,Yerevan,Armenia,False,2,2,Armenia
34125,36391,38674,2017,Azerbaijan,Germany,1,4,FIFA World Cup qualification,Baku,Azerbaijan,False,5,-3,Germany
34126,36392,38675,2017,Barbados,Martinique,2,1,Friendly,Bridgetown,Barbados,False,3,1,Barbados
34127,36393,38676,2017,England,Lithuania,2,0,FIFA World Cup qualification,London,England,False,2,2,England
34128,36394,38677,2017,Kenya,DR Congo,2,1,Friendly,Machakos,Kenya,False,3,1,Kenya
34129,36395,38678,2017,Madagascar,São Tomé and Príncipe,3,2,African Cup of Nations qualification,Antananarivo,Madagascar,False,5,1,Madagascar
34130,36396,38679,2017,Malta,Slovakia,1,3,FIFA World Cup qualification,Attard,Malta,False,4,-2,Slovakia
34131,36397,38680,2017,Montenegro,Poland,1,2,FIFA World Cup qualification,Podgorica,Montenegro,False,3,-1,Poland
34132,36398,38681,2017,Northern Ireland,Norway,2,0,FIFA World Cup qualification,Belfast,Northern Ireland,False,2,2,Northern Ireland
34133,36399,38682,2017,Romania,Denmark,0,0,FIFA World Cup qualification,Cluj,Romania,False,0,0,Draw
34134,36400,38683,2017,San Marino,Czech Republic,0,6,FIFA World Cup qualification,Serravalle,San Marino,False,6,-6,Czech Republic
34135,36401,38684,2017,Scotland,Slovenia,1,0,FIFA World Cup qualification,Glasgow,Scotland,False,1,1,Scotland
34136,36402,38685,2017,Zimbabwe,Zambia,0,0,Friendly,Harare,Zimbabwe,False,0,0,Draw
34137,36403,38686,2017,Central African Republic,Gambia,1,2,Friendly,Rabat,Morocco,True,3,-1,Gambia
34138,36404,38687,2017,Ivory Coast,Senegal,1,1,Friendly,Paris,France,True,2,0,Draw
34139,36405,38688,2017,Mauritania,Congo,2,1,Friendly,Nouakchott,Mauritania,False,3,1,Mauritania
34140,36406,38689,2017,Turkey,Moldova,3,1,Friendly,Eskişehir,Turkey,False,4,2,Turkey
34141,36407,38690,2017,Afghanistan,Vietnam,1,1,AFC Asian Cup qualification,Dushanbe,Tajikistan,True,2,0,Draw
34142,36408,38691,2017,Albania,Bosnia and Herzegovina,1,2,Friendly,Elbasan,Albania,False,3,-1,Bosnia and Herzegovina
34143,36409,38692,2017,Australia,United Arab Emirates,2,0,FIFA World Cup qualification,Sydney,Australia,False,2,2,Australia
34144,36410,38693,2017,Austria,Finland,1,1,Friendly,Innsbruck,Austria,False,2,0,Draw
34145,36411,38694,2017,Bahrain,Singapore,0,0,AFC Asian Cup qualification,Riffa,Bahrain,False,0,0,Draw
34146,36412,38695,2017,Bolivia,Argentina,2,0,FIFA World Cup qualification,La Paz,Bolivia,False,2,2,Bolivia
34147,36413,38696,2017,Brazil,Paraguay,3,0,FIFA World Cup qualification,São Paulo,Brazil,False,3,3,Brazil
34148,36414,38697,2017,Burma,India,0,1,AFC Asian Cup qualification,Rangoon,Burma,False,1,-1,India
34149,36415,38698,2017,Cameroon,Guinea,1,2,Friendly,Molenbeek,Belgium,True,3,-1,Guinea
34150,36416,38699,2017,Chile,Venezuela,3,1,FIFA World Cup qualification,Santiago,Chile,False,4,2,Chile
34151,36417,38700,2017,Ecuador,Colombia,0,2,FIFA World Cup qualification,Quito,Ecuador,False,2,-2,Colombia
34152,36418,38701,2017,Egypt,Togo,3,0,Friendly,Alexandria,Egypt,False,3,3,Egypt
34153,36419,38702,2017,Estonia,Croatia,3,0,Friendly,Tallinn,Estonia,False,3,3,Estonia
34154,36420,38703,2017,France,Spain,0,2,Friendly,Saint-Denis,France,False,2,-2,Spain
34155,36421,38704,2017,Georgia,Latvia,5,0,Friendly,Tbilisi,Georgia,False,5,5,Georgia
34156,36422,38705,2017,Guyana,Martinique,0,0,Friendly,Linden,Guyana,False,0,0,Draw
34157,36423,38706,2017,Honduras,Costa Rica,1,1,FIFA World Cup qualification,San Pedro Sula,Honduras,False,2,0,Draw
34158,36425,38708,2017,Republic of Ireland,Iceland,0,1,Friendly,Dublin,Republic of Ireland,False,1,-1,Iceland
34159,36426,38709,2017,Japan,Thailand,4,0,FIFA World Cup qualification,Saitama,Japan,False,4,4,Japan
34160,36427,38710,2017,Jordan,Cambodia,7,0,AFC Asian Cup qualification,Amman,Jordan,False,7,7,Jordan
34161,36428,38712,2017,Kyrgyzstan,Macau,1,0,AFC Asian Cup qualification,Bishkek,Kyrgyzstan,False,1,1,Kyrgyzstan
34162,36429,38713,2017,Lebanon,Hong Kong,2,0,AFC Asian Cup qualification,Beirut,Lebanon,False,2,2,Lebanon
34163,36431,38716,2017,Maldives,Palestine,0,3,AFC Asian Cup qualification,Malé,Maldives,False,3,-3,Palestine
34164,36432,38717,2017,Mauritius,Comoros,1,1,African Cup of Nations qualification,Mapou,Mauritius,False,2,0,Draw
34165,36433,38718,2017,Morocco,Tunisia,1,0,Friendly,Marrakech,Morocco,False,1,1,Morocco
34166,36434,38719,2017,Mozambique,Lesotho,1,0,Friendly,Beira,Mozambique,False,1,1,Mozambique
34167,36435,38720,2017,Netherlands,Italy,1,2,Friendly,Amsterdam,Netherlands,False,3,-1,Italy
34168,36436,38721,2017,New Zealand,Fiji,2,0,FIFA World Cup qualification,Wellington,New Zealand,False,2,2,New Zealand
34169,36437,38722,2017,Oman,Bhutan,14,0,AFC Asian Cup qualification,Muscat,Oman,False,14,14,Oman
34170,36438,38723,2017,Panama,United States,1,1,FIFA World Cup qualification,Panama City,Panama,False,2,0,Draw
34171,36439,38724,2017,Peru,Uruguay,2,1,FIFA World Cup qualification,Lima,Peru,False,3,1,Peru
34172,36440,38725,2017,Philippines,Nepal,4,1,AFC Asian Cup qualification,Manila,Philippines,False,5,3,Philippines
34173,36441,38726,2017,Portugal,Sweden,2,3,Friendly,Funchal,Portugal,False,5,-1,Sweden
34174,36442,38727,2017,Russia,Belgium,3,3,Friendly,Sochi,Russia,False,6,0,Draw
34175,36443,38728,2017,Saudi Arabia,Iraq,1,0,FIFA World Cup qualification,Jeddah,Saudi Arabia,False,1,1,Saudi Arabia
34176,36444,38729,2017,South Africa,Angola,0,0,Friendly,East London,South Africa,False,0,0,Draw
34177,36445,38730,2017,South Sudan,Djibouti,6,0,African Cup of Nations qualification,Juba,South Sudan,False,6,6,South Sudan
34178,36446,38731,2017,Tanzania,Burundi,2,1,Friendly,Dar es Salaam,Tanzania,False,3,1,Tanzania
34179,36447,38732,2017,Trinidad and Tobago,Mexico,0,1,FIFA World Cup qualification,Port of Spain,Trinidad and Tobago,False,1,-1,Mexico
34180,36448,38733,2017,Uzbekistan,Qatar,1,0,FIFA World Cup qualification,Tashkent,Uzbekistan,False,1,1,Uzbekistan
34181,36449,38734,2017,Yemen,Tajikistan,2,1,AFC Asian Cup qualification,Doha,Qatar,True,3,1,Yemen
34182,36450,38735,2017,Somalia,South Sudan,1,2,African Nations Championship,Djibouti,Djibouti,True,3,-1,South Sudan
34183,36451,38736,2017,Madagascar,Malawi,1,0,African Nations Championship,Antananarivo,Madagascar,False,1,1,Madagascar
34184,36452,38737,2017,Mauritius,Seychelles,2,1,African Nations Championship,Belle Vue Maurel,Mauritius,False,3,1,Mauritius
34185,36453,38738,2017,Martinique,Guadeloupe,4,1,Friendly,Le Lamentin,Martinique,False,5,3,Martinique
34186,36454,38739,2017,Malawi,Madagascar,0,1,African Nations Championship,Lilongwe,Malawi,False,1,-1,Madagascar
34187,36455,38740,2017,Seychelles,Mauritius,1,1,African Nations Championship,Victoria,Seychelles,False,2,0,Draw
34188,36456,38742,2017,South Sudan,Somalia,2,0,African Nations Championship,Juba,South Sudan,False,2,2,South Sudan
34189,36457,38743,2017,Burkina Faso,Benin,1,1,Friendly,Ouagadougou,Burkina Faso,False,2,0,Draw
34190,36458,38744,2017,Saint Kitts and Nevis,Barbados,2,1,Friendly,Basseterre,Saint Kitts and Nevis,False,3,1,Saint Kitts and Nevis
34191,36459,38745,2017,Senegal,Mauritania,2,0,Friendly,Dakar,Senegal,False,2,2,Senegal
34192,36460,38746,2017,Egypt,Libya,1,0,Friendly,Cairo,Egypt,False,1,1,Egypt
34193,36461,38747,2017,Guadeloupe,Dominica,2,2,Friendly,Les Abymes,Guadeloupe,False,4,0,Draw
34194,36462,38748,2017,Benin,Burkina Faso,2,2,Friendly,Cotonou,Benin,False,4,0,Draw
34195,36463,38749,2017,Fiji,Solomon Islands,1,1,Friendly,Suva,Fiji,False,2,0,Draw
34196,36464,38750,2017,Ghana,Benin,1,1,Friendly,Accra,Ghana,False,2,0,Draw
34197,36465,38752,2017,El Salvador,Honduras,2,2,Friendly,Washington,United States,True,4,0,Draw
34198,36466,38753,2017,Fiji,Solomon Islands,1,0,Friendly,Lautoka,Fiji,False,1,1,Fiji
34199,36467,38754,2017,Mexico,Croatia,1,2,Friendly,Los Angeles,United States,True,3,-1,Croatia
34200,36468,38755,2017,Italy,San Marino,8,0,Friendly,Empoli,Italy,False,8,8,Italy
34201,36469,38756,2017,Ivory Coast,Benin,1,1,Friendly,Abidjan,Ivory Coast,False,2,0,Draw
34202,36470,38757,2017,Morocco,Netherlands,1,2,Friendly,Agadir,Morocco,False,3,-1,Netherlands
34203,36471,38758,2017,Iraq,Jordan,1,0,Friendly,Basra,Iraq,False,1,1,Iraq
34204,36472,38759,2017,Mexico,Republic of Ireland,3,1,Friendly,East Rutherford,United States,True,4,2,Mexico
34205,36473,38760,2017,Nigeria,Togo,3,0,Friendly,Saint-Leu-la-Forêt,France,True,3,3,Nigeria
34206,36474,38761,2017,Switzerland,Belarus,1,0,Friendly,Neuchâtel,Switzerland,False,1,1,Switzerland
34207,36475,38762,2017,Chile,Burkina Faso,3,0,Friendly,Santiago,Chile,False,3,3,Chile
34208,36476,38763,2017,France,Paraguay,5,0,Friendly,Rennes,France,False,5,5,France
34209,36477,38764,2017,Nicaragua,Bolivia,0,1,Friendly,Managua,Nicaragua,False,1,-1,Bolivia
34210,36478,38765,2017,Northern Ireland,New Zealand,1,0,Friendly,Belfast,Northern Ireland,False,1,1,Northern Ireland
34211,36479,38766,2017,Oman,Syria,1,1,Friendly,Muscat,Oman,False,2,0,Draw
34212,36480,38767,2017,Ethiopia,Uganda,0,0,Friendly,Hawassa,Ethiopia,False,0,0,Draw
34213,36481,38768,2017,Portugal,Cyprus,4,0,Friendly,Estoril,Portugal,False,4,4,Portugal
34214,36482,38769,2017,United States,Venezuela,1,1,Friendly,Sandy,United States,False,2,0,Draw
34215,36483,38770,2017,Armenia,Saint Kitts and Nevis,5,0,Friendly,Yerevan,Armenia,False,5,5,Armenia
34216,36484,38771,2017,Gabon,Zambia,0,0,Friendly,Libreville,Gabon,False,0,0,Draw
34217,36485,38772,2017,Republic of Ireland,Uruguay,3,1,Friendly,Dublin,Republic of Ireland,False,4,2,Republic of Ireland
34218,36486,38773,2017,Lesotho,Mauritania,1,0,Friendly,Pretoria,South Africa,True,1,1,Lesotho
34219,36487,38774,2017,Luxembourg,Albania,2,1,Friendly,Luxembourg,Luxembourg,False,3,1,Luxembourg
34220,36488,38775,2017,Montenegro,Iran,1,2,Friendly,Podgorica,Montenegro,False,3,-1,Iran
34221,36489,38776,2017,Netherlands,Ivory Coast,5,0,Friendly,Rotterdam,Netherlands,False,5,5,Netherlands
34222,36490,38777,2017,Togo,Comoros,2,0,Friendly,Marseille,France,True,2,2,Togo
34223,36491,38779,2017,Belgium,Czech Republic,2,1,Friendly,Brussels,Belgium,False,3,1,Belgium
34224,36492,38780,2017,DR Congo,Botswana,2,0,Friendly,Salé,Morocco,True,2,2,DR Congo
34225,36493,38781,2017,Egypt,Libya,1,0,Friendly,New Cairo,Egypt,False,1,1,Egypt
34226,36494,38782,2017,Hungary,Russia,0,3,Friendly,Budapest,Hungary,False,3,-3,Russia
34227,36495,38784,2017,Senegal,Uganda,0,0,Friendly,Dakar,Senegal,False,0,0,Draw
34228,36496,38788,2017,Afghanistan,Maldives,2,1,Friendly,Dubai,United Arab Emirates,True,3,1,Afghanistan
34229,36497,38789,2017,Algeria,Guinea,2,1,Friendly,Blida,Algeria,False,3,1,Algeria
34230,36498,38790,2017,Bahrain,Palestine,0,2,Friendly,Riffa,Bahrain,False,2,-2,Palestine
34231,36499,38791,2017,Denmark,Germany,1,1,Friendly,Brøndby,Denmark,False,2,0,Draw
34232,36500,38792,2017,India,Nepal,2,0,Friendly,Bombay,India,False,2,2,India
34233,36501,38793,2017,Israel,Moldova,1,1,Friendly,Netanya,Israel,False,2,0,Draw
34234,36502,38794,2017,Malta,Ukraine,1,0,Friendly,Graz,Austria,True,1,1,Malta
34235,36504,38796,2017,Uzbekistan,Thailand,2,0,Friendly,Tashkent,Uzbekistan,False,2,2,Uzbekistan
34236,36506,38801,2017,Bolivia,Nicaragua,3,2,Friendly,Yacuiba,Bolivia,False,5,1,Bolivia
34237,36507,38803,2017,Fiji,New Caledonia,2,2,FIFA World Cup qualification,Lautoka,Fiji,False,4,0,Draw
34238,36508,38804,2017,Finland,Liechtenstein,1,1,Friendly,Turku,Finland,False,2,0,Draw
34239,36509,38805,2017,Georgia,Saint Kitts and Nevis,3,0,Friendly,Tbilisi,Georgia,False,3,3,Georgia
34240,36510,38806,2017,Hong Kong,Jordan,0,0,Friendly,Kowloon,Hong Kong,False,0,0,Draw
34241,36512,38808,2017,Italy,Uruguay,3,0,Friendly,Nice,France,True,3,3,Italy
34242,36513,38809,2017,Japan,Syria,1,1,Friendly,Chōfu,Japan,False,2,0,Draw
34243,36514,38810,2017,Spain,Colombia,2,2,Friendly,Murcia,Spain,False,4,0,Draw
34244,36515,38811,2017,United Arab Emirates,Laos,4,0,Friendly,Shah Alam,Malaysia,True,4,4,United Arab Emirates
34245,36517,38816,2017,Australia,Saudi Arabia,3,2,FIFA World Cup qualification,Adelaide,Australia,False,5,1,Australia
34246,36518,38817,2017,Cambodia,Indonesia,0,2,Friendly,Phnom Penh,Cambodia,False,2,-2,Indonesia
34247,36519,38818,2017,Costa Rica,Panama,0,0,FIFA World Cup qualification,San José,Costa Rica,False,0,0,Draw
34248,36520,38819,2017,Ecuador,Venezuela,1,1,Friendly,Boca Raton,United States,True,2,0,Draw
34249,36521,38820,2017,Mexico,Honduras,3,0,FIFA World Cup qualification,Mexico City,Mexico,False,3,3,Mexico
34250,36522,38821,2017,Peru,Paraguay,1,0,Friendly,Trujillo,Peru,False,1,1,Peru
34251,36523,38822,2017,United States,Trinidad and Tobago,2,0,FIFA World Cup qualification,Commerce City,United States,False,2,2,United States
34252,36524,38823,2017,Andorra,Hungary,1,0,FIFA World Cup qualification,Sant Julià de Lòria,Andorra,False,1,1,Andorra
34253,36525,38824,2017,Argentina,Brazil,1,0,Friendly,Melbourne,Australia,True,1,1,Argentina
34254,36526,38825,2017,Belarus,Bulgaria,2,1,FIFA World Cup qualification,Barysaw,Belarus,False,3,1,Belarus
34255,36527,38826,2017,Bosnia and Herzegovina,Greece,0,0,FIFA World Cup qualification,Zenica,Bosnia and Herzegovina,False,0,0,Draw
34256,36528,38827,2017,Estonia,Belgium,0,2,FIFA World Cup qualification,Tallinn,Estonia,False,2,-2,Belgium
34257,36529,38828,2017,Faroe Islands,Switzerland,0,2,FIFA World Cup qualification,Tórshavn,Faroe Islands,False,2,-2,Switzerland
34258,36530,38829,2017,Gibraltar,Cyprus,1,2,FIFA World Cup qualification,Faro,Portugal,True,3,-1,Cyprus
34259,36531,38830,2017,Latvia,Portugal,0,3,FIFA World Cup qualification,Riga,Latvia,False,3,-3,Portugal
34260,36532,38831,2017,Libya,Seychelles,5,1,African Cup of Nations qualification,New Cairo,Egypt,True,6,4,Libya
34261,36533,38832,2017,Netherlands,Luxembourg,5,0,FIFA World Cup qualification,Rotterdam,Netherlands,False,5,5,Netherlands
34262,36534,38833,2017,Russia,Chile,1,1,Friendly,Moscow,Russia,False,2,0,Draw
34263,36535,38834,2017,Solomon Islands,Papua New Guinea,3,2,FIFA World Cup qualification,Honiara,Solomon Islands,False,5,1,Solomon Islands
34264,36536,38835,2017,Sudan,Madagascar,1,3,African Cup of Nations qualification,al-Ubayyid,Sudan,False,4,-2,Madagascar
34265,36537,38836,2017,Sweden,France,2,1,FIFA World Cup qualification,Solna,Sweden,False,3,1,Sweden
34266,36538,38841,2017,Azerbaijan,Northern Ireland,0,1,FIFA World Cup qualification,Baku,Azerbaijan,False,1,-1,Northern Ireland
34267,36539,38842,2017,Burkina Faso,Angola,3,1,African Cup of Nations qualification,Ouagadougou,Burkina Faso,False,4,2,Burkina Faso
34268,36540,38843,2017,Burundi,South Sudan,3,0,African Cup of Nations qualification,Bujumbura,Burundi,False,3,3,Burundi
34269,36541,38844,2017,Cameroon,Morocco,1,0,African Cup of Nations qualification,Yaoundé,Cameroon,False,1,1,Cameroon
34270,36542,38845,2017,DR Congo,Congo,3,1,African Cup of Nations qualification,Kinshasa,DR Congo,False,4,2,DR Congo
34271,36543,38846,2017,Germany,San Marino,7,0,FIFA World Cup qualification,Nuremberg,Germany,False,7,7,Germany
34272,36544,38847,2017,Grenada,Bermuda,1,2,Friendly,St. George's,Grenada,False,3,-1,Bermuda
34273,36545,38848,2017,Guinea-Bissau,Namibia,1,0,African Cup of Nations qualification,Bissau,Guinea-Bissau,False,1,1,Guinea-Bissau
34274,36546,38849,2017,Ivory Coast,Guinea,2,3,African Cup of Nations qualification,Bouaké,Ivory Coast,False,5,-1,Guinea
34275,36547,38850,2017,Kazakhstan,Denmark,1,3,FIFA World Cup qualification,Almaty,Kazakhstan,False,4,-2,Denmark
34276,36548,38851,2017,Lithuania,Slovakia,1,2,FIFA World Cup qualification,Vilnius,Lithuania,False,3,-1,Slovakia
34277,36549,38852,2017,Malawi,Comoros,1,0,African Cup of Nations qualification,Lilongwe,Malawi,False,1,1,Malawi
34278,36550,38853,2017,Mali,Gabon,2,1,African Cup of Nations qualification,Bamako,Mali,False,3,1,Mali
34279,36551,38854,2017,Montenegro,Armenia,4,1,FIFA World Cup qualification,Podgorica,Montenegro,False,5,3,Montenegro
34280,36552,38855,2017,Niger,Eswatini,0,0,African Cup of Nations qualification,Niamey,Niger,False,0,0,Draw
34281,36553,38856,2017,Nigeria,South Africa,0,2,African Cup of Nations qualification,Uyo,Nigeria,False,2,-2,South Africa
34282,36554,38857,2017,Norway,Czech Republic,1,1,FIFA World Cup qualification,Oslo,Norway,False,2,0,Draw
34283,36555,38858,2017,Poland,Romania,3,1,FIFA World Cup qualification,Warsaw,Poland,False,4,2,Poland
34284,36556,38859,2017,Scotland,England,2,2,FIFA World Cup qualification,Glasgow,Scotland,False,4,0,Draw
34285,36557,38860,2017,Senegal,Equatorial Guinea,3,0,African Cup of Nations qualification,Dakar,Senegal,False,3,3,Senegal
34286,36558,38861,2017,Sierra Leone,Kenya,2,1,African Cup of Nations qualification,Freetown,Sierra Leone,False,3,1,Sierra Leone
34287,36560,38863,2017,Slovenia,Malta,2,0,FIFA World Cup qualification,Ljubljana,Slovenia,False,2,2,Slovenia
34288,36561,38864,2017,Tanzania,Lesotho,1,1,African Cup of Nations qualification,Dar es Salaam,Tanzania,False,2,0,Draw
34289,36562,38865,2017,Zambia,Mozambique,0,1,African Cup of Nations qualification,Ndola,Zambia,False,1,-1,Mozambique
34290,36563,38868,2017,Algeria,Togo,1,0,African Cup of Nations qualification,Blida,Algeria,False,1,1,Algeria
34291,36564,38869,2017,Benin,Gambia,1,0,African Cup of Nations qualification,Cotonou,Benin,False,1,1,Benin
34292,36565,38871,2017,Central African Republic,Rwanda,2,1,African Cup of Nations qualification,Bangui,Central African Republic,False,3,1,Central African Republic
34293,36566,38872,2017,Finland,Ukraine,1,2,FIFA World Cup qualification,Tampere,Finland,False,3,-1,Ukraine
34294,36567,38873,2017,Ghana,Ethiopia,5,0,African Cup of Nations qualification,Kumasi,Ghana,False,5,5,Ghana
34295,36568,38874,2017,Iceland,Croatia,1,0,FIFA World Cup qualification,Reykjavík,Iceland,False,1,1,Iceland
34296,36569,38875,2017,Republic of Ireland,Austria,1,1,FIFA World Cup qualification,Dublin,Republic of Ireland,False,2,0,Draw
34297,36570,38876,2017,Israel,Albania,0,3,FIFA World Cup qualification,Haifa,Israel,False,3,-3,Albania
34298,36571,38877,2017,Italy,Liechtenstein,5,0,FIFA World Cup qualification,Udine,Italy,False,5,5,Italy
34299,36572,38878,2017,Kosovo,Turkey,1,4,FIFA World Cup qualification,Shkodër,Albania,True,5,-3,Turkey
34300,36573,38880,2017,Mexico,United States,1,1,FIFA World Cup qualification,Mexico City,Mexico,False,2,0,Draw
34301,36574,38881,2017,Moldova,Georgia,2,2,FIFA World Cup qualification,Chișinău,Moldova,False,4,0,Draw
34302,36575,38882,2017,New Caledonia,Fiji,2,1,FIFA World Cup qualification,Nouméa,New Caledonia,False,3,1,New Caledonia
34303,36576,38883,2017,Serbia,Wales,1,1,FIFA World Cup qualification,Belgrade,Serbia,False,2,0,Draw
34304,36577,38884,2017,Zimbabwe,Liberia,3,0,African Cup of Nations qualification,Harare,Zimbabwe,False,3,3,Zimbabwe
34305,36578,38885,2017,Belarus,New Zealand,1,0,Friendly,Minsk,Belarus,False,1,1,Belarus
34306,36579,38886,2017,Iran,Uzbekistan,2,0,FIFA World Cup qualification,Teheran,Iran,False,2,2,Iran
34307,36580,38887,2017,Latvia,Estonia,1,2,Friendly,Riga,Latvia,False,3,-1,Estonia
34308,36581,38888,2017,Australia,Brazil,0,4,Friendly,Melbourne,Australia,False,4,-4,Brazil
34309,36582,38889,2017,Bhutan,Maldives,0,2,AFC Asian Cup qualification,Thimphu,Bhutan,False,2,-2,Maldives
34310,36583,38890,2017,Cambodia,Afghanistan,1,0,AFC Asian Cup qualification,Phnom Penh,Cambodia,False,1,1,Cambodia
34311,36584,38891,2017,Cameroon,Colombia,0,4,Friendly,Getafe,Spain,True,4,-4,Colombia
34312,36585,38892,2017,Canada,Curaçao,2,1,Friendly,Montréal,Canada,False,3,1,Canada
34313,36586,38893,2017,Costa Rica,Trinidad and Tobago,2,1,FIFA World Cup qualification,San José,Costa Rica,False,3,1,Costa Rica
34314,36587,38894,2017,El Salvador,Ecuador,0,3,Friendly,Harrison,United States,True,3,-3,Ecuador
34315,36588,38895,2017,France,England,3,2,Friendly,Saint-Denis,France,False,5,1,France
34316,36590,38897,2017,India,Kyrgyzstan,1,0,AFC Asian Cup qualification,Bangalore,India,False,1,1,India
34317,36591,38898,2017,Indonesia,Puerto Rico,0,0,Friendly,Sleman,Indonesia,False,0,0,Draw
34318,36592,38899,2017,Iraq,Japan,1,1,FIFA World Cup qualification,Teheran,Iran,True,2,0,Draw
34319,36593,38900,2017,Macau,Burma,0,4,AFC Asian Cup qualification,Macau,Macau,False,4,-4,Burma
34320,36594,38901,2017,Malaysia,Lebanon,1,2,AFC Asian Cup qualification,Johor Bahru,Malaysia,False,3,-1,Lebanon
34321,36595,38902,2017,Nepal,Yemen,0,0,AFC Asian Cup qualification,Kathmandu,Nepal,False,0,0,Draw
34322,36596,38903,2017,Norway,Sweden,1,1,Friendly,Oslo,Norway,False,2,0,Draw
34323,36597,38904,2017,Palestine,Oman,2,1,AFC Asian Cup qualification,al-Ram,Palestine,False,3,1,Palestine
34324,36598,38905,2017,Panama,Honduras,2,2,FIFA World Cup qualification,Panama City,Panama,False,4,0,Draw
34325,36599,38906,2017,Papua New Guinea,Solomon Islands,1,2,FIFA World Cup qualification,Port Moresby,Papua New Guinea,False,3,-1,Solomon Islands
34326,36601,38908,2017,Romania,Chile,3,2,Friendly,Cluj,Romania,False,5,1,Romania
34327,36602,38909,2017,Singapore,Argentina,0,6,Friendly,Kallang,Singapore,False,6,-6,Argentina
34328,36603,38910,2017,South Africa,Zambia,1,2,Friendly,Moruleng,South Africa,False,3,-1,Zambia
34329,36605,38912,2017,Tajikistan,Philippines,3,4,AFC Asian Cup qualification,Dushanbe,Tajikistan,False,7,-1,Philippines
34330,36606,38913,2017,Thailand,United Arab Emirates,1,1,FIFA World Cup qualification,Bangkok,Thailand,False,2,0,Draw
34331,36607,38914,2017,Turkmenistan,Bahrain,1,2,AFC Asian Cup qualification,Daşoguz,Turkmenistan,False,3,-1,Bahrain
34332,36608,38915,2017,Vietnam,Jordan,0,0,AFC Asian Cup qualification,Ho Chi Minh City,Vietnam,False,0,0,Draw
34333,36609,38916,2017,Curaçao,Nicaragua,0,0,Friendly,Willemstad,Curaçao,False,0,0,Draw
34334,36610,38917,2017,French Guiana,Barbados,3,0,Friendly,Cayenne,French Guiana,False,3,3,French Guiana
34335,36611,38918,2017,Russia,New Zealand,2,0,Confederations Cup,St. Petersburg,Russia,False,2,2,Russia
34336,36612,38919,2017,Cameroon,Chile,0,2,Confederations Cup,Moscow,Russia,True,2,-2,Chile
34337,36613,38920,2017,Portugal,Mexico,2,2,Confederations Cup,Kazan,Russia,True,4,0,Draw
34338,36614,38921,2017,Australia,Germany,2,3,Confederations Cup,Sochi,Russia,True,5,-1,Germany
34339,36615,38922,2017,Mexico,New Zealand,2,1,Confederations Cup,Sochi,Russia,True,3,1,Mexico
34340,36616,38923,2017,Russia,Portugal,0,1,Confederations Cup,Moscow,Russia,False,1,-1,Portugal
34341,36617,38924,2017,Cameroon,Australia,1,1,Confederations Cup,St. Petersburg,Russia,True,2,0,Draw
34342,36618,38925,2017,Germany,Chile,1,1,Confederations Cup,Kazan,Russia,True,2,0,Draw
34343,36619,38926,2017,Jamaica,French Guiana,1,1,CFU Caribbean Cup,Fort-de-France,Martinique,True,2,0,Draw
34344,36620,38927,2017,Martinique,Curaçao,1,2,CFU Caribbean Cup,Fort-de-France,Martinique,False,3,-1,Curaçao
34345,36621,38928,2017,New Zealand,Portugal,0,4,Confederations Cup,St. Petersburg,Russia,True,4,-4,Portugal
34346,36622,38929,2017,Russia,Mexico,1,2,Confederations Cup,Kazan,Russia,False,3,-1,Mexico
34347,36623,38930,2017,Chile,Australia,1,1,Confederations Cup,Moscow,Russia,True,2,0,Draw
34348,36624,38931,2017,Germany,Cameroon,3,1,Confederations Cup,Sochi,Russia,True,4,2,Germany
34349,36625,38932,2017,Jamaica,Curaçao,1,2,CFU Caribbean Cup,Fort-de-France,Martinique,True,3,-1,Curaçao
34350,36626,38933,2017,Martinique,French Guiana,0,1,CFU Caribbean Cup,Fort-de-France,Martinique,False,1,-1,French Guiana
34351,36627,38934,2017,Mauritius,Angola,0,1,COSAFA Cup,Moruleng,South Africa,True,1,-1,Angola
34352,36628,38935,2017,Tanzania,Malawi,2,0,COSAFA Cup,Moruleng,South Africa,True,2,2,Tanzania
34353,36629,38940,2017,Guernsey,Åland Islands,1,1,Island Games,Dalhem,Sweden,True,2,0,Draw
34354,36631,38944,2017,Madagascar,Seychelles,2,0,COSAFA Cup,Moruleng,South Africa,True,2,2,Madagascar
34355,36632,38945,2017,Mozambique,Zimbabwe,0,4,COSAFA Cup,Moruleng,South Africa,True,4,-4,Zimbabwe
34356,36635,38952,2017,Falkland Islands,Isle of Man,2,5,Island Games,Säve,Sweden,True,7,-3,Isle of Man
34357,36636,38954,2017,Angola,Tanzania,0,0,COSAFA Cup,Rustenburg,South Africa,True,0,0,Draw
34358,36637,38955,2017,Malawi,Mauritius,0,0,COSAFA Cup,Rustenburg,South Africa,True,0,0,Draw
34359,36641,38964,2017,Portugal,Chile,0,0,Confederations Cup,Kazan,Russia,True,0,0,Draw
34360,36642,38965,2017,Seychelles,Mozambique,1,2,COSAFA Cup,Rustenburg,South Africa,True,3,-1,Mozambique
34361,36643,38966,2017,Saint Lucia,Saint Vincent and the Grenadines,2,1,Windward Islands Tournament,St. George's,Grenada,True,3,1,Saint Lucia
34362,36644,38967,2017,Zimbabwe,Madagascar,0,0,COSAFA Cup,Rustenburg,South Africa,True,0,0,Draw
34363,36645,38968,2017,Germany,Mexico,4,1,Confederations Cup,Sochi,Russia,True,5,3,Germany
34364,36646,38969,2017,Malawi,Angola,0,0,COSAFA Cup,Rustenburg,South Africa,True,0,0,Draw
34365,36647,38970,2017,Tanzania,Mauritius,1,1,COSAFA Cup,Moruleng,South Africa,True,2,0,Draw
34366,36650,38978,2017,Guernsey,Isle of Man,3,4,Island Games,Fardhem,Sweden,True,7,-1,Isle of Man
34367,36651,38979,2017,Dominica,Barbados,2,1,Windward Islands Tournament,Sauteurs,Grenada,True,3,1,Dominica
34368,36652,38980,2017,Mozambique,Madagascar,1,4,COSAFA Cup,Moruleng,South Africa,True,5,-3,Madagascar
34369,36653,38981,2017,Zimbabwe,Seychelles,6,0,COSAFA Cup,Rustenburg,South Africa,True,6,6,Zimbabwe
34370,36654,38983,2017,Greenland,Isle of Man,0,6,Island Games,Visby,Sweden,True,6,-6,Isle of Man
34371,36655,38984,2017,Botswana,Zambia,1,2,COSAFA Cup,Rustenburg,South Africa,True,3,-1,Zambia
34372,36656,38985,2017,Gambia,Guinea-Bissau,0,0,Friendly,Bakau,Gambia,False,0,0,Draw
34373,36657,38986,2017,Mexico,Paraguay,2,1,Friendly,Seattle,United States,True,3,1,Mexico
34374,36658,38987,2017,Namibia,Lesotho,0,0,COSAFA Cup,Rustenburg,South Africa,True,0,0,Draw
34375,36659,38988,2017,United States,Ghana,2,1,Friendly,East Hartford,United States,False,3,1,United States
34376,36660,38989,2017,Chile,Germany,0,1,Confederations Cup,St. Petersburg,Russia,True,1,-1,Germany
34377,36661,38990,2017,Portugal,Mexico,2,1,Confederations Cup,Moscow,Russia,True,3,1,Portugal
34378,36662,38991,2017,South Africa,Tanzania,0,1,COSAFA Cup,Rustenburg,South Africa,False,1,-1,Tanzania
34379,36663,38992,2017,Eswatini,Zimbabwe,1,2,COSAFA Cup,Rustenburg,South Africa,True,3,-1,Zimbabwe
34380,36664,38993,2017,Barbados,Saint Lucia,1,1,Windward Islands Tournament,St. George's,Grenada,True,2,0,Draw
34381,36665,38994,2017,Grenada,Saint Vincent and the Grenadines,4,3,Friendly,St. George's,Grenada,False,7,1,Grenada
34382,36666,38995,2017,Namibia,Eswatini,1,0,COSAFA Cup,Moruleng,South Africa,True,1,1,Namibia
34383,36667,38996,2017,South Africa,Botswana,2,0,COSAFA Cup,Moruleng,South Africa,False,2,2,South Africa
34384,36668,38997,2017,Saint Lucia,Dominica,0,0,Windward Islands Tournament,St. George's,Grenada,True,0,0,Draw
34385,36669,38998,2017,Saint Vincent and the Grenadines,Barbados,4,2,Friendly,St. George's,Grenada,True,6,2,Saint Vincent and the Grenadines
34386,36670,38999,2017,Lesotho,Zimbabwe,3,4,COSAFA Cup,Moruleng,South Africa,True,7,-1,Zimbabwe
34387,36671,39000,2017,Zambia,Tanzania,4,2,COSAFA Cup,Moruleng,South Africa,True,6,2,Zambia
34388,36672,39001,2017,Dominica,Saint Vincent and the Grenadines,2,2,Windward Islands Tournament,St. George's,Grenada,True,4,0,Draw
34389,36673,39002,2017,Grenada,Barbados,0,2,Windward Islands Tournament,St. George's,Grenada,False,2,-2,Barbados
34390,36674,39003,2017,French Guiana,Canada,2,4,Gold Cup,Harrison,United States,True,6,-2,Canada
34391,36675,39004,2017,Honduras,Costa Rica,0,1,Gold Cup,Harrison,United States,True,1,-1,Costa Rica
34392,36676,39005,2017,South Africa,Namibia,1,0,COSAFA Cup,Moruleng,South Africa,False,1,1,South Africa
34393,36677,39006,2017,Tanzania,Lesotho,0,0,COSAFA Cup,Moruleng,South Africa,True,0,0,Draw
34394,36678,39007,2017,Guinea-Bissau,Gambia,0,1,Friendly,Bissau,Guinea-Bissau,False,1,-1,Gambia
34395,36679,39008,2017,Martinique,Nicaragua,2,0,Gold Cup,Nashville,United States,True,2,2,Martinique
34396,36680,39009,2017,United States,Panama,1,1,Gold Cup,Nashville,United States,False,2,0,Draw
34397,36681,39010,2017,Curaçao,Jamaica,0,2,Gold Cup,San Diego,United States,True,2,-2,Jamaica
34398,36682,39011,2017,Mexico,El Salvador,3,1,Gold Cup,San Diego,United States,True,4,2,Mexico
34399,36683,39012,2017,Zambia,Zimbabwe,1,3,COSAFA Cup,Rustenburg,South Africa,True,4,-2,Zimbabwe
34400,36684,39013,2017,Costa Rica,Canada,1,1,Gold Cup,Houston,United States,True,2,0,Draw
34401,36685,39014,2017,Honduras,French Guiana,0,0,Gold Cup,Houston,United States,True,0,0,Draw
34402,36686,39015,2017,Panama,Nicaragua,2,1,Gold Cup,Tampa,United States,True,3,1,Panama
34403,36687,39016,2017,United States,Martinique,3,2,Gold Cup,Tampa,United States,False,5,1,United States
34404,36688,39017,2017,El Salvador,Curaçao,2,0,Gold Cup,Denver,United States,True,2,2,El Salvador
34405,36689,39018,2017,Mexico,Jamaica,0,0,Gold Cup,Denver,United States,True,0,0,Draw
34406,36690,39019,2017,Canada,Honduras,0,0,Gold Cup,Frisco,United States,True,0,0,Draw
34407,36691,39020,2017,Costa Rica,French Guiana,3,0,Gold Cup,Frisco,United States,True,3,3,Costa Rica
34408,36693,39022,2017,South Sudan,Uganda,0,0,African Nations Championship,Juba,South Sudan,False,0,0,Draw
34409,36694,39023,2017,Panama,Martinique,3,0,Gold Cup,Cleveland,United States,True,3,3,Panama
34410,36695,39024,2017,United States,Nicaragua,3,0,Gold Cup,Cleveland,United States,False,3,3,United States
34411,36696,39025,2017,Djibouti,Ethiopia,1,5,African Nations Championship,Djibouti,Djibouti,False,6,-4,Ethiopia
34412,36697,39026,2017,Tanzania,Rwanda,1,1,African Nations Championship,Mwanza,Tanzania,False,2,0,Draw
34413,36698,39027,2017,Botswana,South Africa,0,2,African Nations Championship,Francistown,Botswana,False,2,-2,South Africa
34414,36699,39028,2017,Comoros,Lesotho,2,0,African Nations Championship,Moroni,Comoros,False,2,2,Comoros
34415,36700,39029,2017,Gambia,Mali,0,0,African Nations Championship,Bakau,Gambia,False,0,0,Draw
34416,36701,39030,2017,Guinea-Bissau,Guinea,1,3,African Nations Championship,Bissau,Guinea-Bissau,False,4,-2,Guinea
34417,36702,39031,2017,Sierra Leone,Senegal,1,1,African Nations Championship,Freetown,Sierra Leone,False,2,0,Draw
34418,36704,39033,2017,Curaçao,Mexico,0,2,Gold Cup,San Antonio,United States,True,2,-2,Mexico
34419,36705,39034,2017,Jamaica,El Salvador,1,1,Gold Cup,San Antonio,United States,True,2,0,Draw
34420,36706,39035,2017,Madagascar,Mozambique,2,2,African Nations Championship,Antananarivo,Madagascar,False,4,0,Draw
34421,36707,39036,2017,Mauritius,Angola,0,1,African Nations Championship,Belle Vue Maurel,Mauritius,False,1,-1,Angola
34422,36708,39037,2017,Namibia,Zimbabwe,1,0,African Nations Championship,Windhoek,Namibia,False,1,1,Namibia
34423,36709,39038,2017,Eswatini,Zambia,0,4,African Nations Championship,Lobamba,Eswatini,False,4,-4,Zambia
34424,36710,39039,2017,Liberia,Mauritania,0,2,African Nations Championship,Monrovia,Liberia,False,2,-2,Mauritania
34425,36711,39040,2017,Togo,Benin,1,1,African Nations Championship,Lomé,Togo,False,2,0,Draw
34426,36712,39041,2017,Costa Rica,Panama,1,0,Gold Cup,Philadelphia,United States,True,1,1,Costa Rica
34427,36713,39042,2017,United States,El Salvador,2,0,Gold Cup,Philadelphia,United States,False,2,2,United States
34428,36714,39043,2017,Jamaica,Canada,2,1,Gold Cup,Glendale,United States,True,3,1,Jamaica
34429,36715,39044,2017,Mexico,Honduras,1,0,Gold Cup,Glendale,United States,True,1,1,Mexico
34430,36716,39045,2017,United States,Costa Rica,2,0,Gold Cup,Arlington,United States,False,2,2,United States
34431,36717,39046,2017,Rwanda,Tanzania,0,0,African Nations Championship,Kigali,Rwanda,False,0,0,Draw
34432,36718,39047,2017,Uganda,South Sudan,5,1,African Nations Championship,Kampala,Uganda,False,6,4,Uganda
34433,36719,39048,2017,South Africa,Botswana,1,0,African Nations Championship,Saulspoort,South Africa,False,1,1,South Africa
34434,36720,39049,2017,Zambia,Eswatini,3,0,African Nations Championship,Lusaka,Zambia,False,3,3,Zambia
34435,36721,39050,2017,Guinea,Guinea-Bissau,7,0,African Nations Championship,Conakry,Guinea,False,7,7,Guinea
34436,36722,39051,2017,Mali,Gambia,4,0,African Nations Championship,Bamako,Mali,False,4,4,Mali
34437,36723,39052,2017,Senegal,Sierra Leone,3,1,African Nations Championship,Dakar,Senegal,False,4,2,Senegal
34438,36724,39053,2017,Mexico,Jamaica,0,1,Gold Cup,Pasadena,United States,True,1,-1,Jamaica
34439,36725,39054,2017,Burundi,Sudan,0,0,African Nations Championship,Bujumbura,Burundi,False,0,0,Draw
34440,36726,39055,2017,Ethiopia,Djibouti,3,0,African Nations Championship,Awasa,Ethiopia,False,3,3,Ethiopia
34441,36727,39056,2017,Angola,Mauritius,3,2,African Nations Championship,Luanda,Angola,False,5,1,Angola
34442,36728,39057,2017,Lesotho,Comoros,1,0,African Nations Championship,Maseru,Lesotho,False,1,1,Lesotho
34443,36729,39058,2017,Mozambique,Madagascar,0,2,African Nations Championship,Maputo,Mozambique,False,2,-2,Madagascar
34444,36730,39059,2017,Zimbabwe,Namibia,1,0,African Nations Championship,Harare,Zimbabwe,False,1,1,Zimbabwe
34445,36731,39060,2017,Mauritania,Liberia,0,1,African Nations Championship,Zouérat,Mauritania,False,1,-1,Liberia
34446,36732,39061,2017,Benin,Togo,1,1,African Nations Championship,Cotonou,Benin,False,2,0,Draw
34447,36733,39062,2017,Ecuador,Trinidad and Tobago,3,1,Friendly,Guayaquil,Ecuador,False,4,2,Ecuador
34448,36734,39063,2017,United States,Jamaica,2,1,Gold Cup,Santa Clara,United States,False,3,1,United States
34449,36735,39064,2017,Sudan,Burundi,1,0,African Nations Championship,Obeid,Sudan,False,1,1,Sudan
34450,36736,39065,2017,Zambia,Ethiopia,0,0,Friendly,Lusaka,Zambia,False,0,0,Draw
34451,36737,39066,2017,Rwanda,Sudan,2,1,Friendly,Kigali,Rwanda,False,3,1,Rwanda
34452,36738,39067,2017,Congo,DR Congo,0,0,African Nations Championship,Brazzaville,Congo,False,0,0,Draw
34453,36739,39068,2017,São Tomé and Príncipe,Cameroon,0,2,African Nations Championship,São Tomé,São Tomé and Príncipe,False,2,-2,Cameroon
34454,36740,39069,2017,Algeria,Libya,1,2,African Nations Championship,Constantine,Algeria,False,3,-1,Libya
34455,36741,39070,2017,Burkina Faso,Ghana,2,2,African Nations Championship,Ouagadougou,Burkina Faso,False,4,0,Draw
34456,36742,39071,2017,Egypt,Morocco,1,1,African Nations Championship,Alexandria,Egypt,False,2,0,Draw
34457,36743,39072,2017,Niger,Ivory Coast,2,1,African Nations Championship,Niamey,Niger,False,3,1,Niger
34458,36744,39073,2017,Andorra,Qatar,0,1,Friendly,Burton on Trent,England,True,1,-1,Qatar
34459,36745,39074,2017,Libya,Algeria,1,1,African Nations Championship,Sfax,Tunisia,True,2,0,Draw
34460,36746,39075,2017,Morocco,Egypt,3,1,African Nations Championship,Rabat,Morocco,False,4,2,Morocco
34461,36747,39076,2017,India,Mauritius,2,1,Friendly,Bombay,India,False,3,1,India
34462,36748,39077,2017,Cameroon,São Tomé and Príncipe,2,0,African Nations Championship,Yaoundé,Cameroon,False,2,2,Cameroon
34463,36749,39078,2017,DR Congo,Congo,1,1,African Nations Championship,Kinshasa,DR Congo,False,2,0,Draw
34464,36750,39079,2017,Ivory Coast,Niger,1,0,African Nations Championship,Abidjan,Ivory Coast,False,1,1,Ivory Coast
34465,36751,39080,2017,Ghana,Burkina Faso,1,2,African Nations Championship,Kumasi,Ghana,False,3,-1,Burkina Faso
34466,36752,39081,2017,Malaysia,Syria,1,2,Friendly,Paya Rumput,Malaysia,False,3,-1,Syria
34467,36753,39082,2017,Mauritius,Saint Kitts and Nevis,1,1,Friendly,Bombay,India,True,2,0,Draw
34468,36754,39083,2017,Qatar,Turkmenistan,2,1,Friendly,al-Rayyan,Qatar,False,3,1,Qatar
34469,36755,39084,2017,India,Saint Kitts and Nevis,1,1,Friendly,Bombay,India,False,2,0,Draw
34470,36756,39085,2017,Trinidad and Tobago,Jamaica,1,2,Friendly,Port of Spain,Trinidad and Tobago,False,3,-1,Jamaica
34471,36757,39086,2017,Iraq,Syria,1,1,Friendly,Paya Rumput,Malaysia,True,2,0,Draw
34472,36758,39087,2017,Bahrain,Jordan,0,0,Friendly,Isa Town,Bahrain,False,0,0,Draw
34473,36759,39088,2017,Burma,Malaysia,1,0,Friendly,Rangoon,Burma,False,1,1,Burma
34474,36760,39089,2017,United Arab Emirates,Saudi Arabia,2,1,FIFA World Cup qualification,al-Ain,United Arab Emirates,False,3,1,United Arab Emirates
34475,36761,39090,2017,Oman,Afghanistan,2,0,Friendly,Muscat,Oman,False,2,2,Oman
34476,36762,39091,2017,Belgium,Gibraltar,9,0,FIFA World Cup qualification,Liège,Belgium,False,9,9,Belgium
34477,36763,39092,2017,Brazil,Ecuador,2,0,FIFA World Cup qualification,Porto Alegre,Brazil,False,2,2,Brazil
34478,36764,39093,2017,Bulgaria,Sweden,3,2,FIFA World Cup qualification,Sofia,Bulgaria,False,5,1,Bulgaria
34479,36765,39094,2017,Chile,Paraguay,0,3,FIFA World Cup qualification,Santiago,Chile,False,3,-3,Paraguay
34480,36766,39096,2017,Cyprus,Bosnia and Herzegovina,3,2,FIFA World Cup qualification,Nicosia,Cyprus,False,5,1,Cyprus
34481,36767,39097,2017,France,Netherlands,4,0,FIFA World Cup qualification,Saint-Denis,France,False,4,4,France
34482,36768,39098,2017,Greece,Estonia,0,0,FIFA World Cup qualification,Piraeus,Greece,False,0,0,Draw
34483,36769,39099,2017,Guinea,Libya,3,2,FIFA World Cup qualification,Conakry,Guinea,False,5,1,Guinea
34484,36770,39100,2017,Hungary,Latvia,3,1,FIFA World Cup qualification,Budapest,Hungary,False,4,2,Hungary
34485,36771,39101,2017,Japan,Australia,2,0,FIFA World Cup qualification,Saitama,Japan,False,2,2,Japan
34486,36772,39102,2017,Kenya,Mauritania,1,1,Friendly,Agadir,Morocco,True,2,0,Draw
34487,36773,39104,2017,Luxembourg,Belarus,1,0,FIFA World Cup qualification,Luxembourg,Luxembourg,False,1,1,Luxembourg
34488,36774,39105,2017,Niger,Togo,0,2,Friendly,Agadir,Morocco,True,2,-2,Togo
34489,36775,39106,2017,Peru,Bolivia,2,1,FIFA World Cup qualification,Lima,Peru,False,3,1,Peru
34490,36776,39107,2017,Portugal,Faroe Islands,5,1,FIFA World Cup qualification,Porto,Portugal,False,6,4,Portugal
34491,36777,39108,2017,Singapore,Hong Kong,1,1,Friendly,Kallang,Singapore,False,2,0,Draw
34492,36778,39109,2017,Switzerland,Andorra,3,0,FIFA World Cup qualification,St. Gallen,Switzerland,False,3,3,Switzerland
34493,36779,39110,2017,Syria,Qatar,3,1,FIFA World Cup qualification,Paya Rumput,Malaysia,True,4,2,Syria
34494,36780,39111,2017,Thailand,Iraq,1,2,FIFA World Cup qualification,Bangkok,Thailand,False,3,-1,Iraq
34495,36781,39112,2017,Uganda,Egypt,1,0,FIFA World Cup qualification,Kampala,Uganda,False,1,1,Uganda
34496,36782,39113,2017,Uruguay,Argentina,0,0,FIFA World Cup qualification,Montevideo,Uruguay,False,0,0,Draw
34497,36783,39114,2017,Venezuela,Colombia,0,0,FIFA World Cup qualification,San Cristóbal,Venezuela,False,0,0,Draw
34498,36784,39116,2017,Czech Republic,Germany,1,2,FIFA World Cup qualification,Prague,Czech Republic,False,3,-1,Germany
34499,36785,39117,2017,Denmark,Poland,4,0,FIFA World Cup qualification,Copenhagen,Denmark,False,4,4,Denmark
34500,36786,39118,2017,Ghana,Congo,1,1,FIFA World Cup qualification,Kumasi,Ghana,False,2,0,Draw
34501,36787,39119,2017,Kazakhstan,Montenegro,0,3,FIFA World Cup qualification,Astana,Kazakhstan,False,3,-3,Montenegro
34502,36788,39120,2017,Lithuania,Scotland,0,3,FIFA World Cup qualification,Vilnius,Lithuania,False,3,-3,Scotland
34503,36789,39121,2017,Malta,England,0,4,FIFA World Cup qualification,Attard,Malta,False,4,-4,England
34504,36790,39122,2017,Mexico,Panama,1,0,FIFA World Cup qualification,Mexico City,Mexico,False,1,1,Mexico
34505,36791,39123,2017,Morocco,Mali,6,0,FIFA World Cup qualification,Rabat,Morocco,False,6,6,Morocco
34506,36792,39124,2017,New Zealand,Solomon Islands,6,1,FIFA World Cup qualification,Auckland,New Zealand,False,7,5,New Zealand
34507,36793,39125,2017,Nigeria,Cameroon,4,0,FIFA World Cup qualification,Uyo,Nigeria,False,4,4,Nigeria
34508,36794,39126,2017,Norway,Azerbaijan,2,0,FIFA World Cup qualification,Oslo,Norway,False,2,2,Norway
34509,36795,39127,2017,Romania,Armenia,1,0,FIFA World Cup qualification,Bucharest,Romania,False,1,1,Romania
34510,36796,39128,2017,San Marino,Northern Ireland,0,3,FIFA World Cup qualification,Serravalle,San Marino,False,3,-3,Northern Ireland
34511,36797,39129,2017,Slovakia,Slovenia,1,0,FIFA World Cup qualification,Trnava,Slovakia,False,1,1,Slovakia
34512,36798,39130,2017,Trinidad and Tobago,Honduras,1,2,FIFA World Cup qualification,Couva,Trinidad and Tobago,False,3,-1,Honduras
34513,36799,39131,2017,Tunisia,DR Congo,2,1,FIFA World Cup qualification,Radès,Tunisia,False,3,1,Tunisia
34514,36800,39132,2017,United States,Costa Rica,0,2,FIFA World Cup qualification,Harrison,United States,False,2,-2,Costa Rica
34515,36801,39133,2017,Albania,Liechtenstein,2,0,FIFA World Cup qualification,Elbasan,Albania,False,2,2,Albania
34516,36802,39134,2017,Canada,Jamaica,2,0,Friendly,Toronto,Canada,False,2,2,Canada
34517,36803,39135,2017,Croatia,Kosovo,1,0,FIFA World Cup qualification,Zagreb,Croatia,False,1,1,Croatia
34518,36804,39136,2017,Finland,Iceland,1,0,FIFA World Cup qualification,Tampere,Finland,False,1,1,Finland
34519,36805,39137,2017,Gabon,Ivory Coast,0,3,FIFA World Cup qualification,Franceville,Gabon,False,3,-3,Ivory Coast
34520,36806,39138,2017,Georgia,Republic of Ireland,1,1,FIFA World Cup qualification,Tbilisi,Georgia,False,2,0,Draw
34521,36807,39139,2017,Indonesia,Fiji,0,0,Friendly,Bekasi,Indonesia,False,0,0,Draw
34522,36809,39141,2017,Mozambique,Kenya,1,1,Friendly,Maputo,Mozambique,False,2,0,Draw
34523,36810,39142,2017,Senegal,Burkina Faso,0,0,FIFA World Cup qualification,Dakar,Senegal,False,0,0,Draw
34524,36811,39143,2017,Serbia,Moldova,3,0,FIFA World Cup qualification,Belgrade,Serbia,False,3,3,Serbia
34525,36812,39144,2017,Spain,Italy,3,0,FIFA World Cup qualification,Madrid,Spain,False,3,3,Spain
34526,36813,39145,2017,Ukraine,Turkey,2,0,FIFA World Cup qualification,Kharkiv,Ukraine,False,2,2,Ukraine
34527,36814,39146,2017,Wales,Austria,1,0,FIFA World Cup qualification,Cardiff,Wales,False,1,1,Wales
34528,36815,39147,2017,Zambia,Algeria,3,1,FIFA World Cup qualification,Lusaka,Zambia,False,4,2,Zambia
34529,36816,39148,2017,Belarus,Sweden,0,4,FIFA World Cup qualification,Barysaw,Belarus,False,4,-4,Sweden
34530,36817,39149,2017,Equatorial Guinea,Benin,1,2,Friendly,Malabo,Equatorial Guinea,False,3,-1,Benin
34531,36818,39150,2017,Estonia,Cyprus,1,0,FIFA World Cup qualification,Tallinn,Estonia,False,1,1,Estonia
34532,36819,39151,2017,Faroe Islands,Andorra,1,0,FIFA World Cup qualification,Tórshavn,Faroe Islands,False,1,1,Faroe Islands
34533,36820,39152,2017,France,Luxembourg,0,0,FIFA World Cup qualification,Toulouse,France,False,0,0,Draw
34534,36821,39153,2017,Gibraltar,Bosnia and Herzegovina,0,4,FIFA World Cup qualification,Faro,Portugal,True,4,-4,Bosnia and Herzegovina
34535,36822,39154,2017,Greece,Belgium,1,2,FIFA World Cup qualification,Piraeus,Greece,False,3,-1,Belgium
34536,36823,39155,2017,Hungary,Portugal,0,1,FIFA World Cup qualification,Budapest,Hungary,False,1,-1,Portugal
34537,36824,39156,2017,Latvia,Switzerland,0,3,FIFA World Cup qualification,Riga,Latvia,False,3,-3,Switzerland
34538,36825,39157,2017,Netherlands,Bulgaria,3,1,FIFA World Cup qualification,Amsterdam,Netherlands,False,4,2,Netherlands
34539,36826,39158,2017,Armenia,Denmark,1,4,FIFA World Cup qualification,Yerevan,Armenia,False,5,-3,Denmark
34540,36827,39159,2017,Azerbaijan,San Marino,5,1,FIFA World Cup qualification,Baku,Azerbaijan,False,6,4,Azerbaijan
34541,36828,39160,2017,Cameroon,Nigeria,1,1,FIFA World Cup qualification,Yaoundé,Cameroon,False,2,0,Draw
34542,36829,39161,2017,England,Slovakia,2,1,FIFA World Cup qualification,London,England,False,3,1,England
34543,36830,39162,2017,Germany,Norway,6,0,FIFA World Cup qualification,Stuttgart,Germany,False,6,6,Germany
34544,36831,39163,2017,Libya,Guinea,1,0,FIFA World Cup qualification,Monastir,Tunisia,True,1,1,Libya
34545,36832,39164,2017,Malawi,Togo,1,0,Friendly,Agadir,Morocco,True,1,1,Malawi
34546,36833,39165,2017,Montenegro,Romania,1,0,FIFA World Cup qualification,Podgorica,Montenegro,False,1,1,Montenegro
34547,36834,39166,2017,Northern Ireland,Czech Republic,2,0,FIFA World Cup qualification,Belfast,Northern Ireland,False,2,2,Northern Ireland
34548,36835,39167,2017,Poland,Kazakhstan,3,0,FIFA World Cup qualification,Warsaw,Poland,False,3,3,Poland
34549,36836,39168,2017,Scotland,Malta,2,0,FIFA World Cup qualification,Glasgow,Scotland,False,2,2,Scotland
34550,36837,39169,2017,Slovenia,Lithuania,4,0,FIFA World Cup qualification,Ljubljana,Slovenia,False,4,4,Slovenia
34551,36838,39170,2017,Algeria,Zambia,0,1,FIFA World Cup qualification,Constantine,Algeria,False,1,-1,Zambia
34552,36839,39171,2017,Argentina,Venezuela,1,1,FIFA World Cup qualification,Buenos Aires,Argentina,False,2,0,Draw
34553,36840,39172,2017,Australia,Thailand,2,1,FIFA World Cup qualification,Melbourne,Australia,False,3,1,Australia
34554,36841,39173,2017,Austria,Georgia,1,1,FIFA World Cup qualification,Vienna,Austria,False,2,0,Draw
34555,36843,39175,2017,Bhutan,Palestine,0,2,AFC Asian Cup qualification,Thimphu,Bhutan,False,2,-2,Palestine
34556,36844,39176,2017,Bolivia,Chile,1,0,FIFA World Cup qualification,La Paz,Bolivia,False,1,1,Bolivia
34557,36845,39177,2017,Burkina Faso,Senegal,2,2,FIFA World Cup qualification,Ouagadougou,Burkina Faso,False,4,0,Draw
34558,36846,39178,2017,Cambodia,Vietnam,1,2,AFC Asian Cup qualification,Phnom Penh,Cambodia,False,3,-1,Vietnam
34559,36847,39179,2017,Colombia,Brazil,1,1,FIFA World Cup qualification,Barranquilla,Colombia,False,2,0,Draw
34560,36848,39180,2017,Congo,Ghana,1,5,FIFA World Cup qualification,Brazzaville,Congo,False,6,-4,Ghana
34561,36849,39181,2017,DR Congo,Tunisia,2,2,FIFA World Cup qualification,Kinshasa,DR Congo,False,4,0,Draw
34562,36850,39182,2017,Costa Rica,Mexico,1,1,FIFA World Cup qualification,San José,Costa Rica,False,2,0,Draw
34563,36851,39183,2017,Ecuador,Peru,0,2,FIFA World Cup qualification,Quito,Ecuador,False,2,-2,Peru
34564,36852,39184,2017,Egypt,Uganda,1,0,FIFA World Cup qualification,Alexandria,Egypt,False,1,1,Egypt
34565,36853,39185,2017,Honduras,United States,1,1,FIFA World Cup qualification,San Pedro Sula,Honduras,False,2,0,Draw
34566,36854,39186,2017,Iceland,Ukraine,2,0,FIFA World Cup qualification,Reykjavík,Iceland,False,2,2,Iceland
34567,36855,39187,2017,Iran,Syria,2,2,FIFA World Cup qualification,Teheran,Iran,False,4,0,Draw
34568,36856,39188,2017,Iraq,United Arab Emirates,1,0,FIFA World Cup qualification,Amman,Jordan,True,1,1,Iraq
34569,36857,39189,2017,Republic of Ireland,Serbia,0,1,FIFA World Cup qualification,Dublin,Republic of Ireland,False,1,-1,Serbia
34570,36858,39190,2017,Italy,Israel,1,0,FIFA World Cup qualification,Reggio Emilia,Italy,False,1,1,Italy
34571,36859,39191,2017,Ivory Coast,Gabon,1,2,FIFA World Cup qualification,Bouaké,Ivory Coast,False,3,-1,Gabon
34572,36860,39192,2017,Jordan,Afghanistan,4,1,AFC Asian Cup qualification,Amman,Jordan,False,5,3,Jordan
34573,36861,39194,2017,Kosovo,Finland,0,1,FIFA World Cup qualification,Shkodër,Albania,True,1,-1,Finland
34574,36862,39195,2017,Liechtenstein,Spain,0,8,FIFA World Cup qualification,Vaduz,Liechtenstein,False,8,-8,Spain
34575,36863,39196,2017,Macau,India,0,2,AFC Asian Cup qualification,Macau,Macau,False,2,-2,India
34576,36864,39198,2017,Malaysia,Hong Kong,1,1,AFC Asian Cup qualification,Paya Rumput,Malaysia,False,2,0,Draw
34577,36865,39199,2017,Mali,Morocco,0,0,FIFA World Cup qualification,Bamako,Mali,False,0,0,Draw
34578,36866,39200,2017,Mauritania,Niger,0,2,Friendly,Agadir,Morocco,True,2,-2,Niger
34579,36867,39201,2017,Moldova,Wales,0,2,FIFA World Cup qualification,Chișinău,Moldova,False,2,-2,Wales
34580,36868,39202,2017,Nepal,Tajikistan,1,2,AFC Asian Cup qualification,Lalitpur,Nepal,False,3,-1,Tajikistan
34581,36869,39203,2017,Oman,Maldives,5,0,AFC Asian Cup qualification,Muscat,Oman,False,5,5,Oman
34582,36870,39204,2017,Panama,Trinidad and Tobago,3,0,FIFA World Cup qualification,Panama City,Panama,False,3,3,Panama
34583,36871,39205,2017,Paraguay,Uruguay,1,2,FIFA World Cup qualification,Asunción,Paraguay,False,3,-1,Uruguay
34584,36872,39206,2017,Philippines,Yemen,2,2,AFC Asian Cup qualification,Bacolod,Philippines,False,4,0,Draw
34585,36874,39208,2017,Saudi Arabia,Japan,1,0,FIFA World Cup qualification,Jeddah,Saudi Arabia,False,1,1,Saudi Arabia
34586,36875,39209,2017,Singapore,Turkmenistan,1,1,AFC Asian Cup qualification,Kallang,Singapore,False,2,0,Draw
34587,36876,39210,2017,Solomon Islands,New Zealand,2,2,FIFA World Cup qualification,Honiara,Solomon Islands,False,4,0,Draw
34588,36878,39212,2017,Turkey,Croatia,1,0,FIFA World Cup qualification,Eskişehir,Turkey,False,1,1,Turkey
34589,36880,39214,2017,Macau,Laos,3,1,Friendly,Macau,Macau,False,4,2,Macau
34590,36881,39215,2017,Argentina,Peru,0,0,FIFA World Cup qualification,Buenos Aires,Argentina,False,0,0,Draw
34591,36882,39216,2017,Armenia,Poland,1,6,FIFA World Cup qualification,Yerevan,Armenia,False,7,-5,Poland
34592,36883,39217,2017,Azerbaijan,Czech Republic,1,2,FIFA World Cup qualification,Baku,Azerbaijan,False,3,-1,Czech Republic
34593,36884,39218,2017,Bolivia,Brazil,0,0,FIFA World Cup qualification,La Paz,Bolivia,False,0,0,Draw
34594,36885,39219,2017,Burma,Thailand,1,3,Friendly,Mandalay,Burma,False,4,-2,Thailand
34595,36886,39220,2017,Chile,Ecuador,2,1,FIFA World Cup qualification,Santiago,Chile,False,3,1,Chile
34596,36887,39221,2017,Colombia,Paraguay,1,2,FIFA World Cup qualification,Barranquilla,Colombia,False,3,-1,Paraguay
34597,36888,39222,2017,England,Slovenia,1,0,FIFA World Cup qualification,London,England,False,1,1,England
34598,36889,39223,2017,Hong Kong,Laos,4,0,Friendly,Kowloon,Hong Kong,False,4,4,Hong Kong
34599,36890,39224,2017,Iran,Togo,2,0,Friendly,Teheran,Iran,False,2,2,Iran
34600,36891,39225,2017,Iraq,Kenya,2,1,Friendly,Basra,Iraq,False,3,1,Iraq
34601,36892,39226,2017,Malta,Lithuania,1,1,FIFA World Cup qualification,Attard,Malta,False,2,0,Draw
34602,36893,39227,2017,Montenegro,Denmark,0,1,FIFA World Cup qualification,Podgorica,Montenegro,False,1,-1,Denmark
34603,36894,39228,2017,Northern Ireland,Germany,1,3,FIFA World Cup qualification,Belfast,Northern Ireland,False,4,-2,Germany
34604,36895,39229,2017,Qatar,Singapore,3,1,Friendly,Doha,Qatar,False,4,2,Qatar
34605,36896,39230,2017,Romania,Kazakhstan,3,1,FIFA World Cup qualification,Ploieşti,Romania,False,4,2,Romania
34606,36897,39231,2017,San Marino,Norway,0,8,FIFA World Cup qualification,Serravalle,San Marino,False,8,-8,Norway
34607,36898,39232,2017,Scotland,Slovakia,1,0,FIFA World Cup qualification,Glasgow,Scotland,False,1,1,Scotland
34608,36899,39233,2017,Syria,Australia,1,1,FIFA World Cup qualification,Paya Rumput,Malaysia,True,2,0,Draw
34609,36900,39235,2017,Venezuela,Uruguay,0,0,FIFA World Cup qualification,San Cristóbal,Venezuela,False,0,0,Draw
34610,36901,39236,2017,Austria,Serbia,3,2,FIFA World Cup qualification,Vienna,Austria,False,5,1,Austria
34611,36902,39237,2017,Croatia,Finland,1,1,FIFA World Cup qualification,Rijeka,Croatia,False,2,0,Draw
34612,36903,39238,2017,Georgia,Wales,0,1,FIFA World Cup qualification,Tbilisi,Georgia,False,1,-1,Wales
34613,36904,39239,2017,Republic of Ireland,Moldova,2,0,FIFA World Cup qualification,Dublin,Republic of Ireland,False,2,2,Republic of Ireland
34614,36906,39241,2017,Japan,New Zealand,2,1,Friendly,Toyota,Japan,False,3,1,Japan
34615,36907,39242,2017,Kosovo,Ukraine,0,2,FIFA World Cup qualification,Shkodër,Albania,True,2,-2,Ukraine
34616,36908,39243,2017,Liechtenstein,Israel,0,1,FIFA World Cup qualification,Vaduz,Liechtenstein,False,1,-1,Israel
34617,36909,39244,2017,Mali,Ivory Coast,0,0,FIFA World Cup qualification,Bamako,Mali,False,0,0,Draw
34618,36910,39245,2017,Mauritania,Comoros,0,1,Friendly,La Marsa,Tunisia,True,1,-1,Comoros
34619,36911,39246,2017,Mexico,Trinidad and Tobago,3,1,FIFA World Cup qualification,San Luis Potosí,Mexico,False,4,2,Mexico
34620,36912,39247,2017,Spain,Albania,3,0,FIFA World Cup qualification,Alicante,Spain,False,3,3,Spain
34621,36913,39248,2017,Turkey,Iceland,0,3,FIFA World Cup qualification,Eskişehir,Turkey,False,3,-3,Iceland
34622,36914,39249,2017,United States,Panama,4,0,FIFA World Cup qualification,Orlando,United States,False,4,4,United States
34623,36915,39250,2017,Andorra,Portugal,0,2,FIFA World Cup qualification,Sant Julià de Lòria,Andorra,False,2,-2,Portugal
34624,36916,39251,2017,Belarus,Netherlands,1,3,FIFA World Cup qualification,Barysaw,Belarus,False,4,-2,Netherlands
34625,36917,39252,2017,Bosnia and Herzegovina,Belgium,3,4,FIFA World Cup qualification,Sarajevo,Bosnia and Herzegovina,False,7,-1,Belgium
34626,36918,39253,2017,Bulgaria,France,0,1,FIFA World Cup qualification,Sofia,Bulgaria,False,1,-1,France
34627,36919,39254,2017,Cameroon,Algeria,2,0,FIFA World Cup qualification,Yaoundé,Cameroon,False,2,2,Cameroon
34628,36920,39256,2017,Costa Rica,Honduras,1,1,FIFA World Cup qualification,San José,Costa Rica,False,2,0,Draw
34629,36921,39257,2017,Cyprus,Greece,1,2,FIFA World Cup qualification,Nicosia,Cyprus,False,3,-1,Greece
34630,36922,39258,2017,Faroe Islands,Latvia,0,0,FIFA World Cup qualification,Tórshavn,Faroe Islands,False,0,0,Draw
34631,36923,39259,2017,Gibraltar,Estonia,0,6,FIFA World Cup qualification,Faro,Portugal,True,6,-6,Estonia
34632,36924,39260,2017,Grenada,Guyana,1,0,Friendly,St. George's,Grenada,False,1,1,Grenada
34633,36925,39261,2017,Guinea,Tunisia,1,4,FIFA World Cup qualification,Conakry,Guinea,False,5,-3,Tunisia
34634,36926,39262,2017,Libya,DR Congo,1,2,FIFA World Cup qualification,Monastir,Tunisia,True,3,-1,DR Congo
34635,36927,39263,2017,Morocco,Gabon,3,0,FIFA World Cup qualification,Casablanca,Morocco,False,3,3,Morocco
34636,36928,39264,2017,Nigeria,Zambia,1,0,FIFA World Cup qualification,Uyo,Nigeria,False,1,1,Nigeria
34637,36930,39266,2017,Saudi Arabia,Jamaica,5,2,Friendly,Jeddah,Saudi Arabia,False,7,3,Saudi Arabia
34638,36931,39267,2017,South Africa,Burkina Faso,3,1,FIFA World Cup qualification,Johannesburg,South Africa,False,4,2,South Africa
34639,36932,39268,2017,Sweden,Luxembourg,8,0,FIFA World Cup qualification,Solna,Sweden,False,8,8,Sweden
34640,36933,39269,2017,Switzerland,Hungary,5,2,FIFA World Cup qualification,Basel,Switzerland,False,7,3,Switzerland
34641,36934,39270,2017,Tanzania,Malawi,1,1,Friendly,Dar es Salaam,Tanzania,False,2,0,Draw
34642,36935,39271,2017,Uganda,Ghana,0,0,FIFA World Cup qualification,Kampala,Uganda,False,0,0,Draw
34643,36936,39272,2017,Czech Republic,San Marino,5,0,FIFA World Cup qualification,Plzeň,Czech Republic,False,5,5,Czech Republic
34644,36937,39273,2017,Denmark,Romania,1,1,FIFA World Cup qualification,Copenhagen,Denmark,False,2,0,Draw
34645,36938,39274,2017,Egypt,Congo,2,1,FIFA World Cup qualification,Alexandria,Egypt,False,3,1,Egypt
34646,36939,39275,2017,El Salvador,Canada,1,0,Friendly,Houston,United States,True,1,1,El Salvador
34647,36940,39276,2017,Germany,Azerbaijan,5,1,FIFA World Cup qualification,Kaiserslautern,Germany,False,6,4,Germany
34648,36941,39277,2017,Kazakhstan,Armenia,1,1,FIFA World Cup qualification,Astana,Kazakhstan,False,2,0,Draw
34649,36942,39278,2017,Lithuania,England,0,1,FIFA World Cup qualification,Vilnius,Lithuania,False,1,-1,England
34650,36943,39279,2017,Norway,Northern Ireland,1,0,FIFA World Cup qualification,Oslo,Norway,False,1,1,Norway
34651,36944,39280,2017,Poland,Montenegro,4,2,FIFA World Cup qualification,Warsaw,Poland,False,6,2,Poland
34652,36945,39281,2017,Slovakia,Malta,3,0,FIFA World Cup qualification,Trnava,Slovakia,False,3,3,Slovakia
34653,36946,39282,2017,Slovenia,Scotland,2,2,FIFA World Cup qualification,Ljubljana,Slovenia,False,4,0,Draw
34654,36947,39283,2017,Thailand,Kenya,1,0,Friendly,Pak Kret,Thailand,False,1,1,Thailand
34655,36948,39284,2017,Albania,Italy,0,1,FIFA World Cup qualification,Shkodër,Albania,False,1,-1,Italy
34656,36949,39285,2017,Equatorial Guinea,Mauritius,3,1,Friendly,Bata,Equatorial Guinea,False,4,2,Equatorial Guinea
34657,36950,39286,2017,Finland,Turkey,2,2,FIFA World Cup qualification,Turku,Finland,False,4,0,Draw
34658,36951,39287,2017,Iceland,Kosovo,2,0,FIFA World Cup qualification,Reykjavík,Iceland,False,2,2,Iceland
34659,36952,39288,2017,Israel,Spain,0,1,FIFA World Cup qualification,Jerusalem,Israel,False,1,-1,Spain
34660,36953,39290,2017,Moldova,Austria,0,1,FIFA World Cup qualification,Chișinău,Moldova,False,1,-1,Austria
34661,36954,39291,2017,Serbia,Georgia,1,0,FIFA World Cup qualification,Belgrade,Serbia,False,1,1,Serbia
34662,36955,39292,2017,Ukraine,Croatia,0,2,FIFA World Cup qualification,Kyïv,Ukraine,False,2,-2,Croatia
34663,36956,39293,2017,Wales,Republic of Ireland,0,1,FIFA World Cup qualification,Cardiff,Wales,False,1,-1,Republic of Ireland
34664,36957,39294,2017,Afghanistan,Jordan,3,3,AFC Asian Cup qualification,Dushanbe,Tajikistan,True,6,0,Draw
34665,36958,39295,2017,Australia,Syria,2,1,FIFA World Cup qualification,Sydney,Australia,False,3,1,Australia
34666,36959,39296,2017,Belgium,Cyprus,4,0,FIFA World Cup qualification,Brussels,Belgium,False,4,4,Belgium
34667,36960,39297,2017,Benin,Gabon,1,0,Friendly,Salon-de-Provence,France,True,1,1,Benin
34668,36961,39298,2017,Brazil,Chile,3,0,FIFA World Cup qualification,São Paulo,Brazil,False,3,3,Brazil
34669,36962,39299,2017,Burma,Kyrgyzstan,2,2,AFC Asian Cup qualification,Rangoon,Burma,False,4,0,Draw
34670,36963,39300,2017,Ecuador,Argentina,1,3,FIFA World Cup qualification,Quito,Ecuador,False,4,-2,Argentina
34671,36964,39301,2017,Estonia,Bosnia and Herzegovina,1,2,FIFA World Cup qualification,Tallinn,Estonia,False,3,-1,Bosnia and Herzegovina
34672,36965,39302,2017,France,Belarus,2,1,FIFA World Cup qualification,Saint-Denis,France,False,3,1,France
34673,36966,39303,2017,Greece,Gibraltar,4,0,FIFA World Cup qualification,Piraeus,Greece,False,4,4,Greece
34674,36967,39304,2017,Honduras,Mexico,3,2,FIFA World Cup qualification,San Pedro Sula,Honduras,False,5,1,Honduras
34675,36968,39305,2017,Hong Kong,Malaysia,2,0,AFC Asian Cup qualification,So Kon Po,Hong Kong,False,2,2,Hong Kong
34676,36969,39306,2017,Hungary,Faroe Islands,1,0,FIFA World Cup qualification,Budapest,Hungary,False,1,1,Hungary
34677,36970,39307,2017,Japan,Haiti,3,3,Friendly,Yokohama,Japan,False,6,0,Draw
34678,36971,39309,2017,Latvia,Andorra,4,0,FIFA World Cup qualification,Riga,Latvia,False,4,4,Latvia
34679,36973,39311,2017,Luxembourg,Bulgaria,1,1,FIFA World Cup qualification,Luxembourg,Luxembourg,False,2,0,Draw
34680,36974,39312,2017,Maldives,Oman,1,3,AFC Asian Cup qualification,Malé,Maldives,False,4,-2,Oman
34681,36975,39313,2017,Netherlands,Sweden,2,0,FIFA World Cup qualification,Amsterdam,Netherlands,False,2,2,Netherlands
34682,36976,39314,2017,Palestine,Bhutan,10,0,AFC Asian Cup qualification,Hebron,Palestine,False,10,10,Palestine
34683,36977,39315,2017,Panama,Costa Rica,2,1,FIFA World Cup qualification,Panama City,Panama,False,3,1,Panama
34684,36978,39316,2017,Paraguay,Venezuela,0,1,FIFA World Cup qualification,Asunción,Paraguay,False,1,-1,Venezuela
34685,36979,39317,2017,Peru,Colombia,1,1,FIFA World Cup qualification,Lima,Peru,False,2,0,Draw
34686,36980,39318,2017,Portugal,Switzerland,2,0,FIFA World Cup qualification,Lisbon,Portugal,False,2,2,Portugal
34687,36981,39319,2017,Qatar,Curaçao,1,2,Friendly,Doha,Qatar,False,3,-1,Curaçao
34688,36982,39320,2017,Russia,Iran,1,1,Friendly,Kazan,Russia,False,2,0,Draw
34689,36983,39321,2017,Saudi Arabia,Ghana,0,3,Friendly,Jeddah,Saudi Arabia,False,3,-3,Ghana
34690,36984,39323,2017,Tajikistan,Nepal,3,0,AFC Asian Cup qualification,Hisor,Tajikistan,False,3,3,Tajikistan
34691,36985,39324,2017,Trinidad and Tobago,United States,2,1,FIFA World Cup qualification,Couva,Trinidad and Tobago,False,3,1,Trinidad and Tobago
34692,36986,39325,2017,Turkmenistan,Singapore,2,1,AFC Asian Cup qualification,Ashgabat,Turkmenistan,False,3,1,Turkmenistan
34693,36987,39326,2017,Uruguay,Bolivia,4,2,FIFA World Cup qualification,Montevideo,Uruguay,False,6,2,Uruguay
34694,36988,39327,2017,Vietnam,Cambodia,5,0,AFC Asian Cup qualification,Hanoi,Vietnam,False,5,5,Vietnam
34695,36989,39328,2017,Yemen,Philippines,1,1,AFC Asian Cup qualification,al-Wakrah,Qatar,True,2,0,Draw
34696,36990,39329,2017,India,Macau,4,1,AFC Asian Cup qualification,Bangalore,India,False,5,3,India
34697,36991,39330,2017,Grenada,Panama,0,5,Friendly,St. George's,Grenada,False,5,-5,Panama
34698,36992,39331,2017,Bermuda,Barbados,2,3,Friendly,Hamilton,Bermuda,False,5,-1,Barbados
34699,36993,39332,2017,Congo,Benin,1,1,Friendly,Brazzaville,Congo,False,2,0,Draw
34700,36994,39333,2017,Iceland,Czech Republic,1,2,Friendly,Doha,Qatar,True,3,-1,Czech Republic
34701,36995,39334,2017,Nicaragua,Dominican Republic,0,3,Friendly,Diriamba,Nicaragua,False,3,-3,Dominican Republic
34702,36996,39335,2017,Armenia,Belarus,4,1,Friendly,Yerevan,Armenia,False,5,3,Armenia
34703,36997,39336,2017,Cambodia,Burma,1,2,Friendly,Phnom Penh,Cambodia,False,3,-1,Burma
34704,36998,39337,2017,Croatia,Greece,4,1,FIFA World Cup qualification,Zagreb,Croatia,False,5,3,Croatia
34705,36999,39338,2017,Finland,Estonia,3,0,Friendly,Helsinki,Finland,False,3,3,Finland
34706,37000,39339,2017,Hong Kong,Bahrain,0,2,Friendly,Kowloon,Hong Kong,False,2,-2,Bahrain
34707,37001,39340,2017,Iran,Panama,2,1,Friendly,Graz,Austria,True,3,1,Iran
34708,37002,39341,2017,Luxembourg,Hungary,2,1,Friendly,Luxembourg,Luxembourg,False,3,1,Luxembourg
34709,37003,39342,2017,Northern Ireland,Switzerland,0,1,FIFA World Cup qualification,Belfast,Northern Ireland,False,1,-1,Switzerland
34710,37004,39343,2017,Romania,Turkey,2,0,Friendly,Cluj,Romania,False,2,2,Romania
34711,37005,39344,2017,Scotland,Netherlands,0,1,Friendly,Aberdeen,Scotland,False,1,-1,Netherlands
34712,37006,39345,2017,Singapore,Lebanon,0,1,Friendly,Kallang,Singapore,False,1,-1,Lebanon
34713,37007,39346,2017,Algeria,Nigeria,3,0,FIFA World Cup qualification,Constantine,Algeria,False,3,3,Algeria
34714,37008,39347,2017,Belgium,Mexico,3,3,Friendly,Brussels,Belgium,False,6,0,Draw
34715,37009,39349,2017,England,Germany,0,0,Friendly,London,England,False,0,0,Draw
34716,37010,39350,2017,France,Wales,2,0,Friendly,Saint-Denis,France,False,2,2,France
34717,37011,39351,2017,Georgia,Cyprus,1,0,Friendly,Gori,Georgia,False,1,1,Georgia
34718,37012,39352,2017,Honduras,Australia,0,0,FIFA World Cup qualification,San Pedro Sula,Honduras,False,0,0,Draw
34719,37013,39353,2017,Japan,Brazil,1,3,Friendly,Villeneuve-d'Ascq,France,True,4,-2,Brazil
34720,37014,39356,2017,Poland,Uruguay,0,0,Friendly,Warsaw,Poland,False,0,0,Draw
34721,37015,39357,2017,Portugal,Saudi Arabia,3,0,Friendly,Viseu,Portugal,False,3,3,Portugal
34722,37016,39358,2017,South Africa,Senegal,0,2,FIFA World Cup qualification,Polokwane,South Africa,False,2,-2,Senegal
34723,37017,39359,2017,Sweden,Italy,1,0,FIFA World Cup qualification,Solna,Sweden,False,1,1,Sweden
34724,37018,39360,2017,Ukraine,Slovakia,2,1,Friendly,L'viv,Ukraine,False,3,1,Ukraine
34725,37019,39361,2017,Comoros,Madagascar,1,1,Friendly,Saint-Leu-la-Forêt,France,True,2,0,Draw
34726,37020,39362,2017,DR Congo,Guinea,3,1,FIFA World Cup qualification,Kinshasa,DR Congo,False,4,2,DR Congo
34727,37021,39363,2017,Denmark,Republic of Ireland,0,0,FIFA World Cup qualification,Copenhagen,Denmark,False,0,0,Draw
34728,37022,39364,2017,Dominican Republic,Nicaragua,1,0,Friendly,San Cristóbal,Dominican Republic,False,1,1,Dominican Republic
34729,37023,39365,2017,Gabon,Mali,0,0,FIFA World Cup qualification,Franceville,Gabon,False,0,0,Draw
34730,37024,39366,2017,Ivory Coast,Morocco,0,2,FIFA World Cup qualification,Abidjan,Ivory Coast,False,2,-2,Morocco
34731,37025,39368,2017,Malawi,Lesotho,1,1,Friendly,Lilongwe,Malawi,False,2,0,Draw
34732,37026,39369,2017,Namibia,Zimbabwe,3,1,Friendly,Windhoek,Namibia,False,4,2,Namibia
34733,37027,39370,2017,New Zealand,Peru,0,0,FIFA World Cup qualification,Wellington,New Zealand,False,0,0,Draw
34734,37028,39371,2017,Qatar,Czech Republic,0,1,Friendly,Doha,Qatar,False,1,-1,Czech Republic
34735,37029,39372,2017,Russia,Argentina,0,1,Friendly,Moscow,Russia,False,1,-1,Argentina
34736,37030,39373,2017,Spain,Costa Rica,5,0,Friendly,Málaga,Spain,False,5,5,Spain
34737,37031,39374,2017,Trinidad and Tobago,Grenada,2,2,Friendly,Couva,Trinidad and Tobago,False,4,0,Draw
34738,37032,39375,2017,Tunisia,Libya,0,0,FIFA World Cup qualification,Radès,Tunisia,False,0,0,Draw
34739,37033,39376,2017,Zambia,Cameroon,2,2,FIFA World Cup qualification,Ndola,Zambia,False,4,0,Draw
34740,37034,39377,2017,Benin,Tanzania,1,1,Friendly,Cotonou,Benin,False,2,0,Draw
34741,37035,39378,2017,Congo,Uganda,1,1,FIFA World Cup qualification,Brazzaville,Congo,False,2,0,Draw
34742,37036,39379,2017,Ghana,Egypt,1,1,FIFA World Cup qualification,Kumasi,Ghana,False,2,0,Draw
34743,37037,39380,2017,Greece,Croatia,0,0,FIFA World Cup qualification,Piraeus,Greece,False,0,0,Draw
34744,37038,39381,2017,Malta,Estonia,0,3,Friendly,Attard,Malta,False,3,-3,Estonia
34745,37039,39382,2017,Switzerland,Northern Ireland,0,0,FIFA World Cup qualification,Basel,Switzerland,False,0,0,Draw
34746,37040,39383,2017,Togo,Mauritius,6,0,Friendly,Lomé,Togo,False,6,6,Togo
34747,37041,39384,2017,Armenia,Cyprus,3,2,Friendly,Yerevan,Armenia,False,5,1,Armenia
34748,37042,39385,2017,Bulgaria,Saudi Arabia,1,0,Friendly,Lisbon,Portugal,True,1,1,Bulgaria
34749,37043,39386,2017,Georgia,Belarus,2,2,Friendly,Kutaisi,Georgia,False,4,0,Draw
34750,37044,39387,2017,Iran,Venezuela,1,0,Friendly,Arnhem,Netherlands,True,1,1,Iran
34751,37045,39388,2017,Iraq,Syria,1,1,Friendly,Karbala,Iraq,False,2,0,Draw
34752,37046,39389,2017,Italy,Sweden,0,0,FIFA World Cup qualification,Milan,Italy,False,0,0,Draw
34753,37047,39390,2017,Kosovo,Latvia,4,3,Friendly,Mitrovica,Kosovo,False,7,1,Kosovo
34754,37049,39392,2017,Poland,Mexico,0,1,Friendly,Gdańsk,Poland,False,1,-1,Mexico
34755,37050,39393,2017,Turkey,Albania,2,3,Friendly,Antalya,Turkey,False,5,-1,Albania
34756,37051,39394,2017,Algeria,Central African Republic,3,0,Friendly,Algiers,Algeria,False,3,3,Algeria
34757,37052,39395,2017,Argentina,Nigeria,2,4,Friendly,Krasnodar,Russia,True,6,-2,Nigeria
34758,37053,39396,2017,Austria,Uruguay,2,1,Friendly,Vienna,Austria,False,3,1,Austria
34759,37054,39397,2017,Belgium,Japan,1,0,Friendly,Bruges,Belgium,False,1,1,Belgium
34760,37055,39398,2017,Bhutan,Oman,2,4,AFC Asian Cup qualification,Thimphu,Bhutan,False,6,-2,Oman
34761,37057,39400,2017,Cambodia,Jordan,0,1,AFC Asian Cup qualification,Phnom Penh,Cambodia,False,1,-1,Jordan
34762,37058,39402,2017,England,Brazil,0,0,Friendly,London,England,False,0,0,Draw
34763,37059,39403,2017,Gabon,Botswana,0,0,Friendly,Franceville,Gabon,False,0,0,Draw
34764,37060,39404,2017,Germany,France,2,2,Friendly,Cologne,Germany,False,4,0,Draw
34765,37061,39405,2017,Hong Kong,Lebanon,0,1,AFC Asian Cup qualification,So Kon Po,Hong Kong,False,1,-1,Lebanon
34766,37062,39406,2017,Hungary,Costa Rica,1,0,Friendly,Budapest,Hungary,False,1,1,Hungary
34767,37063,39407,2017,India,Burma,2,2,AFC Asian Cup qualification,Margao,India,False,4,0,Draw
34768,37064,39408,2017,Republic of Ireland,Denmark,1,5,FIFA World Cup qualification,Dublin,Republic of Ireland,False,6,-4,Denmark
34769,37065,39410,2017,Macau,Kyrgyzstan,3,4,AFC Asian Cup qualification,Macau,Macau,False,7,-1,Kyrgyzstan
34770,37066,39411,2017,Nepal,Philippines,0,0,AFC Asian Cup qualification,Lalitpur,Nepal,False,0,0,Draw
34771,37067,39412,2017,Palestine,Maldives,8,1,AFC Asian Cup qualification,Jenin,Palestine,False,9,7,Palestine
34772,37068,39413,2017,Portugal,United States,1,1,Friendly,Leiria,Portugal,False,2,0,Draw
34773,37069,39414,2017,Qatar,Iceland,1,1,Friendly,Doha,Qatar,False,2,0,Draw
34774,37070,39415,2017,Romania,Netherlands,0,3,Friendly,Bucharest,Romania,False,3,-3,Netherlands
34775,37071,39416,2017,Russia,Spain,3,3,Friendly,St. Petersburg,Russia,False,6,0,Draw
34776,37072,39417,2017,Senegal,South Africa,2,1,FIFA World Cup qualification,Dakar,Senegal,False,3,1,Senegal
34777,37073,39418,2017,Singapore,Bahrain,0,3,AFC Asian Cup qualification,Kallang,Singapore,False,3,-3,Bahrain
34778,37074,39419,2017,Slovakia,Norway,1,0,Friendly,Trnava,Slovakia,False,1,1,Slovakia
34779,37075,39420,2017,Tajikistan,Yemen,0,0,AFC Asian Cup qualification,Hisor,Tajikistan,False,0,0,Draw
34780,37076,39421,2017,Trinidad and Tobago,Guyana,1,1,Friendly,Couva,Trinidad and Tobago,False,2,0,Draw
34781,37078,39423,2017,United Arab Emirates,Uzbekistan,1,0,Friendly,al-Ain,United Arab Emirates,False,1,1,United Arab Emirates
34782,37079,39424,2017,Vietnam,Afghanistan,0,0,AFC Asian Cup qualification,Hanoi,Vietnam,False,0,0,Draw
34783,37080,39425,2017,Wales,Panama,1,1,Friendly,Cardiff,Wales,False,2,0,Draw
34784,37081,39426,2017,Australia,Honduras,3,1,FIFA World Cup qualification,Sydney,Australia,False,4,2,Australia
34785,37082,39427,2017,Peru,New Zealand,2,0,FIFA World Cup qualification,Lima,Peru,False,2,2,Peru
34786,37083,39428,2017,Fiji,Estonia,0,2,Friendly,Suva,Fiji,False,2,-2,Estonia
34787,37084,39429,2017,Vanuatu,Estonia,0,1,Friendly,Port Vila,Vanuatu,False,1,-1,Estonia
34788,37085,39430,2017,Indonesia,Guyana,2,1,Friendly,Cikarang,Indonesia,False,3,1,Indonesia
34789,37086,39431,2017,New Caledonia,Estonia,1,1,Friendly,Nouméa,New Caledonia,False,2,0,Draw
34790,37087,39432,2017,Laos,Philippines,1,3,Friendly,Taipei,Chinese Taipei,True,4,-2,Philippines
34791,37088,39433,2017,Fiji,Tuvalu,8,0,Friendly,Port Vila,Vanuatu,True,8,8,Fiji
34792,37089,39434,2017,Indonesia,Brunei,4,0,Friendly,Banda Aceh,Indonesia,False,4,4,Indonesia
34793,37090,39435,2017,Kyrgyzstan,Mongolia,3,0,Friendly,Banda Aceh,Indonesia,True,3,3,Kyrgyzstan
34794,37091,39436,2017,Tonga,Solomon Islands,0,8,Friendly,Port Vila,Vanuatu,True,8,-8,Solomon Islands
34795,37092,39437,2017,Kenya,Rwanda,2,0,CECAFA Cup,Kakamega,Kenya,False,2,2,Kenya
34796,37093,39438,2017,Laos,East Timor,2,1,Friendly,Taipei,Chinese Taipei,True,3,1,Laos
34797,37094,39439,2017,Libya,Tanzania,0,0,CECAFA Cup,Machakos,Kenya,True,0,0,Draw
34798,37095,39440,2017,Saint Kitts and Nevis,Grenada,1,0,Friendly,Basseterre,Saint Kitts and Nevis,False,1,1,Saint Kitts and Nevis
34799,37096,39442,2017,Brunei,Kyrgyzstan,0,4,Friendly,Banda Aceh,Indonesia,True,4,-4,Kyrgyzstan
34800,37097,39443,2017,Indonesia,Mongolia,3,2,Friendly,Banda Aceh,Indonesia,False,5,1,Indonesia
34801,37098,39445,2017,Uganda,Burundi,0,0,CECAFA Cup,Kakamega,Kenya,True,0,0,Draw
34802,37099,39446,2017,East Timor,Philippines,1,0,Friendly,Taipei,Chinese Taipei,True,1,1,East Timor
34803,37100,39447,2017,Kenya,Libya,0,0,CECAFA Cup,Machakos,Kenya,False,0,0,Draw
34804,37101,39448,2017,South Sudan,Ethiopia,0,3,CECAFA Cup,Kakamega,Kenya,True,3,-3,Ethiopia
34805,37102,39451,2017,Indonesia,Kyrgyzstan,0,1,Friendly,Banda Aceh,Indonesia,False,1,-1,Kyrgyzstan
34806,37103,39452,2017,Solomon Islands,Fiji,0,0,Friendly,Port Vila,Vanuatu,True,0,0,Draw
34807,37104,39453,2017,Vanuatu,Tonga,5,0,Friendly,Port Vila,Vanuatu,False,5,5,Vanuatu
34808,37105,39454,2017,Burundi,Ethiopia,4,1,CECAFA Cup,Kakamega,Kenya,True,5,3,Burundi
34809,37106,39455,2017,Rwanda,Libya,0,0,CECAFA Cup,Machakos,Kenya,True,0,0,Draw
34810,37108,39457,2017,Uganda,South Sudan,5,1,CECAFA Cup,Kakamega,Kenya,True,6,4,Uganda
34811,37111,39461,2017,Rwanda,Tanzania,2,1,CECAFA Cup,Machakos,Kenya,True,3,1,Rwanda
34812,37112,39462,2017,Solomon Islands,Tuvalu,6,0,Friendly,Port Vila,Vanuatu,True,6,6,Solomon Islands
34813,37113,39463,2017,Vanuatu,Fiji,1,1,Friendly,Port Vila,Vanuatu,False,2,0,Draw
34814,37114,39464,2017,Ethiopia,Uganda,1,1,CECAFA Cup,Kakamega,Kenya,True,2,0,Draw
34815,37115,39465,2017,Kenya,Tanzania,1,0,CECAFA Cup,Machakos,Kenya,False,1,1,Kenya
34816,37117,39467,2017,South Sudan,Burundi,0,0,CECAFA Cup,Kakamega,Kenya,True,0,0,Draw
34817,37118,39468,2017,Fiji,Tonga,4,0,Friendly,Port Vila,Vanuatu,True,4,4,Fiji
34818,37120,39471,2017,Vanuatu,Tuvalu,10,0,Friendly,Port Vila,Vanuatu,False,10,10,Vanuatu
34819,37121,39472,2017,Kenya,Burundi,1,0,CECAFA Cup,Kisumu,Kenya,False,1,1,Kenya
34820,37122,39473,2017,Qatar,Liechtenstein,1,2,Friendly,Doha,Qatar,False,3,-1,Liechtenstein
34821,37123,39474,2017,Tuvalu,Tonga,4,3,Friendly,Port Vila,Vanuatu,True,7,1,Tuvalu
34822,37125,39476,2017,Vanuatu,Solomon Islands,3,2,Friendly,Port Vila,Vanuatu,False,5,1,Vanuatu
34823,37127,39479,2017,Burundi,Uganda,1,2,CECAFA Cup,Machakos,Kenya,True,3,-1,Uganda
34824,37129,39481,2017,Bahrain,Kuwait,0,0,Friendly,Riffa,Bahrain,False,0,0,Draw
34825,37130,39482,2017,Kuwait,Saudi Arabia,1,2,Friendly,Kuwait City,Kuwait,False,3,-1,Saudi Arabia
34826,37131,39483,2017,Oman,United Arab Emirates,0,1,Friendly,Kuwait City,Kuwait,True,1,-1,United Arab Emirates
34827,37132,39484,2017,Bahrain,Iraq,1,1,Friendly,Kuwait City,Kuwait,True,2,0,Draw
34828,37133,39485,2017,Qatar,Yemen,4,0,Friendly,Kuwait City,Kuwait,True,4,4,Qatar
34829,37134,39486,2017,Jordan,Libya,1,1,Friendly,Amman,Jordan,False,2,0,Draw
34830,37135,39487,2017,Kuwait,Oman,0,1,Friendly,Kuwait City,Kuwait,False,1,-1,Oman
34831,37136,39488,2017,United Arab Emirates,Saudi Arabia,0,0,Friendly,Kuwait City,Kuwait,True,0,0,Draw
34832,37137,39489,2017,Iraq,Qatar,2,1,Friendly,Kuwait City,Kuwait,True,3,1,Iraq
34833,37138,39490,2017,Yemen,Bahrain,0,1,Friendly,Kuwait City,Kuwait,True,1,-1,Bahrain
34834,37139,39491,2017,Kuwait,United Arab Emirates,0,0,Friendly,Kuwait City,Kuwait,False,0,0,Draw
34835,37140,39492,2017,Saudi Arabia,Oman,0,2,Friendly,Kuwait City,Kuwait,True,2,-2,Oman
34836,37141,39493,2017,Iraq,Yemen,3,0,Friendly,Kuwait City,Kuwait,True,3,3,Iraq
34837,37142,39494,2017,Qatar,Bahrain,1,1,Friendly,Kuwait City,Kuwait,True,2,0,Draw
34838,37143,39495,2018,Iraq,United Arab Emirates,0,0,Friendly,Kuwait City,Kuwait,True,0,0,Draw
34839,37144,39496,2018,Oman,Bahrain,1,0,Friendly,Kuwait City,Kuwait,True,1,1,Oman
34840,37145,39497,2018,Oman,United Arab Emirates,0,0,Friendly,Kuwait City,Kuwait,True,0,0,Draw
34841,37146,39498,2018,Estonia,Sweden,1,1,Friendly,Abu Dhabi,United Arab Emirates,True,2,0,Draw
34842,37147,39499,2018,Denmark,Sweden,0,1,Friendly,Abu Dhabi,United Arab Emirates,True,1,-1,Sweden
34843,37148,39500,2018,Indonesia,Iceland,0,6,Friendly,Sleman,Indonesia,False,6,-6,Iceland
34844,37149,39501,2018,Jordan,Finland,1,2,Friendly,Abu Dhabi,United Arab Emirates,True,3,-1,Finland
34845,37150,39502,2018,Morocco,Mauritania,4,0,African Nations Championship,Casablanca,Morocco,False,4,4,Morocco
34846,37151,39503,2018,Indonesia,Iceland,1,4,Friendly,Jakarta,Indonesia,False,5,-3,Iceland
34847,37152,39504,2018,Guinea,Sudan,1,2,African Nations Championship,Casablanca,Morocco,True,3,-1,Sudan
34848,37153,39505,2018,Ivory Coast,Namibia,0,1,African Nations Championship,Marrakech,Morocco,True,1,-1,Namibia
34849,37154,39506,2018,Zambia,Uganda,3,1,African Nations Championship,Marrakech,Morocco,True,4,2,Zambia
34850,37155,39507,2018,Libya,Equatorial Guinea,3,0,African Nations Championship,Tangiers,Morocco,True,3,3,Libya
34851,37156,39508,2018,Nigeria,Rwanda,0,0,African Nations Championship,Tangiers,Morocco,True,0,0,Draw
34852,37157,39509,2018,Angola,Burkina Faso,0,0,African Nations Championship,Agadir,Morocco,True,0,0,Draw
34853,37158,39510,2018,Cameroon,Congo,0,1,African Nations Championship,Agadir,Morocco,True,1,-1,Congo
34854,37159,39511,2018,Morocco,Guinea,3,1,African Nations Championship,Casablanca,Morocco,False,4,2,Morocco
34855,37160,39512,2018,Sudan,Mauritania,1,0,African Nations Championship,Casablanca,Morocco,True,1,1,Sudan
34856,37161,39513,2018,Ivory Coast,Zambia,0,2,African Nations Championship,Marrakech,Morocco,True,2,-2,Zambia
34857,37162,39514,2018,Uganda,Namibia,0,1,African Nations Championship,Marrakech,Morocco,True,1,-1,Namibia
34858,37163,39515,2018,Libya,Nigeria,0,1,African Nations Championship,Tangiers,Morocco,True,1,-1,Nigeria
34859,37164,39516,2018,Rwanda,Equatorial Guinea,1,0,African Nations Championship,Tangiers,Morocco,True,1,1,Rwanda
34860,37165,39517,2018,Angola,Cameroon,1,0,African Nations Championship,Agadir,Morocco,True,1,1,Angola
34861,37166,39518,2018,Congo,Burkina Faso,2,0,African Nations Championship,Agadir,Morocco,True,2,2,Congo
34862,37167,39519,2018,Mauritania,Guinea,0,1,African Nations Championship,Marrakech,Morocco,True,1,-1,Guinea
34863,37168,39520,2018,Sudan,Morocco,0,0,African Nations Championship,Casablanca,Morocco,True,0,0,Draw
34864,37169,39521,2018,Namibia,Zambia,1,1,African Nations Championship,Casablanca,Morocco,True,2,0,Draw
34865,37170,39522,2018,Uganda,Ivory Coast,0,0,African Nations Championship,Marrakech,Morocco,True,0,0,Draw
34866,37171,39523,2018,Equatorial Guinea,Nigeria,1,3,African Nations Championship,Agadir,Morocco,True,4,-2,Nigeria
34867,37172,39524,2018,Rwanda,Libya,0,1,African Nations Championship,Tangiers,Morocco,True,1,-1,Libya
34868,37173,39525,2018,Burkina Faso,Cameroon,1,1,African Nations Championship,Tangiers,Morocco,True,2,0,Draw
34869,37174,39526,2018,Congo,Angola,0,0,African Nations Championship,Agadir,Morocco,True,0,0,Draw
34870,37176,39528,2018,Morocco,Namibia,2,0,African Nations Championship,Casablanca,Morocco,False,2,2,Morocco
34871,37177,39529,2018,Zambia,Sudan,0,1,African Nations Championship,Marrakech,Morocco,True,1,-1,Sudan
34872,37178,39530,2018,United States,Bosnia and Herzegovina,0,0,Friendly,Carson,United States,False,0,0,Draw
34873,37179,39531,2018,Congo,Libya,1,1,African Nations Championship,Agadir,Morocco,True,2,0,Draw
34874,37180,39532,2018,Nigeria,Angola,2,1,African Nations Championship,Tangiers,Morocco,True,3,1,Nigeria
34875,37181,39534,2018,Azerbaijan,Moldova,0,0,Friendly,Antalya,Turkey,True,0,0,Draw
34876,37183,39536,2018,Mexico,Bosnia and Herzegovina,1,0,Friendly,San Antonio,United States,True,1,1,Mexico
34877,37184,39537,2018,Morocco,Libya,3,1,African Nations Championship,Casablanca,Morocco,False,4,2,Morocco
34878,37185,39538,2018,Sudan,Nigeria,0,1,African Nations Championship,Marrakech,Morocco,True,1,-1,Nigeria
34879,37187,39540,2018,Libya,Sudan,1,1,African Nations Championship,Marrakech,Morocco,True,2,0,Draw
34880,37188,39541,2018,Morocco,Nigeria,4,0,African Nations Championship,Casablanca,Morocco,False,4,4,Morocco
34881,37189,39542,2018,Saudi Arabia,Moldova,3,0,Friendly,Jeddah,Saudi Arabia,False,3,3,Saudi Arabia
34882,37190,39543,2018,Iraq,Saudi Arabia,4,1,Friendly,Basra,Iraq,False,5,3,Iraq
34883,37191,39544,2018,Iran,Sierra Leone,4,0,Friendly,Teheran,Iran,False,4,4,Iran
34884,37192,39545,2018,Andorra,Liechtenstein,1,0,Friendly,La Línea de la Concepción,Spain,True,1,1,Andorra
34885,37193,39546,2018,Antigua and Barbuda,Bermuda,3,2,Friendly,St. John's,Antigua and Barbuda,False,5,1,Antigua and Barbuda
34886,37194,39547,2018,Iraq,Qatar,2,3,Friendly,Basra,Iraq,False,5,-1,Qatar
34887,37195,39548,2018,Jordan,Kuwait,1,0,Friendly,Amman,Jordan,False,1,1,Jordan
34888,37196,39549,2018,Laos,Cambodia,0,1,Friendly,Vientiane,Laos,False,1,-1,Cambodia
34889,37197,39550,2018,Madagascar,Togo,0,0,Friendly,Saint-Leu-la-Forêt,France,True,0,0,Draw
34890,37198,39551,2018,South Africa,Angola,1,1,Friendly,Ndola,Zambia,True,2,0,Draw
34891,37199,39553,2018,Zambia,Zimbabwe,2,2,Friendly,Ndola,Zambia,False,4,0,Draw
34892,37200,39554,2018,Algeria,Tanzania,4,1,Friendly,Algiers,Algeria,False,5,3,Algeria
34893,37201,39555,2018,Bahrain,Palestine,0,0,Friendly,Riffa,Bahrain,False,0,0,Draw
34894,37202,39556,2018,Belize,Grenada,4,2,Friendly,Belmopan,Belize,False,6,2,Belize
34895,37203,39557,2018,Burkina Faso,Guinea-Bissau,2,0,Friendly,Limeil-Brévannes,France,True,2,2,Burkina Faso
34896,37204,39559,2018,Denmark,Panama,1,0,Friendly,Brøndby,Denmark,False,1,1,Denmark
34897,37205,39560,2018,Dominican Republic,Turks and Caicos Islands,4,0,Friendly,Santo Domingo,Dominican Republic,False,4,4,Dominican Republic
34898,37206,39561,2018,Faroe Islands,Latvia,1,1,Friendly,San Pedro de Alcántara,Spain,True,2,0,Draw
34899,37207,39562,2018,Kyrgyzstan,Burma,5,1,AFC Asian Cup qualification,Incheon,South Korea,True,6,4,Kyrgyzstan
34900,37208,39563,2018,Macau,Mauritius,0,1,Friendly,Macau,Macau,False,1,-1,Mauritius
34901,37209,39564,2018,Malaysia,Mongolia,2,2,Friendly,Kuala Lumpur,Malaysia,False,4,0,Draw
34902,37210,39565,2018,Malta,Luxembourg,0,1,Friendly,Attard,Malta,False,1,-1,Luxembourg
34903,37211,39566,2018,Nicaragua,Cuba,3,1,Friendly,Managua,Nicaragua,False,4,2,Nicaragua
34904,37212,39567,2018,Philippines,Fiji,3,2,Friendly,Manila,Philippines,False,5,1,Philippines
34905,37213,39568,2018,Slovakia,United Arab Emirates,2,1,Friendly,Bangkok,Thailand,True,3,1,Slovakia
34906,37214,39569,2018,Thailand,Gabon,0,0,Friendly,Bangkok,Thailand,False,0,0,Draw
34907,37215,39570,2018,Austria,Slovenia,3,0,Friendly,Klagenfurt,Austria,False,3,3,Austria
34908,37216,39571,2018,Azerbaijan,Belarus,0,1,Friendly,Baku,Azerbaijan,False,1,-1,Belarus
34909,37217,39572,2018,Bulgaria,Bosnia and Herzegovina,0,1,Friendly,Razgrad,Bulgaria,False,1,-1,Bosnia and Herzegovina
34910,37218,39573,2018,Curaçao,Bolivia,1,1,Friendly,Willemstad,Curaçao,False,2,0,Draw
34911,37219,39574,2018,Cyprus,Montenegro,0,0,Friendly,Nicosia,Cyprus,False,0,0,Draw
34912,37221,39576,2018,France,Colombia,2,3,Friendly,Saint-Denis,France,False,5,-1,Colombia
34913,37222,39577,2018,Gambia,Central African Republic,1,1,Friendly,Bakau,Gambia,False,2,0,Draw
34914,37223,39578,2018,Germany,Spain,1,1,Friendly,Düsseldorf,Germany,False,2,0,Draw
34915,37224,39579,2018,Greece,Switzerland,0,1,Friendly,Athens,Greece,False,1,-1,Switzerland
34916,37225,39580,2018,Guadeloupe,Trinidad and Tobago,0,1,Friendly,Les Abymes,Guadeloupe,False,1,-1,Trinidad and Tobago
34917,37226,39581,2018,Hungary,Kazakhstan,2,3,Friendly,Budapest,Hungary,False,5,-1,Kazakhstan
34918,37227,39582,2018,Italy,Argentina,0,2,Friendly,Manchester,England,True,2,-2,Argentina
34919,37228,39583,2018,Japan,Mali,1,1,Friendly,Liège,Belgium,True,2,0,Draw
34920,37229,39584,2018,Mexico,Iceland,3,0,Friendly,Santa Clara,United States,True,3,3,Mexico
34921,37230,39585,2018,Netherlands,England,0,1,Friendly,Amsterdam,Netherlands,False,1,-1,England
34922,37231,39586,2018,Norway,Australia,4,1,Friendly,Oslo,Norway,False,5,3,Norway
34923,37232,39587,2018,Peru,Croatia,2,0,Friendly,Miami Gardens,United States,True,2,2,Peru
34924,37233,39588,2018,Poland,Nigeria,0,1,Friendly,Wrocław,Poland,False,1,-1,Nigeria
34925,37234,39589,2018,Portugal,Egypt,2,1,Friendly,Zürich,Switzerland,True,3,1,Portugal
34926,37235,39590,2018,Russia,Brazil,0,3,Friendly,Moscow,Russia,False,3,-3,Brazil
34927,37236,39591,2018,Scotland,Costa Rica,0,1,Friendly,Glasgow,Scotland,False,1,-1,Costa Rica
34928,37237,39592,2018,Senegal,Uzbekistan,1,1,Friendly,Casablanca,Morocco,True,2,0,Draw
34929,37238,39593,2018,Serbia,Morocco,1,2,Friendly,Turin,Italy,True,3,-1,Morocco
34930,37239,39594,2018,Singapore,Maldives,3,2,Friendly,Kallang,Singapore,False,5,1,Singapore
34931,37240,39595,2018,Tunisia,Iran,1,0,Friendly,Radès,Tunisia,False,1,1,Tunisia
34932,37241,39596,2018,Turkey,Republic of Ireland,1,0,Friendly,Antalya,Turkey,False,1,1,Turkey
34933,37242,39597,2018,Ukraine,Saudi Arabia,1,1,Friendly,Marbella,Spain,True,2,0,Draw
34934,37243,39598,2018,Uruguay,Czech Republic,2,0,Friendly,Nanning,China PR,True,2,2,Uruguay
34935,37244,39599,2018,Angola,Zimbabwe,2,2,Friendly,Ndola,Zambia,True,4,0,Draw
34936,37245,39600,2018,Armenia,Estonia,0,0,Friendly,Yerevan,Armenia,False,0,0,Draw
34937,37246,39601,2018,Botswana,Lesotho,1,0,Friendly,Gaborone,Botswana,False,1,1,Botswana
34938,37247,39602,2018,Canada,New Zealand,1,0,Friendly,San Pedro del Pinatar,Spain,True,1,1,Canada
34939,37248,39603,2018,Comoros,Kenya,2,2,Friendly,Marrakech,Morocco,True,4,0,Draw
34940,37249,39604,2018,Georgia,Lithuania,4,0,Friendly,Tbilisi,Georgia,False,4,4,Georgia
34941,37250,39605,2018,Israel,Romania,1,2,Friendly,Netanya,Israel,False,3,-1,Romania
34942,37251,39606,2018,Ivory Coast,Togo,2,2,Friendly,Beauvais,France,True,4,0,Draw
34943,37252,39607,2018,Kosovo,Madagascar,1,0,Friendly,Franconville,France,True,1,1,Kosovo
34944,37253,39608,2018,Mauritania,Guinea,2,0,Friendly,Nouakchott,Mauritania,False,2,2,Mauritania
34945,37255,39610,2018,Qatar,Syria,2,2,Friendly,Basra,Iraq,True,4,0,Draw
34946,37256,39611,2018,Sweden,Chile,1,2,Friendly,Solna,Sweden,False,3,-1,Chile
34947,37257,39613,2018,Uganda,São Tomé and Príncipe,3,1,Friendly,Kampala,Uganda,False,4,2,Uganda
34948,37258,39614,2018,Zambia,South Africa,0,2,Friendly,Ndola,Zambia,False,2,-2,South Africa
34949,37259,39615,2018,Barbados,Bermuda,0,0,Friendly,Bridgetown,Barbados,False,0,0,Draw
34950,37260,39616,2018,Dominican Republic,Saint Kitts and Nevis,2,1,Friendly,Santiago,Dominican Republic,False,3,1,Dominican Republic
34951,37261,39617,2018,Faroe Islands,Liechtenstein,3,0,Friendly,Marbella,Spain,True,3,3,Faroe Islands
34952,37262,39618,2018,Gibraltar,Latvia,1,0,Friendly,Gibraltar,Gibraltar,False,1,1,Gibraltar
34953,37263,39619,2018,Jamaica,Antigua and Barbuda,1,1,Friendly,Kingston,Jamaica,False,2,0,Draw
34954,37264,39620,2018,Kuwait,Cameroon,1,3,Friendly,Kuwait City,Kuwait,False,4,-2,Cameroon
34955,37265,39621,2018,Martinique,Trinidad and Tobago,0,0,Friendly,Fort-de-France,Martinique,False,0,0,Draw
34956,37266,39622,2018,Nicaragua,Cuba,3,3,Friendly,Managua,Nicaragua,False,6,0,Draw
34957,37267,39623,2018,Thailand,Slovakia,2,3,Friendly,Bangkok,Thailand,False,5,-1,Slovakia
34958,37268,39625,2018,Albania,Norway,0,1,Friendly,Elbasan,Albania,False,1,-1,Norway
34959,37269,39626,2018,Bulgaria,Kazakhstan,2,1,Friendly,Felcsút,Hungary,True,3,1,Bulgaria
34960,37270,39628,2018,Curaçao,Bolivia,1,0,Friendly,Willemstad,Curaçao,False,1,1,Curaçao
34961,37271,39629,2018,Finland,Malta,5,0,Friendly,Belek,Turkey,True,5,5,Finland
34962,37272,39630,2018,Portugal,Netherlands,0,3,Friendly,Geneva,Switzerland,True,3,-3,Netherlands
34963,37273,39631,2018,Wales,Uruguay,0,1,Friendly,Nanning,China PR,True,1,-1,Uruguay
34964,37274,39632,2018,Afghanistan,Cambodia,2,1,AFC Asian Cup qualification,Dushanbe,Tajikistan,True,3,1,Afghanistan
34965,37275,39633,2018,Algeria,Iran,1,2,Friendly,Graz,Austria,True,3,-1,Iran
34966,37276,39634,2018,Armenia,Lithuania,0,1,Friendly,Yerevan,Armenia,False,1,-1,Lithuania
34967,37277,39635,2018,Australia,Colombia,0,0,Friendly,London,England,True,0,0,Draw
34968,37279,39637,2018,Bahrain,Turkmenistan,4,0,AFC Asian Cup qualification,Riffa,Bahrain,False,4,4,Bahrain
34969,37280,39638,2018,Belgium,Saudi Arabia,4,0,Friendly,Brussels,Belgium,False,4,4,Belgium
34970,37281,39639,2018,Bosnia and Herzegovina,Senegal,0,0,Friendly,Le Havre,France,True,0,0,Draw
34971,37282,39640,2018,Burma,Macau,1,0,AFC Asian Cup qualification,Rangoon,Burma,False,1,1,Burma
34972,37283,39641,2018,Central African Republic,Kenya,3,2,Friendly,Marrakech,Morocco,True,5,1,Central African Republic
34973,37284,39642,2018,Denmark,Chile,0,0,Friendly,Aalborg,Denmark,False,0,0,Draw
34974,37285,39643,2018,England,Italy,1,1,Friendly,London,England,False,2,0,Draw
34975,37286,39644,2018,Georgia,Estonia,2,0,Friendly,Tbilisi,Georgia,False,2,2,Georgia
34976,37287,39645,2018,Germany,Brazil,0,1,Friendly,Berlin,Germany,False,1,-1,Brazil
34977,37288,39646,2018,Greece,Egypt,1,0,Friendly,Zürich,Switzerland,True,1,1,Greece
34978,37289,39647,2018,Hungary,Scotland,0,1,Friendly,Budapest,Hungary,False,1,-1,Scotland
34979,37290,39648,2018,Iraq,Syria,1,1,Friendly,Basra,Iraq,False,2,0,Draw
34980,37291,39649,2018,Jordan,Vietnam,1,1,AFC Asian Cup qualification,Amman,Jordan,False,2,0,Draw
34981,37292,39651,2018,Kosovo,Burkina Faso,2,0,Friendly,Franconville,France,True,2,2,Kosovo
34982,37293,39652,2018,Kyrgyzstan,India,2,1,AFC Asian Cup qualification,Bishkek,Kyrgyzstan,False,3,1,Kyrgyzstan
34983,37294,39653,2018,Laos,Bangladesh,2,2,Friendly,Vientiane,Laos,False,4,0,Draw
34984,37295,39654,2018,Lebanon,Malaysia,2,1,AFC Asian Cup qualification,Beirut,Lebanon,False,3,1,Lebanon
34985,37296,39655,2018,Luxembourg,Austria,0,4,Friendly,Luxembourg,Luxembourg,False,4,-4,Austria
34986,37297,39656,2018,Maldives,Bhutan,7,0,AFC Asian Cup qualification,Malé,Maldives,False,7,7,Maldives
34987,37298,39657,2018,Mexico,Croatia,0,1,Friendly,Arlington,United States,True,1,-1,Croatia
34988,37299,39658,2018,Moldova,Ivory Coast,1,2,Friendly,Beauvais,France,True,3,-1,Ivory Coast
34989,37300,39659,2018,Mongolia,Mauritius,0,2,Friendly,Ulan Bator,Mongolia,False,2,-2,Mauritius
34990,37301,39660,2018,Montenegro,Turkey,2,2,Friendly,Podgorica,Montenegro,False,4,0,Draw
34991,37302,39661,2018,Morocco,Uzbekistan,2,0,Friendly,Casablanca,Morocco,False,2,2,Morocco
34992,37303,39662,2018,Namibia,Lesotho,2,1,Friendly,Windhoek,Namibia,False,3,1,Namibia
34993,37304,39663,2018,Oman,Palestine,1,0,AFC Asian Cup qualification,Muscat,Oman,False,1,1,Oman
34994,37305,39664,2018,Peru,Iceland,3,1,Friendly,Harrison,United States,True,4,2,Peru
34995,37306,39665,2018,Philippines,Tajikistan,2,1,AFC Asian Cup qualification,Manila,Philippines,False,3,1,Philippines
34996,37308,39667,2018,Romania,Sweden,1,0,Friendly,Craiova,Romania,False,1,1,Romania
34997,37309,39668,2018,Russia,France,1,3,Friendly,St. Petersburg,Russia,False,4,-2,France
34998,37310,39669,2018,Serbia,Nigeria,2,0,Friendly,London,England,True,2,2,Serbia
34999,37311,39670,2018,Seychelles,Eswatini,0,0,Friendly,Victoria,Seychelles,False,0,0,Draw
35000,37312,39671,2018,Slovenia,Belarus,0,2,Friendly,Ljubljana,Slovenia,False,2,-2,Belarus
35001,37313,39672,2018,Spain,Argentina,6,1,Friendly,Madrid,Spain,False,7,5,Spain
35002,37314,39673,2018,Switzerland,Panama,6,0,Friendly,Lucerne,Switzerland,False,6,6,Switzerland
35003,37315,39675,2018,Tanzania,DR Congo,2,0,Friendly,Dar es Salaam,Tanzania,False,2,2,Tanzania
35004,37316,39676,2018,Tunisia,Costa Rica,1,0,Friendly,Nice,France,True,1,1,Tunisia
35005,37317,39677,2018,Uganda,Malawi,0,0,Friendly,Kampala,Uganda,False,0,0,Draw
35006,37318,39678,2018,Ukraine,Japan,2,1,Friendly,Liège,Belgium,True,3,1,Ukraine
35007,37319,39679,2018,United States,Paraguay,1,0,Friendly,Cary,United States,False,1,1,United States
35008,37320,39680,2018,Yemen,Nepal,2,1,AFC Asian Cup qualification,Doha,Qatar,True,3,1,Yemen
35009,37321,39681,2018,Malaysia,Bhutan,7,0,Friendly,Kuala Lumpur,Malaysia,False,7,7,Malaysia
35010,37322,39684,2018,Trinidad and Tobago,Panama,0,1,Friendly,Couva,Trinidad and Tobago,False,1,-1,Panama
35011,37323,39685,2018,Zimbabwe,Botswana,0,1,Friendly,Harare,Zimbabwe,False,1,-1,Botswana
35012,37324,39686,2018,Saint Kitts and Nevis,Jamaica,1,3,Friendly,Basseterre,Saint Kitts and Nevis,False,4,-2,Jamaica
35013,37325,39687,2018,Antigua and Barbuda,Jamaica,0,2,Friendly,St. John's,Antigua and Barbuda,False,2,-2,Jamaica
35014,37326,39689,2018,Iraq,Palestine,0,0,Friendly,Basra,Iraq,False,0,0,Draw
35015,37327,39690,2018,Algeria,Saudi Arabia,0,2,Friendly,Cádiz,Spain,True,2,-2,Saudi Arabia
35016,37328,39691,2018,Kuwait,Palestine,2,0,Friendly,Kuwait City,Kuwait,False,2,2,Kuwait
35017,37329,39692,2018,Saudi Arabia,Greece,2,0,Friendly,Seville,Spain,True,2,2,Saudi Arabia
35018,37330,39693,2018,Iran,Uzbekistan,1,0,Friendly,Teheran,Iran,False,1,1,Iran
35019,37331,39694,2018,Jordan,Cyprus,3,0,Friendly,Amman,Jordan,False,3,3,Jordan
35020,37332,39695,2018,Kuwait,Egypt,1,1,Friendly,Kuwait,Kuwait,False,2,0,Draw
35021,37333,39696,2018,Kenya,Eswatini,0,1,Friendly,Machakos,Kenya,False,1,-1,Eswatini
35022,37334,39698,2018,Cameroon,Burkina Faso,0,1,Friendly,Beauvais,France,True,1,-1,Burkina Faso
35023,37335,39699,2018,Niger,Central African Republic,3,3,Friendly,Niamey,Niger,False,6,0,Draw
35024,37336,39700,2018,Madagascar,Mozambique,2,1,COSAFA Cup,Polokwane,South Africa,True,3,1,Madagascar
35025,37337,39701,2018,Comoros,Seychelles,1,1,COSAFA Cup,Polokwane,South Africa,True,2,0,Draw
35026,37338,39702,2018,United States,Bolivia,3,0,Friendly,Chester,United States,False,3,3,United States
35027,37339,39703,2018,Nigeria,DR Congo,1,1,Friendly,Port Harcourt,Nigeria,False,2,0,Draw
35028,37340,39704,2018,Kenya,Equatorial Guinea,1,0,Friendly,Machakos,Kenya,False,1,1,Kenya
35029,37341,39705,2018,Portugal,Tunisia,2,2,Friendly,Braga,Portugal,False,4,0,Draw
35030,37342,39706,2018,Italy,Saudi Arabia,2,1,Friendly,St. Gallen,Switzerland,True,3,1,Italy
35031,37343,39707,2018,France,Republic of Ireland,2,0,Friendly,Saint-Denis,France,False,2,2,France
35032,37344,39708,2018,Mexico,Wales,0,0,Friendly,Pasadena,United States,True,0,0,Draw
35033,37345,39709,2018,Turkey,Iran,2,1,Friendly,Istanbul,Turkey,False,3,1,Turkey
35034,37346,39711,2018,Bosnia and Herzegovina,Montenegro,0,0,Friendly,Zenica,Bosnia and Herzegovina,False,0,0,Draw
35035,37347,39712,2018,Malawi,Mauritius,0,1,COSAFA Cup,Polokwane,South Africa,True,1,-1,Mauritius
35036,37348,39713,2018,Angola,Botswana,1,2,COSAFA Cup,Polokwane,South Africa,True,3,-1,Botswana
35037,37349,39714,2018,Argentina,Haiti,4,0,Friendly,Buenos Aires,Argentina,False,4,4,Argentina
35038,37350,39715,2018,Albania,Kosovo,0,3,Friendly,Zürich,Switzerland,True,3,-3,Kosovo
35039,37351,39716,2018,Armenia,Malta,1,1,Friendly,Wattens,Austria,True,2,0,Draw
35040,37352,39717,2018,Azerbaijan,Kyrgyzstan,3,0,Friendly,Baku,Azerbaijan,False,3,3,Azerbaijan
35041,37353,39718,2018,Peru,Scotland,2,0,Friendly,Lima,Peru,False,2,2,Peru
35042,37354,39719,2018,Panama,Northern Ireland,0,0,Friendly,Panama City,Panama,False,0,0,Draw
35043,37355,39720,2018,Madagascar,Seychelles,1,1,COSAFA Cup,Polokwane,South Africa,True,2,0,Draw
35044,37356,39721,2018,Comoros,Mozambique,0,3,COSAFA Cup,Polokwane,South Africa,True,3,-3,Mozambique
35045,37357,39722,2018,Japan,Ghana,0,2,Friendly,Yokohama,Japan,False,2,-2,Ghana
35046,37358,39723,2018,Central African Republic,Uganda,1,0,Friendly,Niamey,Niger,True,1,1,Central African Republic
35047,37359,39724,2018,Austria,Russia,1,0,Friendly,Innsbruck,Austria,False,1,1,Austria
35048,37360,39725,2018,Malawi,Botswana,1,1,COSAFA Cup,Polokwane,South Africa,True,2,0,Draw
35049,37361,39726,2018,Angola,Mauritius,1,0,COSAFA Cup,Polokwane,South Africa,True,1,1,Angola
35050,37362,39727,2018,Estonia,Lithuania,2,0,Baltic Cup,Rakvere,Estonia,False,2,2,Estonia
35051,37363,39728,2018,Ukraine,Morocco,0,0,Friendly,Geneva,Switzerland,True,0,0,Draw
35052,37364,39729,2018,Romania,Chile,3,2,Friendly,Graz,Austria,True,5,1,Romania
35053,37365,39730,2018,Luxembourg,Senegal,0,0,Friendly,Luxembourg,Luxembourg,False,0,0,Draw
35054,37366,39731,2018,Mozambique,Seychelles,2,1,COSAFA Cup,Polokwane,South Africa,True,3,1,Mozambique
35055,37367,39732,2018,Comoros,Madagascar,0,1,COSAFA Cup,Polokwane,South Africa,True,1,-1,Madagascar
35056,37368,39733,2018,Slovakia,Netherlands,1,1,Friendly,Trnava,Slovakia,False,2,0,Draw
35057,37370,39742,2018,France,Italy,3,1,Friendly,Nice,France,False,4,2,France
35058,37371,39743,2018,Turkey,Tunisia,2,2,Friendly,Geneva,Switzerland,True,4,0,Draw
35059,37372,39745,2018,Czech Republic,Australia,0,4,Friendly,Sankt Pölten,Austria,True,4,-4,Australia
35060,37374,39747,2018,Colombia,Egypt,0,0,Friendly,Bergamo,Italy,True,0,0,Draw
35061,37375,39748,2018,Malta,Georgia,0,1,Friendly,Schwaz,Austria,True,1,-1,Georgia
35062,37376,39749,2018,Botswana,Mauritius,6,0,COSAFA Cup,Polokwane,South Africa,True,6,6,Botswana
35063,37377,39750,2018,Angola,Malawi,0,0,COSAFA Cup,Polokwane,South Africa,True,0,0,Draw
35064,37379,39752,2018,El Salvador,Honduras,1,0,Friendly,Houston,United States,True,1,1,El Salvador
35065,37381,39754,2018,England,Nigeria,2,1,Friendly,London,England,False,3,1,England
35066,37382,39755,2018,Montenegro,Slovenia,0,2,Friendly,Podgorica,Montenegro,False,2,-2,Slovenia
35067,37383,39756,2018,Mexico,Scotland,1,0,Friendly,Mexico City,Mexico,False,1,1,Mexico
35068,37384,39757,2018,Sweden,Denmark,0,0,Friendly,Solna,Sweden,False,0,0,Draw
35069,37385,39758,2018,Republic of Ireland,United States,2,1,Friendly,Dublin,Republic of Ireland,False,3,1,Republic of Ireland
35070,37386,39759,2018,Belgium,Portugal,0,0,Friendly,Brussels,Belgium,False,0,0,Draw
35071,37387,39760,2018,Austria,Germany,2,1,Friendly,Klagenfurt,Austria,False,3,1,Austria
35072,37388,39761,2018,Niger,Uganda,2,1,Friendly,Niamey,Niger,False,3,1,Niger
35073,37389,39762,2018,Iceland,Norway,2,3,Friendly,Reykjavík,Iceland,False,5,-1,Norway
35074,37390,39763,2018,Zambia,Namibia,0,0,COSAFA Cup,Polokwane,South Africa,True,0,0,Draw
35075,37391,39764,2018,Lesotho,Eswatini,1,0,COSAFA Cup,Polokwane,South Africa,True,1,1,Lesotho
35076,37392,39765,2018,Latvia,Estonia,1,0,Baltic Cup,Riga,Latvia,False,1,1,Latvia
35077,37393,39766,2018,Kenya,New Zealand,2,1,Intercontinental Cup,Mumbai,India,True,3,1,Kenya
35078,37395,39775,2018,Albania,Ukraine,1,4,Friendly,Évian-les-Bains,France,True,5,-3,Ukraine
35079,37396,39776,2018,Saudi Arabia,Peru,0,3,Friendly,St. Gallen,Switzerland,True,3,-3,Peru
35080,37397,39777,2018,Spain,Switzerland,1,1,Friendly,Vila-real,Spain,False,2,0,Draw
35081,37398,39778,2018,Croatia,Brazil,0,2,Friendly,Liverpool,England,True,2,-2,Brazil
35082,37399,39779,2018,Costa Rica,Northern Ireland,3,0,Friendly,San José,Costa Rica,False,3,3,Costa Rica
35083,37400,39780,2018,Barbados,Belize,0,0,Friendly,Bridgetown,Barbados,False,0,0,Draw
35084,37402,39782,2018,South Africa,Madagascar,0,0,COSAFA Cup,Polokwane,South Africa,False,0,0,Draw
35085,37403,39783,2018,Zimbabwe,Botswana,1,1,COSAFA Cup,Polokwane,South Africa,True,2,0,Draw
35086,37405,39792,2018,Italy,Netherlands,1,1,Friendly,Turin,Italy,False,2,0,Draw
35087,37406,39793,2018,Serbia,Chile,0,1,Friendly,Graz,Austria,True,1,-1,Chile
35088,37407,39794,2018,Slovakia,Morocco,1,2,Friendly,Geneva,Switzerland,True,3,-1,Morocco
35089,37408,39795,2018,Armenia,Moldova,0,0,Friendly,Kematen,Austria,True,0,0,Draw
35090,37409,39796,2018,India,Kenya,3,0,Intercontinental Cup,Mumbai,India,False,3,3,India
35091,37410,39797,2018,Russia,Turkey,1,1,Friendly,Moscow,Russia,False,2,0,Draw
35092,37411,39798,2018,Romania,Finland,2,0,Friendly,Ploiești,Romania,False,2,2,Romania
35093,37412,39799,2018,Luxembourg,Georgia,1,0,Friendly,Luxembourg,Luxembourg,False,1,1,Luxembourg
35094,37413,39800,2018,Kazakhstan,Azerbaijan,3,0,Friendly,Astana,Kazakhstan,False,3,3,Kazakhstan
35095,37414,39801,2018,Martinique,French Guiana,3,0,Friendly,Fort-de-France,Martinique,False,3,3,Martinique
35096,37415,39802,2018,Lithuania,Latvia,1,1,Friendly,Vilnius,Lithuania,False,2,0,Draw
35097,37416,39804,2018,South Africa,Namibia,4,1,COSAFA Cup,Polokwane,South Africa,False,5,3,South Africa
35098,37417,39805,2018,Eswatini,Botswana,0,2,COSAFA Cup,Polokwane,South Africa,True,2,-2,Botswana
35099,37418,39813,2018,Norway,Panama,1,0,Friendly,Oslo,Norway,False,1,1,Norway
35100,37419,39814,2018,Czech Republic,Nigeria,1,0,Friendly,Schwechat,Austria,True,1,1,Czech Republic
35101,37420,39815,2018,Belgium,Egypt,3,0,Friendly,Brussels,Belgium,False,3,3,Belgium
35102,37421,39816,2018,Belarus,Hungary,1,1,Friendly,Brest,Belarus,False,2,0,Draw
35103,37422,39817,2018,Zambia,Madagascar,1,0,COSAFA Cup,Polokwane,South Africa,True,1,1,Zambia
35104,37423,39818,2018,Lesotho,Zimbabwe,0,0,COSAFA Cup,Polokwane,South Africa,True,0,0,Draw
35105,37424,39819,2018,England,Costa Rica,2,0,Friendly,Leeds,England,False,2,2,England
35106,37425,39820,2018,Uruguay,Uzbekistan,3,0,Friendly,Montevideo,Uruguay,False,3,3,Uruguay
35107,37426,39821,2018,Portugal,Algeria,3,0,Friendly,Lisbon,Portugal,False,3,3,Portugal
35108,37427,39823,2018,Iceland,Ghana,2,2,Friendly,Reykjavík,Iceland,False,4,0,Draw
35109,37428,39824,2018,Guadeloupe,French Guiana,0,2,Friendly,Fort-de-France,Martinique,True,2,-2,French Guiana
35110,37429,39825,2018,India,New Zealand,1,2,Intercontinental Cup,Mumbai,India,False,3,-1,New Zealand
35111,37430,39833,2018,Germany,Saudi Arabia,2,1,Friendly,Leverkusen,Germany,False,3,1,Germany
35112,37431,39834,2018,Croatia,Senegal,2,1,Friendly,Osijek,Croatia,False,3,1,Croatia
35113,37432,39835,2018,Switzerland,Japan,2,0,Friendly,Lugano,Switzerland,False,2,2,Switzerland
35114,37433,39836,2018,Lithuania,Iran,0,1,Friendly,Moscow,Russia,True,1,-1,Iran
35115,37434,39837,2018,Poland,Chile,2,2,Friendly,Poznań,Poland,False,4,0,Draw
35116,37435,39839,2018,Serbia,Bolivia,5,1,Friendly,Graz,Austria,True,6,4,Serbia
35117,37436,39840,2018,Denmark,Mexico,2,0,Friendly,Brøndby,Denmark,False,2,2,Denmark
35118,37437,39841,2018,Sweden,Peru,0,0,Friendly,Gothenburg,Sweden,False,0,0,Draw
35119,37438,39842,2018,Hungary,Australia,1,2,Friendly,Budapest,Hungary,False,3,-1,Australia
35120,37439,39843,2018,Estonia,Morocco,1,3,Friendly,Tallinn,Estonia,False,4,-2,Morocco
35121,37440,39844,2018,Latvia,Azerbaijan,1,3,Friendly,Riga,Latvia,False,4,-2,Azerbaijan
35122,37441,39845,2018,Finland,Belarus,2,0,Friendly,Tampere,Finland,False,2,2,Finland
35123,37442,39846,2018,Tunisia,Spain,0,1,Friendly,Krasnodar,Russia,True,1,-1,Spain
35124,37443,39847,2018,France,United States,1,1,Friendly,Lyon,France,False,2,0,Draw
35125,37444,39855,2018,Austria,Brazil,0,3,Friendly,Vienna,Austria,False,3,-3,Brazil
35126,37445,39856,2018,India,Kenya,2,0,Intercontinental Cup,Mumbai,India,False,2,2,India
35127,37446,39858,2018,Belgium,Costa Rica,4,1,Friendly,Brussels,Belgium,False,5,3,Belgium
35128,37447,39859,2018,Japan,Paraguay,4,2,Friendly,Innsbruck,Austria,True,6,2,Japan
35129,37448,39860,2018,Poland,Lithuania,4,0,Friendly,Warsaw,Poland,False,4,4,Poland
35130,37449,39861,2018,Russia,Saudi Arabia,5,0,FIFA World Cup,Moscow,Russia,False,5,5,Russia
35131,37450,39862,2018,Egypt,Uruguay,0,1,FIFA World Cup,Ekaterinburg,Russia,True,1,-1,Uruguay
35132,37451,39863,2018,Morocco,Iran,0,1,FIFA World Cup,St. Petersburg,Russia,True,1,-1,Iran
35133,37452,39864,2018,Portugal,Spain,3,3,FIFA World Cup,Sochi,Russia,True,6,0,Draw
35134,37453,39865,2018,France,Australia,2,1,FIFA World Cup,Kazan,Russia,True,3,1,France
35135,37454,39866,2018,Argentina,Iceland,1,1,FIFA World Cup,Moscow,Russia,True,2,0,Draw
35136,37455,39867,2018,Peru,Denmark,0,1,FIFA World Cup,Saransk,Russia,True,1,-1,Denmark
35137,37456,39868,2018,Croatia,Nigeria,2,0,FIFA World Cup,Kaliningrad,Russia,True,2,2,Croatia
35138,37457,39869,2018,Costa Rica,Serbia,0,1,FIFA World Cup,Samara,Russia,True,1,-1,Serbia
35139,37458,39870,2018,Germany,Mexico,0,1,FIFA World Cup,Moscow,Russia,True,1,-1,Mexico
35140,37459,39871,2018,Brazil,Switzerland,1,1,FIFA World Cup,Rostov-on-Don,Russia,True,2,0,Draw
35141,37461,39873,2018,Belgium,Panama,3,0,FIFA World Cup,Sochi,Russia,True,3,3,Belgium
35142,37462,39874,2018,Tunisia,England,1,2,FIFA World Cup,Volgograd,Russia,True,3,-1,England
35143,37463,39875,2018,Colombia,Japan,1,2,FIFA World Cup,Saransk,Russia,True,3,-1,Japan
35144,37464,39876,2018,Poland,Senegal,1,2,FIFA World Cup,Moscow,Russia,True,3,-1,Senegal
35145,37465,39877,2018,Russia,Egypt,3,1,FIFA World Cup,St. Petersburg,Russia,False,4,2,Russia
35146,37466,39878,2018,Portugal,Morocco,1,0,FIFA World Cup,Moscow,Russia,True,1,1,Portugal
35147,37467,39879,2018,Uruguay,Saudi Arabia,1,0,FIFA World Cup,Rostov-on-Don,Russia,True,1,1,Uruguay
35148,37468,39880,2018,Iran,Spain,0,1,FIFA World Cup,Kazan,Russia,True,1,-1,Spain
35149,37469,39881,2018,Denmark,Australia,1,1,FIFA World Cup,Samara,Russia,True,2,0,Draw
35150,37470,39882,2018,France,Peru,1,0,FIFA World Cup,Ekaterinburg,Russia,True,1,1,France
35151,37471,39883,2018,Argentina,Croatia,0,3,FIFA World Cup,Nizhny Novgorod,Russia,True,3,-3,Croatia
35152,37472,39884,2018,Brazil,Costa Rica,2,0,FIFA World Cup,St. Petersburg,Russia,True,2,2,Brazil
35153,37473,39885,2018,Nigeria,Iceland,2,0,FIFA World Cup,Volgograd,Russia,True,2,2,Nigeria
35154,37474,39886,2018,Serbia,Switzerland,1,2,FIFA World Cup,Kaliningrad,Russia,True,3,-1,Switzerland
35155,37475,39887,2018,Belgium,Tunisia,5,2,FIFA World Cup,Moscow,Russia,True,7,3,Belgium
35156,37476,39889,2018,Germany,Sweden,2,1,FIFA World Cup,Sochi,Russia,True,3,1,Germany
35157,37477,39890,2018,England,Panama,6,1,FIFA World Cup,Nizhny Novgorod,Russia,True,7,5,England
35158,37478,39891,2018,Japan,Senegal,2,2,FIFA World Cup,Ekaterinburg,Russia,True,4,0,Draw
35159,37479,39892,2018,Poland,Colombia,0,3,FIFA World Cup,Kazan,Russia,True,3,-3,Colombia
35160,37480,39893,2018,Russia,Uruguay,0,3,FIFA World Cup,Samara,Russia,False,3,-3,Uruguay
35161,37481,39894,2018,Saudi Arabia,Egypt,2,1,FIFA World Cup,Volgograd,Russia,True,3,1,Saudi Arabia
35162,37482,39895,2018,Spain,Morocco,2,2,FIFA World Cup,Kaliningrad,Russia,True,4,0,Draw
35163,37483,39896,2018,Iran,Portugal,1,1,FIFA World Cup,Saransk,Russia,True,2,0,Draw
35164,37484,39897,2018,Australia,Peru,0,2,FIFA World Cup,Sochi,Russia,True,2,-2,Peru
35165,37485,39898,2018,Denmark,France,0,0,FIFA World Cup,Moscow,Russia,True,0,0,Draw
35166,37486,39899,2018,Nigeria,Argentina,1,2,FIFA World Cup,St. Petersburg,Russia,True,3,-1,Argentina
35167,37487,39900,2018,Iceland,Croatia,1,2,FIFA World Cup,Rostov-on-Don,Russia,True,3,-1,Croatia
35168,37488,39902,2018,Mexico,Sweden,0,3,FIFA World Cup,Ekaterinburg,Russia,True,3,-3,Sweden
35169,37489,39903,2018,Serbia,Brazil,0,2,FIFA World Cup,Moscow,Russia,True,2,-2,Brazil
35170,37490,39904,2018,Switzerland,Costa Rica,2,2,FIFA World Cup,Nizhny Novgorod,Russia,True,4,0,Draw
35171,37491,39905,2018,Japan,Poland,0,1,FIFA World Cup,Volgograd,Russia,True,1,-1,Poland
35172,37492,39906,2018,Senegal,Colombia,0,1,FIFA World Cup,Samara,Russia,True,1,-1,Colombia
35173,37493,39907,2018,Panama,Tunisia,1,2,FIFA World Cup,Saransk,Russia,True,3,-1,Tunisia
35174,37494,39908,2018,England,Belgium,0,1,FIFA World Cup,Kaliningrad,Russia,True,1,-1,Belgium
35175,37495,39909,2018,France,Argentina,4,3,FIFA World Cup,Kazan,Russia,True,7,1,France
35176,37496,39910,2018,Uruguay,Portugal,2,1,FIFA World Cup,Sochi,Russia,True,3,1,Uruguay
35177,37497,39911,2018,Russia,Spain,1,1,FIFA World Cup,Moscow,Russia,False,2,0,Draw
35178,37498,39912,2018,Croatia,Denmark,1,1,FIFA World Cup,Nizhny Novgorod,Russia,True,2,0,Draw
35179,37499,39913,2018,Brazil,Mexico,2,0,FIFA World Cup,Samara,Russia,True,2,2,Brazil
35180,37500,39914,2018,Belgium,Japan,3,2,FIFA World Cup,Rostov-on-Don,Russia,True,5,1,Belgium
35181,37501,39915,2018,Sweden,Switzerland,1,0,FIFA World Cup,St. Petersburg,Russia,True,1,1,Sweden
35182,37502,39916,2018,Colombia,England,1,1,FIFA World Cup,Moscow,Russia,True,2,0,Draw
35183,37503,39917,2018,Malaysia,Fiji,1,0,Friendly,Kuala Lumpur,Malaysia,False,1,1,Malaysia
35184,37504,39918,2018,Uruguay,France,0,2,FIFA World Cup,Nizhny Novgorod,Russia,True,2,-2,France
35185,37505,39919,2018,Brazil,Belgium,1,2,FIFA World Cup,Kazan,Russia,True,3,-1,Belgium
35186,37506,39920,2018,Sweden,England,0,2,FIFA World Cup,Samara,Russia,True,2,-2,England
35187,37507,39921,2018,Russia,Croatia,2,2,FIFA World Cup,Sochi,Russia,False,4,0,Draw
35188,37508,39922,2018,France,Belgium,1,0,FIFA World Cup,St. Petersburg,Russia,True,1,1,France
35189,37509,39923,2018,Croatia,England,2,1,FIFA World Cup,Moscow,Russia,True,3,1,Croatia
35190,37510,39924,2018,Belgium,England,2,0,FIFA World Cup,St. Petersburg,Russia,True,2,2,Belgium
35191,37511,39925,2018,France,Croatia,4,2,FIFA World Cup,Moscow,Russia,True,6,2,France
35192,37512,39926,2018,Liberia,Sierra Leone,0,0,Friendly,Monrovia,Liberia,False,0,0,Draw
35193,37513,39927,2018,Belize,Barbados,1,0,Friendly,San Pedro,Belize,False,1,1,Belize
35194,37514,39928,2018,Palestine,Iraq,0,3,Friendly,Al Ram,Palestine,False,3,-3,Iraq
35195,37515,39929,2018,Guatemala,Cuba,3,0,Friendly,Guatemala City,Guatemala,False,3,3,Guatemala
35196,37516,39930,2018,Andorra,United Arab Emirates,0,0,Friendly,Grödig,Austria,True,0,0,Draw
35197,37517,39931,2018,Grenada,Jamaica,1,5,Friendly,St. George's,Grenada,False,6,-4,Jamaica
35198,37518,39932,2018,Guatemala,Cuba,1,0,Friendly,Quetzaltenango,Guatemala,False,1,1,Guatemala
35199,37519,39933,2018,Barbados,Jamaica,2,2,Friendly,Bridgetown,Barbados,False,4,0,Draw
35200,37520,39934,2018,Sint Maarten,Anguilla,1,1,Friendly,Philipsburg,Sint Maarten,False,2,0,Draw
35201,37521,39935,2018,Anguilla,Saint Martin,1,2,Friendly,The Valley,Anguilla,False,3,-1,Saint Martin
35202,37522,39936,2018,Barbados,Cuba,0,0,Friendly,Bridgetown,Barbados,False,0,0,Draw
35203,37523,39937,2018,Bangladesh,Sri Lanka,0,1,Friendly,Nilphamari Sadar,Bangladesh,False,1,-1,Sri Lanka
35204,37524,39938,2018,Barbados,Cuba,0,2,Friendly,Bridgetown,Barbados,False,2,-2,Cuba
35205,37525,39939,2018,Macau,Solomon Islands,1,4,Friendly,Taipa,Macau,False,5,-3,Solomon Islands
35206,37526,39940,2018,Timor-Leste,Brunei,3,1,AFF Championship qualification,Kuala Lumpur,Malaysia,True,4,2,Timor-Leste
35207,37527,39941,2018,Ethiopia,Burundi,1,1,Friendly,Awassa,Ethiopia,False,2,0,Draw
35208,37528,39942,2018,Guam,Northern Mariana Islands,4,0,EAFF Championship,Ulaanbaatar,Mongolia,True,4,4,Guam
35209,37529,39943,2018,Mongolia,Macau,4,1,EAFF Championship,Ulaanbaatar,Mongolia,False,5,3,Mongolia
35210,37530,39944,2018,Macau,Guam,2,0,EAFF Championship,Ulaanbaatar,Mongolia,True,2,2,Macau
35211,37531,39945,2018,Mongolia,Northern Mariana Islands,9,0,EAFF Championship,Ulaanbaatar,Mongolia,False,9,9,Mongolia
35212,37532,39946,2018,Nepal,Pakistan,1,2,SAFF Cup,Dhaka,Bangladesh,True,3,-1,Pakistan
35213,37533,39947,2018,Bangladesh,Bhutan,2,0,SAFF Cup,Dhaka,Bangladesh,False,2,2,Bangladesh
35214,37534,39948,2018,Fiji,Solomon Islands,1,1,Friendly,Suva,Fiji,False,2,0,Draw
35215,37535,39949,2018,Slovakia,Denmark,3,0,Friendly,Trnava,Slovakia,False,3,3,Slovakia
35216,37536,39950,2018,India,Sri Lanka,2,0,SAFF Cup,Dhaka,Bangladesh,True,2,2,India
35217,37537,39951,2018,Germany,France,0,0,UEFA Nations League,Munich,Germany,False,0,0,Draw
35218,37538,39952,2018,Czech Republic,Ukraine,1,2,UEFA Nations League,Uherské Hradiště,Czech Republic,False,3,-1,Ukraine
35219,37539,39953,2018,Wales,Republic of Ireland,4,1,UEFA Nations League,Cardiff,Wales,False,5,3,Wales
35220,37540,39954,2018,Norway,Cyprus,2,0,UEFA Nations League,Oslo,Norway,False,2,2,Norway
35221,37541,39955,2018,Slovenia,Bulgaria,1,2,UEFA Nations League,Ljubljana,Slovenia,False,3,-1,Bulgaria
35222,37542,39956,2018,Kazakhstan,Georgia,0,2,UEFA Nations League,Astana,Kazakhstan,False,2,-2,Georgia
35223,37543,39957,2018,Latvia,Andorra,0,0,UEFA Nations League,Riga,Latvia,False,0,0,Draw
35224,37544,39958,2018,Armenia,Liechtenstein,2,1,UEFA Nations League,Yerevan,Armenia,False,3,1,Armenia
35225,37546,39960,2018,Austria,Sweden,2,0,Friendly,Vienna,Austria,False,2,2,Austria
35226,37547,39961,2018,Bahrain,Philippines,1,1,Friendly,East Riffa,Bahrain,False,2,0,Draw
35227,37548,39962,2018,Jordan,Lebanon,0,1,Friendly,Amman,Jordan,False,1,-1,Lebanon
35228,37549,39963,2018,Kyrgyzstan,Palestine,1,1,Friendly,Bishkek,Kyrgyzstan,False,2,0,Draw
35229,37550,39964,2018,Netherlands,Peru,2,1,Friendly,Amsterdam,Netherlands,False,3,1,Netherlands
35230,37551,39965,2018,Portugal,Croatia,1,1,Friendly,Faro-Loulé,Portugal,False,2,0,Draw
35231,37552,39966,2018,Trinidad and Tobago,United Arab Emirates,2,0,Friendly,Llagostera,Trinidad and Tobago,False,2,2,Trinidad and Tobago
35232,37553,39967,2018,Uzbekistan,Syria,1,1,Friendly,Tashkent,Uzbekistan,False,2,0,Draw
35233,37554,39968,2018,Northern Mariana Islands,Macau,1,1,EAFF Championship,Ulaanbaatar,Mongolia,True,2,0,Draw
35234,37555,39969,2018,Mongolia,Guam,1,1,EAFF Championship,Ulaanbaatar,Mongolia,False,2,0,Draw
35235,37556,39970,2018,Nepal,Bhutan,4,0,SAFF Cup,Dhaka,Bangladesh,True,4,4,Nepal
35236,37557,39971,2018,Bangladesh,Pakistan,1,0,SAFF Cup,Dhaka,Bangladesh,False,1,1,Bangladesh
35237,37558,39972,2018,Italy,Poland,1,1,UEFA Nations League,Bologna,Italy,False,2,0,Draw
35238,37559,39973,2018,Turkey,Russia,1,2,UEFA Nations League,Trabzon,Turkey,False,3,-1,Russia
35239,37560,39974,2018,Albania,Israel,1,0,UEFA Nations League,Elbasan,Albania,False,1,1,Albania
35240,37561,39975,2018,Lithuania,Serbia,0,1,UEFA Nations League,Vilnius,Lithuania,False,1,-1,Serbia
35241,37562,39976,2018,Romania,Montenegro,0,0,UEFA Nations League,Ploiești,Romania,False,0,0,Draw
35242,37563,39977,2018,Faroe Islands,Malta,3,1,UEFA Nations League,Tórshavn,Faroe Islands,False,4,2,Faroe Islands
35243,37564,39978,2018,Azerbaijan,Kosovo,0,0,UEFA Nations League,Baku,Azerbaijan,False,0,0,Draw
35244,37565,39979,2018,Argentina,Guatemala,3,0,Friendly,Los Angeles,United States,True,3,3,Argentina
35245,37566,39981,2018,Ecuador,Jamaica,2,0,Friendly,Harrison,United States,True,2,2,Ecuador
35246,37567,39983,2018,Mexico,Uruguay,1,4,Friendly,Houston,United States,True,5,-3,Uruguay
35247,37569,39985,2018,Scotland,Belgium,0,4,Friendly,Glasgow,Scotland,False,4,-4,Belgium
35248,37570,39986,2018,Singapore,Mauritius,1,1,Friendly,Bishan,Singapore,False,2,0,Draw
35249,37571,39987,2018,United States,Brazil,0,2,Friendly,East Rutherford,United States,False,2,-2,Brazil
35250,37572,39988,2018,Venezuela,Colombia,1,2,Friendly,Miami Gardens,United States,True,3,-1,Colombia
35251,37573,39989,2018,Maldives,Sri Lanka,0,0,SAFF Cup,Dhaka,Bangladesh,True,0,0,Draw
35252,37574,39990,2018,Switzerland,Iceland,6,0,UEFA Nations League,St. Gallen,Switzerland,False,6,6,Switzerland
35253,37575,39991,2018,England,Spain,1,2,UEFA Nations League,London,England,False,3,-1,Spain
35254,37576,39992,2018,Northern Ireland,Bosnia and Herzegovina,1,2,UEFA Nations League,Belfast,Northern Ireland,False,3,-1,Bosnia and Herzegovina
35255,37577,39993,2018,Finland,Hungary,1,0,UEFA Nations League,Tampere,Finland,False,1,1,Finland
35256,37578,39994,2018,Estonia,Greece,0,1,UEFA Nations League,Tallinn,Estonia,False,1,-1,Greece
35257,37579,39995,2018,Belarus,San Marino,5,0,UEFA Nations League,Minsk,Belarus,False,5,5,Belarus
35258,37580,39996,2018,Luxembourg,Moldova,4,0,UEFA Nations League,Luxembourg City,Luxembourg,False,4,4,Luxembourg
35259,37581,39997,2018,Brunei,Timor-Leste,1,0,AFF Championship qualification,Bandar Seri Begawan,Brunei,False,1,1,Brunei
35260,37582,39998,2018,Equatorial Guinea,Sudan,1,0,African Cup of Nations qualification,Bata,Equatorial Guinea,False,1,1,Equatorial Guinea
35261,37583,39999,2018,Comoros,Cameroon,1,1,African Cup of Nations qualification,Mitsamiouli,Comoros,False,2,0,Draw
35262,37584,40000,2018,Gabon,Burundi,1,1,African Cup of Nations qualification,Libreville,Gabon,False,2,0,Draw
35263,37585,40001,2018,Gambia,Algeria,1,1,African Cup of Nations qualification,Bakau,Gambia,False,2,0,Draw
35264,37586,40002,2018,South Africa,Libya,0,0,African Cup of Nations qualification,Durban,South Africa,False,0,0,Draw
35265,37587,40003,2018,Mauritania,Burkina Faso,2,0,African Cup of Nations qualification,Nouakchott,Mauritania,False,2,2,Mauritania
35266,37588,40004,2018,Egypt,Niger,6,0,African Cup of Nations qualification,Alexandria,Egypt,False,6,6,Egypt
35267,37589,40005,2018,Namibia,Zambia,1,1,African Cup of Nations qualification,Windhoek,Namibia,False,2,0,Draw
35268,37590,40006,2018,Uganda,Tanzania,0,0,African Cup of Nations qualification,Kira,Uganda,False,0,0,Draw
35269,37591,40007,2018,Pakistan,Bhutan,3,0,SAFF Cup,Dhaka,Bangladesh,True,3,3,Pakistan
35270,37592,40008,2018,Bangladesh,Nepal,0,2,SAFF Cup,Dhaka,Bangladesh,False,2,-2,Nepal
35271,37593,40009,2018,France,Netherlands,2,1,UEFA Nations League,Paris,France,False,3,1,France
35272,37594,40010,2018,Ukraine,Slovakia,1,0,UEFA Nations League,Lviv,Ukraine,False,1,1,Ukraine
35273,37595,40011,2018,Denmark,Wales,2,0,UEFA Nations League,Aarhus,Denmark,False,2,2,Denmark
35274,37596,40012,2018,Bulgaria,Norway,1,0,UEFA Nations League,Sofia,Bulgaria,False,1,1,Bulgaria
35275,37597,40013,2018,Cyprus,Slovenia,2,1,UEFA Nations League,Nicosia,Cyprus,False,3,1,Cyprus
35276,37598,40014,2018,Georgia,Latvia,1,0,UEFA Nations League,Tbilisi,Georgia,False,1,1,Georgia
35277,37599,40016,2018,Liechtenstein,Gibraltar,2,0,UEFA Nations League,Vaduz,Liechtenstein,False,2,2,Liechtenstein
35278,37600,40017,2018,Germany,Peru,2,1,Friendly,Sinsheim,Germany,False,3,1,Germany
35279,37601,40018,2018,Lebanon,Oman,0,0,Friendly,Amman,Jordan,True,0,0,Draw
35280,37602,40019,2018,Congo,Zimbabwe,1,1,African Cup of Nations qualification,Brazzaville,Congo,False,2,0,Draw
35281,37603,40020,2018,Rwanda,Ivory Coast,1,2,African Cup of Nations qualification,Kigali,Rwanda,False,3,-1,Ivory Coast
35282,37604,40021,2018,India,Maldives,2,0,SAFF Cup,Dhaka,Bangladesh,True,2,2,India
35283,37605,40022,2018,Portugal,Italy,1,0,UEFA Nations League,Lisbon,Portugal,False,1,1,Portugal
35284,37606,40023,2018,Sweden,Turkey,2,3,UEFA Nations League,Stockholm,Sweden,False,5,-1,Turkey
35285,37607,40024,2018,Scotland,Albania,2,0,UEFA Nations League,Glasgow,Scotland,False,2,2,Scotland
35286,37608,40025,2018,Montenegro,Lithuania,2,0,UEFA Nations League,Podgorica,Montenegro,False,2,2,Montenegro
35287,37609,40026,2018,Serbia,Romania,2,2,UEFA Nations League,Belgrade,Serbia,False,4,0,Draw
35288,37610,40027,2018,Andorra,Kazakhstan,1,1,UEFA Nations League,Andorra la Vella,Andorra,False,2,0,Draw
35289,37611,40028,2018,Kosovo,Faroe Islands,2,0,UEFA Nations League,Pristina,Kosovo,False,2,2,Kosovo
35290,37612,40029,2018,Malta,Azerbaijan,1,1,UEFA Nations League,Attard,Malta,False,2,0,Draw
35291,37614,40031,2018,Cambodia,Malaysia,1,3,Friendly,Phnom Penh,Cambodia,False,4,-2,Malaysia
35292,37615,40032,2018,Kuwait,Iraq,2,2,Friendly,Al Farwaniyah,Kuwait,False,4,0,Draw
35293,37616,40033,2018,Kyrgyzstan,Syria,2,1,Friendly,Bishkek,Kyrgyzstan,False,3,1,Kyrgyzstan
35294,37617,40034,2018,Russia,Czech Republic,5,1,Friendly,Rostov-on-Don,Russia,False,6,4,Russia
35295,37618,40035,2018,Saudi Arabia,Bolivia,2,2,Friendly,Riyadh,Saudi Arabia,False,4,0,Draw
35296,37619,40036,2018,Iceland,Belgium,0,3,UEFA Nations League,Reykjavík,Iceland,False,3,-3,Belgium
35297,37620,40037,2018,Spain,Croatia,6,0,UEFA Nations League,Elche,Spain,False,6,6,Spain
35298,37621,40038,2018,Bosnia and Herzegovina,Austria,1,0,UEFA Nations League,Zenica,Bosnia and Herzegovina,False,1,1,Bosnia and Herzegovina
35299,37622,40039,2018,Hungary,Greece,2,1,UEFA Nations League,Budapest,Hungary,False,3,1,Hungary
35300,37623,40040,2018,Finland,Estonia,1,0,UEFA Nations League,Turku,Finland,False,1,1,Finland
35301,37624,40041,2018,San Marino,Luxembourg,0,3,UEFA Nations League,Serravalle,San Marino,False,3,-3,Luxembourg
35302,37625,40042,2018,Moldova,Belarus,0,0,UEFA Nations League,Chișinău,Moldova,False,0,0,Draw
35303,37626,40043,2018,Colombia,Argentina,0,0,Friendly,East Rutherford,United States,True,0,0,Draw
35304,37627,40044,2018,Ecuador,Guatemala,2,0,Friendly,Bridgeview,United States,True,2,2,Ecuador
35305,37628,40045,2018,England,Switzerland,1,0,Friendly,London,England,False,1,1,England
35306,37629,40046,2018,Gabon,Zambia,0,1,Friendly,Libreville,Gabon,False,1,-1,Zambia
35307,37630,40047,2018,Indonesia,Mauritius,1,0,Friendly,Cikarang,Indonesia,False,1,1,Indonesia
35308,37631,40048,2018,Japan,Costa Rica,3,0,Friendly,Suita,Japan,False,3,3,Japan
35309,37632,40049,2018,Jordan,Oman,0,0,Friendly,Amman,Jordan,False,0,0,Draw
35310,37633,40050,2018,Kenya,Malawi,1,0,Friendly,Nairobi,Kenya,False,1,1,Kenya
35311,37634,40052,2018,Laos,United Arab Emirates,0,3,Friendly,Llagostera,Laos,False,3,-3,United Arab Emirates
35312,37635,40053,2018,Liberia,Nigeria,1,2,Friendly,Monrovia,Liberia,False,3,-1,Nigeria
35313,37636,40054,2018,Northern Ireland,Israel,3,0,Friendly,Belfast,Northern Ireland,False,3,3,Northern Ireland
35314,37637,40055,2018,Panama,Venezuela,0,2,Friendly,Panama City,Panama,False,2,-2,Venezuela
35315,37638,40056,2018,Poland,Republic of Ireland,1,1,Friendly,Wroclaw,Poland,False,2,0,Draw
35316,37639,40057,2018,Qatar,Palestine,3,0,Friendly,Doha,Qatar,False,3,3,Qatar
35317,37640,40058,2018,Singapore,Fiji,2,0,Friendly,Bishan,Singapore,False,2,2,Singapore
35318,37641,40059,2018,United States,Mexico,1,0,Friendly,Nashville,United States,False,1,1,United States
35319,37642,40060,2018,Uzbekistan,Iran,0,1,Friendly,Tashkent,Uzbekistan,False,1,-1,Iran
35320,37643,40061,2018,Brazil,El Salvador,5,0,Friendly,Landover,United States,True,5,5,Brazil
35321,37644,40062,2018,India,Pakistan,3,1,SAFF Cup,Dhaka,Bangladesh,True,4,2,India
35322,37645,40063,2018,Nepal,Maldives,0,3,SAFF Cup,Dhaka,Bangladesh,True,3,-3,Maldives
35323,37646,40064,2018,Maldives,India,2,1,SAFF Cup,Dhaka,Bangladesh,True,3,1,Maldives
35324,37647,40065,2018,Botswana,Namibia,1,0,Friendly,Gaborone,Botswana,False,1,1,Botswana
35325,37648,40066,2018,Saint Vincent and the Grenadines,Barbados,1,1,Friendly,Georgetown,Saint Vincent and the Grenadines,False,2,0,Draw
35326,37649,40067,2018,Albania,Jordan,0,0,Friendly,Elbasan,Albania,False,0,0,Draw
35327,37650,40068,2018,Indonesia,Myanmar,3,0,Friendly,Cikarang,Indonesia,False,3,3,Indonesia
35328,37651,40069,2018,Italy,Ukraine,1,1,Friendly,Genoa,Italy,False,2,0,Draw
35329,37652,40070,2018,Ethiopia,Kenya,0,0,African Cup of Nations qualification,Bahir Dar,Ethiopia,False,0,0,Draw
35330,37653,40071,2018,Zambia,Guinea-Bissau,2,1,African Cup of Nations qualification,Lusaka,Zambia,False,3,1,Zambia
35331,37654,40072,2018,Poland,Portugal,2,3,UEFA Nations League,Chorzow,Poland,False,5,-1,Portugal
35332,37655,40073,2018,Russia,Sweden,0,0,UEFA Nations League,Kaliningrad,Russia,False,0,0,Draw
35333,37656,40074,2018,Israel,Scotland,2,1,UEFA Nations League,Haifa,Israel,False,3,1,Israel
35334,37657,40075,2018,Montenegro,Serbia,0,2,UEFA Nations League,Podgorica,Montenegro,False,2,-2,Serbia
35335,37658,40076,2018,Lithuania,Romania,1,2,UEFA Nations League,Vilnius,Lithuania,False,3,-1,Romania
35336,37659,40077,2018,Faroe Islands,Azerbaijan,0,3,UEFA Nations League,Tórshavn,Faroe Islands,False,3,-3,Azerbaijan
35337,37660,40078,2018,Kosovo,Malta,3,1,UEFA Nations League,Pristina,Kosovo,False,4,2,Kosovo
35338,37661,40079,2018,Argentina,Iraq,4,0,Friendly,Riyadh,Saudi Arabia,True,4,4,Argentina
35339,37662,40080,2018,Bahrain,Syria,0,1,Friendly,East Riffa,Bahrain,False,1,-1,Syria
35340,37663,40081,2018,France,Iceland,2,2,Friendly,Guingamp,France,False,4,0,Draw
35341,37664,40082,2018,Honduras,United Arab Emirates,1,1,Friendly,Barcelona,Spain,True,2,0,Draw
35342,37665,40083,2018,Hong Kong,Thailand,0,1,Friendly,Hong Kong,Hong Kong,False,1,-1,Thailand
35343,37666,40084,2018,Kuwait,Lebanon,1,0,Friendly,Kuwait City,Kuwait,False,1,1,Kuwait
35344,37667,40085,2018,Mexico,Costa Rica,3,2,Friendly,San Nicolás de los Garza,Mexico,False,5,1,Mexico
35345,37668,40086,2018,Turkey,Bosnia and Herzegovina,0,0,Friendly,Rize,Turkey,False,0,0,Draw
35346,37669,40087,2018,United States,Colombia,2,4,Friendly,Tampa,United States,False,6,-2,Colombia
35347,37670,40088,2018,Wales,Spain,1,4,Friendly,Cardiff,Wales,False,5,-3,Spain
35348,37671,40089,2018,Congo,Liberia,3,1,African Cup of Nations qualification,Brazzaville,Congo,False,4,2,Congo
35349,37672,40090,2018,Belgium,Switzerland,2,1,UEFA Nations League,Brussels,Belgium,False,3,1,Belgium
35350,37673,40091,2018,Croatia,England,0,0,UEFA Nations League,Rijeka,Croatia,False,0,0,Draw
35351,37674,40092,2018,Austria,Northern Ireland,1,0,UEFA Nations League,Vienna,Austria,False,1,1,Austria
35352,37675,40093,2018,Estonia,Finland,0,1,UEFA Nations League,Tallinn,Estonia,False,1,-1,Finland
35353,37676,40094,2018,Greece,Hungary,1,0,UEFA Nations League,Athens,Greece,False,1,1,Greece
35354,37677,40095,2018,Belarus,Luxembourg,1,0,UEFA Nations League,Minsk,Belarus,False,1,1,Belarus
35355,37678,40096,2018,Moldova,San Marino,2,0,UEFA Nations League,Chișinău,Moldova,False,2,2,Moldova
35356,37679,40097,2018,Cambodia,Timor-Leste,2,2,Friendly,Phnom Penh,Cambodia,False,4,0,Draw
35357,37680,40098,2018,Japan,Panama,3,0,Friendly,Niigata,Japan,False,3,3,Japan
35358,37681,40100,2018,Peru,Chile,3,0,Friendly,Miami Gardens,United States,True,3,3,Peru
35359,37682,40101,2018,Qatar,Ecuador,4,3,Friendly,Doha,Qatar,False,7,1,Qatar
35360,37683,40102,2018,Saudi Arabia,Brazil,0,2,Friendly,Riyadh,Saudi Arabia,False,2,-2,Brazil
35361,37684,40103,2018,Singapore,Mongolia,2,0,Friendly,Bishan,Singapore,False,2,2,Singapore
35362,37685,40104,2018,Sri Lanka,Malaysia,1,4,Friendly,Colombo,Sri Lanka,False,5,-3,Malaysia
35363,37686,40105,2018,Cameroon,Malawi,1,0,African Cup of Nations qualification,Yaoundé,Cameroon,False,1,1,Cameroon
35364,37687,40106,2018,Gabon,South Sudan,3,0,African Cup of Nations qualification,Libreville,Gabon,False,3,3,Gabon
35365,37688,40107,2018,Togo,Gambia,1,1,African Cup of Nations qualification,Lomé,Togo,False,2,0,Draw
35366,37689,40108,2018,Ivory Coast,Central African Republic,4,0,African Cup of Nations qualification,Bouaké,Ivory Coast,False,4,4,Ivory Coast
35367,37690,40109,2018,Angola,Mauritania,4,1,African Cup of Nations qualification,Luanda,Angola,False,5,3,Angola
35368,37691,40110,2018,Egypt,Eswatini,4,1,African Cup of Nations qualification,Cairo,Egypt,False,5,3,Egypt
35369,37692,40113,2018,Netherlands,Germany,3,0,UEFA Nations League,Amsterdam,Netherlands,False,3,3,Netherlands
35370,37693,40114,2018,Slovakia,Czech Republic,1,2,UEFA Nations League,Trnava,Slovakia,False,3,-1,Czech Republic
35371,37694,40115,2018,Republic of Ireland,Denmark,0,0,UEFA Nations League,Dublin,Republic of Ireland,False,0,0,Draw
35372,37695,40116,2018,Norway,Slovenia,1,0,UEFA Nations League,Oslo,Norway,False,1,1,Norway
35373,37696,40117,2018,Bulgaria,Cyprus,2,1,UEFA Nations League,Sofia,Bulgaria,False,3,1,Bulgaria
35374,37697,40118,2018,Latvia,Kazakhstan,1,1,UEFA Nations League,Riga,Latvia,False,2,0,Draw
35375,37698,40119,2018,Georgia,Andorra,3,0,UEFA Nations League,Tbilisi,Georgia,False,3,3,Georgia
35376,37699,40120,2018,Armenia,Gibraltar,0,1,UEFA Nations League,Yerevan,Armenia,False,1,-1,Gibraltar
35377,37700,40123,2018,Myanmar,Bolivia,0,3,Friendly,Yangon,Myanmar,False,3,-3,Bolivia
35378,37701,40124,2018,Oman,Philippines,1,1,Friendly,Al Rayyan,Oman,False,2,0,Draw
35379,37703,40126,2018,Equatorial Guinea,Madagascar,0,1,African Cup of Nations qualification,Bata,Equatorial Guinea,False,1,-1,Madagascar
35380,37704,40127,2018,Nigeria,Libya,4,0,African Cup of Nations qualification,Uyo,Nigeria,False,4,4,Nigeria
35381,37705,40128,2018,Poland,Italy,0,1,UEFA Nations League,Chorzow,Poland,False,1,-1,Italy
35382,37706,40129,2018,Russia,Turkey,2,0,UEFA Nations League,Sochi,Russia,False,2,2,Russia
35383,37707,40130,2018,Israel,Albania,2,0,UEFA Nations League,Beer Sheva,Israel,False,2,2,Israel
35384,37708,40131,2018,Romania,Serbia,0,0,UEFA Nations League,Bucharest,Romania,False,0,0,Draw
35385,37709,40132,2018,Lithuania,Montenegro,1,4,UEFA Nations League,Vilnius,Lithuania,False,5,-3,Montenegro
35386,37710,40133,2018,Faroe Islands,Kosovo,1,1,UEFA Nations League,Tórshavn,Faroe Islands,False,2,0,Draw
35387,37711,40134,2018,Azerbaijan,Malta,1,1,UEFA Nations League,Baku,Azerbaijan,False,2,0,Draw
35388,37712,40135,2018,Scotland,Portugal,1,3,Friendly,Glasgow,Scotland,False,4,-2,Portugal
35389,37713,40136,2018,Thailand,Trinidad and Tobago,1,0,Friendly,Suphan Buri,Thailand,False,1,1,Thailand
35390,37714,40137,2018,Guinea-Bissau,Zambia,2,1,African Cup of Nations qualification,Bissau,Guinea-Bissau,False,3,1,Guinea-Bissau
35391,37715,40138,2018,Iceland,Switzerland,1,2,UEFA Nations League,Reykjavík,Iceland,False,3,-1,Switzerland
35392,37716,40139,2018,Spain,England,2,3,UEFA Nations League,Sevilla,Spain,False,5,-1,England
35393,37717,40140,2018,Bosnia and Herzegovina,Northern Ireland,2,0,UEFA Nations League,Sarajevo,Bosnia and Herzegovina,False,2,2,Bosnia and Herzegovina
35394,37718,40141,2018,Estonia,Hungary,3,3,UEFA Nations League,Tallinn,Estonia,False,6,0,Draw
35395,37719,40142,2018,Finland,Greece,2,0,UEFA Nations League,Tampere,Finland,False,2,2,Finland
35396,37720,40143,2018,Luxembourg,San Marino,3,0,UEFA Nations League,Luxembourg City,Luxembourg,False,3,3,Luxembourg
35397,37721,40144,2018,Belarus,Moldova,0,0,UEFA Nations League,Minsk,Belarus,False,0,0,Draw
35398,37722,40145,2018,Croatia,Jordan,2,1,Friendly,Rijeka,Croatia,False,3,1,Croatia
35399,37723,40146,2018,Kuwait,Australia,0,4,Friendly,Kuwait City,Kuwait,False,4,-4,Australia
35400,37724,40147,2018,Saudi Arabia,Iraq,1,1,Friendly,Riyadh,Saudi Arabia,False,2,0,Draw
35401,37725,40148,2018,France,Germany,2,1,UEFA Nations League,Paris,France,False,3,1,France
35402,37726,40149,2018,Ukraine,Czech Republic,1,0,UEFA Nations League,Kharkiv,Ukraine,False,1,1,Ukraine
35403,37727,40150,2018,Republic of Ireland,Wales,0,1,UEFA Nations League,Dublin,Republic of Ireland,False,1,-1,Wales
35404,37728,40151,2018,Norway,Bulgaria,1,0,UEFA Nations League,Oslo,Norway,False,1,1,Norway
35405,37729,40152,2018,Slovenia,Cyprus,1,1,UEFA Nations League,Ljubljana,Slovenia,False,2,0,Draw
35406,37730,40153,2018,Kazakhstan,Andorra,4,0,UEFA Nations League,Astana,Kazakhstan,False,4,4,Kazakhstan
35407,37731,40154,2018,Latvia,Georgia,0,3,UEFA Nations League,Riga,Latvia,False,3,-3,Georgia
35408,37733,40156,2018,Gibraltar,Liechtenstein,2,1,UEFA Nations League,Gibraltar,Gibraltar,False,3,1,Gibraltar
35409,37734,40157,2018,Bahrain,Myanmar,4,1,Friendly,East Riffa,Bahrain,False,5,3,Bahrain
35410,37735,40158,2018,Belgium,Netherlands,1,1,Friendly,Brussels,Belgium,False,2,0,Draw
35411,37736,40159,2018,Cambodia,Singapore,1,2,Friendly,Phnom Penh,Cambodia,False,3,-1,Singapore
35412,37737,40161,2018,Colombia,Costa Rica,3,1,Friendly,Harrison,United States,True,4,2,Colombia
35413,37738,40162,2018,Denmark,Austria,2,0,Friendly,Herning,Denmark,False,2,2,Denmark
35414,37739,40163,2018,Indonesia,Hong Kong,1,1,Friendly,Cikarang,Indonesia,False,2,0,Draw
35415,37740,40164,2018,Iran,Bolivia,2,1,Friendly,Tehran,Iran,False,3,1,Iran
35416,37741,40165,2018,Japan,Uruguay,4,3,Friendly,Saitama,Japan,False,7,1,Japan
35417,37742,40167,2018,Laos,Mongolia,1,4,Friendly,Vientiane,Laos,False,5,-3,Mongolia
35418,37743,40168,2018,Malaysia,Kyrgyzstan,0,1,Friendly,Malacca City,Malaysia,False,1,-1,Kyrgyzstan
35419,37744,40169,2018,Mexico,Chile,0,1,Friendly,Queretaro,Mexico,False,1,-1,Chile
35420,37745,40170,2018,Oman,Ecuador,0,0,Friendly,Doha,Qatar,True,0,0,Draw
35421,37746,40171,2018,Sweden,Slovakia,1,1,Friendly,Stockholm,Sweden,False,2,0,Draw
35422,37747,40172,2018,United Arab Emirates,Venezuela,0,2,Friendly,Barcelona,Spain,True,2,-2,Venezuela
35423,37748,40173,2018,United States,Peru,1,1,Friendly,East Hartford,United States,False,2,0,Draw
35424,37749,40174,2018,Uzbekistan,Qatar,2,0,Friendly,Tashkent,Uzbekistan,False,2,2,Uzbekistan
35425,37750,40175,2018,Madagascar,Equatorial Guinea,1,0,African Cup of Nations qualification,Antananarivo,Madagascar,False,1,1,Madagascar
35426,37751,40176,2018,Malawi,Cameroon,0,0,African Cup of Nations qualification,Blantyre,Malawi,False,0,0,Draw
35427,37752,40177,2018,Burundi,Mali,1,1,African Cup of Nations qualification,Bujumbura,Burundi,False,2,0,Draw
35428,37753,40178,2018,Benin,Algeria,1,0,African Cup of Nations qualification,Cotonou,Benin,False,1,1,Benin
35429,37754,40179,2018,Seychelles,South Africa,0,0,African Cup of Nations qualification,Victoria,Seychelles,False,0,0,Draw
35430,37755,40180,2018,Liberia,Congo,2,1,African Cup of Nations qualification,Monrovia,Liberia,False,3,1,Liberia
35431,37756,40181,2018,Central African Republic,Ivory Coast,0,0,African Cup of Nations qualification,Bangui,Central African Republic,False,0,0,Draw
35432,37757,40182,2018,Mauritania,Angola,1,0,African Cup of Nations qualification,Nouakchott,Mauritania,False,1,1,Mauritania
35433,37758,40183,2018,Eswatini,Egypt,0,2,African Cup of Nations qualification,Manzini,Eswatini,False,2,-2,Egypt
35434,37760,40185,2018,Argentina,Brazil,0,1,Friendly,Jeddah,Saudi Arabia,True,1,-1,Brazil
35435,37761,40187,2018,Malaysia,Maldives,3,0,Friendly,Kuala Lumpur,Malaysia,False,3,3,Malaysia
35436,37762,40188,2018,Cambodia,Malaysia,0,1,AFF Championship,Phnom Penh,Cambodia,False,1,-1,Malaysia
35437,37763,40189,2018,Laos,Vietnam,0,3,AFF Championship,Vientiane,Laos,False,3,-3,Vietnam
35438,37764,40190,2018,Timor-Leste,Thailand,0,7,AFF Championship,Bangkok,Thailand,True,7,-7,Thailand
35439,37765,40191,2018,Singapore,Indonesia,1,0,AFF Championship,Kallang,Singapore,False,1,1,Singapore
35440,37766,40194,2018,Myanmar,Cambodia,4,1,AFF Championship,Mandalay,Myanmar,False,5,3,Myanmar
35441,37767,40195,2018,Malaysia,Laos,3,1,AFF Championship,Kuala Lumpur,Malaysia,False,4,2,Malaysia
35442,37768,40196,2018,Indonesia,Timor-Leste,3,1,AFF Championship,Jakarta,Indonesia,False,4,2,Indonesia
35443,37769,40197,2018,Philippines,Singapore,1,0,AFF Championship,Bacolod,Philippines,False,1,1,Philippines
35444,37771,40200,2018,Switzerland,Qatar,0,1,Friendly,Lugano,Switzerland,False,1,-1,Qatar
35445,37772,40201,2018,Vanuatu,New Caledonia,0,1,Friendly,Port Vila,Vanuatu,False,1,-1,New Caledonia
35446,37773,40202,2018,Belgium,Iceland,2,0,UEFA Nations League,Brussels,Belgium,False,2,2,Belgium
35447,37774,40203,2018,Croatia,Spain,3,2,UEFA Nations League,Zagreb,Croatia,False,5,1,Croatia
35448,37775,40204,2018,Austria,Bosnia and Herzegovina,0,0,UEFA Nations League,Vienna,Austria,False,0,0,Draw
35449,37776,40205,2018,Hungary,Estonia,2,0,UEFA Nations League,Budapest,Hungary,False,2,2,Hungary
35450,37777,40206,2018,Greece,Finland,1,0,UEFA Nations League,Athens,Greece,False,1,1,Greece
35451,37778,40207,2018,Andorra,Georgia,1,1,UEFA Nations League,Andorra la Vella,Andorra,False,2,0,Draw
35452,37779,40208,2018,Kazakhstan,Latvia,1,1,UEFA Nations League,Astana,Kazakhstan,False,2,0,Draw
35453,37780,40209,2018,Luxembourg,Belarus,0,2,UEFA Nations League,Luxembourg City,Luxembourg,False,2,-2,Belarus
35454,37781,40210,2018,San Marino,Moldova,0,1,UEFA Nations League,Serravalle,San Marino,False,1,-1,Moldova
35455,37782,40211,2018,England,United States,3,0,Friendly,London,England,False,3,3,England
35456,37783,40212,2018,Germany,Russia,3,0,Friendly,Leipzig,Germany,False,3,3,Germany
35457,37784,40213,2018,Iran,Trinidad and Tobago,1,0,Friendly,Tehran,Iran,False,1,1,Iran
35458,37785,40214,2018,Israel,Guatemala,7,0,Friendly,Netanya,Israel,False,7,7,Israel
35459,37786,40215,2018,Peru,Ecuador,0,2,Friendly,Lima,Peru,False,2,-2,Ecuador
35460,37787,40216,2018,Poland,Czech Republic,0,1,Friendly,Gdańsk,Poland,False,1,-1,Czech Republic
35461,37788,40217,2018,Republic of Ireland,Northern Ireland,0,0,Friendly,Dublin,Republic of Ireland,False,0,0,Draw
35462,37789,40218,2018,Uzbekistan,Lebanon,0,0,Friendly,Robina,Australia,True,0,0,Draw
35463,37790,40219,2018,Netherlands,France,2,0,UEFA Nations League,Rotterdam,Netherlands,False,2,2,Netherlands
35464,37791,40220,2018,Slovakia,Ukraine,4,1,UEFA Nations League,Trnava,Slovakia,False,5,3,Slovakia
35465,37792,40221,2018,Wales,Denmark,1,2,UEFA Nations League,Cardiff,Wales,False,3,-1,Denmark
35466,37793,40222,2018,Slovenia,Norway,1,1,UEFA Nations League,Ljubljana,Slovenia,False,2,0,Draw
35467,37794,40223,2018,Cyprus,Bulgaria,1,1,UEFA Nations League,Nicosia,Cyprus,False,2,0,Draw
35468,37795,40224,2018,Gibraltar,Armenia,2,6,UEFA Nations League,Gibraltar,Gibraltar,False,8,-4,Armenia
35469,37797,40226,2018,Argentina,Mexico,2,0,Friendly,Cordoba,Argentina,False,2,2,Argentina
35470,37798,40227,2018,Brazil,Uruguay,1,0,Friendly,London,England,True,1,1,Brazil
35471,37799,40228,2018,Chile,Costa Rica,2,3,Friendly,Rancagua,Chile,False,5,-1,Costa Rica
35472,37800,40229,2018,Honduras,Panama,1,0,Friendly,Tegucigalpa,Honduras,False,1,1,Honduras
35473,37801,40230,2018,Japan,Venezuela,1,1,Friendly,Ōita,Japan,False,2,0,Draw
35474,37802,40231,2018,Oman,Syria,1,1,Friendly,Muscat,Oman,False,2,0,Draw
35475,37803,40232,2018,Palestine,Pakistan,2,1,Friendly,Al Ram,Palestine,False,3,1,Palestine
35476,37804,40233,2018,Saudi Arabia,Yemen,1,0,Friendly,Damman,Saudi Arabia,False,1,1,Saudi Arabia
35477,37805,40234,2018,United Arab Emirates,Bolivia,0,0,Friendly,Dubai,United Arab Emirates,False,0,0,Draw
35478,37806,40235,2018,Laos,Myanmar,1,3,AFF Championship,Vientiane,Laos,False,4,-2,Myanmar
35479,37807,40236,2018,Vietnam,Malaysia,2,0,AFF Championship,Hanoi,Vietnam,False,2,2,Vietnam
35480,37808,40237,2018,Morocco,Cameroon,2,0,African Cup of Nations qualification,Casablanca,Morocco,False,2,2,Morocco
35481,37809,40238,2018,South Sudan,Burundi,2,5,African Cup of Nations qualification,Juba,South Sudan,False,7,-3,Burundi
35482,37810,40239,2018,Egypt,Tunisia,3,2,African Cup of Nations qualification,Alexandria,Egypt,False,5,1,Egypt
35483,37811,40241,2018,Mongolia,Hong Kong,1,5,EAFF Championship,Taipei,Chinese Taipei,True,6,-4,Hong Kong
35484,37812,40242,2018,Italy,Portugal,0,0,UEFA Nations League,Milan,Italy,False,0,0,Draw
35485,37813,40243,2018,Turkey,Sweden,0,1,UEFA Nations League,Konya,Turkey,False,1,-1,Sweden
35486,37814,40244,2018,Albania,Scotland,0,4,UEFA Nations League,Shkodër,Albania,False,4,-4,Scotland
35487,37815,40245,2018,Serbia,Montenegro,2,1,UEFA Nations League,Belgrade,Serbia,False,3,1,Serbia
35488,37816,40246,2018,Romania,Lithuania,3,0,UEFA Nations League,Ploiești,Romania,False,3,3,Romania
35489,37817,40247,2018,Malta,Kosovo,0,5,UEFA Nations League,Attard,Malta,False,5,-5,Kosovo
35490,37818,40248,2018,Azerbaijan,Faroe Islands,2,0,UEFA Nations League,Baku,Azerbaijan,False,2,2,Azerbaijan
35491,37820,40250,2018,Jordan,India,2,1,Friendly,Amman,Jordan,False,3,1,Jordan
35492,37821,40251,2018,Vanuatu,New Caledonia,2,2,Friendly,Port Vila,Vanuatu,False,4,0,Draw
35493,37822,40252,2018,Thailand,Indonesia,4,2,AFF Championship,Bangkok,Thailand,False,6,2,Thailand
35494,37823,40253,2018,Timor-Leste,Philippines,2,3,AFF Championship,Kuala Lumpur,Malaysia,True,5,-1,Philippines
35495,37824,40254,2018,Equatorial Guinea,Senegal,0,1,African Cup of Nations qualification,Bata,Equatorial Guinea,False,1,-1,Senegal
35496,37825,40255,2018,Gambia,Benin,3,1,African Cup of Nations qualification,Bakau,Gambia,False,4,2,Gambia
35497,37826,40256,2018,Seychelles,Libya,1,8,African Cup of Nations qualification,Victoria,Seychelles,False,9,-7,Libya
35498,37827,40257,2018,Namibia,Guinea-Bissau,0,0,African Cup of Nations qualification,Windhoek,Namibia,False,0,0,Draw
35499,37829,40259,2018,Switzerland,Belgium,5,2,UEFA Nations League,Luzern,Switzerland,False,7,3,Switzerland
35500,37830,40260,2018,England,Croatia,2,1,UEFA Nations League,London,England,False,3,1,England
35501,37831,40261,2018,Northern Ireland,Austria,1,2,UEFA Nations League,Belfast,Northern Ireland,False,3,-1,Austria
35502,37832,40262,2018,Greece,Estonia,0,1,UEFA Nations League,Athens,Greece,False,1,-1,Estonia
35503,37833,40263,2018,Hungary,Finland,2,0,UEFA Nations League,Budapest,Hungary,False,2,2,Hungary
35504,37834,40264,2018,San Marino,Belarus,0,2,UEFA Nations League,Serravalle,San Marino,False,2,-2,Belarus
35505,37835,40265,2018,Moldova,Luxembourg,1,1,UEFA Nations League,Chișinău,Moldova,False,2,0,Draw
35506,37836,40266,2018,Spain,Bosnia and Herzegovina,1,0,Friendly,Las Palmas,Spain,False,1,1,Spain
35507,37837,40267,2018,Ethiopia,Ghana,0,2,African Cup of Nations qualification,Addis Ababa,Ethiopia,False,2,-2,Ghana
35508,37838,40268,2018,Congo,DR Congo,1,1,African Cup of Nations qualification,Brazzaville,Congo,False,2,0,Draw
35509,37839,40269,2018,Guinea,Ivory Coast,1,1,African Cup of Nations qualification,Conakry,Guinea,False,2,0,Draw
35510,37840,40270,2018,Angola,Burkina Faso,2,1,African Cup of Nations qualification,Luanda,Angola,False,3,1,Angola
35511,37841,40272,2018,Germany,Netherlands,2,2,UEFA Nations League,Gelsenkirchen,Germany,False,4,0,Draw
35512,37842,40273,2018,Czech Republic,Slovakia,1,0,UEFA Nations League,Prague,Czech Republic,False,1,1,Czech Republic
35513,37843,40274,2018,Denmark,Republic of Ireland,0,0,UEFA Nations League,Aarhus,Denmark,False,0,0,Draw
35514,37844,40275,2018,Bulgaria,Slovenia,1,1,UEFA Nations League,Sofia,Bulgaria,False,2,0,Draw
35515,37845,40276,2018,Cyprus,Norway,0,2,UEFA Nations League,Nicosia,Cyprus,False,2,-2,Norway
35516,37846,40277,2018,Andorra,Latvia,0,0,UEFA Nations League,Andorra la Vella,Andorra,False,0,0,Draw
35517,37847,40278,2018,Georgia,Kazakhstan,2,1,UEFA Nations League,Tbilisi,Georgia,False,3,1,Georgia
35518,37848,40280,2018,Liechtenstein,Armenia,2,2,UEFA Nations League,Vaduz,Liechtenstein,False,4,0,Draw
35519,37849,40281,2018,Iceland,Qatar,2,2,Friendly,Eupen,Belgium,True,4,0,Draw
35520,37850,40282,2018,Oman,Bahrain,2,1,Friendly,Muscat,Oman,False,3,1,Oman
35521,37851,40283,2018,Portugal,Poland,1,1,UEFA Nations League,Guimaraes,Portugal,False,2,0,Draw
35522,37852,40284,2018,Sweden,Russia,2,0,UEFA Nations League,Stockholm,Sweden,False,2,2,Sweden
35523,37853,40285,2018,Scotland,Israel,3,2,UEFA Nations League,Glasgow,Scotland,False,5,1,Scotland
35524,37854,40286,2018,Montenegro,Romania,0,1,UEFA Nations League,Podgorica,Montenegro,False,1,-1,Romania
35525,37855,40287,2018,Serbia,Lithuania,4,1,UEFA Nations League,Belgrade,Serbia,False,5,3,Serbia
35526,37856,40288,2018,Kosovo,Azerbaijan,4,0,UEFA Nations League,Pristina,Kosovo,False,4,4,Kosovo
35527,37857,40289,2018,Malta,Faroe Islands,1,1,UEFA Nations League,Attard,Malta,False,2,0,Draw
35528,37858,40290,2018,Albania,Wales,1,0,Friendly,Elbasan,Albania,False,1,1,Albania
35529,37859,40291,2018,Argentina,Mexico,2,0,Friendly,Mendoza,Argentina,False,2,2,Argentina
35530,37860,40292,2018,Australia,Lebanon,3,0,Friendly,Sydney,Australia,False,3,3,Australia
35531,37861,40293,2018,Brazil,Cameroon,1,0,Friendly,London,England,True,1,1,Brazil
35532,37862,40294,2018,Chile,Honduras,4,1,Friendly,Temuco,Chile,False,5,3,Chile
35533,37863,40296,2018,El Salvador,Haiti,1,0,Friendly,San Salvador,El Salvador,False,1,1,El Salvador
35534,37864,40297,2018,France,Uruguay,1,0,Friendly,Paris,France,False,1,1,France
35535,37865,40298,2018,Iran,Venezuela,1,1,Friendly,Doha,Qatar,True,2,0,Draw
35536,37866,40299,2018,Iraq,Bolivia,0,0,Friendly,Al-Ain,Iraq,False,0,0,Draw
35537,37867,40300,2018,Italy,United States,1,0,Friendly,Genk,Belgium,True,1,1,Italy
35538,37868,40301,2018,Japan,Kyrgyzstan,4,0,Friendly,Toyota,Japan,False,4,4,Japan
35539,37869,40302,2018,Jordan,Saudi Arabia,1,1,Friendly,Amman,Jordan,False,2,0,Draw
35540,37870,40304,2018,Kuwait,Syria,1,2,Friendly,Al Farwaniyah,Kuwait,False,3,-1,Syria
35541,37871,40305,2018,Nigeria,Uganda,0,0,Friendly,Asaba,Nigeria,False,0,0,Draw
35542,37872,40306,2018,Panama,Ecuador,1,2,Friendly,Panama City,Panama,False,3,-1,Ecuador
35543,37873,40307,2018,Peru,Costa Rica,2,3,Friendly,Arequipa,Peru,False,5,-1,Costa Rica
35544,37874,40308,2018,South Africa,Paraguay,1,1,Friendly,Durban,South Africa,False,2,0,Draw
35545,37875,40309,2018,Tunisia,Morocco,0,1,Friendly,Radès,Tunisia,False,1,-1,Morocco
35546,37876,40310,2018,Turkey,Ukraine,0,0,Friendly,Antalya,Turkey,False,0,0,Draw
35547,37877,40311,2018,United Arab Emirates,Yemen,2,0,Friendly,Dubai,United Arab Emirates,False,2,2,United Arab Emirates
35548,37878,40312,2018,Myanmar,Vietnam,0,0,AFF Championship,Yangon,Myanmar,False,0,0,Draw
35549,37879,40313,2018,Cambodia,Laos,3,1,AFF Championship,Phnom Penh,Cambodia,False,4,2,Cambodia
35550,37880,40314,2018,Philippines,Thailand,1,1,AFF Championship,Bacolod,Philippines,False,2,0,Draw
35551,37881,40315,2018,Singapore,Timor-Leste,6,1,AFF Championship,Kallang,Singapore,False,7,5,Singapore
35552,37882,40316,2018,Vietnam,Cambodia,3,0,AFF Championship,Hanoi,Vietnam,False,3,3,Vietnam
35553,37883,40317,2018,Malaysia,Myanmar,3,0,AFF Championship,Kuala Lumpur,Malaysia,False,3,3,Malaysia
35554,37884,40318,2018,Indonesia,Philippines,0,0,AFF Championship,Jakarta,Indonesia,False,0,0,Draw
35555,37885,40319,2018,Thailand,Singapore,3,0,AFF Championship,Bangkok,Thailand,False,3,3,Thailand
35556,37886,40320,2018,Malaysia,Thailand,0,0,AFF Championship,Kuala Lumpur,Malaysia,False,0,0,Draw
35557,37887,40321,2018,Philippines,Vietnam,1,2,AFF Championship,Bacolod,Philippines,False,3,-1,Vietnam
35558,37888,40322,2018,Thailand,Malaysia,2,2,AFF Championship,Bangkok,Thailand,False,4,0,Draw
35559,37889,40323,2018,Vietnam,Philippines,2,1,AFF Championship,Hanoi,Vietnam,False,3,1,Vietnam
35560,37890,40324,2018,Malaysia,Vietnam,2,2,AFF Championship,Kuala Lumpur,Malaysia,False,4,0,Draw
35561,37891,40325,2018,Oman,Tajikistan,2,1,Friendly,Muscat,Oman,False,3,1,Oman
35562,37892,40326,2018,Vietnam,Malaysia,1,0,AFF Championship,Hanoi,Vietnam,False,1,1,Vietnam
35563,37893,40327,2018,Oman,Tajikistan,1,0,Friendly,Muscat,Oman,False,1,1,Oman
35564,37894,40328,2018,Palestine,Pakistan,2,0,Friendly,Doha,Qatar,True,2,2,Palestine
35565,37895,40329,2018,Bahrain,Tajikistan,5,0,Friendly,Isa Town,Bahrain,False,5,5,Bahrain
35566,37896,40330,2018,Jordan,Kyrgyzstan,0,1,Friendly,Doha,Qatar,True,1,-1,Kyrgyzstan
35567,37897,40331,2018,Qatar,Jordan,2,0,Friendly,Doha,Qatar,False,2,2,Qatar
35568,37899,40333,2018,Palestine,Iran,1,1,Friendly,Doha,Qatar,True,2,0,Draw
35569,37900,40334,2018,Afghanistan,Turkmenistan,0,2,Friendly,Antalya,Turkey,True,2,-2,Turkmenistan
35570,37901,40335,2018,Qatar,Kyrgyzstan,1,0,Friendly,Doha,Qatar,False,1,1,Qatar
35571,37903,40337,2018,Bahrain,Lebanon,1,0,Friendly,East Riffa,Bahrain,False,1,1,Bahrain
35572,37904,40338,2018,India,Oman,0,0,Friendly,Abu Dhabi,United Arab Emirates,True,0,0,Draw
35573,37905,40339,2018,Qatar,Algeria,0,1,Friendly,Doha,Qatar,False,1,-1,Algeria
35574,37906,40341,2018,Iraq,Palestine,1,0,Friendly,Doha,Qatar,True,1,1,Iraq
35575,37907,40342,2018,United Arab Emirates,Kuwait,0,2,Friendly,Dubai,United Arab Emirates,False,2,-2,Kuwait
35576,37909,40344,2018,Australia,Oman,5,0,Friendly,Dubai,United Arab Emirates,True,5,5,Australia
35577,37910,40345,2018,Yemen,Syria,0,1,Friendly,Abu Dhabi,United Arab Emirates,True,1,-1,Syria
35578,37911,40347,2018,Kyrgyzstan,Palestine,2,1,Friendly,Doha,Qatar,True,3,1,Kyrgyzstan
35579,37912,40348,2018,Philippines,Vietnam,2,4,Friendly,Doha,Qatar,True,6,-2,Vietnam
35580,37913,40349,2018,Qatar,Iran,1,2,Friendly,Doha,Qatar,False,3,-1,Iran
35581,37914,40350,2019,Oman,Thailand,2,0,Friendly,Abu Dhabi,United Arab Emirates,True,2,2,Oman
35582,37915,40351,2019,United Arab Emirates,Bahrain,1,1,AFC Asian Cup,Abu Dhabi,United Arab Emirates,False,2,0,Draw
35583,37916,40352,2019,Thailand,India,1,4,AFC Asian Cup,Abu Dhabi,United Arab Emirates,True,5,-3,India
35584,37917,40353,2019,Australia,Jordan,0,1,AFC Asian Cup,Al Ain,United Arab Emirates,True,1,-1,Jordan
35585,37918,40354,2019,Syria,Palestine,0,0,AFC Asian Cup,Sharjah,United Arab Emirates,True,0,0,Draw
35586,37919,40357,2019,Iran,Yemen,5,0,AFC Asian Cup,Abu Dhabi,United Arab Emirates,True,5,5,Iran
35587,37920,40358,2019,Finland,Sweden,1,0,Friendly,Doha,Qatar,True,1,1,Finland
35588,37921,40359,2019,Iraq,Vietnam,3,2,AFC Asian Cup,Abu Dhabi,United Arab Emirates,True,5,1,Iraq
35589,37923,40361,2019,Qatar,Lebanon,2,0,AFC Asian Cup,Al Ain,United Arab Emirates,True,2,2,Qatar
35590,37924,40362,2019,Japan,Turkmenistan,3,2,AFC Asian Cup,Abu Dhabi,United Arab Emirates,True,5,1,Japan
35591,37925,40363,2019,Uzbekistan,Oman,2,1,AFC Asian Cup,Sharjah,United Arab Emirates,True,3,1,Uzbekistan
35592,37926,40364,2019,Bahrain,Thailand,0,1,AFC Asian Cup,Dubai,United Arab Emirates,True,1,-1,Thailand
35593,37927,40365,2019,India,United Arab Emirates,0,2,AFC Asian Cup,Abu Dhabi,United Arab Emirates,True,2,-2,United Arab Emirates
35594,37928,40366,2019,Jordan,Syria,2,0,AFC Asian Cup,Al Ain,United Arab Emirates,True,2,2,Jordan
35595,37929,40367,2019,Estonia,Finland,2,1,Friendly,Doha,Qatar,True,3,1,Estonia
35596,37930,40368,2019,Iceland,Sweden,2,2,Friendly,Doha,Qatar,True,4,0,Draw
35597,37931,40369,2019,Palestine,Australia,0,3,AFC Asian Cup,Dubai,United Arab Emirates,True,3,-3,Australia
35598,37934,40372,2019,Vietnam,Iran,0,2,AFC Asian Cup,Abu Dhabi,United Arab Emirates,True,2,-2,Iran
35599,37935,40373,2019,Yemen,Iraq,0,3,AFC Asian Cup,Sharjah,United Arab Emirates,True,3,-3,Iraq
35600,37936,40374,2019,Lebanon,Saudi Arabia,0,2,AFC Asian Cup,Dubai,United Arab Emirates,True,2,-2,Saudi Arabia
35601,37937,40376,2019,Oman,Japan,0,1,AFC Asian Cup,Abu Dhabi,United Arab Emirates,True,1,-1,Japan
35602,37938,40377,2019,Turkmenistan,Uzbekistan,0,4,AFC Asian Cup,Dubai,United Arab Emirates,True,4,-4,Uzbekistan
35603,37939,40378,2019,India,Bahrain,0,1,AFC Asian Cup,Sharjah,United Arab Emirates,True,1,-1,Bahrain
35604,37940,40379,2019,United Arab Emirates,Thailand,1,1,AFC Asian Cup,Al Ain,United Arab Emirates,False,2,0,Draw
35605,37941,40380,2019,Estonia,Iceland,0,0,Friendly,Doha,Qatar,True,0,0,Draw
35606,37942,40381,2019,Australia,Syria,3,2,AFC Asian Cup,Al Ain,United Arab Emirates,True,5,1,Australia
35607,37943,40382,2019,Palestine,Jordan,0,0,AFC Asian Cup,Abu Dhabi,United Arab Emirates,True,0,0,Draw
35608,37944,40384,2019,Kyrgyzstan,Philippines,3,1,AFC Asian Cup,Dubai,United Arab Emirates,True,4,2,Kyrgyzstan
35609,37945,40385,2019,Iran,Iraq,0,0,AFC Asian Cup,Dubai,United Arab Emirates,True,0,0,Draw
35610,37946,40386,2019,Vietnam,Yemen,2,0,AFC Asian Cup,Al Ain,United Arab Emirates,True,2,2,Vietnam
35611,37948,40388,2019,Saudi Arabia,Qatar,0,2,AFC Asian Cup,Abu Dhabi,United Arab Emirates,True,2,-2,Qatar
35612,37949,40389,2019,Japan,Uzbekistan,2,1,AFC Asian Cup,Al Ain,United Arab Emirates,True,3,1,Japan
35613,37950,40390,2019,Oman,Turkmenistan,3,1,AFC Asian Cup,Abu Dhabi,United Arab Emirates,True,4,2,Oman
35614,37951,40391,2019,Iran,Oman,2,0,AFC Asian Cup,Abu Dhabi,United Arab Emirates,True,2,2,Iran
35615,37952,40392,2019,Jordan,Vietnam,1,1,AFC Asian Cup,Dubai,United Arab Emirates,True,2,0,Draw
35616,37954,40394,2019,Australia,Uzbekistan,0,0,AFC Asian Cup,Al Ain,United Arab Emirates,True,0,0,Draw
35617,37955,40395,2019,Japan,Saudi Arabia,1,0,AFC Asian Cup,Sharjah,United Arab Emirates,True,1,1,Japan
35618,37956,40396,2019,United Arab Emirates,Kyrgyzstan,3,2,AFC Asian Cup,Abu Dhabi,United Arab Emirates,False,5,1,United Arab Emirates
35619,37957,40398,2019,Qatar,Iraq,1,0,AFC Asian Cup,Abu Dhabi,United Arab Emirates,True,1,1,Qatar
35620,37958,40400,2019,Vietnam,Japan,0,1,AFC Asian Cup,Dubai,United Arab Emirates,True,1,-1,Japan
35621,37959,40402,2019,United Arab Emirates,Australia,1,0,AFC Asian Cup,Al Ain,United Arab Emirates,False,1,1,United Arab Emirates
35622,37960,40403,2019,United States,Panama,3,0,Friendly,Glendale,United States,False,3,3,United States
35623,37961,40404,2019,Iran,Japan,0,3,AFC Asian Cup,Al Ain,United Arab Emirates,True,3,-3,Japan
35624,37962,40405,2019,Qatar,United Arab Emirates,4,0,AFC Asian Cup,Abu Dhabi,United Arab Emirates,True,4,4,Qatar
35625,37963,40406,2019,Japan,Qatar,1,3,AFC Asian Cup,Abu Dhabi,United Arab Emirates,True,4,-2,Qatar
35626,37964,40407,2019,United States,Costa Rica,2,0,Friendly,San Jose,United States,False,2,2,United States
35627,37965,40408,2019,Kazakhstan,Moldova,1,0,Friendly,Belek,Turkey,True,1,1,Kazakhstan
35628,37966,40409,2019,Cuba,Bermuda,5,0,Friendly,Havana,Cuba,False,5,5,Cuba
35629,37967,40410,2019,Bolivia,Nicaragua,2,2,Friendly,Villa Tunari,Bolivia,False,4,0,Draw
35630,37968,40411,2019,Barbados,Grenada,3,0,Friendly,Kingstown,Saint Vincent and the Grenadines,True,3,3,Barbados
35631,37969,40412,2019,El Salvador,Guatemala,3,1,Friendly,Los Angeles,United States,True,4,2,El Salvador
35632,37970,40413,2019,Cambodia,Bangladesh,0,1,Friendly,Phnom Penh,Cambodia,False,1,-1,Bangladesh
35633,37971,40414,2019,Bahamas,Turks and Caicos Islands,6,1,Friendly,Nassau,Bahamas,False,7,5,Bahamas
35634,37972,40415,2019,Fiji,New Caledonia,3,0,Friendly,Suva,Fiji,False,3,3,Fiji
35635,37973,40416,2019,Solomon Islands,Vanuatu,3,1,Friendly,Honiara,Solomon Islands,False,4,2,Solomon Islands
35636,37975,40418,2019,Germany,Serbia,1,1,Friendly,Wolfsburg,Germany,False,2,0,Draw
35637,37976,40419,2019,Wales,Trinidad and Tobago,1,0,Friendly,Wrexham,Wales,False,1,1,Wales
35638,37977,40420,2019,Kosovo,Denmark,2,2,Friendly,Pristina,Kosovo,False,4,0,Draw
35639,37978,40421,2019,Kuwait,Nepal,0,0,Friendly,Al Ahmadi,Kuwait,False,0,0,Draw
35640,37979,40422,2019,Mauritius,New Caledonia,3,1,Friendly,Lautoka,Fiji,True,4,2,Mauritius
35641,37980,40423,2019,United Arab Emirates,Saudi Arabia,2,1,Friendly,Abu Dhabi,United Arab Emirates,False,3,1,United Arab Emirates
35642,37981,40424,2019,United States,Ecuador,1,0,Friendly,Orlando,United States,False,1,1,United States
35643,37982,40425,2019,Northern Ireland,Estonia,2,0,UEFA Euro qualification,Belfast,Northern Ireland,False,2,2,Northern Ireland
35644,37983,40426,2019,Netherlands,Belarus,4,0,UEFA Euro qualification,Rotterdam,Netherlands,False,4,4,Netherlands
35645,37984,40427,2019,Croatia,Azerbaijan,2,1,UEFA Euro qualification,Zagreb,Croatia,False,3,1,Croatia
35646,37985,40428,2019,Slovakia,Hungary,2,0,UEFA Euro qualification,Trnava,Slovakia,False,2,2,Slovakia
35647,37986,40429,2019,Austria,Poland,0,1,UEFA Euro qualification,Vienna,Austria,False,1,-1,Poland
35648,37987,40431,2019,Israel,Slovenia,1,1,UEFA Euro qualification,Haifa,Israel,False,2,0,Draw
35649,37988,40432,2019,Cyprus,San Marino,5,0,UEFA Euro qualification,Nicosia,Cyprus,False,5,5,Cyprus
35650,37989,40433,2019,Belgium,Russia,3,1,UEFA Euro qualification,Brussels,Belgium,False,4,2,Belgium
35651,37990,40434,2019,Kazakhstan,Scotland,3,0,UEFA Euro qualification,Nursultan,Kazakhstan,False,3,3,Kazakhstan
35652,37991,40435,2019,Argentina,Venezuela,1,3,Friendly,Madrid,Spain,True,4,-2,Venezuela
35653,37992,40436,2019,Guatemala,Costa Rica,1,0,Friendly,Guatemala City,Guatemala,False,1,1,Guatemala
35654,37993,40437,2019,Japan,Colombia,0,1,Friendly,Yokohama,Japan,False,1,-1,Colombia
35655,37994,40439,2019,Mexico,Chile,3,1,Friendly,San Diego,United States,True,4,2,Mexico
35656,37995,40440,2019,Peru,Paraguay,1,0,Friendly,Harrison,United States,True,1,1,Peru
35657,37996,40441,2019,Bulgaria,Montenegro,1,1,UEFA Euro qualification,Sofia,Bulgaria,False,2,0,Draw
35658,37997,40442,2019,England,Czech Republic,5,0,UEFA Euro qualification,London,England,False,5,5,England
35659,37998,40443,2019,Portugal,Ukraine,0,0,UEFA Euro qualification,Lisbon,Portugal,False,0,0,Draw
35660,37999,40444,2019,Luxembourg,Lithuania,2,1,UEFA Euro qualification,Luxembourg City,Luxembourg,False,3,1,Luxembourg
35661,38000,40445,2019,Albania,Turkey,0,2,UEFA Euro qualification,Shkodër,Albania,False,2,-2,Turkey
35662,38001,40446,2019,Andorra,Iceland,0,2,UEFA Euro qualification,Andorra la Vella,Andorra,False,2,-2,Iceland
35663,38002,40447,2019,Moldova,France,1,4,UEFA Euro qualification,Chișinău,Moldova,False,5,-3,France
35664,38003,40448,2019,Botswana,Angola,0,1,African Cup of Nations qualification,Francistown,Botswana,False,1,-1,Angola
35665,38004,40449,2019,Brazil,Panama,1,1,Friendly,Porto,Portugal,True,2,0,Draw
35666,38005,40450,2019,Malaysia,Afghanistan,2,1,Friendly,Kuala Lumpur,Malaysia,False,3,1,Malaysia
35667,38006,40451,2019,Oman,Singapore,1,1,Friendly,Kuala Lumpur,Malaysia,True,2,0,Draw
35668,38007,40452,2019,Georgia,Switzerland,0,2,UEFA Euro qualification,Tbilisi,Georgia,False,2,-2,Switzerland
35669,38008,40453,2019,Gibraltar,Republic of Ireland,0,1,UEFA Euro qualification,Gibraltar,Gibraltar,False,1,-1,Republic of Ireland
35670,38009,40454,2019,Malta,Faroe Islands,2,1,UEFA Euro qualification,Attard,Malta,False,3,1,Malta
35671,38010,40455,2019,Sweden,Romania,2,1,UEFA Euro qualification,Stockholm,Sweden,False,3,1,Sweden
35672,38011,40456,2019,Spain,Norway,2,1,UEFA Euro qualification,Valencia,Spain,False,3,1,Spain
35673,38012,40457,2019,Bosnia and Herzegovina,Armenia,2,1,UEFA Euro qualification,Sarajevo,Bosnia and Herzegovina,False,3,1,Bosnia and Herzegovina
35674,38013,40458,2019,Italy,Finland,2,0,UEFA Euro qualification,Udine,Italy,False,2,2,Italy
35675,38014,40459,2019,Liechtenstein,Greece,0,2,UEFA Euro qualification,Vaduz,Liechtenstein,False,2,-2,Greece
35676,38015,40460,2019,Senegal,Madagascar,2,0,African Cup of Nations qualification,Thiès,Senegal,False,2,2,Senegal
35677,38016,40461,2019,Cameroon,Comoros,3,0,African Cup of Nations qualification,Yaoundé,Cameroon,False,3,3,Cameroon
35678,38017,40462,2019,Mali,South Sudan,3,0,African Cup of Nations qualification,Bamako,Mali,False,3,3,Mali
35679,38018,40463,2019,Ghana,Kenya,1,0,African Cup of Nations qualification,Accra,Ghana,False,1,1,Ghana
35680,38019,40464,2019,Niger,Egypt,1,1,African Cup of Nations qualification,Niamey,Niger,False,2,0,Draw
35681,38020,40465,2019,Zambia,Namibia,4,1,African Cup of Nations qualification,Lusaka,Zambia,False,5,3,Zambia
35682,38021,40467,2019,Fiji,Mauritius,1,0,Friendly,Lautoka,Fiji,False,1,1,Fiji
35683,38022,40468,2019,Northern Ireland,Belarus,2,1,UEFA Euro qualification,Belfast,Northern Ireland,False,3,1,Northern Ireland
35684,38023,40469,2019,Netherlands,Germany,2,3,UEFA Euro qualification,Amsterdam,Netherlands,False,5,-1,Germany
35685,38024,40470,2019,Wales,Slovakia,1,0,UEFA Euro qualification,Cardiff,Wales,False,1,1,Wales
35686,38025,40471,2019,Hungary,Croatia,2,1,UEFA Euro qualification,Budapest,Hungary,False,3,1,Hungary
35687,38026,40472,2019,Israel,Austria,4,2,UEFA Euro qualification,Haifa,Israel,False,6,2,Israel
35688,38027,40473,2019,Poland,Latvia,2,0,UEFA Euro qualification,Warsaw,Poland,False,2,2,Poland
35689,38029,40475,2019,San Marino,Scotland,0,2,UEFA Euro qualification,Serravalle,San Marino,False,2,-2,Scotland
35690,38030,40476,2019,Kazakhstan,Russia,0,4,UEFA Euro qualification,Nursultan,Kazakhstan,False,4,-4,Russia
35691,38031,40477,2019,Cyprus,Belgium,0,2,UEFA Euro qualification,Nicosia,Cyprus,False,2,-2,Belgium
35692,38032,40478,2019,Benin,Togo,2,1,African Cup of Nations qualification,Cotonou,Benin,False,3,1,Benin
35693,38033,40479,2019,Libya,South Africa,1,2,African Cup of Nations qualification,Sfax,Tunisia,True,3,-1,South Africa
35694,38034,40480,2019,Zimbabwe,Congo,2,0,African Cup of Nations qualification,Harare,Zimbabwe,False,2,2,Zimbabwe
35695,38035,40481,2019,Central African Republic,Guinea,0,0,African Cup of Nations qualification,Bangui,Central African Republic,False,0,0,Draw
35696,38036,40482,2019,Tanzania,Uganda,3,0,African Cup of Nations qualification,Dar es Salaam,Tanzania,False,3,3,Tanzania
35697,38037,40483,2019,Azerbaijan,Lithuania,0,0,Friendly,Baku,Azerbaijan,False,0,0,Draw
35698,38038,40484,2019,Kuwait,Nepal,1,0,Friendly,Al Ahmadi,Kuwait,False,1,1,Kuwait
35699,38039,40485,2019,Myanmar,Indonesia,0,2,Friendly,Mandalay,Myanmar,False,2,-2,Indonesia
35700,38040,40486,2019,Saudi Arabia,Equatorial Guinea,3,2,Friendly,Riyadh,Saudi Arabia,False,5,1,Saudi Arabia
35701,38041,40487,2019,Kosovo,Bulgaria,1,1,UEFA Euro qualification,Pristina,Kosovo,False,2,0,Draw
35702,38042,40488,2019,Montenegro,England,1,5,UEFA Euro qualification,Podgorica,Montenegro,False,6,-4,England
35703,38043,40489,2019,Portugal,Serbia,1,1,UEFA Euro qualification,Lisbon,Portugal,False,2,0,Draw
35704,38044,40490,2019,Luxembourg,Ukraine,1,2,UEFA Euro qualification,Luxembourg City,Luxembourg,False,3,-1,Ukraine
35705,38045,40491,2019,Turkey,Moldova,4,0,UEFA Euro qualification,Eskişehir,Turkey,False,4,4,Turkey
35706,38046,40492,2019,Andorra,Albania,0,3,UEFA Euro qualification,Andorra la Vella,Andorra,False,3,-3,Albania
35707,38047,40493,2019,France,Iceland,4,0,UEFA Euro qualification,Paris,France,False,4,4,France
35708,38048,40494,2019,Algeria,Tunisia,1,0,Friendly,Blida,Algeria,False,1,1,Algeria
35709,38049,40495,2019,Costa Rica,Jamaica,1,0,Friendly,San José,Costa Rica,False,1,1,Costa Rica
35710,38050,40496,2019,Czech Republic,Brazil,1,3,Friendly,Prague,Czech Republic,False,4,-2,Brazil
35711,38051,40497,2019,Ghana,Mauritania,3,1,Friendly,Accra,Ghana,False,4,2,Ghana
35712,38052,40498,2019,Gibraltar,Estonia,0,1,Friendly,Gibraltar,Gibraltar,False,1,-1,Estonia
35713,38053,40499,2019,Honduras,Ecuador,0,0,Friendly,Harrison,United States,True,0,0,Draw
35714,38054,40500,2019,Ivory Coast,Liberia,1,0,Friendly,Abidjan,Ivory Coast,False,1,1,Ivory Coast
35715,38055,40501,2019,Japan,Bolivia,0,1,Friendly,Kobe,Japan,False,1,-1,Bolivia
35716,38056,40503,2019,Morocco,Argentina,0,1,Friendly,Tangiers,Morocco,False,1,-1,Argentina
35717,38057,40504,2019,Nicaragua,Guatemala,0,1,Friendly,Managua,Nicaragua,False,1,-1,Guatemala
35718,38058,40505,2019,Nigeria,Egypt,1,0,Friendly,Asaba,Nigeria,False,1,1,Nigeria
35719,38059,40506,2019,Paraguay,Mexico,2,4,Friendly,Santa Clara,United States,True,6,-2,Mexico
35720,38060,40507,2019,Peru,El Salvador,0,2,Friendly,Washington,United States,True,2,-2,El Salvador
35721,38061,40508,2019,Senegal,Mali,2,1,Friendly,Dakar,Senegal,False,3,1,Senegal
35722,38062,40509,2019,United Arab Emirates,Syria,0,0,Friendly,Abu Dhabi,United Arab Emirates,False,0,0,Draw
35723,38063,40510,2019,United States,Chile,1,1,Friendly,Houston,United States,False,2,0,Draw
35724,38064,40511,2019,Republic of Ireland,Georgia,1,0,UEFA Euro qualification,Dublin,Republic of Ireland,False,1,1,Republic of Ireland
35725,38065,40512,2019,Switzerland,Denmark,3,3,UEFA Euro qualification,Basel,Switzerland,False,6,0,Draw
35726,38066,40513,2019,Malta,Spain,0,2,UEFA Euro qualification,Attard,Malta,False,2,-2,Spain
35727,38067,40514,2019,Norway,Sweden,3,3,UEFA Euro qualification,Oslo,Norway,False,6,0,Draw
35728,38068,40515,2019,Romania,Faroe Islands,4,1,UEFA Euro qualification,Cluj-Napoca,Romania,False,5,3,Romania
35729,38069,40516,2019,Bosnia and Herzegovina,Greece,2,2,UEFA Euro qualification,Zenica,Bosnia and Herzegovina,False,4,0,Draw
35730,38070,40517,2019,Italy,Liechtenstein,6,0,UEFA Euro qualification,Parma,Italy,False,6,6,Italy
35731,38071,40518,2019,Armenia,Finland,0,2,UEFA Euro qualification,Yerevan,Armenia,False,2,-2,Finland
35732,38072,40519,2019,Botswana,Seychelles,2,0,African Nations Championship,Lobatse,Botswana,False,2,2,Botswana
35733,38073,40520,2019,Eswatini,Malawi,0,0,African Nations Championship,Manzini,Eswatini,False,0,0,Draw
35734,38074,40522,2019,Malawi,Eswatini,1,1,African Nations Championship,Blantyre,Malawi,False,2,0,Draw
35735,38075,40523,2019,Seychelles,Botswana,1,3,African Nations Championship,Victoria,Seychelles,False,4,-2,Botswana
35736,38076,40524,2019,Eswatini,Mauritius,2,2,COSAFA Cup,Durban,South Africa,True,4,0,Draw
35737,38077,40527,2019,Mozambique,Namibia,1,2,COSAFA Cup,Durban,South Africa,True,3,-1,Namibia
35738,38078,40528,2019,Malawi,Seychelles,3,0,COSAFA Cup,Durban,South Africa,True,3,3,Malawi
35739,38079,40529,2019,Eswatini,Comoros,2,2,COSAFA Cup,Durban,South Africa,True,4,0,Draw
35740,38080,40530,2019,Seychelles,Mozambique,0,0,COSAFA Cup,Durban,South Africa,True,0,0,Draw
35741,38081,40531,2019,Namibia,Malawi,1,2,COSAFA Cup,Durban,South Africa,True,3,-1,Malawi
35742,38082,40532,2019,Laos,Sri Lanka,2,1,Friendly,Vientiane,Laos,False,3,1,Laos
35743,38083,40533,2019,Comoros,Mauritius,2,1,COSAFA Cup,Durban,South Africa,True,3,1,Comoros
35744,38085,40535,2019,Mozambique,Malawi,1,1,COSAFA Cup,Durban,South Africa,True,2,0,Draw
35745,38086,40536,2019,Namibia,Seychelles,3,0,COSAFA Cup,Durban,South Africa,True,3,3,Namibia
35746,38087,40537,2019,Turkey,Greece,2,1,Friendly,Antalya,Turkey,False,3,1,Turkey
35747,38088,40538,2019,Laos,Sri Lanka,2,2,Friendly,Vientiane,Laos,False,4,0,Draw
35748,38089,40539,2019,Lesotho,Uganda,0,0,COSAFA Cup,Durban,South Africa,True,0,0,Draw
35749,38090,40540,2019,Zimbabwe,Comoros,2,0,COSAFA Cup,Durban,South Africa,True,2,2,Zimbabwe
35750,38091,40541,2019,Venezuela,Ecuador,1,1,Friendly,Miami Gardens,United States,True,2,0,Draw
35751,38092,40543,2019,South Africa,Botswana,2,2,COSAFA Cup,Durban,South Africa,False,4,0,Draw
35752,38093,40544,2019,Zambia,Malawi,2,2,COSAFA Cup,Durban,South Africa,True,4,0,Draw
35753,38094,40545,2019,El Salvador,Haiti,1,0,Friendly,Washington,United States,True,1,1,El Salvador
35754,38095,40546,2019,France,Bolivia,2,0,Friendly,Nantes,France,False,2,2,France
35755,38096,40547,2019,Luxembourg,Madagascar,3,3,Friendly,Luxembourg City,Luxembourg,False,6,0,Draw
35756,38097,40548,2019,Malaysia,Nepal,2,0,Friendly,Kuala Lumpur,Malaysia,False,2,2,Malaysia
35757,38098,40549,2019,Turkey,Uzbekistan,0,0,Friendly,Alanya,Turkey,False,0,0,Draw
35758,38099,40555,2019,Colombia,Panama,3,0,Friendly,Bogota,Colombia,False,3,3,Colombia
35759,38101,40561,2019,Comoros,Malawi,1,2,COSAFA Cup,Durban,South Africa,True,3,-1,Malawi
35760,38102,40562,2019,Uganda,South Africa,1,1,COSAFA Cup,Durban,South Africa,True,2,0,Draw
35761,38103,40567,2019,Lesotho,Botswana,1,2,COSAFA Cup,Durban,South Africa,True,3,-1,Botswana
35762,38104,40568,2019,Zimbabwe,Zambia,0,0,COSAFA Cup,Durban,South Africa,True,0,0,Draw
35763,38105,40569,2019,Brazil,Qatar,2,0,Friendly,Brasilia,Brazil,False,2,2,Brazil
35764,38106,40570,2019,Mexico,Venezuela,3,1,Friendly,Atlanta,United States,True,4,2,Mexico
35765,38107,40571,2019,Paraguay,Honduras,1,1,Friendly,Ciudad del Este,Paraguay,False,2,0,Draw
35766,38108,40572,2019,Peru,Costa Rica,1,0,Friendly,Lima,Peru,False,1,1,Peru
35767,38109,40573,2019,United States,Jamaica,0,1,Friendly,Washington,United States,False,1,-1,Jamaica
35768,38110,40574,2019,Portugal,Switzerland,3,1,UEFA Nations League,Porto,Portugal,False,4,2,Portugal
35769,38111,40575,2019,Bermuda,Guyana,1,0,Friendly,Hamilton,Bermuda,False,1,1,Bermuda
35770,38112,40576,2019,Chile,Haiti,2,1,Friendly,Coquimbo,Chile,False,3,1,Chile
35771,38113,40578,2019,Iran,Syria,5,0,Friendly,Tehran,Iran,False,5,5,Iran
35772,38114,40579,2019,Slovakia,Jordan,5,1,Friendly,Trnava,Slovakia,False,6,4,Slovakia
35773,38115,40580,2019,Tajikistan,Afghanistan,1,1,Friendly,Dushanbe,Tajikistan,False,2,0,Draw
35774,38116,40581,2019,England,Netherlands,1,3,UEFA Nations League,Guimaraes,Portugal,True,4,-2,Netherlands
35775,38117,40586,2019,Czech Republic,Bulgaria,2,1,UEFA Euro qualification,Prague,Czech Republic,False,3,1,Czech Republic
35776,38118,40587,2019,Montenegro,Kosovo,1,1,UEFA Euro qualification,Podgorica,Montenegro,False,2,0,Draw
35777,38119,40588,2019,Lithuania,Luxembourg,1,1,UEFA Euro qualification,Vilnius,Lithuania,False,2,0,Draw
35778,38120,40589,2019,Ukraine,Serbia,5,0,UEFA Euro qualification,Lviv,Ukraine,False,5,5,Ukraine
35779,38121,40590,2019,Georgia,Gibraltar,3,0,UEFA Euro qualification,Tbilisi,Georgia,False,3,3,Georgia
35780,38122,40591,2019,Denmark,Republic of Ireland,1,1,UEFA Euro qualification,Copenhagen,Denmark,False,2,0,Draw
35781,38123,40592,2019,Faroe Islands,Spain,1,4,UEFA Euro qualification,Tórshavn,Faroe Islands,False,5,-3,Spain
35782,38124,40593,2019,Norway,Romania,2,2,UEFA Euro qualification,Oslo,Norway,False,4,0,Draw
35783,38125,40594,2019,Sweden,Malta,3,0,UEFA Euro qualification,Stockholm,Sweden,False,3,3,Sweden
35784,38126,40595,2019,Austria,Slovenia,1,0,UEFA Euro qualification,Klagenfurt,Austria,False,1,1,Austria
35785,38127,40597,2019,Latvia,Israel,0,3,UEFA Euro qualification,Riga,Latvia,False,3,-3,Israel
35786,38128,40598,2019,Lesotho,Zimbabwe,2,2,COSAFA Cup,Durban,South Africa,True,4,0,Draw
35787,38129,40599,2019,South Africa,Malawi,0,0,COSAFA Cup,Durban,South Africa,False,0,0,Draw
35788,38130,40600,2019,Argentina,Nicaragua,5,1,Friendly,San Juan,Argentina,False,6,4,Argentina
35789,38132,40603,2019,Ivory Coast,Comoros,3,1,Friendly,Boulogne-Sur-Mer,Ivory Coast,False,4,2,Ivory Coast
35790,38133,40604,2019,Kenya,Madagascar,1,0,Friendly,Bondoufle,Kenya,False,1,1,Kenya
35791,38134,40606,2019,Tunisia,Iraq,2,0,Friendly,Radès,Tunisia,False,2,2,Tunisia
35792,38135,40607,2019,Uruguay,Panama,3,0,Friendly,Montevideo,Uruguay,False,3,3,Uruguay
35793,38137,40609,2019,Estonia,Northern Ireland,1,2,UEFA Euro qualification,Tallinn,Estonia,False,3,-1,Northern Ireland
35794,38138,40610,2019,Belarus,Germany,0,2,UEFA Euro qualification,Borisov,Belarus,False,2,-2,Germany
35795,38139,40611,2019,Croatia,Wales,2,1,UEFA Euro qualification,Osijek,Croatia,False,3,1,Croatia
35796,38140,40612,2019,Azerbaijan,Hungary,1,3,UEFA Euro qualification,Baku,Azerbaijan,False,4,-2,Hungary
35797,38141,40613,2019,Iceland,Albania,1,0,UEFA Euro qualification,Reykjavík,Iceland,False,1,1,Iceland
35798,38142,40614,2019,Moldova,Andorra,1,0,UEFA Euro qualification,Chișinău,Moldova,False,1,1,Moldova
35799,38143,40615,2019,Turkey,France,2,0,UEFA Euro qualification,Konya,Turkey,False,2,2,Turkey
35800,38144,40616,2019,Russia,San Marino,9,0,UEFA Euro qualification,Saransk,Russia,False,9,9,Russia
35801,38145,40617,2019,Scotland,Cyprus,2,1,UEFA Euro qualification,Glasgow,Scotland,False,3,1,Scotland
35802,38146,40618,2019,Belgium,Kazakhstan,3,0,UEFA Euro qualification,Brussels,Belgium,False,3,3,Belgium
35803,38147,40619,2019,Finland,Bosnia and Herzegovina,2,0,UEFA Euro qualification,Tampere,Finland,False,2,2,Finland
35804,38148,40620,2019,Armenia,Liechtenstein,3,0,UEFA Euro qualification,Yerevan,Armenia,False,3,3,Armenia
35805,38149,40621,2019,Greece,Italy,0,3,UEFA Euro qualification,Athens,Greece,False,3,-3,Italy
35806,38150,40622,2019,Botswana,Zambia,0,1,COSAFA Cup,Durban,South Africa,True,1,-1,Zambia
35807,38151,40623,2019,Angola,Guinea-Bissau,2,0,Friendly,Penafiel,Angola,False,2,2,Angola
35808,38152,40624,2019,Nigeria,Zimbabwe,0,0,Friendly,Asaba,Nigeria,False,0,0,Draw
35809,38153,40625,2019,Singapore,Solomon Islands,4,3,Friendly,Kallang,Singapore,False,7,1,Singapore
35810,38154,40629,2019,Brazil,Honduras,7,0,Friendly,Porto Alegre,Brazil,False,7,7,Brazil
35811,38155,40630,2019,Cameroon,Zambia,2,1,Friendly,Majadahonda,Cameroon,False,3,1,Cameroon
35812,38156,40631,2019,DR Congo,Burkina Faso,0,0,Friendly,Marbella,Spain,True,0,0,Draw
35813,38157,40632,2019,Mexico,Ecuador,3,2,Friendly,Arlington,United States,True,5,1,Mexico
35814,38158,40633,2019,Paraguay,Guatemala,2,0,Friendly,Asuncion,Paraguay,False,2,2,Paraguay
35815,38159,40634,2019,Peru,Colombia,0,3,Friendly,Lima,Peru,False,3,-3,Colombia
35816,38160,40635,2019,Turkmenistan,Uganda,0,0,Friendly,Abu Dhabi,United Arab Emirates,True,0,0,Draw
35817,38161,40636,2019,United States,Venezuela,0,3,Friendly,Cincinnati,United States,False,3,-3,Venezuela
35818,38162,40637,2019,Switzerland,England,0,0,UEFA Nations League,Guimaraes,Portugal,True,0,0,Draw
35819,38163,40638,2019,Portugal,Netherlands,1,0,UEFA Nations League,Porto,Portugal,False,1,1,Portugal
35820,38164,40640,2019,Czech Republic,Montenegro,3,0,UEFA Euro qualification,Olomouc,Czech Republic,False,3,3,Czech Republic
35821,38165,40641,2019,Bulgaria,Kosovo,2,3,UEFA Euro qualification,Sofia,Bulgaria,False,5,-1,Kosovo
35822,38166,40642,2019,Serbia,Lithuania,4,1,UEFA Euro qualification,Belgrade,Serbia,False,5,3,Serbia
35823,38167,40643,2019,Ukraine,Luxembourg,1,0,UEFA Euro qualification,Lviv,Ukraine,False,1,1,Ukraine
35824,38168,40644,2019,Republic of Ireland,Gibraltar,2,0,UEFA Euro qualification,Dublin,Republic of Ireland,False,2,2,Republic of Ireland
35825,38169,40645,2019,Denmark,Georgia,5,1,UEFA Euro qualification,Copenhagen,Denmark,False,6,4,Denmark
35826,38170,40646,2019,Faroe Islands,Norway,0,2,UEFA Euro qualification,Tórshavn,Faroe Islands,False,2,-2,Norway
35827,38171,40647,2019,Malta,Romania,0,4,UEFA Euro qualification,Attard,Malta,False,4,-4,Romania
35828,38172,40648,2019,Spain,Sweden,3,0,UEFA Euro qualification,Madrid,Spain,False,3,3,Spain
35829,38173,40650,2019,Poland,Israel,4,0,UEFA Euro qualification,Warsaw,Poland,False,4,4,Poland
35830,38174,40651,2019,Latvia,Slovenia,0,5,UEFA Euro qualification,Riga,Latvia,False,5,-5,Slovenia
35831,38175,40652,2019,Vanuatu,Fiji,0,0,Friendly,Port Vila,Vanuatu,False,0,0,Draw
35832,38176,40653,2019,Germany,Estonia,8,0,UEFA Euro qualification,Mainz,Germany,False,8,8,Germany
35833,38177,40654,2019,Belarus,Northern Ireland,0,1,UEFA Euro qualification,Borisov,Belarus,False,1,-1,Northern Ireland
35834,38178,40655,2019,Azerbaijan,Slovakia,1,5,UEFA Euro qualification,Baku,Azerbaijan,False,6,-4,Slovakia
35835,38179,40656,2019,Hungary,Wales,1,0,UEFA Euro qualification,Budapest,Hungary,False,1,1,Hungary
35836,38180,40657,2019,Iceland,Turkey,2,1,UEFA Euro qualification,Reykjavík,Iceland,False,3,1,Iceland
35837,38181,40658,2019,Albania,Moldova,2,0,UEFA Euro qualification,Elbasan,Albania,False,2,2,Albania
35838,38182,40659,2019,Andorra,France,0,4,UEFA Euro qualification,Andorra la Vella,Andorra,False,4,-4,France
35839,38183,40660,2019,Kazakhstan,San Marino,4,0,UEFA Euro qualification,Nur-Sultan,Kazakhstan,False,4,4,Kazakhstan
35840,38184,40661,2019,Belgium,Scotland,3,0,UEFA Euro qualification,Brussels,Belgium,False,3,3,Belgium
35841,38185,40662,2019,Russia,Cyprus,1,0,UEFA Euro qualification,Nizhny Novgorod,Russia,False,1,1,Russia
35842,38186,40663,2019,Italy,Bosnia and Herzegovina,2,1,UEFA Euro qualification,Turin,Italy,False,3,1,Italy
35843,38187,40664,2019,Liechtenstein,Finland,0,2,UEFA Euro qualification,Vaduz,Liechtenstein,False,2,-2,Finland
35844,38188,40665,2019,Greece,Armenia,2,3,UEFA Euro qualification,Athens,Greece,False,5,-1,Armenia
35845,38189,40666,2019,Algeria,Burundi,1,1,Friendly,Doha,Qatar,True,2,0,Draw
35846,38190,40667,2019,Benin,Guinea,1,0,Friendly,Marrakech,Morocco,True,1,1,Benin
35847,38191,40669,2019,Croatia,Tunisia,1,2,Friendly,Varaždin,Croatia,False,3,-1,Tunisia
35848,38193,40671,2019,Jordan,Indonesia,4,1,Friendly,Amman,Jordan,False,5,3,Jordan
35849,38194,40673,2019,Kyrgyzstan,Palestine,2,2,Friendly,Bishkek,Kyrgyzstan,False,4,0,Draw
35850,38195,40674,2019,Singapore,Myanmar,1,2,Friendly,Kallang,Singapore,False,3,-1,Myanmar
35851,38196,40675,2019,Uzbekistan,Syria,2,0,Friendly,Tashkent,Uzbekistan,False,2,2,Uzbekistan
35852,38197,40676,2019,Morocco,Gambia,0,1,Friendly,Marrakech,Morocco,False,1,-1,Gambia
35853,38198,40678,2019,Egypt,Tanzania,1,0,Friendly,Alexandria,Egypt,False,1,1,Egypt
35854,38199,40679,2019,Cameroon,Mali,1,1,Friendly,Al Wakrah,Qatar,True,2,0,Draw
35855,38200,40680,2019,Madagascar,Mauritania,1,3,Friendly,Marrakech,Morocco,True,4,-2,Mauritania
35856,38201,40681,2019,Brazil,Bolivia,3,0,Copa América,São Paulo,Brazil,False,3,3,Brazil
35857,38202,40682,2019,Venezuela,Peru,0,0,Copa América,Porto Alegre,Brazil,True,0,0,Draw
35858,38203,40683,2019,Argentina,Colombia,0,2,Copa América,Salvador,Brazil,True,2,-2,Colombia
35859,38204,40684,2019,Canada,Martinique,4,0,Gold Cup,Los Angeles,United States,True,4,4,Canada
35860,38205,40685,2019,Mexico,Cuba,7,0,Gold Cup,Los Angeles,United States,True,7,7,Mexico
35861,38206,40686,2019,Ghana,South Africa,0,0,Friendly,Dubai,United Arab Emirates,True,0,0,Draw
35862,38207,40687,2019,Indonesia,Vanuatu,6,0,Friendly,Jakarta,Indonesia,False,6,6,Indonesia
35863,38208,40688,2019,Ivory Coast,Uganda,0,1,Friendly,Abu Dhabi,United Arab Emirates,True,1,-1,Uganda
35864,38209,40689,2019,Kenya,DR Congo,1,1,Friendly,Madrid,Spain,True,2,0,Draw
35865,38210,40690,2019,Tanzania,Zimbabwe,1,1,Friendly,Cairo,Egypt,True,2,0,Draw
35866,38213,40695,2019,Paraguay,Qatar,2,2,Copa América,Rio de Janeiro,Brazil,True,4,0,Draw
35867,38214,40696,2019,Uruguay,Ecuador,4,0,Copa América,Belo Horizonte,Brazil,True,4,4,Uruguay
35868,38215,40697,2019,Haiti,Bermuda,2,1,Gold Cup,San José,Jamaica,True,3,1,Haiti
35869,38216,40698,2019,Costa Rica,Nicaragua,4,0,Gold Cup,San José,Jamaica,True,4,4,Costa Rica
35870,38217,40699,2019,Algeria,Mali,3,2,Friendly,Doha,Qatar,True,5,1,Algeria
35871,38218,40700,2019,Egypt,Guinea,3,1,Friendly,Alexandria,Egypt,False,4,2,Egypt
35872,38219,40701,2019,Morocco,Zambia,2,3,Friendly,Marrakech,Morocco,False,5,-1,Zambia
35873,38220,40702,2019,Senegal,Nigeria,1,0,Friendly,Ismaila,Egypt,True,1,1,Senegal
35874,38224,40707,2019,Japan,Chile,0,4,Copa América,São Paulo,Brazil,True,4,-4,Chile
35875,38225,40708,2019,Curacao,El Salvador,0,1,Gold Cup,Kingston,Jamaica,True,1,-1,El Salvador
35876,38226,40709,2019,Jamaica,Honduras,3,2,Gold Cup,Kingston,Jamaica,False,5,1,Jamaica
35877,38227,40710,2019,Tunisia,Burundi,2,1,Friendly,Radès,Tunisia,False,3,1,Tunisia
35878,38229,40714,2019,Guernsey,Saint Helena,9,0,Inter Games Football Tournament,Anglesey,Wales,True,9,9,Guernsey
35879,38230,40715,2019,Bolivia,Peru,1,3,Copa América,Rio de Janeiro,Brazil,True,4,-2,Peru
35880,38231,40716,2019,Brazil,Venezuela,0,0,Copa América,Salvador,Brazil,False,0,0,Draw
35881,38232,40717,2019,Panama,Trinidad and Tobago,2,0,Gold Cup,Saint Paul,United States,True,2,2,Panama
35882,38233,40718,2019,United States,Guyana,4,0,Gold Cup,Saint Paul,United States,False,4,4,United States
35883,38234,40719,2019,Benin,Mauritania,3,1,Friendly,Marrakech,Morocco,True,4,2,Benin
35884,38235,40720,2019,Colombia,Qatar,1,0,Copa América,São Paulo,Brazil,True,1,1,Colombia
35885,38236,40721,2019,Argentina,Paraguay,1,1,Copa América,Belo Horizonte,Brazil,True,2,0,Draw
35886,38237,40722,2019,Cuba,Martinique,0,3,Gold Cup,Denver,United States,True,3,-3,Martinique
35887,38238,40723,2019,Mexico,Canada,3,1,Gold Cup,Denver,United States,True,4,2,Mexico
35888,38239,40724,2019,Ivory Coast,Zambia,4,1,Friendly,Abu Dhabi,United Arab Emirates,True,5,3,Ivory Coast
35889,38241,40729,2019,Isle of Man,Guernsey,2,3,Inter Games Football Tournament,Anglesey,Wales,True,5,-1,Guernsey
35890,38242,40730,2019,Uruguay,Japan,2,2,Copa América,Porto Alegre,Brazil,True,4,0,Draw
35891,38243,40731,2019,Nicaragua,Haiti,0,2,Gold Cup,Frisco,United States,True,2,-2,Haiti
35892,38244,40732,2019,Costa Rica,Bermuda,2,1,Gold Cup,Frisco,United States,True,3,1,Costa Rica
35893,38245,40735,2019,Egypt,Zimbabwe,1,0,African Cup of Nations,Cairo,Egypt,False,1,1,Egypt
35894,38246,40736,2019,Ecuador,Chile,1,2,Copa América,Salvador,Brazil,True,3,-1,Chile
35895,38247,40737,2019,El Salvador,Jamaica,0,0,Gold Cup,Houston,United States,True,0,0,Draw
35896,38248,40738,2019,Honduras,Curacao,0,1,Gold Cup,Houston,United States,True,1,-1,Curacao
35897,38249,40739,2019,DR Congo,Uganda,0,2,African Cup of Nations,Cairo,Egypt,True,2,-2,Uganda
35898,38250,40740,2019,Nigeria,Burundi,1,0,African Cup of Nations,Alexandria,Egypt,True,1,1,Nigeria
35899,38251,40741,2019,Guinea,Madagascar,2,2,African Cup of Nations,Alexandria,Egypt,True,4,0,Draw
35900,38252,40742,2019,Bolivia,Venezuela,1,3,Copa América,Belo Horizonte,Brazil,True,4,-2,Venezuela
35901,38253,40743,2019,Peru,Brazil,0,5,Copa América,São Paulo,Brazil,True,5,-5,Brazil
35902,38254,40744,2019,Guyana,Panama,2,4,Gold Cup,Cleveland,United States,True,6,-2,Panama
35903,38255,40745,2019,United States,Trinidad and Tobago,6,0,Gold Cup,Cleveland,United States,False,6,6,United States
35904,38256,40746,2019,Senegal,Tanzania,2,0,African Cup of Nations,Cairo,Egypt,True,2,2,Senegal
35905,38257,40747,2019,Algeria,Kenya,2,0,African Cup of Nations,Cairo,Egypt,True,2,2,Algeria
35906,38258,40748,2019,Morocco,Namibia,1,0,African Cup of Nations,Cairo,Egypt,True,1,1,Morocco
35907,38259,40749,2019,Colombia,Paraguay,1,0,Copa América,Salvador,Brazil,True,1,1,Colombia
35908,38260,40750,2019,Qatar,Argentina,0,2,Copa América,Porto Alegre,Brazil,True,2,-2,Argentina
35909,38261,40751,2019,Canada,Cuba,7,0,Gold Cup,Charlotte,United States,True,7,7,Canada
35910,38262,40752,2019,Martinique,Mexico,2,3,Gold Cup,Charlotte,United States,True,5,-1,Mexico
35911,38263,40753,2019,Ivory Coast,South Africa,1,0,African Cup of Nations,Cairo,Egypt,True,1,1,Ivory Coast
35912,38264,40754,2019,Tunisia,Angola,1,1,African Cup of Nations,Suez,Egypt,True,2,0,Draw
35913,38265,40755,2019,Mali,Mauritania,4,1,African Cup of Nations,Suez,Egypt,True,5,3,Mali
35914,38266,40756,2019,Chile,Uruguay,0,1,Copa América,Rio de Janeiro,Brazil,True,1,-1,Uruguay
35915,38267,40757,2019,Ecuador,Japan,1,1,Copa América,Belo Horizonte,Brazil,True,2,0,Draw
35916,38268,40758,2019,Bermuda,Nicaragua,2,0,Gold Cup,New Jersey,United States,True,2,2,Bermuda
35917,38269,40759,2019,Haiti,Costa Rica,2,1,Gold Cup,New Jersey,United States,True,3,1,Haiti
35918,38270,40760,2019,Cameroon,Guinea-Bissau,2,0,African Cup of Nations,Ismailia,Egypt,True,2,2,Cameroon
35919,38271,40761,2019,Ghana,Benin,2,2,African Cup of Nations,Ismailia,Egypt,True,4,0,Draw
35920,38272,40762,2019,Jamaica,Curacao,1,1,Gold Cup,Los Angeles,United States,True,2,0,Draw
35921,38273,40763,2019,Honduras,El Salvador,4,0,Gold Cup,Los Angeles,United States,True,4,4,Honduras
35922,38274,40764,2019,Uganda,Zimbabwe,1,1,African Cup of Nations,Cairo,Egypt,True,2,0,Draw
35923,38275,40765,2019,Egypt,DR Congo,2,0,African Cup of Nations,Cairo,Egypt,False,2,2,Egypt
35924,38276,40766,2019,Nigeria,Guinea,1,0,African Cup of Nations,Alexandria,Egypt,True,1,1,Nigeria
35925,38277,40767,2019,Trinidad and Tobago,Guyana,1,1,Gold Cup,Kansas City,United States,True,2,0,Draw
35926,38278,40768,2019,United States,Panama,1,0,Gold Cup,Kansas City,United States,False,1,1,United States
35927,38279,40769,2019,Madagascar,Burundi,1,0,African Cup of Nations,Alexandria,Egypt,True,1,1,Madagascar
35928,38280,40770,2019,Senegal,Algeria,0,1,African Cup of Nations,Cairo,Egypt,True,1,-1,Algeria
35929,38281,40771,2019,Kenya,Tanzania,3,2,African Cup of Nations,Cairo,Egypt,True,5,1,Kenya
35930,38282,40772,2019,Brazil,Paraguay,0,0,Copa América,Porto Alegre,Brazil,False,0,0,Draw
35931,38283,40773,2019,Morocco,Ivory Coast,1,0,African Cup of Nations,Cairo,Egypt,True,1,1,Morocco
35932,38284,40774,2019,South Africa,Namibia,1,0,African Cup of Nations,Cairo,Egypt,True,1,1,South Africa
35933,38285,40775,2019,Tunisia,Mali,1,1,African Cup of Nations,Suez,Egypt,True,2,0,Draw
35934,38286,40776,2019,Colombia,Chile,0,0,Copa América,São Paulo,Brazil,True,0,0,Draw
35935,38287,40777,2019,Venezuela,Argentina,0,2,Copa América,Rio de Janeiro,Brazil,True,2,-2,Argentina
35936,38288,40778,2019,Mauritania,Angola,0,0,African Cup of Nations,Suez,Egypt,True,0,0,Draw
35937,38289,40779,2019,Cameroon,Ghana,0,0,African Cup of Nations,Ismailia,Egypt,True,0,0,Draw
35938,38290,40780,2019,Benin,Guinea-Bissau,0,0,African Cup of Nations,Ismailia,Egypt,True,0,0,Draw
35939,38291,40781,2019,Uruguay,Peru,0,0,Copa América,Salvador,Brazil,True,0,0,Draw
35940,38292,40782,2019,Haiti,Canada,3,2,Gold Cup,Houston,United States,True,5,1,Haiti
35941,38293,40783,2019,Mexico,Costa Rica,1,1,Gold Cup,Houston,United States,True,2,0,Draw
35942,38294,40784,2019,Egypt,Uganda,2,0,African Cup of Nations,Cairo,Egypt,False,2,2,Egypt
35943,38295,40785,2019,Zimbabwe,DR Congo,0,4,African Cup of Nations,Cairo,Egypt,True,4,-4,DR Congo
35944,38296,40786,2019,Burundi,Guinea,0,2,African Cup of Nations,Cairo,Egypt,True,2,-2,Guinea
35945,38297,40787,2019,Madagascar,Nigeria,2,0,African Cup of Nations,Alexandria,Egypt,True,2,2,Madagascar
35946,38298,40788,2019,Jamaica,Panama,1,0,Gold Cup,Philadelphia,United States,True,1,1,Jamaica
35947,38299,40789,2019,United States,Curacao,1,0,Gold Cup,Philadelphia,United States,False,1,1,United States
35948,38300,40790,2019,Kenya,Senegal,0,3,African Cup of Nations,Cairo,Egypt,True,3,-3,Senegal
35949,38301,40791,2019,Tanzania,Algeria,0,3,African Cup of Nations,Cairo,Egypt,True,3,-3,Algeria
35950,38302,40792,2019,Namibia,Ivory Coast,1,4,African Cup of Nations,Cairo,Egypt,True,5,-3,Ivory Coast
35951,38303,40793,2019,South Africa,Morocco,0,1,African Cup of Nations,Cairo,Egypt,True,1,-1,Morocco
35952,38304,40794,2019,Angola,Mali,0,1,African Cup of Nations,Ismailia,Egypt,True,1,-1,Mali
35953,38305,40795,2019,Mauritania,Tunisia,0,0,African Cup of Nations,Suez,Egypt,True,0,0,Draw
35954,38306,40796,2019,Benin,Cameroon,0,0,African Cup of Nations,Ismailia,Egypt,True,0,0,Draw
35955,38307,40797,2019,Guinea-Bissau,Ghana,0,2,African Cup of Nations,Suez,Egypt,True,2,-2,Ghana
35956,38308,40798,2019,Brazil,Argentina,2,0,Copa América,Belo Horizonte,Brazil,False,2,2,Brazil
35957,38309,40799,2019,Haiti,Mexico,0,1,Gold Cup,Glendale,United States,True,1,-1,Mexico
35958,38310,40800,2019,Chile,Peru,0,3,Copa América,Porto Alegre,Brazil,True,3,-3,Peru
35959,38311,40801,2019,United States,Jamaica,3,1,Gold Cup,Nashville,United States,False,4,2,United States
35960,38312,40802,2019,Morocco,Benin,1,1,African Cup of Nations,Cairo,Egypt,True,2,0,Draw
35961,38313,40803,2019,Uganda,Senegal,0,1,African Cup of Nations,Cairo,Egypt,True,1,-1,Senegal
35962,38314,40804,2019,Egypt,South Africa,0,1,African Cup of Nations,Cairo,Egypt,False,1,-1,South Africa
35963,38315,40805,2019,Nigeria,Cameroon,3,2,African Cup of Nations,Alexandria,Egypt,True,5,1,Nigeria
35964,38316,40806,2019,Argentina,Chile,2,1,Copa América,São Paulo,Brazil,True,3,1,Argentina
35965,38317,40807,2019,Algeria,Guinea,3,0,African Cup of Nations,Cairo,Egypt,True,3,3,Algeria
35966,38318,40808,2019,Madagascar,DR Congo,2,2,African Cup of Nations,Alexandria,Egypt,True,4,0,Draw
35967,38319,40809,2019,Brazil,Peru,3,1,Copa América,Rio de Janeiro,Brazil,False,4,2,Brazil
35968,38320,40810,2019,United States,Mexico,0,1,Gold Cup,Chicago,United States,False,1,-1,Mexico
35969,38321,40811,2019,India,Tajikistan,2,4,Intercontinental Cup,Ahmedabad,India,False,6,-2,Tajikistan
35970,38322,40812,2019,Ghana,Tunisia,1,1,African Cup of Nations,Ismaila,Egypt,True,2,0,Draw
35971,38323,40813,2019,Mali,Ivory Coast,0,1,African Cup of Nations,Suez,Egypt,True,1,-1,Ivory Coast
35972,38324,40814,2019,Samoa,Papua New Guinea,0,6,Pacific Games,Apia,Samoa,False,6,-6,Papua New Guinea
35973,38325,40815,2019,American Samoa,New Caledonia,0,5,Pacific Games,Apia,Samoa,True,5,-5,New Caledonia
35974,38326,40816,2019,Tuvalu,Solomon Islands,0,13,Pacific Games,Apia,Samoa,True,13,-13,Solomon Islands
35975,38328,40819,2019,Nigeria,South Africa,2,1,African Cup of Nations,Cairo,Egypt,True,3,1,Nigeria
35976,38329,40820,2019,Senegal,Benin,1,0,African Cup of Nations,Cairo,Egypt,True,1,1,Senegal
35977,38330,40821,2019,Papua New Guinea,Vanuatu,2,0,Pacific Games,Apia,Samoa,True,2,2,Papua New Guinea
35978,38332,40823,2019,American Samoa,Fiji,0,9,Pacific Games,Apia,Samoa,True,9,-9,Fiji
35979,38333,40824,2019,Solomon Islands,New Caledonia,0,2,Pacific Games,Apia,Samoa,True,2,-2,New Caledonia
35980,38334,40825,2019,Tajikistan,Syria,2,0,Intercontinental Cup,Ahmedabad,India,True,2,2,Tajikistan
35981,38335,40826,2019,Ivory Coast,Algeria,1,1,African Cup of Nations,Suez,Egypt,True,2,0,Draw
35982,38336,40827,2019,Madagascar,Tunisia,0,3,African Cup of Nations,Cairo,Egypt,True,3,-3,Tunisia
35983,38337,40828,2019,Samoa,Tonga,2,0,Pacific Games,Apia,Samoa,False,2,2,Samoa
35984,38338,40829,2019,American Samoa,Tuvalu,1,1,Pacific Games,Apia,Samoa,True,2,0,Draw
35985,38340,40831,2019,New Caledonia,Fiji,1,0,Pacific Games,Apia,Samoa,True,1,1,New Caledonia
35986,38342,40833,2019,Algeria,Nigeria,2,1,African Cup of Nations,Cairo,Egypt,True,3,1,Algeria
35987,38343,40834,2019,Senegal,Tunisia,1,0,African Cup of Nations,Cairo,Egypt,True,1,1,Senegal
35988,38344,40835,2019,Tonga,Vanuatu,0,14,Pacific Games,Apia,Samoa,True,14,-14,Vanuatu
35989,38345,40836,2019,Fiji,Tuvalu,10,1,Pacific Games,Apia,Samoa,True,11,9,Fiji
35990,38346,40837,2019,Solomon Islands,American Samoa,13,0,Pacific Games,Apia,Samoa,True,13,13,Solomon Islands
35991,38347,40840,2019,India,Syria,1,1,Intercontinental Cup,Ahmedabad,India,False,2,0,Draw
35992,38348,40841,2019,Tunisia,Nigeria,0,1,African Cup of Nations,Cairo,Egypt,True,1,-1,Nigeria
35993,38349,40842,2019,Papua New Guinea,Tonga,8,0,Pacific Games,Apia,Samoa,True,8,8,Papua New Guinea
35994,38350,40843,2019,Samoa,Vanuatu,0,11,Pacific Games,Apia,Samoa,False,11,-11,Vanuatu
35995,38351,40844,2019,New Caledonia,Tuvalu,11,0,Pacific Games,Apia,Samoa,True,11,11,New Caledonia
35996,38353,40846,2019,Fiji,Solomon Islands,4,4,Pacific Games,Apia,Samoa,True,8,0,Draw
35997,38354,40847,2019,Senegal,Algeria,0,1,African Cup of Nations,Cairo,Egypt,True,1,-1,Algeria
35998,38356,40849,2019,Papua New Guinea,Fiji,1,1,Pacific Games,Apia,Samoa,True,2,0,Draw
35999,38357,40850,2019,Equatorial Guinea,Liberia,1,1,Friendly,Malabo,Equatorial Guinea,False,2,0,Draw
36000,38358,40852,2019,Dominican Republic,Guatemala,0,0,Friendly,Santiago de los Caballeros,Dominican Republic,False,0,0,Draw
36001,38360,40856,2019,United Arab Emirates,Dominican Republic,4,0,Friendly,Riffa,Bahrain,True,4,4,United Arab Emirates
36002,38362,40859,2019,Malaysia,Jordan,0,1,Friendly,Kuala Lumpur,Malaysia,False,1,-1,Jordan
36003,38363,40860,2019,United Arab Emirates,Sri Lanka,5,1,Friendly,Riffa,Bahrain,True,6,4,United Arab Emirates
36004,38364,40861,2019,Libya,Burkina Faso,0,1,Friendly,Marrakech,Morocco,True,1,-1,Burkina Faso
36005,38365,40862,2019,Argentina,Chile,0,0,Friendly,Los Angeles,United States,True,0,0,Draw
36006,38366,40863,2019,Honduras,Puerto Rico,4,0,Friendly,Tegucigalpa,Honduras,False,4,4,Honduras
36007,38367,40865,2019,Montenegro,Hungary,2,1,Friendly,Podgorica,Montenegro,False,3,1,Montenegro
36008,38368,40866,2019,Northern Ireland,Luxembourg,1,0,Friendly,Belfast,Northern Ireland,False,1,1,Northern Ireland
36009,38369,40867,2019,Peru,Ecuador,0,1,Friendly,Harrison,United States,True,1,-1,Ecuador
36010,38370,40868,2019,Saudi Arabia,Mali,1,1,Friendly,Riyadh,Saudi Arabia,False,2,0,Draw
36011,38371,40869,2019,Republic of Ireland,Switzerland,1,1,UEFA Euro qualification,Dublin,Republic of Ireland,False,2,0,Draw
36012,38372,40870,2019,Gibraltar,Denmark,0,6,UEFA Euro qualification,Gibraltar,Gibraltar,False,6,-6,Denmark
36013,38373,40871,2019,Faroe Islands,Sweden,0,4,UEFA Euro qualification,Tórshavn,Faroe Islands,False,4,-4,Sweden
36014,38374,40872,2019,Norway,Malta,2,0,UEFA Euro qualification,Oslo,Norway,False,2,2,Norway
36015,38375,40873,2019,Romania,Spain,1,2,UEFA Euro qualification,Bucharest,Romania,False,3,-1,Spain
36016,38377,40875,2019,Armenia,Italy,1,3,UEFA Euro qualification,Yerevan,Armenia,False,4,-2,Italy
36017,38378,40876,2019,Bosnia and Herzegovina,Liechtenstein,5,0,UEFA Euro qualification,Zenica,Bosnia and Herzegovina,False,5,5,Bosnia and Herzegovina
36018,38379,40877,2019,Finland,Greece,1,0,UEFA Euro qualification,Tampere,Finland,False,1,1,Finland
36019,38380,40878,2019,Brazil,Colombia,2,2,Friendly,Miami Gardens,United States,True,4,0,Draw
36020,38381,40879,2019,Costa Rica,Uruguay,1,2,Friendly,San José,Costa Rica,False,3,-1,Uruguay
36021,38382,40880,2019,Ivory Coast,Benin,1,2,Friendly,Caen,Egypt,True,3,-1,Benin
36022,38383,40881,2019,Morocco,Burkina Faso,1,1,Friendly,Marrakech,Morocco,False,2,0,Draw
36023,38384,40882,2019,Tunisia,Mauritania,1,0,Friendly,Radès,Tunisia,False,1,1,Tunisia
36024,38385,40883,2019,United States,Mexico,0,3,Friendly,East Rutherford,United States,True,3,-3,Mexico
36025,38386,40884,2019,Estonia,Belarus,1,2,UEFA Euro qualification,Tallinn,Estonia,False,3,-1,Belarus
36026,38387,40885,2019,Germany,Netherlands,2,4,UEFA Euro qualification,Hamburg,Germany,False,6,-2,Netherlands
36027,38388,40886,2019,Wales,Azerbaijan,2,1,UEFA Euro qualification,Cardiff,Wales,False,3,1,Wales
36028,38389,40887,2019,Slovakia,Croatia,0,4,UEFA Euro qualification,Trnava,Slovakia,False,4,-4,Croatia
36029,38390,40888,2019,Austria,Latvia,6,0,UEFA Euro qualification,Salzburg,Austria,False,6,6,Austria
36030,38391,40889,2019,Slovenia,Poland,2,0,UEFA Euro qualification,Ljubljana,Slovenia,False,2,2,Slovenia
36031,38392,40890,2019,Cyprus,Kazakhstan,1,1,UEFA Euro qualification,Nicosia,Cyprus,False,2,0,Draw
36032,38393,40891,2019,Scotland,Russia,1,2,UEFA Euro qualification,Glasgow,Scotland,False,3,-1,Russia
36033,38394,40892,2019,San Marino,Belgium,0,4,UEFA Euro qualification,Serravalle,San Marino,False,4,-4,Belgium
36034,38395,40893,2019,Libya,Niger,2,0,Friendly,Berrechid,Egypt,True,2,2,Libya
36035,38396,40894,2019,Kosovo,Czech Republic,2,1,UEFA Euro qualification,Pristina,Kosovo,False,3,1,Kosovo
36036,38397,40895,2019,England,Bulgaria,4,0,UEFA Euro qualification,London,England,False,4,4,England
36037,38398,40896,2019,Lithuania,Ukraine,0,3,UEFA Euro qualification,Vilnius,Lithuania,False,3,-3,Ukraine
36038,38399,40897,2019,Serbia,Portugal,2,4,UEFA Euro qualification,Belgrade,Serbia,False,6,-2,Portugal
36039,38400,40898,2019,Iceland,Moldova,3,0,UEFA Euro qualification,Reykjavík,Iceland,False,3,3,Iceland
36040,38401,40899,2019,France,Albania,4,1,UEFA Euro qualification,Paris,France,False,5,3,France
36041,38402,40900,2019,Turkey,Andorra,1,0,UEFA Euro qualification,Istanbul,Turkey,False,1,1,Turkey
36042,38403,40901,2019,Kenya,Uganda,1,1,Friendly,Nairobi,Kenya,False,2,0,Draw
36043,38404,40902,2019,Switzerland,Gibraltar,4,0,UEFA Euro qualification,Sion,Switzerland,False,4,4,Switzerland
36044,38405,40903,2019,Georgia,Denmark,0,0,UEFA Euro qualification,Tbilisi,Georgia,False,0,0,Draw
36045,38406,40904,2019,Romania,Malta,1,0,UEFA Euro qualification,Ploiești,Romania,False,1,1,Romania
36046,38407,40905,2019,Spain,Faroe Islands,4,0,UEFA Euro qualification,Gijon,Egypt,True,4,4,Spain
36047,38408,40906,2019,Sweden,Norway,1,1,UEFA Euro qualification,Stockholm,Sweden,False,2,0,Draw
36048,38409,40907,2019,Armenia,Bosnia and Herzegovina,4,2,UEFA Euro qualification,Yerevan,Armenia,False,6,2,Armenia
36049,38410,40908,2019,Finland,Italy,1,2,UEFA Euro qualification,Tampere,Finland,False,3,-1,Italy
36050,38411,40909,2019,Greece,Liechtenstein,1,1,UEFA Euro qualification,Athens,Greece,False,2,0,Draw
36051,38412,40910,2019,Algeria,Benin,1,0,Friendly,Algiers,Algeria,False,1,1,Algeria
36052,38413,40911,2019,Iraq,Uzbekistan,0,0,Friendly,Amman,Jordan,True,0,0,Draw
36053,38414,40912,2019,Wales,Belarus,1,0,Friendly,Cardiff,Wales,False,1,1,Wales
36054,38415,40913,2019,Northern Ireland,Germany,0,2,UEFA Euro qualification,Belfast,Northern Ireland,False,2,-2,Germany
36055,38416,40914,2019,Estonia,Netherlands,0,4,UEFA Euro qualification,Tallinn,Estonia,False,4,-4,Netherlands
36056,38417,40915,2019,Azerbaijan,Croatia,1,1,UEFA Euro qualification,Baku,Azerbaijan,False,2,0,Draw
36057,38418,40916,2019,Hungary,Slovakia,1,2,UEFA Euro qualification,Budapest,Hungary,False,3,-1,Slovakia
36058,38419,40917,2019,Poland,Austria,0,0,UEFA Euro qualification,Warsaw,Poland,False,0,0,Draw
36059,38420,40918,2019,Slovenia,Israel,3,2,UEFA Euro qualification,Ljubljana,Slovenia,False,5,1,Slovenia
36060,38422,40920,2019,Scotland,Belgium,0,4,UEFA Euro qualification,Glasgow,Scotland,False,4,-4,Belgium
36061,38423,40921,2019,Russia,Kazakhstan,1,0,UEFA Euro qualification,Kaliningrad,Russia,False,1,1,Russia
36062,38424,40922,2019,San Marino,Cyprus,0,4,UEFA Euro qualification,Serravalle,San Marino,False,4,-4,Cyprus
36063,38425,40923,2019,Argentina,Mexico,4,0,Friendly,San Antonio,United States,True,4,4,Argentina
36064,38426,40924,2019,Brazil,Peru,0,1,Friendly,Los Angeles,United States,True,1,-1,Peru
36065,38427,40925,2019,Colombia,Venezuela,0,0,Friendly,Tampa,United States,True,0,0,Draw
36066,38428,40926,2019,Ecuador,Bolivia,3,0,Friendly,Cuenca,Ecuador,False,3,3,Ecuador
36067,38429,40927,2019,Honduras,Chile,2,1,Friendly,San Pedro Sula,Honduras,False,3,1,Honduras
36068,38430,40928,2019,Ivory Coast,Tunisia,2,1,Friendly,Rouen,France,True,3,1,Ivory Coast
36069,38431,40929,2019,Jordan,Paraguay,2,4,Friendly,Amman,Jordan,False,6,-2,Paraguay
36070,38432,40930,2019,Morocco,Niger,1,0,Friendly,Marrakech,Morocco,False,1,1,Morocco
36071,38433,40931,2019,Oman,Lebanon,1,0,Friendly,Muscat,Oman,False,1,1,Oman
36072,38434,40932,2019,Republic of Ireland,Bulgaria,3,1,Friendly,Dublin,Republic of Ireland,False,4,2,Republic of Ireland
36073,38435,40933,2019,Ukraine,Nigeria,2,2,Friendly,Dnipro,Egypt,True,4,0,Draw
36074,38436,40934,2019,United States,Uruguay,1,1,Friendly,St Louis,Egypt,True,2,0,Draw
36075,38437,40935,2019,England,Kosovo,5,3,UEFA Euro qualification,London,England,False,8,2,England
36076,38438,40936,2019,Montenegro,Czech Republic,0,3,UEFA Euro qualification,Podgorica,Montenegro,False,3,-3,Czech Republic
36077,38439,40937,2019,Luxembourg,Serbia,1,3,UEFA Euro qualification,Luxembourg City,Luxembourg,False,4,-2,Serbia
36078,38440,40938,2019,Lithuania,Portugal,1,5,UEFA Euro qualification,Vilnius,Lithuania,False,6,-4,Portugal
36079,38441,40939,2019,Albania,Iceland,4,2,UEFA Euro qualification,Elbasan,Albania,False,6,2,Albania
36080,38442,40940,2019,France,Andorra,3,0,UEFA Euro qualification,Paris,France,False,3,3,France
36081,38443,40941,2019,Moldova,Turkey,0,4,UEFA Euro qualification,Chișinău,Moldova,False,4,-4,Turkey
36082,38444,40942,2019,DR Congo,Rwanda,2,3,Friendly,Kinshasa,DR Congo,True,5,-1,Rwanda
36083,38445,40943,2019,Bangladesh,Bhutan,4,1,Friendly,Dhaka,Bangladesh,False,5,3,Bangladesh
36084,38446,40944,2019,Botswana,Liberia,0,0,Friendly,Gaborone,Botswana,False,0,0,Draw
